2020-01-01 00:00:10,1,1,19316,2621,16695,29.47%,13.57%
2020-01-01 00:00:10,1,2,4689,166,4523,7.15%,3.54%
2020-01-01 00:00:10,1,3,855,7,848,1.30%,0.82%
2020-01-01 00:00:10,1,4,14277,1499,12778,21.78%,10.50%
2020-01-01 00:00:10,1,5,13771,1401,12370,21.01%,10.17%
2020-01-01 00:00:10,1,6,13676,1384,12292,20.87%,10.12%
2020-01-01 00:00:10,1,7,3810,117,3693,5.81%,3.07%
2020-01-01 00:00:10,1,8,2981,55,2926,4.55%,1.85%
2020-01-01 00:00:10,1,9,13642,1378,12264,20.82%,10.10%
2020-01-01 00:00:10,1,10,2642,47,2595,4.03%,1.78%
2020-01-01 00:00:10,1,11,2690,48,2642,4.10%,1.78%
2020-01-01 00:00:10,1,12,13614,1371,12243,20.77%,10.07%
2020-01-01 00:00:10,2,1,455,1,454,0.69%,0.22%
2020-01-01 00:00:10,2,2,27614,5000,22614,42.14%,18.11%
2020-01-01 00:00:10,2,3,22691,3470,19221,34.62%,15.29%
2020-01-01 00:00:10,2,4,349,0,349,0.53%,0.00%
2020-01-01 00:00:10,2,5,13442,1262,12180,20.51%,9.39%
2020-01-01 00:00:10,2,6,58,0,58,0.09%,0.00%
2020-01-01 00:00:10,2,7,4455,153,4302,6.80%,3.43%
2020-01-01 00:00:10,2,8,3264,83,3181,4.98%,2.54%
2020-01-01 00:00:10,2,9,13410,1257,12153,20.46%,9.37%
2020-01-01 00:00:10,2,10,2549,58,2491,3.89%,2.28%
2020-01-01 00:00:10,2,11,2555,58,2497,3.90%,2.27%
2020-01-01 00:00:10,2,12,13264,1235,12029,20.24%,9.31%
2020-01-01 00:00:10,3,1,1770,36,1734,2.70%,2.03%
2020-01-01 00:00:10,3,2,22512,3380,19132,34.35%,15.01%
2020-01-01 00:00:10,3,3,71519,27951,43568,109.13%,39.08%
2020-01-01 00:00:10,3,4,7290,398,6892,11.12%,5.46%
2020-01-01 00:00:10,3,5,47833,13870,33963,72.99%,29.00%
2020-01-01 00:00:10,3,6,8484,517,7967,12.95%,6.09%
2020-01-01 00:00:10,3,7,19137,2431,16706,29.20%,12.70%
2020-01-01 00:00:10,3,8,15850,1683,14167,24.19%,10.62%
2020-01-01 00:00:10,3,9,38921,9587,29334,59.39%,24.63%
2020-01-01 00:00:10,3,10,6409,315,6094,9.78%,4.91%
2020-01-01 00:00:10,3,11,1880,21,1859,2.87%,1.12%
2020-01-01 00:00:10,3,12,28507,5411,23096,43.50%,18.98%
2020-01-01 00:00:10,4,1,457,0,457,0.70%,0.00%
2020-01-01 00:00:10,4,2,240,0,240,0.37%,0.00%
2020-01-01 00:00:10,4,3,846,6,840,1.29%,0.71%
2020-01-01 00:00:10,4,4,28679,5480,23199,43.76%,19.11%
2020-01-01 00:00:10,4,5,17674,2197,15477,26.97%,12.43%
2020-01-01 00:00:10,4,6,24282,4002,20280,37.05%,16.48%
2020-01-01 00:00:10,4,7,5262,225,5037,8.03%,4.28%
2020-01-01 00:00:10,4,8,2475,43,2432,3.78%,1.74%
2020-01-01 00:00:10,4,9,15488,1722,13766,23.63%,11.12%
2020-01-01 00:00:10,4,10,2009,36,1973,3.07%,1.79%
2020-01-01 00:00:10,4,11,99,0,99,0.15%,0.00%
2020-01-01 00:00:10,4,12,12666,1158,11508,19.33%,9.14%
2020-01-01 00:00:10,5,1,2763,57,2706,4.22%,2.06%
2020-01-01 00:00:10,5,2,734,6,728,1.12%,0.82%
2020-01-01 00:00:10,5,3,431,3,428,0.66%,0.70%
2020-01-01 00:00:10,5,4,24608,4058,20550,37.55%,16.49%
2020-01-01 00:00:10,5,5,10617,836,9781,16.20%,7.87%
2020-01-01 00:00:10,5,6,15392,1706,13686,23.49%,11.08%
2020-01-01 00:00:10,5,7,4326,179,4147,6.60%,4.14%
2020-01-01 00:00:10,5,8,3335,106,3229,5.09%,3.18%
2020-01-01 00:00:10,5,9,9994,747,9247,15.25%,7.47%
2020-01-01 00:00:10,5,10,1152,13,1139,1.76%,1.13%
2020-01-01 00:00:10,5,11,699,6,693,1.07%,0.86%
2020-01-01 00:00:10,5,12,8361,525,7836,12.76%,6.28%
2020-01-01 00:00:10,6,1,1097,6,1091,1.67%,0.55%
2020-01-01 00:00:10,6,2,1189,6,1183,1.81%,0.50%
2020-01-01 00:00:10,6,3,1616,19,1597,2.47%,1.18%
2020-01-01 00:00:10,6,4,1487,14,1473,2.27%,0.94%
2020-01-01 00:00:10,6,5,12459,1082,11377,19.01%,8.68%
2020-01-01 00:00:10,6,6,4384,158,4226,6.69%,3.60%
2020-01-01 00:00:10,6,7,2324,44,2280,3.55%,1.89%
2020-01-01 00:00:10,6,8,1348,23,1325,2.06%,1.71%
2020-01-01 00:00:10,6,9,6123,238,5885,9.34%,3.89%
2020-01-01 00:00:10,6,10,1966,22,1944,3.00%,1.12%
2020-01-01 00:00:10,6,11,472,4,468,0.72%,0.85%
2020-01-01 00:00:10,6,12,4090,115,3975,6.24%,2.81%
2020-01-01 00:00:10,7,1,515,1,514,0.79%,0.19%
2020-01-01 00:00:10,7,2,93,0,93,0.14%,0.00%
2020-01-01 00:00:10,7,3,434,1,433,0.66%,0.23%
2020-01-01 00:00:10,7,4,2367,31,2336,3.61%,1.31%
2020-01-01 00:00:10,7,5,7685,439,7246,11.73%,5.71%
2020-01-01 00:00:10,7,6,13273,1264,12009,20.25%,9.52%
2020-01-01 00:00:10,7,7,3147,67,3080,4.80%,2.13%
2020-01-01 00:00:10,7,8,1025,6,1019,1.56%,0.59%
2020-01-01 00:00:10,7,9,7075,361,6714,10.80%,5.10%
2020-01-01 00:00:10,7,10,1456,10,1446,2.22%,0.69%
2020-01-01 00:00:10,7,11,89,0,89,0.14%,0.00%
2020-01-01 00:00:10,7,12,5643,229,5414,8.61%,4.06%
2020-01-01 00:00:10,8,1,489,3,486,0.75%,0.61%
2020-01-01 00:00:10,8,2,103,0,103,0.16%,0.00%
2020-01-01 00:00:10,8,3,1209,6,1203,1.84%,0.50%
2020-01-01 00:00:10,8,4,2726,54,2672,4.16%,1.98%
2020-01-01 00:00:10,8,5,7572,395,7177,11.55%,5.22%
2020-01-01 00:00:10,8,6,16079,1829,14250,24.53%,11.38%
2020-01-01 00:00:10,8,7,5715,245,5470,8.72%,4.29%
2020-01-01 00:00:10,8,8,2190,41,2149,3.34%,1.87%
2020-01-01 00:00:10,8,9,6134,255,5879,9.36%,4.16%
2020-01-01 00:00:10,8,10,1415,10,1405,2.16%,0.71%
2020-01-01 00:00:10,8,11,262,0,262,0.40%,0.00%
2020-01-01 00:00:10,8,12,4620,160,4460,7.05%,3.46%
2020-01-01 00:00:10,9,1,282,1,281,0.43%,0.35%
2020-01-01 00:00:10,9,2,5244,190,5054,8.00%,3.62%
2020-01-01 00:00:10,9,3,4583,145,4438,6.99%,3.16%
2020-01-01 00:00:10,9,4,5755,241,5514,8.78%,4.19%
2020-01-01 00:00:10,9,5,391,2,389,0.60%,0.51%
2020-01-01 00:00:10,9,6,6672,330,6342,10.18%,4.95%
2020-01-01 00:00:10,9,7,28164,5259,22905,42.97%,18.67%
2020-01-01 00:00:10,9,8,10819,846,9973,16.51%,7.82%
2020-01-01 00:00:10,9,9,286,2,284,0.44%,0.70%
2020-01-01 00:00:10,9,10,3375,76,3299,5.15%,2.25%
2020-01-01 00:00:10,9,11,9645,678,8967,14.72%,7.03%
2020-01-01 00:00:10,9,12,5824,239,5585,8.89%,4.10%
2020-01-01 00:00:10,10,1,1421,172,1249,2.17%,12.10%
2020-01-01 00:00:10,10,2,4266,261,4005,6.51%,6.12%
2020-01-01 00:00:10,10,3,2654,46,2608,4.05%,1.73%
2020-01-01 00:00:10,10,4,3920,944,2976,5.98%,24.08%
2020-01-01 00:00:10,10,5,696,1,695,1.06%,0.14%
2020-01-01 00:00:10,10,6,5707,1027,4680,8.71%,18.00%
2020-01-01 00:00:10,10,7,11523,1798,9725,17.58%,15.60%
2020-01-01 00:00:10,10,8,29634,7401,22233,45.22%,24.97%
2020-01-01 00:00:10,10,9,588,2,586,0.90%,0.34%
2020-01-01 00:00:10,10,10,2207,39,2168,3.37%,1.77%
2020-01-01 00:00:10,10,11,13592,1877,11715,20.74%,13.81%
2020-01-01 00:00:10,10,12,10918,1411,9507,16.66%,12.92%
2020-01-01 00:00:10,11,1,2771,67,2704,4.23%,2.42%
2020-01-01 00:00:10,11,2,5014,199,4815,7.65%,3.97%
2020-01-01 00:00:10,11,3,2090,36,2054,3.19%,1.72%
2020-01-01 00:00:10,11,4,3728,145,3583,5.69%,3.89%
2020-01-01 00:00:10,11,5,167,0,167,0.25%,0.00%
2020-01-01 00:00:10,11,6,4445,189,4256,6.78%,4.25%
2020-01-01 00:00:10,11,7,11290,967,10323,17.23%,8.57%
2020-01-01 00:00:10,11,8,24344,4024,20320,37.15%,16.53%
2020-01-01 00:00:10,11,9,347,0,347,0.53%,0.00%
2020-01-01 00:00:10,11,10,2746,44,2702,4.19%,1.60%
2020-01-01 00:00:10,11,11,9430,639,8791,14.39%,6.78%
2020-01-01 00:00:10,11,12,6326,295,6031,9.65%,4.66%
2020-01-01 00:00:10,12,1,109,0,109,0.17%,0.00%
2020-01-01 00:00:10,12,2,688,218,470,1.05%,31.69%
2020-01-01 00:00:10,12,3,2526,255,2271,3.85%,10.10%
2020-01-01 00:00:10,12,4,2396,37,2359,3.66%,1.54%
2020-01-01 00:00:10,12,5,8321,725,7596,12.70%,8.71%
2020-01-01 00:00:10,12,6,5036,209,4827,7.68%,4.15%
2020-01-01 00:00:10,12,7,2373,64,2309,3.62%,2.70%
2020-01-01 00:00:10,12,8,1164,295,869,1.78%,25.34%
2020-01-01 00:00:10,12,9,21821,4289,17532,33.30%,19.66%
2020-01-01 00:00:10,12,10,4376,398,3978,6.68%,9.10%
2020-01-01 00:00:10,12,11,1597,299,1298,2.44%,18.72%
2020-01-01 00:00:10,12,12,8177,1134,7043,12.48%,13.87%
2020-01-01 00:00:10,13,1,2306,51,2255,3.52%,2.21%
2020-01-01 00:00:10,13,2,2743,69,2674,4.19%,2.52%
2020-01-01 00:00:10,13,3,669,6,663,1.02%,0.90%
2020-01-01 00:00:10,13,4,6217,627,5590,9.49%,10.09%
2020-01-01 00:00:10,13,5,8282,982,7300,12.64%,11.86%
2020-01-01 00:00:10,13,6,6797,676,6121,10.37%,9.95%
2020-01-01 00:00:10,13,7,5320,238,5082,8.12%,4.47%
2020-01-01 00:00:10,13,8,7369,407,6962,11.24%,5.52%
2020-01-01 00:00:10,13,9,8625,1033,7592,13.16%,11.98%
2020-01-01 00:00:10,13,10,28142,6070,22072,42.94%,21.57%
2020-01-01 00:00:10,13,11,16797,2470,14327,25.63%,14.71%
2020-01-01 00:00:10,13,12,8856,1127,7729,13.51%,12.73%
2020-01-01 00:00:10,14,1,250,0,250,0.38%,0.00%
2020-01-01 00:00:10,14,2,1493,9,1484,2.28%,0.60%
2020-01-01 00:00:10,14,3,986,6,980,1.50%,0.61%
2020-01-01 00:00:10,14,4,5512,234,5278,8.41%,4.25%
2020-01-01 00:00:10,14,5,1143,10,1133,1.74%,0.87%
2020-01-01 00:00:10,14,6,5649,249,5400,8.62%,4.41%
2020-01-01 00:00:10,14,7,13253,1299,11954,20.22%,9.80%
2020-01-01 00:00:10,14,8,14745,1545,13200,22.50%,10.48%
2020-01-01 00:00:10,14,9,1557,21,1536,2.38%,1.35%
2020-01-01 00:00:10,14,10,4451,134,4317,6.79%,3.01%
2020-01-01 00:00:10,14,11,28138,5280,22858,42.94%,18.76%
2020-01-01 00:00:10,14,12,8708,554,8154,13.29%,6.36%
2020-01-01 00:00:10,15,1,493,3,490,0.75%,0.61%
2020-01-01 00:00:10,15,2,197,2,195,0.30%,1.02%
2020-01-01 00:00:10,15,3,4011,121,3890,6.12%,3.02%
2020-01-01 00:00:10,15,4,5575,267,5308,8.51%,4.79%
2020-01-01 00:00:10,15,5,11140,948,10192,17.00%,8.51%
2020-01-01 00:00:10,15,6,5793,283,5510,8.84%,4.89%
2020-01-01 00:00:10,15,7,4328,154,4174,6.60%,3.56%
2020-01-01 00:00:10,15,8,7277,414,6863,11.10%,5.69%
2020-01-01 00:00:10,15,9,11338,974,10364,17.30%,8.59%
2020-01-01 00:00:10,15,10,4848,298,4550,7.40%,6.15%
2020-01-01 00:00:10,15,11,12296,1224,11072,18.76%,9.95%
2020-01-01 00:00:10,15,12,30680,6603,24077,46.81%,21.52%
2020-01-01 00:00:10,16,1,508,4,504,0.78%,0.79%
2020-01-01 00:00:10,16,2,244,1,243,0.37%,0.41%
2020-01-01 00:00:10,16,3,1365,18,1347,2.08%,1.32%
2020-01-01 00:00:10,16,4,4035,106,3929,6.16%,2.63%
2020-01-01 00:00:10,16,5,7317,411,6906,11.16%,5.62%
2020-01-01 00:00:10,16,6,4805,152,4653,7.33%,3.16%
2020-01-01 00:00:10,16,7,3885,114,3771,5.93%,2.93%
2020-01-01 00:00:10,16,8,8162,564,7598,12.45%,6.91%
2020-01-01 00:00:10,16,9,7778,453,7325,11.87%,5.82%
2020-01-01 00:00:10,16,10,1629,19,1610,2.49%,1.17%
2020-01-01 00:00:10,16,11,9945,784,9161,15.17%,7.88%
2020-01-01 00:00:10,16,12,25461,4438,21023,38.85%,17.43%
2020-01-01 00:00:20,1,1,20242,2935,17307,30.89%,14.50%
2020-01-01 00:00:20,1,2,9264,640,8624,14.14%,6.91%
2020-01-01 00:00:20,1,3,419,4,415,0.64%,0.95%
2020-01-01 00:00:20,1,4,10469,856,9613,15.97%,8.18%
2020-01-01 00:00:20,1,5,10125,810,9315,15.45%,8.00%
2020-01-01 00:00:20,1,6,10045,799,9246,15.33%,7.95%
2020-01-01 00:00:20,1,7,8823,574,8249,13.46%,6.51%
2020-01-01 00:00:20,1,8,6283,293,5990,9.59%,4.66%
2020-01-01 00:00:20,1,9,9976,789,9187,15.22%,7.91%
2020-01-01 00:00:20,1,10,5497,227,5270,8.39%,4.13%
2020-01-01 00:00:20,1,11,5674,239,5435,8.66%,4.21%
2020-01-01 00:00:20,1,12,9958,786,9172,15.19%,7.89%
2020-01-01 00:00:20,2,1,502,3,499,0.77%,0.60%
2020-01-01 00:00:20,2,2,22444,3468,18976,34.25%,15.45%
2020-01-01 00:00:20,2,3,17772,2209,15563,27.12%,12.43%
2020-01-01 00:00:20,2,4,403,1,402,0.61%,0.25%
2020-01-01 00:00:20,2,5,10332,760,9572,15.77%,7.36%
2020-01-01 00:00:20,2,6,45,0,45,0.07%,0.00%
2020-01-01 00:00:20,2,7,4149,132,4017,6.33%,3.18%
2020-01-01 00:00:20,2,8,3151,78,3073,4.81%,2.48%
2020-01-01 00:00:20,2,9,10296,755,9541,15.71%,7.33%
2020-01-01 00:00:20,2,10,2389,50,2339,3.65%,2.09%
2020-01-01 00:00:20,2,11,2405,50,2355,3.67%,2.08%
2020-01-01 00:00:20,2,12,10144,736,9408,15.48%,7.26%
2020-01-01 00:00:20,3,1,1465,19,1446,2.24%,1.30%
2020-01-01 00:00:20,3,2,24362,3970,20392,37.17%,16.30%
2020-01-01 00:00:20,3,3,75842,30671,45171,115.73%,40.44%
2020-01-01 00:00:20,3,4,12906,1194,11712,19.69%,9.25%
2020-01-01 00:00:20,3,5,50466,15107,35359,77.01%,29.94%
2020-01-01 00:00:20,3,6,14244,1424,12820,21.73%,10.00%
2020-01-01 00:00:20,3,7,21078,3011,18067,32.16%,14.29%
2020-01-01 00:00:20,3,8,17352,2113,15239,26.48%,12.18%
2020-01-01 00:00:20,3,9,35877,8232,27645,54.74%,22.95%
2020-01-01 00:00:20,3,10,5990,260,5730,9.14%,4.34%
2020-01-01 00:00:20,3,11,1893,26,1867,2.89%,1.37%
2020-01-01 00:00:20,3,12,25529,4335,21194,38.95%,16.98%
2020-01-01 00:00:20,4,1,616,1,615,0.94%,0.16%
2020-01-01 00:00:20,4,2,396,0,396,0.60%,0.00%
2020-01-01 00:00:20,4,3,746,3,743,1.14%,0.40%
2020-01-01 00:00:20,4,4,29003,5524,23479,44.26%,19.05%
2020-01-01 00:00:20,4,5,17944,2228,15716,27.38%,12.42%
2020-01-01 00:00:20,4,6,24713,4073,20640,37.71%,16.48%
2020-01-01 00:00:20,4,7,5716,241,5475,8.72%,4.22%
2020-01-01 00:00:20,4,8,3372,76,3296,5.15%,2.25%
2020-01-01 00:00:20,4,9,15866,1732,14134,24.21%,10.92%
2020-01-01 00:00:20,4,10,2023,45,1978,3.09%,2.22%
2020-01-01 00:00:20,4,11,135,0,135,0.21%,0.00%
2020-01-01 00:00:20,4,12,12548,1089,11459,19.15%,8.68%
2020-01-01 00:00:20,5,1,3065,76,2989,4.68%,2.48%
2020-01-01 00:00:20,5,2,754,5,749,1.15%,0.66%
2020-01-01 00:00:20,5,3,484,2,482,0.74%,0.41%
2020-01-01 00:00:20,5,4,23517,3785,19732,35.88%,16.09%
2020-01-01 00:00:20,5,5,8297,520,7777,12.66%,6.27%
2020-01-01 00:00:20,5,6,13605,1345,12260,20.76%,9.89%
2020-01-01 00:00:20,5,7,4849,171,4678,7.40%,3.53%
2020-01-01 00:00:20,5,8,3690,99,3591,5.63%,2.68%
2020-01-01 00:00:20,5,9,7664,455,7209,11.69%,5.94%
2020-01-01 00:00:20,5,10,909,8,901,1.39%,0.88%
2020-01-01 00:00:20,5,11,525,6,519,0.80%,1.14%
2020-01-01 00:00:20,5,12,6639,345,6294,10.13%,5.20%
2020-01-01 00:00:20,6,1,1157,8,1149,1.77%,0.69%
2020-01-01 00:00:20,6,2,1202,8,1194,1.83%,0.67%
2020-01-01 00:00:20,6,3,1872,23,1849,2.86%,1.23%
2020-01-01 00:00:20,6,4,1364,11,1353,2.08%,0.81%
2020-01-01 00:00:20,6,5,14135,1425,12710,21.57%,10.08%
2020-01-01 00:00:20,6,6,4540,131,4409,6.93%,2.89%
2020-01-01 00:00:20,6,7,2559,47,2512,3.90%,1.84%
2020-01-01 00:00:20,6,8,1803,27,1776,2.75%,1.50%
2020-01-01 00:00:20,6,9,7501,435,7066,11.45%,5.80%
2020-01-01 00:00:20,6,10,2338,43,2295,3.57%,1.84%
2020-01-01 00:00:20,6,11,441,2,439,0.67%,0.45%
2020-01-01 00:00:20,6,12,5110,198,4912,7.80%,3.87%
2020-01-01 00:00:20,7,1,462,3,459,0.70%,0.65%
2020-01-01 00:00:20,7,2,181,2,179,0.28%,1.10%
2020-01-01 00:00:20,7,3,563,1,562,0.86%,0.18%
2020-01-01 00:00:20,7,4,1646,23,1623,2.51%,1.40%
2020-01-01 00:00:20,7,5,7685,448,7237,11.73%,5.83%
2020-01-01 00:00:20,7,6,13157,1286,11871,20.08%,9.77%
2020-01-01 00:00:20,7,7,3769,86,3683,5.75%,2.28%
2020-01-01 00:00:20,7,8,1459,18,1441,2.23%,1.23%
2020-01-01 00:00:20,7,9,7052,373,6679,10.76%,5.29%
2020-01-01 00:00:20,7,10,1553,10,1543,2.37%,0.64%
2020-01-01 00:00:20,7,11,122,0,122,0.19%,0.00%
2020-01-01 00:00:20,7,12,5483,240,5243,8.37%,4.38%
2020-01-01 00:00:20,8,1,435,0,435,0.66%,0.00%
2020-01-01 00:00:20,8,2,72,0,72,0.11%,0.00%
2020-01-01 00:00:20,8,3,1794,19,1775,2.74%,1.06%
2020-01-01 00:00:20,8,4,2695,66,2629,4.11%,2.45%
2020-01-01 00:00:20,8,5,8352,508,7844,12.74%,6.08%
2020-01-01 00:00:20,8,6,15963,1837,14126,24.36%,11.51%
2020-01-01 00:00:20,8,7,4723,155,4568,7.21%,3.28%
2020-01-01 00:00:20,8,8,1941,19,1922,2.96%,0.98%
2020-01-01 00:00:20,8,9,6306,316,5990,9.62%,5.01%
2020-01-01 00:00:20,8,10,1584,17,1567,2.42%,1.07%
2020-01-01 00:00:20,8,11,128,1,127,0.20%,0.78%
2020-01-01 00:00:20,8,12,4720,185,4535,7.20%,3.92%
2020-01-01 00:00:20,9,1,473,3,470,0.72%,0.63%
2020-01-01 00:00:20,9,2,3043,74,2969,4.64%,2.43%
2020-01-01 00:00:20,9,3,2234,33,2201,3.41%,1.48%
2020-01-01 00:00:20,9,4,3664,86,3578,5.59%,2.35%
2020-01-01 00:00:20,9,5,186,0,186,0.28%,0.00%
2020-01-01 00:00:20,9,6,4660,140,4520,7.11%,3.00%
2020-01-01 00:00:20,9,7,26143,4652,21491,39.89%,17.79%
2020-01-01 00:00:20,9,8,9099,650,8449,13.88%,7.14%
2020-01-01 00:00:20,9,9,127,0,127,0.19%,0.00%
2020-01-01 00:00:20,9,10,2866,85,2781,4.37%,2.97%
2020-01-01 00:00:20,9,11,7910,497,7413,12.07%,6.28%
2020-01-01 00:00:20,9,12,4729,184,4545,7.22%,3.89%
2020-01-01 00:00:20,10,1,1139,170,969,1.74%,14.93%
2020-01-01 00:00:20,10,2,4488,303,4185,6.85%,6.75%
2020-01-01 00:00:20,10,3,3187,69,3118,4.86%,2.17%
2020-01-01 00:00:20,10,4,4528,1119,3409,6.91%,24.71%
2020-01-01 00:00:20,10,5,709,53,656,1.08%,7.48%
2020-01-01 00:00:20,10,6,6255,1279,4976,9.54%,20.45%
2020-01-01 00:00:20,10,7,12696,2153,10543,19.37%,16.96%
2020-01-01 00:00:20,10,8,30111,7528,22583,45.95%,25.00%
2020-01-01 00:00:20,10,9,822,0,822,1.25%,0.00%
2020-01-01 00:00:20,10,10,2420,36,2384,3.69%,1.49%
2020-01-01 00:00:20,10,11,13754,1710,12044,20.99%,12.43%
2020-01-01 00:00:20,10,12,10613,1226,9387,16.19%,11.55%
2020-01-01 00:00:20,11,1,2670,51,2619,4.07%,1.91%
2020-01-01 00:00:20,11,2,4289,156,4133,6.54%,3.64%
2020-01-01 00:00:20,11,3,1439,47,1392,2.20%,3.27%
2020-01-01 00:00:20,11,4,4476,158,4318,6.83%,3.53%
2020-01-01 00:00:20,11,5,262,0,262,0.40%,0.00%
2020-01-01 00:00:20,11,6,5422,226,5196,8.27%,4.17%
2020-01-01 00:00:20,11,7,11365,950,10415,17.34%,8.36%
2020-01-01 00:00:20,11,8,27618,4992,22626,42.14%,18.08%
2020-01-01 00:00:20,11,9,316,0,316,0.48%,0.00%
2020-01-01 00:00:20,11,10,4169,129,4040,6.36%,3.09%
2020-01-01 00:00:20,11,11,11565,985,10580,17.65%,8.52%
2020-01-01 00:00:20,11,12,7060,385,6675,10.77%,5.45%
2020-01-01 00:00:20,12,1,38,0,38,0.06%,0.00%
2020-01-01 00:00:20,12,2,709,169,540,1.08%,23.84%
2020-01-01 00:00:20,12,3,2716,232,2484,4.14%,8.54%
2020-01-01 00:00:20,12,4,3809,79,3730,5.81%,2.07%
2020-01-01 00:00:20,12,5,9472,794,8678,14.45%,8.38%
2020-01-01 00:00:20,12,6,5937,235,5702,9.06%,3.96%
2020-01-01 00:00:20,12,7,1908,31,1877,2.91%,1.62%
2020-01-01 00:00:20,12,8,1623,289,1334,2.48%,17.81%
2020-01-01 00:00:20,12,9,22663,4274,18389,34.58%,18.86%
2020-01-01 00:00:20,12,10,4416,417,3999,6.74%,9.44%
2020-01-01 00:00:20,12,11,1748,293,1455,2.67%,16.76%
2020-01-01 00:00:20,12,12,8258,951,7307,12.60%,11.52%
2020-01-01 00:00:20,13,1,2292,49,2243,3.50%,2.14%
2020-01-01 00:00:20,13,2,2659,101,2558,4.06%,3.80%
2020-01-01 00:00:20,13,3,702,4,698,1.07%,0.57%
2020-01-01 00:00:20,13,4,5996,628,5368,9.15%,10.47%
2020-01-01 00:00:20,13,5,8211,954,7257,12.53%,11.62%
2020-01-01 00:00:20,13,6,6709,693,6016,10.24%,10.33%
2020-01-01 00:00:20,13,7,4734,247,4487,7.22%,5.22%
2020-01-01 00:00:20,13,8,7345,460,6885,11.21%,6.26%
2020-01-01 00:00:20,13,9,8565,992,7573,13.07%,11.58%
2020-01-01 00:00:20,13,10,30774,7196,23578,46.96%,23.38%
2020-01-01 00:00:20,13,11,19378,3340,16038,29.57%,17.24%
2020-01-01 00:00:20,13,12,11609,1726,9883,17.71%,14.87%
2020-01-01 00:00:20,14,1,213,0,213,0.33%,0.00%
2020-01-01 00:00:20,14,2,1288,21,1267,1.97%,1.63%
2020-01-01 00:00:20,14,3,885,10,875,1.35%,1.13%
2020-01-01 00:00:20,14,4,5217,200,5017,7.96%,3.83%
2020-01-01 00:00:20,14,5,1152,13,1139,1.76%,1.13%
2020-01-01 00:00:20,14,6,5552,219,5333,8.47%,3.94%
2020-01-01 00:00:20,14,7,12794,1183,11611,19.52%,9.25%
2020-01-01 00:00:20,14,8,14412,1493,12919,21.99%,10.36%
2020-01-01 00:00:20,14,9,1269,15,1254,1.94%,1.18%
2020-01-01 00:00:20,14,10,3382,78,3304,5.16%,2.31%
2020-01-01 00:00:20,14,11,26274,4576,21698,40.09%,17.42%
2020-01-01 00:00:20,14,12,8132,457,7675,12.41%,5.62%
2020-01-01 00:00:20,15,1,556,3,553,0.85%,0.54%
2020-01-01 00:00:20,15,2,171,0,171,0.26%,0.00%
2020-01-01 00:00:20,15,3,4222,145,4077,6.44%,3.43%
2020-01-01 00:00:20,15,4,5054,177,4877,7.71%,3.50%
2020-01-01 00:00:20,15,5,10146,747,9399,15.48%,7.36%
2020-01-01 00:00:20,15,6,5284,200,5084,8.06%,3.79%
2020-01-01 00:00:20,15,7,3687,144,3543,5.63%,3.91%
2020-01-01 00:00:20,15,8,6118,329,5789,9.34%,5.38%
2020-01-01 00:00:20,15,9,10301,766,9535,15.72%,7.44%
2020-01-01 00:00:20,15,10,5303,188,5115,8.09%,3.55%
2020-01-01 00:00:20,15,11,11565,963,10602,17.65%,8.33%
2020-01-01 00:00:20,15,12,27152,5199,21953,41.43%,19.15%
2020-01-01 00:00:20,16,1,569,3,566,0.87%,0.53%
2020-01-01 00:00:20,16,2,325,1,324,0.50%,0.31%
2020-01-01 00:00:20,16,3,1864,24,1840,2.84%,1.29%
2020-01-01 00:00:20,16,4,3699,88,3611,5.64%,2.38%
2020-01-01 00:00:20,16,5,7485,443,7042,11.42%,5.92%
2020-01-01 00:00:20,16,6,4430,143,4287,6.76%,3.23%
2020-01-01 00:00:20,16,7,3760,101,3659,5.74%,2.69%
2020-01-01 00:00:20,16,8,7460,498,6962,11.38%,6.68%
2020-01-01 00:00:20,16,9,7909,490,7419,12.07%,6.20%
2020-01-01 00:00:20,16,10,1415,18,1397,2.16%,1.27%
2020-01-01 00:00:20,16,11,9161,676,8485,13.98%,7.38%
2020-01-01 00:00:20,16,12,24902,4186,20716,38.00%,16.81%
2020-01-01 00:00:30,1,1,16422,1917,14505,25.06%,11.67%
2020-01-01 00:00:30,1,2,5334,227,5107,8.14%,4.26%
2020-01-01 00:00:30,1,3,573,3,570,0.87%,0.52%
2020-01-01 00:00:30,1,4,10718,844,9874,16.35%,7.87%
2020-01-01 00:00:30,1,5,10502,816,9686,16.02%,7.77%
2020-01-01 00:00:30,1,6,10476,807,9669,15.99%,7.70%
2020-01-01 00:00:30,1,7,4745,179,4566,7.24%,3.77%
2020-01-01 00:00:30,1,8,3894,119,3775,5.94%,3.06%
2020-01-01 00:00:30,1,9,10396,794,9602,15.86%,7.64%
2020-01-01 00:00:30,1,10,3281,93,3188,5.01%,2.83%
2020-01-01 00:00:30,1,11,3391,97,3294,5.17%,2.86%
2020-01-01 00:00:30,1,12,10379,792,9587,15.84%,7.63%
2020-01-01 00:00:30,2,1,1648,2,1646,2.51%,0.12%
2020-01-01 00:00:30,2,2,26189,4621,21568,39.96%,17.64%
2020-01-01 00:00:30,2,3,19321,2575,16746,29.48%,13.33%
2020-01-01 00:00:30,2,4,1538,2,1536,2.35%,0.13%
2020-01-01 00:00:30,2,5,12678,1113,11565,19.35%,8.78%
2020-01-01 00:00:30,2,6,52,0,52,0.08%,0.00%
2020-01-01 00:00:30,2,7,5212,210,5002,7.95%,4.03%
2020-01-01 00:00:30,2,8,4067,120,3947,6.21%,2.95%
2020-01-01 00:00:30,2,9,12563,1091,11472,19.17%,8.68%
2020-01-01 00:00:30,2,10,3400,85,3315,5.19%,2.50%
2020-01-01 00:00:30,2,11,3452,89,3363,5.27%,2.58%
2020-01-01 00:00:30,2,12,12312,1055,11257,18.79%,8.57%
2020-01-01 00:00:30,3,1,1547,16,1531,2.36%,1.03%
2020-01-01 00:00:30,3,2,22106,3311,18795,33.73%,14.98%
2020-01-01 00:00:30,3,3,74655,30242,44413,113.91%,40.51%
2020-01-01 00:00:30,3,4,9031,608,8423,13.78%,6.73%
2020-01-01 00:00:30,3,5,51167,15815,35352,78.07%,30.91%
2020-01-01 00:00:30,3,6,10538,819,9719,16.08%,7.77%
2020-01-01 00:00:30,3,7,19136,2519,16617,29.20%,13.16%
2020-01-01 00:00:30,3,8,15580,1748,13832,23.77%,11.22%
2020-01-01 00:00:30,3,9,40260,10294,29966,61.43%,25.57%
2020-01-01 00:00:30,3,10,5190,195,4995,7.92%,3.76%
2020-01-01 00:00:30,3,11,1579,20,1559,2.41%,1.27%
2020-01-01 00:00:30,3,12,33136,7206,25930,50.56%,21.75%
2020-01-01 00:00:30,4,1,501,4,497,0.76%,0.80%
2020-01-01 00:00:30,4,2,323,3,320,0.49%,0.93%
2020-01-01 00:00:30,4,3,740,7,733,1.13%,0.95%
2020-01-01 00:00:30,4,4,26383,4671,21712,40.26%,17.70%
2020-01-01 00:00:30,4,5,16845,1990,14855,25.70%,11.81%
2020-01-01 00:00:30,4,6,22627,3519,19108,34.53%,15.55%
2020-01-01 00:00:30,4,7,4529,174,4355,6.91%,3.84%
2020-01-01 00:00:30,4,8,2675,62,2613,4.08%,2.32%
2020-01-01 00:00:30,4,9,15025,1577,13448,22.93%,10.50%
2020-01-01 00:00:30,4,10,1958,37,1921,2.99%,1.89%
2020-01-01 00:00:30,4,11,108,0,108,0.16%,0.00%
2020-01-01 00:00:30,4,12,12415,1063,11352,18.94%,8.56%
2020-01-01 00:00:30,5,1,2907,71,2836,4.44%,2.44%
2020-01-01 00:00:30,5,2,699,4,695,1.07%,0.57%
2020-01-01 00:00:30,5,3,542,2,540,0.83%,0.37%
2020-01-01 00:00:30,5,4,27668,5080,22588,42.22%,18.36%
2020-01-01 00:00:30,5,5,9485,656,8829,14.47%,6.92%
2020-01-01 00:00:30,5,6,15146,1621,13525,23.11%,10.70%
2020-01-01 00:00:30,5,7,5186,209,4977,7.91%,4.03%
2020-01-01 00:00:30,5,8,3310,79,3231,5.05%,2.39%
2020-01-01 00:00:30,5,9,8796,576,8220,13.42%,6.55%
2020-01-01 00:00:30,5,10,1003,6,997,1.53%,0.60%
2020-01-01 00:00:30,5,11,895,5,890,1.37%,0.56%
2020-01-01 00:00:30,5,12,7549,452,7097,11.52%,5.99%
2020-01-01 00:00:30,6,1,1143,4,1139,1.74%,0.35%
2020-01-01 00:00:30,6,2,1256,5,1251,1.92%,0.40%
2020-01-01 00:00:30,6,3,1756,17,1739,2.68%,0.97%
2020-01-01 00:00:30,6,4,1364,9,1355,2.08%,0.66%
2020-01-01 00:00:30,6,5,17436,2104,15332,26.61%,12.07%
2020-01-01 00:00:30,6,6,4490,134,4356,6.85%,2.98%
2020-01-01 00:00:30,6,7,2588,54,2534,3.95%,2.09%
2020-01-01 00:00:30,6,8,2134,36,2098,3.26%,1.69%
2020-01-01 00:00:30,6,9,10888,862,10026,16.61%,7.92%
2020-01-01 00:00:30,6,10,2620,67,2553,4.00%,2.56%
2020-01-01 00:00:30,6,11,428,3,425,0.65%,0.70%
2020-01-01 00:00:30,6,12,8119,474,7645,12.39%,5.84%
2020-01-01 00:00:30,7,1,295,1,294,0.45%,0.34%
2020-01-01 00:00:30,7,2,278,2,276,0.42%,0.72%
2020-01-01 00:00:30,7,3,1441,10,1431,2.20%,0.69%
2020-01-01 00:00:30,7,4,1498,21,1477,2.29%,1.40%
2020-01-01 00:00:30,7,5,7953,478,7475,12.14%,6.01%
2020-01-01 00:00:30,7,6,13166,1173,11993,20.09%,8.91%
2020-01-01 00:00:30,7,7,3690,90,3600,5.63%,2.44%
2020-01-01 00:00:30,7,8,1447,11,1436,2.21%,0.76%
2020-01-01 00:00:30,7,9,6431,292,6139,9.81%,4.54%
2020-01-01 00:00:30,7,10,2005,19,1986,3.06%,0.95%
2020-01-01 00:00:30,7,11,103,0,103,0.16%,0.00%
2020-01-01 00:00:30,7,12,4423,136,4287,6.75%,3.07%
2020-01-01 00:00:30,8,1,366,3,363,0.56%,0.82%
2020-01-01 00:00:30,8,2,101,1,100,0.15%,0.99%
2020-01-01 00:00:30,8,3,1695,21,1674,2.59%,1.24%
2020-01-01 00:00:30,8,4,2555,47,2508,3.90%,1.84%
2020-01-01 00:00:30,8,5,8355,546,7809,12.75%,6.54%
2020-01-01 00:00:30,8,6,15746,1743,14003,24.03%,11.07%
2020-01-01 00:00:30,8,7,4788,158,4630,7.31%,3.30%
2020-01-01 00:00:30,8,8,1777,24,1753,2.71%,1.35%
2020-01-01 00:00:30,8,9,6451,333,6118,9.84%,5.16%
2020-01-01 00:00:30,8,10,2020,39,1981,3.08%,1.93%
2020-01-01 00:00:30,8,11,147,0,147,0.22%,0.00%
2020-01-01 00:00:30,8,12,4378,165,4213,6.68%,3.77%
2020-01-01 00:00:30,9,1,308,1,307,0.47%,0.32%
2020-01-01 00:00:30,9,2,6685,360,6325,10.20%,5.39%
2020-01-01 00:00:30,9,3,5845,280,5565,8.92%,4.79%
2020-01-01 00:00:30,9,4,11858,993,10865,18.09%,8.37%
2020-01-01 00:00:30,9,5,292,0,292,0.45%,0.00%
2020-01-01 00:00:30,9,6,12356,1093,11263,18.85%,8.85%
2020-01-01 00:00:30,9,7,33818,7429,26389,51.60%,21.97%
2020-01-01 00:00:30,9,8,9773,726,9047,14.91%,7.43%
2020-01-01 00:00:30,9,9,174,0,174,0.27%,0.00%
2020-01-01 00:00:30,9,10,2518,58,2460,3.84%,2.30%
2020-01-01 00:00:30,9,11,8395,539,7856,12.81%,6.42%
2020-01-01 00:00:30,9,12,5569,226,5343,8.50%,4.06%
2020-01-01 00:00:30,10,1,1112,272,840,1.70%,24.46%
2020-01-01 00:00:30,10,2,2944,331,2613,4.49%,11.24%
2020-01-01 00:00:30,10,3,1589,41,1548,2.42%,2.58%
2020-01-01 00:00:30,10,4,3650,923,2727,5.57%,25.29%
2020-01-01 00:00:30,10,5,510,5,505,0.78%,0.98%
2020-01-01 00:00:30,10,6,5541,1037,4504,8.45%,18.72%
2020-01-01 00:00:30,10,7,10181,1756,8425,15.53%,17.25%
2020-01-01 00:00:30,10,8,26451,6467,19984,40.36%,24.45%
2020-01-01 00:00:30,10,9,688,4,684,1.05%,0.58%
2020-01-01 00:00:30,10,10,2508,34,2474,3.83%,1.36%
2020-01-01 00:00:30,10,11,12201,1392,10809,18.62%,11.41%
2020-01-01 00:00:30,10,12,8828,923,7905,13.47%,10.46%
2020-01-01 00:00:30,11,1,1809,28,1781,2.76%,1.55%
2020-01-01 00:00:30,11,2,3579,74,3505,5.46%,2.07%
2020-01-01 00:00:30,11,3,1600,9,1591,2.44%,0.56%
2020-01-01 00:00:30,11,4,4046,131,3915,6.17%,3.24%
2020-01-01 00:00:30,11,5,209,0,209,0.32%,0.00%
2020-01-01 00:00:30,11,6,4839,190,4649,7.38%,3.93%
2020-01-01 00:00:30,11,7,10422,787,9635,15.90%,7.55%
2020-01-01 00:00:30,11,8,24364,3972,20392,37.18%,16.30%
2020-01-01 00:00:30,11,9,222,0,222,0.34%,0.00%
2020-01-01 00:00:30,11,10,3338,78,3260,5.09%,2.34%
2020-01-01 00:00:30,11,11,10471,740,9731,15.98%,7.07%
2020-01-01 00:00:30,11,12,6940,342,6598,10.59%,4.93%
2020-01-01 00:00:30,12,1,17,0,17,0.03%,0.00%
2020-01-01 00:00:30,12,2,639,218,421,0.98%,34.12%
2020-01-01 00:00:30,12,3,2392,247,2145,3.65%,10.33%
2020-01-01 00:00:30,12,4,2586,43,2543,3.95%,1.66%
2020-01-01 00:00:30,12,5,9280,780,8500,14.16%,8.41%
2020-01-01 00:00:30,12,6,6061,262,5799,9.25%,4.32%
2020-01-01 00:00:30,12,7,3346,85,3261,5.11%,2.54%
2020-01-01 00:00:30,12,8,1201,174,1027,1.83%,14.49%
2020-01-01 00:00:30,12,9,20998,3913,17085,32.04%,18.64%
2020-01-01 00:00:30,12,10,3989,279,3710,6.09%,6.99%
2020-01-01 00:00:30,12,11,1429,178,1251,2.18%,12.46%
2020-01-01 00:00:30,12,12,7087,967,6120,10.81%,13.64%
2020-01-01 00:00:30,13,1,2388,48,2340,3.64%,2.01%
2020-01-01 00:00:30,13,2,2872,66,2806,4.38%,2.30%
2020-01-01 00:00:30,13,3,627,3,624,0.96%,0.48%
2020-01-01 00:00:30,13,4,5171,701,4470,7.89%,13.56%
2020-01-01 00:00:30,13,5,7748,991,6757,11.82%,12.79%
2020-01-01 00:00:30,13,6,6281,779,5502,9.58%,12.40%
2020-01-01 00:00:30,13,7,5687,236,5451,8.68%,4.15%
2020-01-01 00:00:30,13,8,7946,430,7516,12.12%,5.41%
2020-01-01 00:00:30,13,9,7939,1008,6931,12.11%,12.70%
2020-01-01 00:00:30,13,10,28562,6141,22421,43.58%,21.50%
2020-01-01 00:00:30,13,11,18126,2683,15443,27.66%,14.80%
2020-01-01 00:00:30,13,12,9523,1091,8432,14.53%,11.46%
2020-01-01 00:00:30,14,1,450,0,450,0.69%,0.00%
2020-01-01 00:00:30,14,2,1722,16,1706,2.63%,0.93%
2020-01-01 00:00:30,14,3,1149,5,1144,1.75%,0.44%
2020-01-01 00:00:30,14,4,4261,129,4132,6.50%,3.03%
2020-01-01 00:00:30,14,5,1293,17,1276,1.97%,1.31%
2020-01-01 00:00:30,14,6,4456,133,4323,6.80%,2.98%
2020-01-01 00:00:30,14,7,11451,934,10517,17.47%,8.16%
2020-01-01 00:00:30,14,8,13401,1264,12137,20.45%,9.43%
2020-01-01 00:00:30,14,9,1650,25,1625,2.52%,1.52%
2020-01-01 00:00:30,14,10,3818,107,3711,5.83%,2.80%
2020-01-01 00:00:30,14,11,25008,4220,20788,38.16%,16.87%
2020-01-01 00:00:30,14,12,7532,410,7122,11.49%,5.44%
2020-01-01 00:00:30,15,1,442,0,442,0.67%,0.00%
2020-01-01 00:00:30,15,2,132,0,132,0.20%,0.00%
2020-01-01 00:00:30,15,3,3915,110,3805,5.97%,2.81%
2020-01-01 00:00:30,15,4,5876,264,5612,8.97%,4.49%
2020-01-01 00:00:30,15,5,11584,997,10587,17.68%,8.61%
2020-01-01 00:00:30,15,6,6092,282,5810,9.30%,4.63%
2020-01-01 00:00:30,15,7,4412,180,4232,6.73%,4.08%
2020-01-01 00:00:30,15,8,6335,333,6002,9.67%,5.26%
2020-01-01 00:00:30,15,9,11803,1028,10775,18.01%,8.71%
2020-01-01 00:00:30,15,10,4419,143,4276,6.74%,3.24%
2020-01-01 00:00:30,15,11,10893,887,10006,16.62%,8.14%
2020-01-01 00:00:30,15,12,27586,5318,22268,42.09%,19.28%
2020-01-01 00:00:30,16,1,353,5,348,0.54%,1.42%
2020-01-01 00:00:30,16,2,285,0,285,0.43%,0.00%
2020-01-01 00:00:30,16,3,1221,8,1213,1.86%,0.66%
2020-01-01 00:00:30,16,4,4288,153,4135,6.54%,3.57%
2020-01-01 00:00:30,16,5,7681,556,7125,11.72%,7.24%
2020-01-01 00:00:30,16,6,5043,210,4833,7.70%,4.16%
2020-01-01 00:00:30,16,7,3639,96,3543,5.55%,2.64%
2020-01-01 00:00:30,16,8,7469,437,7032,11.40%,5.85%
2020-01-01 00:00:30,16,9,8127,591,7536,12.40%,7.27%
2020-01-01 00:00:30,16,10,1307,18,1289,1.99%,1.38%
2020-01-01 00:00:30,16,11,9127,625,8502,13.93%,6.85%
2020-01-01 00:00:30,16,12,25484,4516,20968,38.89%,17.72%
2020-01-01 00:00:40,1,1,16085,1905,14180,24.54%,11.84%
2020-01-01 00:00:40,1,2,6970,385,6585,10.64%,5.52%
2020-01-01 00:00:40,1,3,679,2,677,1.04%,0.29%
2020-01-01 00:00:40,1,4,8825,638,8187,13.47%,7.23%
2020-01-01 00:00:40,1,5,8495,607,7888,12.96%,7.15%
2020-01-01 00:00:40,1,6,8444,600,7844,12.88%,7.11%
2020-01-01 00:00:40,1,7,6276,316,5960,9.58%,5.04%
2020-01-01 00:00:40,1,8,5511,233,5278,8.41%,4.23%
2020-01-01 00:00:40,1,9,8403,596,7807,12.82%,7.09%
2020-01-01 00:00:40,1,10,4596,158,4438,7.01%,3.44%
2020-01-01 00:00:40,1,11,4775,178,4597,7.29%,3.73%
2020-01-01 00:00:40,1,12,8370,594,7776,12.77%,7.10%
2020-01-01 00:00:40,2,1,864,3,861,1.32%,0.35%
2020-01-01 00:00:40,2,2,29496,5832,23664,45.01%,19.77%
2020-01-01 00:00:40,2,3,24556,4119,20437,37.47%,16.77%
2020-01-01 00:00:40,2,4,826,3,823,1.26%,0.36%
2020-01-01 00:00:40,2,5,16417,1922,14495,25.05%,11.71%
2020-01-01 00:00:40,2,6,66,0,66,0.10%,0.00%
2020-01-01 00:00:40,2,7,4048,111,3937,6.18%,2.74%
2020-01-01 00:00:40,2,8,2545,46,2499,3.88%,1.81%
2020-01-01 00:00:40,2,9,16351,1909,14442,24.95%,11.68%
2020-01-01 00:00:40,2,10,1757,18,1739,2.68%,1.02%
2020-01-01 00:00:40,2,11,1780,20,1760,2.72%,1.12%
2020-01-01 00:00:40,2,12,16225,1884,14341,24.76%,11.61%
2020-01-01 00:00:40,3,1,1500,12,1488,2.29%,0.80%
2020-01-01 00:00:40,3,2,20832,2980,17852,31.79%,14.30%
2020-01-01 00:00:40,3,3,68882,26205,42677,105.11%,38.04%
2020-01-01 00:00:40,3,4,10469,763,9706,15.97%,7.29%
2020-01-01 00:00:40,3,5,47197,13645,33552,72.02%,28.91%
2020-01-01 00:00:40,3,6,11920,998,10922,18.19%,8.37%
2020-01-01 00:00:40,3,7,17491,2134,15357,26.69%,12.20%
2020-01-01 00:00:40,3,8,14663,1529,13134,22.37%,10.43%
2020-01-01 00:00:40,3,9,34973,7985,26988,53.36%,22.83%
2020-01-01 00:00:40,3,10,5003,201,4802,7.63%,4.02%
2020-01-01 00:00:40,3,11,2032,27,2005,3.10%,1.33%
2020-01-01 00:00:40,3,12,26200,4664,21536,39.98%,17.80%
2020-01-01 00:00:40,4,1,588,4,584,0.90%,0.68%
2020-01-01 00:00:40,4,2,374,2,372,0.57%,0.53%
2020-01-01 00:00:40,4,3,610,4,606,0.93%,0.66%
2020-01-01 00:00:40,4,4,29095,5593,23502,44.40%,19.22%
2020-01-01 00:00:40,4,5,17652,2153,15499,26.93%,12.20%
2020-01-01 00:00:40,4,6,24927,4182,20745,38.04%,16.78%
2020-01-01 00:00:40,4,7,5481,221,5260,8.36%,4.03%
2020-01-01 00:00:40,4,8,3154,91,3063,4.81%,2.89%
2020-01-01 00:00:40,4,9,15773,1730,14043,24.07%,10.97%
2020-01-01 00:00:40,4,10,1917,31,1886,2.93%,1.62%
2020-01-01 00:00:40,4,11,266,0,266,0.41%,0.00%
2020-01-01 00:00:40,4,12,13127,1222,11905,20.03%,9.31%
2020-01-01 00:00:40,5,1,2950,67,2883,4.50%,2.27%
2020-01-01 00:00:40,5,2,1417,18,1399,2.16%,1.27%
2020-01-01 00:00:40,5,3,755,4,751,1.15%,0.53%
2020-01-01 00:00:40,5,4,21708,3268,18440,33.12%,15.05%
2020-01-01 00:00:40,5,5,9980,731,9249,15.23%,7.32%
2020-01-01 00:00:40,5,6,14367,1485,12882,21.92%,10.34%
2020-01-01 00:00:40,5,7,4053,152,3901,6.18%,3.75%
2020-01-01 00:00:40,5,8,3084,93,2991,4.71%,3.02%
2020-01-01 00:00:40,5,9,9097,629,8468,13.88%,6.91%
2020-01-01 00:00:40,5,10,1556,20,1536,2.37%,1.29%
2020-01-01 00:00:40,5,11,648,8,640,0.99%,1.23%
2020-01-01 00:00:40,5,12,6992,394,6598,10.67%,5.64%
2020-01-01 00:00:40,6,1,1049,10,1039,1.60%,0.95%
2020-01-01 00:00:40,6,2,1210,13,1197,1.85%,1.07%
2020-01-01 00:00:40,6,3,1925,26,1899,2.94%,1.35%
2020-01-01 00:00:40,6,4,1299,9,1290,1.98%,0.69%
2020-01-01 00:00:40,6,5,14520,1504,13016,22.16%,10.36%
2020-01-01 00:00:40,6,6,5231,193,5038,7.98%,3.69%
2020-01-01 00:00:40,6,7,3553,92,3461,5.42%,2.59%
2020-01-01 00:00:40,6,8,3076,76,3000,4.69%,2.47%
2020-01-01 00:00:40,6,9,7120,391,6729,10.86%,5.49%
2020-01-01 00:00:40,6,10,1772,21,1751,2.70%,1.19%
2020-01-01 00:00:40,6,11,437,1,436,0.67%,0.23%
2020-01-01 00:00:40,6,12,5246,205,5041,8.00%,3.91%
2020-01-01 00:00:40,7,1,548,1,547,0.84%,0.18%
2020-01-01 00:00:40,7,2,223,0,223,0.34%,0.00%
2020-01-01 00:00:40,7,3,903,5,898,1.38%,0.55%
2020-01-01 00:00:40,7,4,1984,57,1927,3.03%,2.87%
2020-01-01 00:00:40,7,5,6770,380,6390,10.33%,5.61%
2020-01-01 00:00:40,7,6,12628,1237,11391,19.27%,9.80%
2020-01-01 00:00:40,7,7,3835,116,3719,5.85%,3.02%
2020-01-01 00:00:40,7,8,1815,33,1782,2.77%,1.82%
2020-01-01 00:00:40,7,9,5826,278,5548,8.89%,4.77%
2020-01-01 00:00:40,7,10,989,5,984,1.51%,0.51%
2020-01-01 00:00:40,7,11,45,0,45,0.07%,0.00%
2020-01-01 00:00:40,7,12,4841,183,4658,7.39%,3.78%
2020-01-01 00:00:40,8,1,384,0,384,0.59%,0.00%
2020-01-01 00:00:40,8,2,94,2,92,0.14%,2.13%
2020-01-01 00:00:40,8,3,1687,32,1655,2.57%,1.90%
2020-01-01 00:00:40,8,4,3056,67,2989,4.66%,2.19%
2020-01-01 00:00:40,8,5,8643,545,8098,13.19%,6.31%
2020-01-01 00:00:40,8,6,17191,2064,15127,26.23%,12.01%
2020-01-01 00:00:40,8,7,5458,263,5195,8.33%,4.82%
2020-01-01 00:00:40,8,8,2689,84,2605,4.10%,3.12%
2020-01-01 00:00:40,8,9,6723,333,6390,10.26%,4.95%
2020-01-01 00:00:40,8,10,1990,25,1965,3.04%,1.26%
2020-01-01 00:00:40,8,11,114,0,114,0.17%,0.00%
2020-01-01 00:00:40,8,12,4695,180,4515,7.16%,3.83%
2020-01-01 00:00:40,9,1,305,0,305,0.47%,0.00%
2020-01-01 00:00:40,9,2,1876,20,1856,2.86%,1.07%
2020-01-01 00:00:40,9,3,1074,6,1068,1.64%,0.56%
2020-01-01 00:00:40,9,4,7015,322,6693,10.70%,4.59%
2020-01-01 00:00:40,9,5,722,1,721,1.10%,0.14%
2020-01-01 00:00:40,9,6,8666,516,8150,13.22%,5.95%
2020-01-01 00:00:40,9,7,26032,4565,21467,39.72%,17.54%
2020-01-01 00:00:40,9,8,8906,567,8339,13.59%,6.37%
2020-01-01 00:00:40,9,9,265,0,265,0.40%,0.00%
2020-01-01 00:00:40,9,10,2358,33,2325,3.60%,1.40%
2020-01-01 00:00:40,9,11,7641,420,7221,11.66%,5.50%
2020-01-01 00:00:40,9,12,5025,195,4830,7.67%,3.88%
2020-01-01 00:00:40,10,1,1144,227,917,1.75%,19.84%
2020-01-01 00:00:40,10,2,3038,281,2757,4.64%,9.25%
2020-01-01 00:00:40,10,3,1774,30,1744,2.71%,1.69%
2020-01-01 00:00:40,10,4,4266,1078,3188,6.51%,25.27%
2020-01-01 00:00:40,10,5,859,55,804,1.31%,6.40%
2020-01-01 00:00:40,10,6,6296,1264,5032,9.61%,20.08%
2020-01-01 00:00:40,10,7,11112,2008,9104,16.96%,18.07%
2020-01-01 00:00:40,10,8,30729,8259,22470,46.89%,26.88%
2020-01-01 00:00:40,10,9,617,1,616,0.94%,0.16%
2020-01-01 00:00:40,10,10,2681,48,2633,4.09%,1.79%
2020-01-01 00:00:40,10,11,14669,1977,12692,22.38%,13.48%
2020-01-01 00:00:40,10,12,11196,1377,9819,17.08%,12.30%
2020-01-01 00:00:40,11,1,2077,34,2043,3.17%,1.64%
2020-01-01 00:00:40,11,2,3015,78,2937,4.60%,2.59%
2020-01-01 00:00:40,11,3,767,8,759,1.17%,1.04%
2020-01-01 00:00:40,11,4,4900,184,4716,7.48%,3.76%
2020-01-01 00:00:40,11,5,210,1,209,0.32%,0.48%
2020-01-01 00:00:40,11,6,5624,239,5385,8.58%,4.25%
2020-01-01 00:00:40,11,7,10404,840,9564,15.88%,8.07%
2020-01-01 00:00:40,11,8,24691,4106,20585,37.68%,16.63%
2020-01-01 00:00:40,11,9,407,1,406,0.62%,0.25%
2020-01-01 00:00:40,11,10,3340,91,3249,5.10%,2.72%
2020-01-01 00:00:40,11,11,10749,851,9898,16.40%,7.92%
2020-01-01 00:00:40,11,12,7094,376,6718,10.82%,5.30%
2020-01-01 00:00:40,12,1,35,0,35,0.05%,0.00%
2020-01-01 00:00:40,12,2,420,120,300,0.64%,28.57%
2020-01-01 00:00:40,12,3,2291,150,2141,3.50%,6.55%
2020-01-01 00:00:40,12,4,3347,81,3266,5.11%,2.42%
2020-01-01 00:00:40,12,5,8307,593,7714,12.68%,7.14%
2020-01-01 00:00:40,12,6,5405,221,5184,8.25%,4.09%
2020-01-01 00:00:40,12,7,1881,39,1842,2.87%,2.07%
2020-01-01 00:00:40,12,8,1553,225,1328,2.37%,14.49%
2020-01-01 00:00:40,12,9,24005,4662,19343,36.63%,19.42%
2020-01-01 00:00:40,12,10,4170,317,3853,6.36%,7.60%
2020-01-01 00:00:40,12,11,1744,230,1514,2.66%,13.19%
2020-01-01 00:00:40,12,12,8996,1257,7739,13.73%,13.97%
2020-01-01 00:00:40,13,1,1989,32,1957,3.03%,1.61%
2020-01-01 00:00:40,13,2,2374,43,2331,3.62%,1.81%
2020-01-01 00:00:40,13,3,623,2,621,0.95%,0.32%
2020-01-01 00:00:40,13,4,4711,585,4126,7.19%,12.42%
2020-01-01 00:00:40,13,5,6881,901,5980,10.50%,13.09%
2020-01-01 00:00:40,13,6,5205,615,4590,7.94%,11.82%
2020-01-01 00:00:40,13,7,4933,185,4748,7.53%,3.75%
2020-01-01 00:00:40,13,8,7138,397,6741,10.89%,5.56%
2020-01-01 00:00:40,13,9,7245,929,6316,11.05%,12.82%
2020-01-01 00:00:40,13,10,27089,5521,21568,41.33%,20.38%
2020-01-01 00:00:40,13,11,17281,2359,14922,26.37%,13.65%
2020-01-01 00:00:40,13,12,9759,1003,8756,14.89%,10.28%
2020-01-01 00:00:40,14,1,303,1,302,0.46%,0.33%
2020-01-01 00:00:40,14,2,1953,31,1922,2.98%,1.59%
2020-01-01 00:00:40,14,3,1437,11,1426,2.19%,0.77%
2020-01-01 00:00:40,14,4,3752,146,3606,5.73%,3.89%
2020-01-01 00:00:40,14,5,1754,24,1730,2.68%,1.37%
2020-01-01 00:00:40,14,6,4060,156,3904,6.20%,3.84%
2020-01-01 00:00:40,14,7,11524,954,10570,17.58%,8.28%
2020-01-01 00:00:40,14,8,13796,1364,12432,21.05%,9.89%
2020-01-01 00:00:40,14,9,2175,33,2142,3.32%,1.52%
2020-01-01 00:00:40,14,10,4743,172,4571,7.24%,3.63%
2020-01-01 00:00:40,14,11,28187,5289,22898,43.01%,18.76%
2020-01-01 00:00:40,14,12,9285,612,8673,14.17%,6.59%
2020-01-01 00:00:40,15,1,630,4,626,0.96%,0.63%
2020-01-01 00:00:40,15,2,140,0,140,0.21%,0.00%
2020-01-01 00:00:40,15,3,3156,72,3084,4.82%,2.28%
2020-01-01 00:00:40,15,4,5720,289,5431,8.73%,5.05%
2020-01-01 00:00:40,15,5,9794,788,9006,14.94%,8.05%
2020-01-01 00:00:40,15,6,5999,369,5630,9.15%,6.15%
2020-01-01 00:00:40,15,7,3437,97,3340,5.24%,2.82%
2020-01-01 00:00:40,15,8,6815,331,6484,10.40%,4.86%
2020-01-01 00:00:40,15,9,9967,809,9158,15.21%,8.12%
2020-01-01 00:00:40,15,10,9436,755,8681,14.40%,8.00%
2020-01-01 00:00:40,15,11,16401,1984,14417,25.03%,12.10%
2020-01-01 00:00:40,15,12,32609,7333,25276,49.76%,22.49%
2020-01-01 00:00:40,16,1,589,7,582,0.90%,1.19%
2020-01-01 00:00:40,16,2,250,2,248,0.38%,0.80%
2020-01-01 00:00:40,16,3,963,17,946,1.47%,1.77%
2020-01-01 00:00:40,16,4,4057,130,3927,6.19%,3.20%
2020-01-01 00:00:40,16,5,7665,485,7180,11.70%,6.33%
2020-01-01 00:00:40,16,6,4849,194,4655,7.40%,4.00%
2020-01-01 00:00:40,16,7,3268,79,3189,4.99%,2.42%
2020-01-01 00:00:40,16,8,7360,444,6916,11.23%,6.03%
2020-01-01 00:00:40,16,9,8152,541,7611,12.44%,6.64%
2020-01-01 00:00:40,16,10,1704,29,1675,2.60%,1.70%
2020-01-01 00:00:40,16,11,9383,678,8705,14.32%,7.23%
2020-01-01 00:00:40,16,12,26988,4922,22066,41.18%,18.24%
2020-01-01 00:00:50,1,1,21301,3159,18142,32.50%,14.83%
2020-01-01 00:00:50,1,2,7510,415,7095,11.46%,5.53%
2020-01-01 00:00:50,1,3,663,2,661,1.01%,0.30%
2020-01-01 00:00:50,1,4,13493,1336,12157,20.59%,9.90%
2020-01-01 00:00:50,1,5,12564,1170,11394,19.17%,9.31%
2020-01-01 00:00:50,1,6,12522,1161,11361,19.11%,9.27%
2020-01-01 00:00:50,1,7,6824,344,6480,10.41%,5.04%
2020-01-01 00:00:50,1,8,5729,231,5498,8.74%,4.03%
2020-01-01 00:00:50,1,9,12469,1150,11319,19.03%,9.22%
2020-01-01 00:00:50,1,10,5072,177,4895,7.74%,3.49%
2020-01-01 00:00:50,1,11,5157,187,4970,7.87%,3.63%
2020-01-01 00:00:50,1,12,12449,1146,11303,19.00%,9.21%
2020-01-01 00:00:50,2,1,1534,15,1519,2.34%,0.98%
2020-01-01 00:00:50,2,2,28353,5260,23093,43.26%,18.55%
2020-01-01 00:00:50,2,3,23997,3891,20106,36.62%,16.21%
2020-01-01 00:00:50,2,4,1465,9,1456,2.24%,0.61%
2020-01-01 00:00:50,2,5,15623,1769,13854,23.84%,11.32%
2020-01-01 00:00:50,2,6,27,0,27,0.04%,0.00%
2020-01-01 00:00:50,2,7,2795,48,2747,4.26%,1.72%
2020-01-01 00:00:50,2,8,1593,12,1581,2.43%,0.75%
2020-01-01 00:00:50,2,9,15522,1749,13773,23.68%,11.27%
2020-01-01 00:00:50,2,10,1133,6,1127,1.73%,0.53%
2020-01-01 00:00:50,2,11,1147,6,1141,1.75%,0.52%
2020-01-01 00:00:50,2,12,15402,1730,13672,23.50%,11.23%
2020-01-01 00:00:50,3,1,1808,26,1782,2.76%,1.44%
2020-01-01 00:00:50,3,2,23644,3875,19769,36.08%,16.39%
2020-01-01 00:00:50,3,3,72256,28336,43920,110.25%,39.22%
2020-01-01 00:00:50,3,4,10261,726,9535,15.66%,7.08%
2020-01-01 00:00:50,3,5,44922,12269,32653,68.55%,27.31%
2020-01-01 00:00:50,3,6,11486,911,10575,17.53%,7.93%
2020-01-01 00:00:50,3,7,20035,2842,17193,30.57%,14.19%
2020-01-01 00:00:50,3,8,16002,1860,14142,24.42%,11.62%
2020-01-01 00:00:50,3,9,32793,6925,25868,50.04%,21.12%
2020-01-01 00:00:50,3,10,3382,82,3300,5.16%,2.42%
2020-01-01 00:00:50,3,11,1977,32,1945,3.02%,1.62%
2020-01-01 00:00:50,3,12,27524,4986,22538,42.00%,18.12%
2020-01-01 00:00:50,4,1,584,4,580,0.89%,0.68%
2020-01-01 00:00:50,4,2,362,2,360,0.55%,0.55%
2020-01-01 00:00:50,4,3,651,0,651,0.99%,0.00%
2020-01-01 00:00:50,4,4,27076,4936,22140,41.31%,18.23%
2020-01-01 00:00:50,4,5,17426,2187,15239,26.59%,12.55%
2020-01-01 00:00:50,4,6,23422,3790,19632,35.74%,16.18%
2020-01-01 00:00:50,4,7,4559,168,4391,6.96%,3.69%
2020-01-01 00:00:50,4,8,2868,59,2809,4.38%,2.06%
2020-01-01 00:00:50,4,9,15649,1797,13852,23.88%,11.48%
2020-01-01 00:00:50,4,10,1770,18,1752,2.70%,1.02%
2020-01-01 00:00:50,4,11,209,1,208,0.32%,0.48%
2020-01-01 00:00:50,4,12,12934,1207,11727,19.74%,9.33%
2020-01-01 00:00:50,5,1,2639,52,2587,4.03%,1.97%
2020-01-01 00:00:50,5,2,791,3,788,1.21%,0.38%
2020-01-01 00:00:50,5,3,618,2,616,0.94%,0.32%
2020-01-01 00:00:50,5,4,25061,4290,20771,38.24%,17.12%
2020-01-01 00:00:50,5,5,9883,702,9181,15.08%,7.10%
2020-01-01 00:00:50,5,6,15385,1677,13708,23.48%,10.90%
2020-01-01 00:00:50,5,7,5000,192,4808,7.63%,3.84%
2020-01-01 00:00:50,5,8,3477,94,3383,5.31%,2.70%
2020-01-01 00:00:50,5,9,9072,589,8483,13.84%,6.49%
2020-01-01 00:00:50,5,10,1279,19,1260,1.95%,1.49%
2020-01-01 00:00:50,5,11,1055,14,1041,1.61%,1.33%
2020-01-01 00:00:50,5,12,7284,371,6913,11.11%,5.09%
2020-01-01 00:00:50,6,1,1105,5,1100,1.69%,0.45%
2020-01-01 00:00:50,6,2,1248,11,1237,1.90%,0.88%
2020-01-01 00:00:50,6,3,1733,31,1702,2.64%,1.79%
2020-01-01 00:00:50,6,4,1357,23,1334,2.07%,1.69%
2020-01-01 00:00:50,6,5,16019,1806,14213,24.44%,11.27%
2020-01-01 00:00:50,6,6,4006,122,3884,6.11%,3.05%
2020-01-01 00:00:50,6,7,2328,50,2278,3.55%,2.15%
2020-01-01 00:00:50,6,8,1783,30,1753,2.72%,1.68%
2020-01-01 00:00:50,6,9,10025,749,9276,15.30%,7.47%
2020-01-01 00:00:50,6,10,2457,48,2409,3.75%,1.95%
2020-01-01 00:00:50,6,11,388,2,386,0.59%,0.52%
2020-01-01 00:00:50,6,12,7507,410,7097,11.45%,5.46%
2020-01-01 00:00:50,7,1,497,1,496,0.76%,0.20%
2020-01-01 00:00:50,7,2,140,0,140,0.21%,0.00%
2020-01-01 00:00:50,7,3,1407,17,1390,2.15%,1.21%
2020-01-01 00:00:50,7,4,2182,23,2159,3.33%,1.05%
2020-01-01 00:00:50,7,5,6747,306,6441,10.30%,4.54%
2020-01-01 00:00:50,7,6,12916,1165,11751,19.71%,9.02%
2020-01-01 00:00:50,7,7,3923,122,3801,5.99%,3.11%
2020-01-01 00:00:50,7,8,1572,23,1549,2.40%,1.46%
2020-01-01 00:00:50,7,9,5206,182,5024,7.94%,3.50%
2020-01-01 00:00:50,7,10,1384,10,1374,2.11%,0.72%
2020-01-01 00:00:50,7,11,211,0,211,0.32%,0.00%
2020-01-01 00:00:50,7,12,3840,107,3733,5.86%,2.79%
2020-01-01 00:00:50,8,1,329,1,328,0.50%,0.30%
2020-01-01 00:00:50,8,2,132,0,132,0.20%,0.00%
2020-01-01 00:00:50,8,3,1507,20,1487,2.30%,1.33%
2020-01-01 00:00:50,8,4,2302,44,2258,3.51%,1.91%
2020-01-01 00:00:50,8,5,8168,490,7678,12.46%,6.00%
2020-01-01 00:00:50,8,6,15535,1753,13782,23.70%,11.28%
2020-01-01 00:00:50,8,7,5013,200,4813,7.65%,3.99%
2020-01-01 00:00:50,8,8,2061,30,2031,3.14%,1.46%
2020-01-01 00:00:50,8,9,6426,320,6106,9.81%,4.98%
2020-01-01 00:00:50,8,10,1865,22,1843,2.85%,1.18%
2020-01-01 00:00:50,8,11,254,0,254,0.39%,0.00%
2020-01-01 00:00:50,8,12,4457,157,4300,6.80%,3.52%
2020-01-01 00:00:50,9,1,848,0,848,1.29%,0.00%
2020-01-01 00:00:50,9,2,2726,48,2678,4.16%,1.76%
2020-01-01 00:00:50,9,3,1468,11,1457,2.24%,0.75%
2020-01-01 00:00:50,9,4,10777,839,9938,16.44%,7.79%
2020-01-01 00:00:50,9,5,417,1,416,0.64%,0.24%
2020-01-01 00:00:50,9,6,11625,970,10655,17.74%,8.34%
2020-01-01 00:00:50,9,7,30711,6226,24485,46.86%,20.27%
2020-01-01 00:00:50,9,8,10831,909,9922,16.53%,8.39%
2020-01-01 00:00:50,9,9,315,0,315,0.48%,0.00%
2020-01-01 00:00:50,9,10,3720,87,3633,5.68%,2.34%
2020-01-01 00:00:50,9,11,9822,751,9071,14.99%,7.65%
2020-01-01 00:00:50,9,12,5765,249,5516,8.80%,4.32%
2020-01-01 00:00:50,10,1,1296,353,943,1.98%,27.24%
2020-01-01 00:00:50,10,2,3102,400,2702,4.73%,12.89%
2020-01-01 00:00:50,10,3,1681,23,1658,2.57%,1.37%
2020-01-01 00:00:50,10,4,4520,1276,3244,6.90%,28.23%
2020-01-01 00:00:50,10,5,765,11,754,1.17%,1.44%
2020-01-01 00:00:50,10,6,6468,1399,5069,9.87%,21.63%
2020-01-01 00:00:50,10,7,11687,2307,9380,17.83%,19.74%
2020-01-01 00:00:50,10,8,27585,6758,20827,42.09%,24.50%
2020-01-01 00:00:50,10,9,815,5,810,1.24%,0.61%
2020-01-01 00:00:50,10,10,3456,105,3351,5.27%,3.04%
2020-01-01 00:00:50,10,11,12612,1410,11202,19.24%,11.18%
2020-01-01 00:00:50,10,12,8629,820,7809,13.17%,9.50%
2020-01-01 00:00:50,11,1,2974,59,2915,4.54%,1.98%
2020-01-01 00:00:50,11,2,5060,169,4891,7.72%,3.34%
2020-01-01 00:00:50,11,3,1902,20,1882,2.90%,1.05%
2020-01-01 00:00:50,11,4,5296,200,5096,8.08%,3.78%
2020-01-01 00:00:50,11,5,603,2,601,0.92%,0.33%
2020-01-01 00:00:50,11,6,6690,323,6367,10.21%,4.83%
2020-01-01 00:00:50,11,7,13575,1293,12282,20.71%,9.52%
2020-01-01 00:00:50,11,8,27421,4955,22466,41.84%,18.07%
2020-01-01 00:00:50,11,9,204,0,204,0.31%,0.00%
2020-01-01 00:00:50,11,10,2904,71,2833,4.43%,2.44%
2020-01-01 00:00:50,11,11,9883,728,9155,15.08%,7.37%
2020-01-01 00:00:50,11,12,6595,326,6269,10.06%,4.94%
2020-01-01 00:00:50,12,1,38,0,38,0.06%,0.00%
2020-01-01 00:00:50,12,2,608,238,370,0.93%,39.14%
2020-01-01 00:00:50,12,3,3304,309,2995,5.04%,9.35%
2020-01-01 00:00:50,12,4,3557,58,3499,5.43%,1.63%
2020-01-01 00:00:50,12,5,10195,936,9259,15.56%,9.18%
2020-01-01 00:00:50,12,6,6043,228,5815,9.22%,3.77%
2020-01-01 00:00:50,12,7,2385,53,2332,3.64%,2.22%
2020-01-01 00:00:50,12,8,1576,259,1317,2.40%,16.43%
2020-01-01 00:00:50,12,9,23661,4806,18855,36.10%,20.31%
2020-01-01 00:00:50,12,10,4064,366,3698,6.20%,9.01%
2020-01-01 00:00:50,12,11,1776,266,1510,2.71%,14.98%
2020-01-01 00:00:50,12,12,7912,1249,6663,12.07%,15.79%
2020-01-01 00:00:50,13,1,2245,41,2204,3.43%,1.83%
2020-01-01 00:00:50,13,2,2602,57,2545,3.97%,2.19%
2020-01-01 00:00:50,13,3,727,0,727,1.11%,0.00%
2020-01-01 00:00:50,13,4,4275,404,3871,6.52%,9.45%
2020-01-01 00:00:50,13,5,6634,693,5941,10.12%,10.45%
2020-01-01 00:00:50,13,6,5048,446,4602,7.70%,8.84%
2020-01-01 00:00:50,13,7,5257,212,5045,8.02%,4.03%
2020-01-01 00:00:50,13,8,7215,384,6831,11.01%,5.32%
2020-01-01 00:00:50,13,9,6893,720,6173,10.52%,10.45%
2020-01-01 00:00:50,13,10,25617,5026,20591,39.09%,19.62%
2020-01-01 00:00:50,13,11,16631,2360,14271,25.38%,14.19%
2020-01-01 00:00:50,13,12,8802,996,7806,13.43%,11.32%
2020-01-01 00:00:50,14,1,388,0,388,0.59%,0.00%
2020-01-01 00:00:50,14,2,2013,31,1982,3.07%,1.54%
2020-01-01 00:00:50,14,3,1317,12,1305,2.01%,0.91%
2020-01-01 00:00:50,14,4,3565,101,3464,5.44%,2.83%
2020-01-01 00:00:50,14,5,1418,15,1403,2.16%,1.06%
2020-01-01 00:00:50,14,6,3821,119,3702,5.83%,3.11%
2020-01-01 00:00:50,14,7,10771,874,9897,16.44%,8.11%
2020-01-01 00:00:50,14,8,12408,1154,11254,18.93%,9.30%
2020-01-01 00:00:50,14,9,1770,23,1747,2.70%,1.30%
2020-01-01 00:00:50,14,10,5372,189,5183,8.20%,3.52%
2020-01-01 00:00:50,14,11,24657,4159,20498,37.62%,16.87%
2020-01-01 00:00:50,14,12,6658,310,6348,10.16%,4.66%
2020-01-01 00:00:50,15,1,427,2,425,0.65%,0.47%
2020-01-01 00:00:50,15,2,126,0,126,0.19%,0.00%
2020-01-01 00:00:50,15,3,3711,89,3622,5.66%,2.40%
2020-01-01 00:00:50,15,4,5225,202,5023,7.97%,3.87%
2020-01-01 00:00:50,15,5,9699,646,9053,14.80%,6.66%
2020-01-01 00:00:50,15,6,5430,230,5200,8.29%,4.24%
2020-01-01 00:00:50,15,7,3571,102,3469,5.45%,2.86%
2020-01-01 00:00:50,15,8,5374,233,5141,8.20%,4.34%
2020-01-01 00:00:50,15,9,9856,667,9189,15.04%,6.77%
2020-01-01 00:00:50,15,10,4690,178,4512,7.16%,3.80%
2020-01-01 00:00:50,15,11,10216,740,9476,15.59%,7.24%
2020-01-01 00:00:50,15,12,24938,4335,20603,38.05%,17.38%
2020-01-01 00:00:50,16,1,536,9,527,0.82%,1.68%
2020-01-01 00:00:50,16,2,297,0,297,0.45%,0.00%
2020-01-01 00:00:50,16,3,2508,47,2461,3.83%,1.87%
2020-01-01 00:00:50,16,4,4361,167,4194,6.65%,3.83%
2020-01-01 00:00:50,16,5,9120,668,8452,13.92%,7.32%
2020-01-01 00:00:50,16,6,5109,221,4888,7.80%,4.33%
2020-01-01 00:00:50,16,7,3110,94,3016,4.75%,3.02%
2020-01-01 00:00:50,16,8,6679,378,6301,10.19%,5.66%
2020-01-01 00:00:50,16,9,9512,724,8788,14.51%,7.61%
2020-01-01 00:00:50,16,10,1560,15,1545,2.38%,0.96%
2020-01-01 00:00:50,16,11,8456,599,7857,12.90%,7.08%
2020-01-01 00:00:50,16,12,26832,4959,21873,40.94%,18.48%
2020-01-01 00:01:00,1,1,17786,2258,15528,27.14%,12.70%
2020-01-01 00:01:00,1,2,8312,561,7751,12.68%,6.75%
2020-01-01 00:01:00,1,3,1657,26,1631,2.53%,1.57%
2020-01-01 00:01:00,1,4,9112,650,8462,13.90%,7.13%
2020-01-01 00:01:00,1,5,8519,572,7947,13.00%,6.71%
2020-01-01 00:01:00,1,6,8487,560,7927,12.95%,6.60%
2020-01-01 00:01:00,1,7,6638,369,6269,10.13%,5.56%
2020-01-01 00:01:00,1,8,4995,213,4782,7.62%,4.26%
2020-01-01 00:01:00,1,9,8422,553,7869,12.85%,6.57%
2020-01-01 00:01:00,1,10,4192,144,4048,6.40%,3.44%
2020-01-01 00:01:00,1,11,4257,150,4107,6.50%,3.52%
2020-01-01 00:01:00,1,12,8055,496,7559,12.29%,6.16%
2020-01-01 00:01:00,2,1,690,3,687,1.05%,0.43%
2020-01-01 00:01:00,2,2,36445,8560,27885,55.61%,23.49%
2020-01-01 00:01:00,2,3,31340,6478,24862,47.82%,20.67%
2020-01-01 00:01:00,2,4,657,3,654,1.00%,0.46%
2020-01-01 00:01:00,2,5,13263,1314,11949,20.24%,9.91%
2020-01-01 00:01:00,2,6,84,0,84,0.13%,0.00%
2020-01-01 00:01:00,2,7,4393,158,4235,6.70%,3.60%
2020-01-01 00:01:00,2,8,3013,68,2945,4.60%,2.26%
2020-01-01 00:01:00,2,9,13120,1284,11836,20.02%,9.79%
2020-01-01 00:01:00,2,10,2307,40,2267,3.52%,1.73%
2020-01-01 00:01:00,2,11,2342,40,2302,3.57%,1.71%
2020-01-01 00:01:00,2,12,12956,1248,11708,19.77%,9.63%
2020-01-01 00:01:00,3,1,2037,30,2007,3.11%,1.47%
2020-01-01 00:01:00,3,2,23909,3867,20042,36.48%,16.17%
2020-01-01 00:01:00,3,3,65192,23981,41211,99.48%,36.79%
2020-01-01 00:01:00,3,4,8146,506,7640,12.43%,6.21%
2020-01-01 00:01:00,3,5,39791,10030,29761,60.72%,25.21%
2020-01-01 00:01:00,3,6,9571,692,8879,14.60%,7.23%
2020-01-01 00:01:00,3,7,19839,2690,17149,30.27%,13.56%
2020-01-01 00:01:00,3,8,15625,1722,13903,23.84%,11.02%
2020-01-01 00:01:00,3,9,29789,5888,23901,45.45%,19.77%
2020-01-01 00:01:00,3,10,3840,132,3708,5.86%,3.44%
2020-01-01 00:01:00,3,11,2155,37,2118,3.29%,1.72%
2020-01-01 00:01:00,3,12,23391,3717,19674,35.69%,15.89%
2020-01-01 00:01:00,4,1,387,1,386,0.59%,0.26%
2020-01-01 00:01:00,4,2,237,0,237,0.36%,0.00%
2020-01-01 00:01:00,4,3,864,5,859,1.32%,0.58%
2020-01-01 00:01:00,4,4,26368,4594,21774,40.23%,17.42%
2020-01-01 00:01:00,4,5,17264,2088,15176,26.34%,12.09%
2020-01-01 00:01:00,4,6,22987,3590,19397,35.08%,15.62%
2020-01-01 00:01:00,4,7,4449,139,4310,6.79%,3.12%
2020-01-01 00:01:00,4,8,2510,45,2465,3.83%,1.79%
2020-01-01 00:01:00,4,9,15254,1637,13617,23.28%,10.73%
2020-01-01 00:01:00,4,10,1769,30,1739,2.70%,1.70%
2020-01-01 00:01:00,4,11,94,0,94,0.14%,0.00%
2020-01-01 00:01:00,4,12,12692,1097,11595,19.37%,8.64%
2020-01-01 00:01:00,5,1,3054,76,2978,4.66%,2.49%
2020-01-01 00:01:00,5,2,690,6,684,1.05%,0.87%
2020-01-01 00:01:00,5,3,598,3,595,0.91%,0.50%
2020-01-01 00:01:00,5,4,26740,5028,21712,40.80%,18.80%
2020-01-01 00:01:00,5,5,10832,863,9969,16.53%,7.97%
2020-01-01 00:01:00,5,6,17823,2419,15404,27.20%,13.57%
2020-01-01 00:01:00,5,7,6448,482,5966,9.84%,7.48%
2020-01-01 00:01:00,5,8,3883,123,3760,5.92%,3.17%
2020-01-01 00:01:00,5,9,10112,768,9344,15.43%,7.59%
2020-01-01 00:01:00,5,10,832,8,824,1.27%,0.96%
2020-01-01 00:01:00,5,11,1073,12,1061,1.64%,1.12%
2020-01-01 00:01:00,5,12,8499,558,7941,12.97%,6.57%
2020-01-01 00:01:00,6,1,994,11,983,1.52%,1.11%
2020-01-01 00:01:00,6,2,1111,13,1098,1.70%,1.17%
2020-01-01 00:01:00,6,3,1544,27,1517,2.36%,1.75%
2020-01-01 00:01:00,6,4,1763,26,1737,2.69%,1.47%
2020-01-01 00:01:00,6,5,16715,1973,14742,25.51%,11.80%
2020-01-01 00:01:00,6,6,5016,210,4806,7.65%,4.19%
2020-01-01 00:01:00,6,7,2964,59,2905,4.52%,1.99%
2020-01-01 00:01:00,6,8,1554,19,1535,2.37%,1.22%
2020-01-01 00:01:00,6,9,9687,702,8985,14.78%,7.25%
2020-01-01 00:01:00,6,10,2167,31,2136,3.31%,1.43%
2020-01-01 00:01:00,6,11,436,1,435,0.67%,0.23%
2020-01-01 00:01:00,6,12,7424,439,6985,11.33%,5.91%
2020-01-01 00:01:00,7,1,487,2,485,0.74%,0.41%
2020-01-01 00:01:00,7,2,90,0,90,0.14%,0.00%
2020-01-01 00:01:00,7,3,1225,13,1212,1.87%,1.06%
2020-01-01 00:01:00,7,4,1605,17,1588,2.45%,1.06%
2020-01-01 00:01:00,7,5,7270,350,6920,11.09%,4.81%
2020-01-01 00:01:00,7,6,12031,1002,11029,18.36%,8.33%
2020-01-01 00:01:00,7,7,3106,87,3019,4.74%,2.80%
2020-01-01 00:01:00,7,8,1277,13,1264,1.95%,1.02%
2020-01-01 00:01:00,7,9,5963,239,5724,9.10%,4.01%
2020-01-01 00:01:00,7,10,1070,6,1064,1.63%,0.56%
2020-01-01 00:01:00,7,11,129,0,129,0.20%,0.00%
2020-01-01 00:01:00,7,12,4975,167,4808,7.59%,3.36%
2020-01-01 00:01:00,8,1,481,1,480,0.73%,0.21%
2020-01-01 00:01:00,8,2,112,0,112,0.17%,0.00%
2020-01-01 00:01:00,8,3,1768,20,1748,2.70%,1.13%
2020-01-01 00:01:00,8,4,2371,38,2333,3.62%,1.60%
2020-01-01 00:01:00,8,5,8213,480,7733,12.53%,5.84%
2020-01-01 00:01:00,8,6,16404,1948,14456,25.03%,11.88%
2020-01-01 00:01:00,8,7,5796,260,5536,8.84%,4.49%
2020-01-01 00:01:00,8,8,2169,50,2119,3.31%,2.31%
2020-01-01 00:01:00,8,9,6041,251,5790,9.22%,4.15%
2020-01-01 00:01:00,8,10,1745,31,1714,2.66%,1.78%
2020-01-01 00:01:00,8,11,328,2,326,0.50%,0.61%
2020-01-01 00:01:00,8,12,4249,125,4124,6.48%,2.94%
2020-01-01 00:01:00,9,1,457,0,457,0.70%,0.00%
2020-01-01 00:01:00,9,2,2061,24,2037,3.14%,1.16%
2020-01-01 00:01:00,9,3,1281,8,1273,1.95%,0.62%
2020-01-01 00:01:00,9,4,9669,621,9048,14.75%,6.42%
2020-01-01 00:01:00,9,5,431,0,431,0.66%,0.00%
2020-01-01 00:01:00,9,6,10478,740,9738,15.99%,7.06%
2020-01-01 00:01:00,9,7,32394,6831,25563,49.43%,21.09%
2020-01-01 00:01:00,9,8,11414,898,10516,17.42%,7.87%
2020-01-01 00:01:00,9,9,352,0,352,0.54%,0.00%
2020-01-01 00:01:00,9,10,3749,99,3650,5.72%,2.64%
2020-01-01 00:01:00,9,11,10074,715,9359,15.37%,7.10%
2020-01-01 00:01:00,9,12,6077,262,5815,9.27%,4.31%
2020-01-01 00:01:00,10,1,1395,298,1097,2.13%,21.36%
2020-01-01 00:01:00,10,2,3055,349,2706,4.66%,11.42%
2020-01-01 00:01:00,10,3,1522,18,1504,2.32%,1.18%
2020-01-01 00:01:00,10,4,4076,1084,2992,6.22%,26.59%
2020-01-01 00:01:00,10,5,653,7,646,1.00%,1.07%
2020-01-01 00:01:00,10,6,6074,1194,4880,9.27%,19.66%
2020-01-01 00:01:00,10,7,11169,2017,9152,17.04%,18.06%
2020-01-01 00:01:00,10,8,26646,6580,20066,40.66%,24.69%
2020-01-01 00:01:00,10,9,794,3,791,1.21%,0.38%
2020-01-01 00:01:00,10,10,2389,43,2346,3.65%,1.80%
2020-01-01 00:01:00,10,11,11688,1389,10299,17.83%,11.88%
2020-01-01 00:01:00,10,12,8782,981,7801,13.40%,11.17%
2020-01-01 00:01:00,11,1,2436,48,2388,3.72%,1.97%
2020-01-01 00:01:00,11,2,3869,100,3769,5.90%,2.58%
2020-01-01 00:01:00,11,3,1171,7,1164,1.79%,0.60%
2020-01-01 00:01:00,11,4,3750,112,3638,5.72%,2.99%
2020-01-01 00:01:00,11,5,664,7,657,1.01%,1.05%
2020-01-01 00:01:00,11,6,5159,208,4951,7.87%,4.03%
2020-01-01 00:01:00,11,7,10664,840,9824,16.27%,7.88%
2020-01-01 00:01:00,11,8,24195,3913,20282,36.92%,16.17%
2020-01-01 00:01:00,11,9,243,0,243,0.37%,0.00%
2020-01-01 00:01:00,11,10,3053,69,2984,4.66%,2.26%
2020-01-01 00:01:00,11,11,10183,747,9436,15.54%,7.34%
2020-01-01 00:01:00,11,12,6759,334,6425,10.31%,4.94%
2020-01-01 00:01:00,12,1,25,0,25,0.04%,0.00%
2020-01-01 00:01:00,12,2,648,227,421,0.99%,35.03%
2020-01-01 00:01:00,12,3,3168,289,2879,4.83%,9.12%
2020-01-01 00:01:00,12,4,3113,70,3043,4.75%,2.25%
2020-01-01 00:01:00,12,5,10493,1017,9476,16.01%,9.69%
2020-01-01 00:01:00,12,6,6532,363,6169,9.97%,5.56%
2020-01-01 00:01:00,12,7,3267,103,3164,4.99%,3.15%
2020-01-01 00:01:00,12,8,1388,189,1199,2.12%,13.62%
2020-01-01 00:01:00,12,9,23623,4836,18787,36.05%,20.47%
2020-01-01 00:01:00,12,10,4277,324,3953,6.53%,7.58%
2020-01-01 00:01:00,12,11,1563,193,1370,2.38%,12.35%
2020-01-01 00:01:00,12,12,7139,1041,6098,10.89%,14.58%
2020-01-01 00:01:00,13,1,2391,36,2355,3.65%,1.51%
2020-01-01 00:01:00,13,2,2701,48,2653,4.12%,1.78%
2020-01-01 00:01:00,13,3,648,3,645,0.99%,0.46%
2020-01-01 00:01:00,13,4,5031,450,4581,7.68%,8.94%
2020-01-01 00:01:00,13,5,7214,758,6456,11.01%,10.51%
2020-01-01 00:01:00,13,6,5907,520,5387,9.01%,8.80%
2020-01-01 00:01:00,13,7,5368,212,5156,8.19%,3.95%
2020-01-01 00:01:00,13,8,7244,381,6863,11.05%,5.26%
2020-01-01 00:01:00,13,9,7528,830,6698,11.49%,11.03%
2020-01-01 00:01:00,13,10,26140,5079,21061,39.89%,19.43%
2020-01-01 00:01:00,13,11,16594,2171,14423,25.32%,13.08%
2020-01-01 00:01:00,13,12,8875,843,8032,13.54%,9.50%
2020-01-01 00:01:00,14,1,310,0,310,0.47%,0.00%
2020-01-01 00:01:00,14,2,1443,13,1430,2.20%,0.90%
2020-01-01 00:01:00,14,3,965,3,962,1.47%,0.31%
2020-01-01 00:01:00,14,4,4834,170,4664,7.38%,3.52%
2020-01-01 00:01:00,14,5,1435,20,1415,2.19%,1.39%
2020-01-01 00:01:00,14,6,5000,182,4818,7.63%,3.64%
2020-01-01 00:01:00,14,7,11631,970,10661,17.75%,8.34%
2020-01-01 00:01:00,14,8,13430,1297,12133,20.49%,9.66%
2020-01-01 00:01:00,14,9,1768,28,1740,2.70%,1.58%
2020-01-01 00:01:00,14,10,4497,173,4324,6.86%,3.85%
2020-01-01 00:01:00,14,11,24864,4188,20676,37.94%,16.84%
2020-01-01 00:01:00,14,12,6761,339,6422,10.32%,5.01%
2020-01-01 00:01:00,15,1,503,2,501,0.77%,0.40%
2020-01-01 00:01:00,15,2,133,0,133,0.20%,0.00%
2020-01-01 00:01:00,15,3,4002,110,3892,6.11%,2.75%
2020-01-01 00:01:00,15,4,7284,688,6596,11.11%,9.45%
2020-01-01 00:01:00,15,5,12695,1422,11273,19.37%,11.20%
2020-01-01 00:01:00,15,6,7475,709,6766,11.41%,9.48%
2020-01-01 00:01:00,15,7,3846,133,3713,5.87%,3.46%
2020-01-01 00:01:00,15,8,5270,240,5030,8.04%,4.55%
2020-01-01 00:01:00,15,9,12899,1447,11452,19.68%,11.22%
2020-01-01 00:01:00,15,10,4790,214,4576,7.31%,4.47%
2020-01-01 00:01:00,15,11,10557,867,9690,16.11%,8.21%
2020-01-01 00:01:00,15,12,29192,6159,23033,44.54%,21.10%
2020-01-01 00:01:00,16,1,458,1,457,0.70%,0.22%
2020-01-01 00:01:00,16,2,266,3,263,0.41%,1.13%
2020-01-01 00:01:00,16,3,1074,15,1059,1.64%,1.40%
2020-01-01 00:01:00,16,4,4337,124,4213,6.62%,2.86%
2020-01-01 00:01:00,16,5,7500,479,7021,11.44%,6.39%
2020-01-01 00:01:00,16,6,5123,200,4923,7.82%,3.90%
2020-01-01 00:01:00,16,7,3744,146,3598,5.71%,3.90%
2020-01-01 00:01:00,16,8,7271,421,6850,11.09%,5.79%
2020-01-01 00:01:00,16,9,7848,508,7340,11.98%,6.47%
2020-01-01 00:01:00,16,10,1602,19,1583,2.44%,1.19%
2020-01-01 00:01:00,16,11,9050,628,8422,13.81%,6.94%
2020-01-01 00:01:00,16,12,25128,4381,20747,38.34%,17.43%
2020-01-01 00:01:10,1,1,18024,2304,15720,27.50%,12.78%
2020-01-01 00:01:10,1,2,8440,504,7936,12.88%,5.97%
2020-01-01 00:01:10,1,3,502,4,498,0.77%,0.80%
2020-01-01 00:01:10,1,4,9273,639,8634,14.15%,6.89%
2020-01-01 00:01:10,1,5,8949,603,8346,13.66%,6.74%
2020-01-01 00:01:10,1,6,8909,596,8313,13.59%,6.69%
2020-01-01 00:01:10,1,7,7916,457,7459,12.08%,5.77%
2020-01-01 00:01:10,1,8,7144,372,6772,10.90%,5.21%
2020-01-01 00:01:10,1,9,8871,591,8280,13.54%,6.66%
2020-01-01 00:01:10,1,10,6496,302,6194,9.91%,4.65%
2020-01-01 00:01:10,1,11,6589,306,6283,10.05%,4.64%
2020-01-01 00:01:10,1,12,8809,583,8226,13.44%,6.62%
2020-01-01 00:01:10,2,1,388,1,387,0.59%,0.26%
2020-01-01 00:01:10,2,2,25685,4374,21311,39.19%,17.03%
2020-01-01 00:01:10,2,3,19981,2735,17246,30.49%,13.69%
2020-01-01 00:01:10,2,4,344,1,343,0.52%,0.29%
2020-01-01 00:01:10,2,5,12437,1113,11324,18.98%,8.95%
2020-01-01 00:01:10,2,6,68,0,68,0.10%,0.00%
2020-01-01 00:01:10,2,7,5301,224,5077,8.09%,4.23%
2020-01-01 00:01:10,2,8,4012,134,3878,6.12%,3.34%
2020-01-01 00:01:10,2,9,12284,1083,11201,18.74%,8.82%
2020-01-01 00:01:10,2,10,3078,82,2996,4.70%,2.66%
2020-01-01 00:01:10,2,11,3100,84,3016,4.73%,2.71%
2020-01-01 00:01:10,2,12,12129,1059,11070,18.51%,8.73%
2020-01-01 00:01:10,3,1,2291,40,2251,3.50%,1.75%
2020-01-01 00:01:10,3,2,26705,4705,22000,40.75%,17.62%
2020-01-01 00:01:10,3,3,76816,31511,45305,117.21%,41.02%
2020-01-01 00:01:10,3,4,9253,586,8667,14.12%,6.33%
2020-01-01 00:01:10,3,5,48818,14382,34436,74.49%,29.46%
2020-01-01 00:01:10,3,6,10613,801,9812,16.19%,7.55%
2020-01-01 00:01:10,3,7,22608,3469,19139,34.50%,15.34%
2020-01-01 00:01:10,3,8,18107,2253,15854,27.63%,12.44%
2020-01-01 00:01:10,3,9,37728,9078,28650,57.57%,24.06%
2020-01-01 00:01:10,3,10,4607,157,4450,7.03%,3.41%
2020-01-01 00:01:10,3,11,1624,20,1604,2.48%,1.23%
2020-01-01 00:01:10,3,12,30870,6291,24579,47.10%,20.38%
2020-01-01 00:01:10,4,1,540,1,539,0.82%,0.19%
2020-01-01 00:01:10,4,2,324,1,323,0.49%,0.31%
2020-01-01 00:01:10,4,3,770,5,765,1.17%,0.65%
2020-01-01 00:01:10,4,4,27679,5105,22574,42.23%,18.44%
2020-01-01 00:01:10,4,5,17357,2126,15231,26.48%,12.25%
2020-01-01 00:01:10,4,6,23624,3772,19852,36.05%,15.97%
2020-01-01 00:01:10,4,7,4986,202,4784,7.61%,4.05%
2020-01-01 00:01:10,4,8,2765,59,2706,4.22%,2.13%
2020-01-01 00:01:10,4,9,15290,1671,13619,23.33%,10.93%
2020-01-01 00:01:10,4,10,1900,35,1865,2.90%,1.84%
2020-01-01 00:01:10,4,11,212,0,212,0.32%,0.00%
2020-01-01 00:01:10,4,12,12747,1162,11585,19.45%,9.12%
2020-01-01 00:01:10,5,1,3082,67,3015,4.70%,2.17%
2020-01-01 00:01:10,5,2,944,5,939,1.44%,0.53%
2020-01-01 00:01:10,5,3,1106,10,1096,1.69%,0.90%
2020-01-01 00:01:10,5,4,23994,3945,20049,36.61%,16.44%
2020-01-01 00:01:10,5,5,9973,726,9247,15.22%,7.28%
2020-01-01 00:01:10,5,6,16616,1916,14700,25.35%,11.53%
2020-01-01 00:01:10,5,7,6186,271,5915,9.44%,4.38%
2020-01-01 00:01:10,5,8,4575,147,4428,6.98%,3.21%
2020-01-01 00:01:10,5,9,8718,578,8140,13.30%,6.63%
2020-01-01 00:01:10,5,10,941,4,937,1.44%,0.43%
2020-01-01 00:01:10,5,11,669,5,664,1.02%,0.75%
2020-01-01 00:01:10,5,12,7270,408,6862,11.09%,5.61%
2020-01-01 00:01:10,6,1,1137,10,1127,1.73%,0.88%
2020-01-01 00:01:10,6,2,1254,12,1242,1.91%,0.96%
2020-01-01 00:01:10,6,3,1910,22,1888,2.91%,1.15%
2020-01-01 00:01:10,6,4,1160,7,1153,1.77%,0.60%
2020-01-01 00:01:10,6,5,14599,1482,13117,22.28%,10.15%
2020-01-01 00:01:10,6,6,3929,131,3798,6.00%,3.33%
2020-01-01 00:01:10,6,7,2271,58,2213,3.47%,2.55%
2020-01-01 00:01:10,6,8,1754,42,1712,2.68%,2.39%
2020-01-01 00:01:10,6,9,8080,461,7619,12.33%,5.71%
2020-01-01 00:01:10,6,10,2083,34,2049,3.18%,1.63%
2020-01-01 00:01:10,6,11,425,2,423,0.65%,0.47%
2020-01-01 00:01:10,6,12,5930,258,5672,9.05%,4.35%
2020-01-01 00:01:10,7,1,455,3,452,0.69%,0.66%
2020-01-01 00:01:10,7,2,192,0,192,0.29%,0.00%
2020-01-01 00:01:10,7,3,984,6,978,1.50%,0.61%
2020-01-01 00:01:10,7,4,1970,35,1935,3.01%,1.78%
2020-01-01 00:01:10,7,5,7871,420,7451,12.01%,5.34%
2020-01-01 00:01:10,7,6,13423,1254,12169,20.48%,9.34%
2020-01-01 00:01:10,7,7,3539,110,3429,5.40%,3.11%
2020-01-01 00:01:10,7,8,1647,20,1627,2.51%,1.21%
2020-01-01 00:01:10,7,9,6517,280,6237,9.94%,4.30%
2020-01-01 00:01:10,7,10,1236,12,1224,1.89%,0.97%
2020-01-01 00:01:10,7,11,73,0,73,0.11%,0.00%
2020-01-01 00:01:10,7,12,5315,197,5118,8.11%,3.71%
2020-01-01 00:01:10,8,1,449,2,447,0.69%,0.45%
2020-01-01 00:01:10,8,2,39,0,39,0.06%,0.00%
2020-01-01 00:01:10,8,3,1729,22,1707,2.64%,1.27%
2020-01-01 00:01:10,8,4,2850,72,2778,4.35%,2.53%
2020-01-01 00:01:10,8,5,8310,496,7814,12.68%,5.97%
2020-01-01 00:01:10,8,6,16808,1965,14843,25.65%,11.69%
2020-01-01 00:01:10,8,7,5632,241,5391,8.59%,4.28%
2020-01-01 00:01:10,8,8,2795,67,2728,4.26%,2.40%
2020-01-01 00:01:10,8,9,6325,274,6051,9.65%,4.33%
2020-01-01 00:01:10,8,10,1591,11,1580,2.43%,0.69%
2020-01-01 00:01:10,8,11,135,0,135,0.21%,0.00%
2020-01-01 00:01:10,8,12,4747,170,4577,7.24%,3.58%
2020-01-01 00:01:10,9,1,244,0,244,0.37%,0.00%
2020-01-01 00:01:10,9,2,1757,22,1735,2.68%,1.25%
2020-01-01 00:01:10,9,3,1192,8,1184,1.82%,0.67%
2020-01-01 00:01:10,9,4,5702,260,5442,8.70%,4.56%
2020-01-01 00:01:10,9,5,314,0,314,0.48%,0.00%
2020-01-01 00:01:10,9,6,6570,340,6230,10.03%,5.18%
2020-01-01 00:01:10,9,7,28963,5572,23391,44.19%,19.24%
2020-01-01 00:01:10,9,8,12102,1030,11072,18.47%,8.51%
2020-01-01 00:01:10,9,9,228,0,228,0.35%,0.00%
2020-01-01 00:01:10,9,10,2932,49,2883,4.47%,1.67%
2020-01-01 00:01:10,9,11,10999,854,10145,16.78%,7.76%
2020-01-01 00:01:10,9,12,7604,441,7163,11.60%,5.80%
2020-01-01 00:01:10,10,1,1478,282,1196,2.26%,19.08%
2020-01-01 00:01:10,10,2,3488,362,3126,5.32%,10.38%
2020-01-01 00:01:10,10,3,1840,31,1809,2.81%,1.68%
2020-01-01 00:01:10,10,4,4400,1111,3289,6.71%,25.25%
2020-01-01 00:01:10,10,5,1046,92,954,1.60%,8.80%
2020-01-01 00:01:10,10,6,6458,1317,5141,9.85%,20.39%
2020-01-01 00:01:10,10,7,11883,2143,9740,18.13%,18.03%
2020-01-01 00:01:10,10,8,28928,7263,21665,44.14%,25.11%
2020-01-01 00:01:10,10,9,633,3,630,0.97%,0.47%
2020-01-01 00:01:10,10,10,2362,47,2315,3.60%,1.99%
2020-01-01 00:01:10,10,11,12475,1562,10913,19.04%,12.52%
2020-01-01 00:01:10,10,12,9605,1122,8483,14.66%,11.68%
2020-01-01 00:01:10,11,1,2224,44,2180,3.39%,1.98%
2020-01-01 00:01:10,11,2,3682,130,3552,5.62%,3.53%
2020-01-01 00:01:10,11,3,1099,18,1081,1.68%,1.64%
2020-01-01 00:01:10,11,4,3619,130,3489,5.52%,3.59%
2020-01-01 00:01:10,11,5,185,0,185,0.28%,0.00%
2020-01-01 00:01:10,11,6,4324,175,4149,6.60%,4.05%
2020-01-01 00:01:10,11,7,9736,757,8979,14.86%,7.78%
2020-01-01 00:01:10,11,8,24688,4281,20407,37.67%,17.34%
2020-01-01 00:01:10,11,9,279,0,279,0.43%,0.00%
2020-01-01 00:01:10,11,10,3343,77,3266,5.10%,2.30%
2020-01-01 00:01:10,11,11,11066,892,10174,16.89%,8.06%
2020-01-01 00:01:10,11,12,7258,419,6839,11.07%,5.77%
2020-01-01 00:01:10,12,1,24,0,24,0.04%,0.00%
2020-01-01 00:01:10,12,2,444,136,308,0.68%,30.63%
2020-01-01 00:01:10,12,3,2520,182,2338,3.85%,7.22%
2020-01-01 00:01:10,12,4,3336,70,3266,5.09%,2.10%
2020-01-01 00:01:10,12,5,8569,602,7967,13.08%,7.03%
2020-01-01 00:01:10,12,6,5360,187,5173,8.18%,3.49%
2020-01-01 00:01:10,12,7,1905,20,1885,2.91%,1.05%
2020-01-01 00:01:10,12,8,1504,261,1243,2.29%,17.35%
2020-01-01 00:01:10,12,9,21637,3951,17686,33.02%,18.26%
2020-01-01 00:01:10,12,10,4143,358,3785,6.32%,8.64%
2020-01-01 00:01:10,12,11,1648,264,1384,2.51%,16.02%
2020-01-01 00:01:10,12,12,7632,1101,6531,11.65%,14.43%
2020-01-01 00:01:10,13,1,1819,19,1800,2.78%,1.04%
2020-01-01 00:01:10,13,2,2129,32,2097,3.25%,1.50%
2020-01-01 00:01:10,13,3,457,1,456,0.70%,0.22%
2020-01-01 00:01:10,13,4,4721,556,4165,7.20%,11.78%
2020-01-01 00:01:10,13,5,7042,918,6124,10.75%,13.04%
2020-01-01 00:01:10,13,6,5386,598,4788,8.22%,11.10%
2020-01-01 00:01:10,13,7,4348,138,4210,6.63%,3.17%
2020-01-01 00:01:10,13,8,6658,334,6324,10.16%,5.02%
2020-01-01 00:01:10,13,9,7456,966,6490,11.38%,12.96%
2020-01-01 00:01:10,13,10,26190,5215,20975,39.96%,19.91%
2020-01-01 00:01:10,13,11,16211,2066,14145,24.74%,12.74%
2020-01-01 00:01:10,13,12,9180,876,8304,14.01%,9.54%
2020-01-01 00:01:10,14,1,442,2,440,0.67%,0.45%
2020-01-01 00:01:10,14,2,1635,18,1617,2.49%,1.10%
2020-01-01 00:01:10,14,3,996,5,991,1.52%,0.50%
2020-01-01 00:01:10,14,4,4369,137,4232,6.67%,3.14%
2020-01-01 00:01:10,14,5,1745,25,1720,2.66%,1.43%
2020-01-01 00:01:10,14,6,4730,156,4574,7.22%,3.30%
2020-01-01 00:01:10,14,7,12114,998,11116,18.48%,8.24%
2020-01-01 00:01:10,14,8,13841,1301,12540,21.12%,9.40%
2020-01-01 00:01:10,14,9,2007,32,1975,3.06%,1.59%
2020-01-01 00:01:10,14,10,4453,158,4295,6.79%,3.55%
2020-01-01 00:01:10,14,11,26478,4592,21886,40.40%,17.34%
2020-01-01 00:01:10,14,12,7834,439,7395,11.95%,5.60%
2020-01-01 00:01:10,15,1,742,3,739,1.13%,0.40%
2020-01-01 00:01:10,15,2,139,0,139,0.21%,0.00%
2020-01-01 00:01:10,15,3,7040,377,6663,10.74%,5.36%
2020-01-01 00:01:10,15,4,5148,222,4926,7.86%,4.31%
2020-01-01 00:01:10,15,5,12966,1212,11754,19.78%,9.35%
2020-01-01 00:01:10,15,6,5392,254,5138,8.23%,4.71%
2020-01-01 00:01:10,15,7,3321,74,3247,5.07%,2.23%
2020-01-01 00:01:10,15,8,5410,216,5194,8.26%,3.99%
2020-01-01 00:01:10,15,9,13138,1241,11897,20.05%,9.45%
2020-01-01 00:01:10,15,10,5106,285,4821,7.79%,5.58%
2020-01-01 00:01:10,15,11,10872,943,9929,16.59%,8.67%
2020-01-01 00:01:10,15,12,29686,6156,23530,45.30%,20.74%
2020-01-01 00:01:10,16,1,485,2,483,0.74%,0.41%
2020-01-01 00:01:10,16,2,294,2,292,0.45%,0.68%
2020-01-01 00:01:10,16,3,1550,19,1531,2.37%,1.23%
2020-01-01 00:01:10,16,4,3906,108,3798,5.96%,2.76%
2020-01-01 00:01:10,16,5,7639,511,7128,11.66%,6.69%
2020-01-01 00:01:10,16,6,4744,175,4569,7.24%,3.69%
2020-01-01 00:01:10,16,7,3764,100,3664,5.74%,2.66%
2020-01-01 00:01:10,16,8,7531,494,7037,11.49%,6.56%
2020-01-01 00:01:10,16,9,8021,553,7468,12.24%,6.89%
2020-01-01 00:01:10,16,10,1386,18,1368,2.11%,1.30%
2020-01-01 00:01:10,16,11,9075,681,8394,13.85%,7.50%
2020-01-01 00:01:10,16,12,26279,4685,21594,40.10%,17.83%
2020-01-01 00:01:20,1,1,21428,3136,18292,32.70%,14.64%
2020-01-01 00:01:20,1,2,11414,938,10476,17.42%,8.22%
2020-01-01 00:01:20,1,3,559,2,557,0.85%,0.36%
2020-01-01 00:01:20,1,4,9768,710,9058,14.90%,7.27%
2020-01-01 00:01:20,1,5,8910,609,8301,13.60%,6.84%
2020-01-01 00:01:20,1,6,8843,604,8239,13.49%,6.83%
2020-01-01 00:01:20,1,7,10822,839,9983,16.51%,7.75%
2020-01-01 00:01:20,1,8,9513,646,8867,14.52%,6.79%
2020-01-01 00:01:20,1,9,8797,600,8197,13.42%,6.82%
2020-01-01 00:01:20,1,10,8775,561,8214,13.39%,6.39%
2020-01-01 00:01:20,1,11,8868,572,8296,13.53%,6.45%
2020-01-01 00:01:20,1,12,8754,595,8159,13.36%,6.80%
2020-01-01 00:01:20,2,1,857,6,851,1.31%,0.70%
2020-01-01 00:01:20,2,2,25462,4369,21093,38.85%,17.16%
2020-01-01 00:01:20,2,3,20656,2957,17699,31.52%,14.32%
2020-01-01 00:01:20,2,4,779,3,776,1.19%,0.39%
2020-01-01 00:01:20,2,5,13150,1272,11878,20.07%,9.67%
2020-01-01 00:01:20,2,6,41,0,41,0.06%,0.00%
2020-01-01 00:01:20,2,7,3916,118,3798,5.98%,3.01%
2020-01-01 00:01:20,2,8,3278,82,3196,5.00%,2.50%
2020-01-01 00:01:20,2,9,13071,1258,11813,19.94%,9.62%
2020-01-01 00:01:20,2,10,2560,46,2514,3.91%,1.80%
2020-01-01 00:01:20,2,11,2567,46,2521,3.92%,1.79%
2020-01-01 00:01:20,2,12,12929,1225,11704,19.73%,9.47%
2020-01-01 00:01:20,3,1,1443,16,1427,2.20%,1.11%
2020-01-01 00:01:20,3,2,24717,4195,20522,37.72%,16.97%
2020-01-01 00:01:20,3,3,68795,26315,42480,104.97%,38.25%
2020-01-01 00:01:20,3,4,12905,1239,11666,19.69%,9.60%
2020-01-01 00:01:20,3,5,43468,11745,31723,66.33%,27.02%
2020-01-01 00:01:20,3,6,13963,1427,12536,21.31%,10.22%
2020-01-01 00:01:20,3,7,21346,3191,18155,32.57%,14.95%
2020-01-01 00:01:20,3,8,17532,2201,15331,26.75%,12.55%
2020-01-01 00:01:20,3,9,28891,5533,23358,44.08%,19.15%
2020-01-01 00:01:20,3,10,5698,233,5465,8.69%,4.09%
2020-01-01 00:01:20,3,11,2065,38,2027,3.15%,1.84%
2020-01-01 00:01:20,3,12,21051,3104,17947,32.12%,14.75%
2020-01-01 00:01:20,4,1,480,1,479,0.73%,0.21%
2020-01-01 00:01:20,4,2,281,1,280,0.43%,0.36%
2020-01-01 00:01:20,4,3,986,10,976,1.50%,1.01%
2020-01-01 00:01:20,4,4,26886,4803,22083,41.02%,17.86%
2020-01-01 00:01:20,4,5,17596,2161,15435,26.85%,12.28%
2020-01-01 00:01:20,4,6,23492,3740,19752,35.85%,15.92%
2020-01-01 00:01:20,4,7,4394,163,4231,6.70%,3.71%
2020-01-01 00:01:20,4,8,2854,76,2778,4.35%,2.66%
2020-01-01 00:01:20,4,9,15538,1694,13844,23.71%,10.90%
2020-01-01 00:01:20,4,10,1907,34,1873,2.91%,1.78%
2020-01-01 00:01:20,4,11,177,0,177,0.27%,0.00%
2020-01-01 00:01:20,4,12,12784,1157,11627,19.51%,9.05%
2020-01-01 00:01:20,5,1,2507,43,2464,3.83%,1.72%
2020-01-01 00:01:20,5,2,682,6,676,1.04%,0.88%
2020-01-01 00:01:20,5,3,1126,10,1116,1.72%,0.89%
2020-01-01 00:01:20,5,4,22969,3633,19336,35.05%,15.82%
2020-01-01 00:01:20,5,5,10975,906,10069,16.75%,8.26%
2020-01-01 00:01:20,5,6,16631,1978,14653,25.38%,11.89%
2020-01-01 00:01:20,5,7,5019,223,4796,7.66%,4.44%
2020-01-01 00:01:20,5,8,3664,126,3538,5.59%,3.44%
2020-01-01 00:01:20,5,9,9662,728,8934,14.74%,7.53%
2020-01-01 00:01:20,5,10,852,8,844,1.30%,0.94%
2020-01-01 00:01:20,5,11,969,10,959,1.48%,1.03%
2020-01-01 00:01:20,5,12,8352,538,7814,12.74%,6.44%
2020-01-01 00:01:20,6,1,961,9,952,1.47%,0.94%
2020-01-01 00:01:20,6,2,1070,12,1058,1.63%,1.12%
2020-01-01 00:01:20,6,3,2253,30,2223,3.44%,1.33%
2020-01-01 00:01:20,6,4,1021,8,1013,1.56%,0.78%
2020-01-01 00:01:20,6,5,15553,1714,13839,23.73%,11.02%
2020-01-01 00:01:20,6,6,3324,94,3230,5.07%,2.83%
2020-01-01 00:01:20,6,7,1844,38,1806,2.81%,2.06%
2020-01-01 00:01:20,6,8,1310,24,1286,2.00%,1.83%
2020-01-01 00:01:20,6,9,9534,693,8841,14.55%,7.27%
2020-01-01 00:01:20,6,10,2108,32,2076,3.22%,1.52%
2020-01-01 00:01:20,6,11,445,1,444,0.68%,0.22%
2020-01-01 00:01:20,6,12,7313,423,6890,11.16%,5.78%
2020-01-01 00:01:20,7,1,572,1,571,0.87%,0.17%
2020-01-01 00:01:20,7,2,135,0,135,0.21%,0.00%
2020-01-01 00:01:20,7,3,680,7,673,1.04%,1.03%
2020-01-01 00:01:20,7,4,1673,12,1661,2.55%,0.72%
2020-01-01 00:01:20,7,5,6546,328,6218,9.99%,5.01%
2020-01-01 00:01:20,7,6,11867,976,10891,18.11%,8.22%
2020-01-01 00:01:20,7,7,3615,90,3525,5.52%,2.49%
2020-01-01 00:01:20,7,8,1392,19,1373,2.12%,1.36%
2020-01-01 00:01:20,7,9,5735,253,5482,8.75%,4.41%
2020-01-01 00:01:20,7,10,1163,12,1151,1.77%,1.03%
2020-01-01 00:01:20,7,11,36,0,36,0.05%,0.00%
2020-01-01 00:01:20,7,12,4574,159,4415,6.98%,3.48%
2020-01-01 00:01:20,8,1,447,1,446,0.68%,0.22%
2020-01-01 00:01:20,8,2,84,0,84,0.13%,0.00%
2020-01-01 00:01:20,8,3,1478,18,1460,2.26%,1.22%
2020-01-01 00:01:20,8,4,2621,53,2568,4.00%,2.02%
2020-01-01 00:01:20,8,5,8106,502,7604,12.37%,6.19%
2020-01-01 00:01:20,8,6,14848,1612,13236,22.66%,10.86%
2020-01-01 00:01:20,8,7,4082,140,3942,6.23%,3.43%
2020-01-01 00:01:20,8,8,1721,26,1695,2.63%,1.51%
2020-01-01 00:01:20,8,9,6435,320,6115,9.82%,4.97%
2020-01-01 00:01:20,8,10,1790,27,1763,2.73%,1.51%
2020-01-01 00:01:20,8,11,210,1,209,0.32%,0.48%
2020-01-01 00:01:20,8,12,4568,147,4421,6.97%,3.22%
2020-01-01 00:01:20,9,1,579,1,578,0.88%,0.17%
2020-01-01 00:01:20,9,2,2378,40,2338,3.63%,1.68%
2020-01-01 00:01:20,9,3,1286,13,1273,1.96%,1.01%
2020-01-01 00:01:20,9,4,8332,490,7842,12.71%,5.88%
2020-01-01 00:01:20,9,5,1052,8,1044,1.61%,0.76%
2020-01-01 00:01:20,9,6,9673,646,9027,14.76%,6.68%
2020-01-01 00:01:20,9,7,36818,8808,28010,56.18%,23.92%
2020-01-01 00:01:20,9,8,15230,1719,13511,23.24%,11.29%
2020-01-01 00:01:20,9,9,234,1,233,0.36%,0.43%
2020-01-01 00:01:20,9,10,4946,261,4685,7.55%,5.28%
2020-01-01 00:01:20,9,11,14107,1478,12629,21.53%,10.48%
2020-01-01 00:01:20,9,12,8818,549,8269,13.46%,6.23%
2020-01-01 00:01:20,10,1,1382,269,1113,2.11%,19.46%
2020-01-01 00:01:20,10,2,4710,416,4294,7.19%,8.83%
2020-01-01 00:01:20,10,3,3191,81,3110,4.87%,2.54%
2020-01-01 00:01:20,10,4,4485,1052,3433,6.84%,23.46%
2020-01-01 00:01:20,10,5,743,31,712,1.13%,4.17%
2020-01-01 00:01:20,10,6,6159,1193,4966,9.40%,19.37%
2020-01-01 00:01:20,10,7,12592,2181,10411,19.21%,17.32%
2020-01-01 00:01:20,10,8,29095,7196,21899,44.40%,24.73%
2020-01-01 00:01:20,10,9,575,0,575,0.88%,0.00%
2020-01-01 00:01:20,10,10,2164,24,2140,3.30%,1.11%
2020-01-01 00:01:20,10,11,11896,1323,10573,18.15%,11.12%
2020-01-01 00:01:20,10,12,9130,959,8171,13.93%,10.50%
2020-01-01 00:01:20,11,1,2176,36,2140,3.32%,1.65%
2020-01-01 00:01:20,11,2,3332,95,3237,5.08%,2.85%
2020-01-01 00:01:20,11,3,975,9,966,1.49%,0.92%
2020-01-01 00:01:20,11,4,4222,129,4093,6.44%,3.06%
2020-01-01 00:01:20,11,5,200,0,200,0.31%,0.00%
2020-01-01 00:01:20,11,6,5140,182,4958,7.84%,3.54%
2020-01-01 00:01:20,11,7,9924,761,9163,15.14%,7.67%
2020-01-01 00:01:20,11,8,27457,5077,22380,41.90%,18.49%
2020-01-01 00:01:20,11,9,367,0,367,0.56%,0.00%
2020-01-01 00:01:20,11,10,3265,86,3179,4.98%,2.63%
2020-01-01 00:01:20,11,11,13492,1326,12166,20.59%,9.83%
2020-01-01 00:01:20,11,12,9916,703,9213,15.13%,7.09%
2020-01-01 00:01:20,12,1,39,0,39,0.06%,0.00%
2020-01-01 00:01:20,12,2,606,221,385,0.92%,36.47%
2020-01-01 00:01:20,12,3,2270,245,2025,3.46%,10.79%
2020-01-01 00:01:20,12,4,3341,102,3239,5.10%,3.05%
2020-01-01 00:01:20,12,5,8645,691,7954,13.19%,7.99%
2020-01-01 00:01:20,12,6,5537,238,5299,8.45%,4.30%
2020-01-01 00:01:20,12,7,2104,38,2066,3.21%,1.81%
2020-01-01 00:01:20,12,8,1204,252,952,1.84%,20.93%
2020-01-01 00:01:20,12,9,20758,3844,16914,31.67%,18.52%
2020-01-01 00:01:20,12,10,3883,350,3533,5.92%,9.01%
2020-01-01 00:01:20,12,11,1472,254,1218,2.25%,17.26%
2020-01-01 00:01:20,12,12,7289,988,6301,11.12%,13.55%
2020-01-01 00:01:20,13,1,2036,28,2008,3.11%,1.38%
2020-01-01 00:01:20,13,2,2307,38,2269,3.52%,1.65%
2020-01-01 00:01:20,13,3,827,5,822,1.26%,0.60%
2020-01-01 00:01:20,13,4,4852,511,4341,7.40%,10.53%
2020-01-01 00:01:20,13,5,7199,819,6380,10.98%,11.38%
2020-01-01 00:01:20,13,6,5465,554,4911,8.34%,10.14%
2020-01-01 00:01:20,13,7,4665,159,4506,7.12%,3.41%
2020-01-01 00:01:20,13,8,7137,370,6767,10.89%,5.18%
2020-01-01 00:01:20,13,9,7526,848,6678,11.48%,11.27%
2020-01-01 00:01:20,13,10,26460,5232,21228,40.37%,19.77%
2020-01-01 00:01:20,13,11,16180,2048,14132,24.69%,12.66%
2020-01-01 00:01:20,13,12,8585,783,7802,13.10%,9.12%
2020-01-01 00:01:20,14,1,396,3,393,0.60%,0.76%
2020-01-01 00:01:20,14,2,1800,21,1779,2.75%,1.17%
2020-01-01 00:01:20,14,3,1210,7,1203,1.85%,0.58%
2020-01-01 00:01:20,14,4,3809,92,3717,5.81%,2.42%
2020-01-01 00:01:20,14,5,1628,24,1604,2.48%,1.47%
2020-01-01 00:01:20,14,6,4180,119,4061,6.38%,2.85%
2020-01-01 00:01:20,14,7,11315,923,10392,17.27%,8.16%
2020-01-01 00:01:20,14,8,12825,1145,11680,19.57%,8.93%
2020-01-01 00:01:20,14,9,1852,27,1825,2.83%,1.46%
2020-01-01 00:01:20,14,10,4666,152,4514,7.12%,3.26%
2020-01-01 00:01:20,14,11,24568,4078,20490,37.49%,16.60%
2020-01-01 00:01:20,14,12,6766,383,6383,10.32%,5.66%
2020-01-01 00:01:20,15,1,495,0,495,0.76%,0.00%
2020-01-01 00:01:20,15,2,111,0,111,0.17%,0.00%
2020-01-01 00:01:20,15,3,5313,213,5100,8.11%,4.01%
2020-01-01 00:01:20,15,4,5254,223,5031,8.02%,4.24%
2020-01-01 00:01:20,15,5,12596,1149,11447,19.22%,9.12%
2020-01-01 00:01:20,15,6,5589,247,5342,8.53%,4.42%
2020-01-01 00:01:20,15,7,3467,88,3379,5.29%,2.54%
2020-01-01 00:01:20,15,8,5380,217,5163,8.21%,4.03%
2020-01-01 00:01:20,15,9,12732,1177,11555,19.43%,9.24%
2020-01-01 00:01:20,15,10,5444,244,5200,8.31%,4.48%
2020-01-01 00:01:20,15,11,10979,900,10079,16.75%,8.20%
2020-01-01 00:01:20,15,12,28486,5708,22778,43.47%,20.04%
2020-01-01 00:01:20,16,1,442,1,441,0.67%,0.23%
2020-01-01 00:01:20,16,2,325,1,324,0.50%,0.31%
2020-01-01 00:01:20,16,3,1466,23,1443,2.24%,1.57%
2020-01-01 00:01:20,16,4,6460,297,6163,9.86%,4.60%
2020-01-01 00:01:20,16,5,10317,828,9489,15.74%,8.03%
2020-01-01 00:01:20,16,6,7373,377,6996,11.25%,5.11%
2020-01-01 00:01:20,16,7,3587,98,3489,5.47%,2.73%
2020-01-01 00:01:20,16,8,7298,382,6916,11.14%,5.23%
2020-01-01 00:01:20,16,9,10684,875,9809,16.30%,8.19%
2020-01-01 00:01:20,16,10,1663,39,1624,2.54%,2.35%
2020-01-01 00:01:20,16,11,9230,649,8581,14.08%,7.03%
2020-01-01 00:01:20,16,12,28486,5544,22942,43.47%,19.46%
2020-01-01 00:01:30,1,1,17463,2210,15253,26.65%,12.66%
2020-01-01 00:01:30,1,2,7434,433,7001,11.34%,5.82%
2020-01-01 00:01:30,1,3,673,2,671,1.03%,0.30%
2020-01-01 00:01:30,1,4,9711,743,8968,14.82%,7.65%
2020-01-01 00:01:30,1,5,9373,687,8686,14.30%,7.33%
2020-01-01 00:01:30,1,6,9312,677,8635,14.21%,7.27%
2020-01-01 00:01:30,1,7,6748,360,6388,10.30%,5.33%
2020-01-01 00:01:30,1,8,5363,235,5128,8.18%,4.38%
2020-01-01 00:01:30,1,9,9274,676,8598,14.15%,7.29%
2020-01-01 00:01:30,1,10,4502,158,4344,6.87%,3.51%
2020-01-01 00:01:30,1,11,4564,166,4398,6.96%,3.64%
2020-01-01 00:01:30,1,12,9249,670,8579,14.11%,7.24%
2020-01-01 00:01:30,2,1,1012,16,996,1.54%,1.58%
2020-01-01 00:01:30,2,2,29375,5612,23763,44.82%,19.10%
2020-01-01 00:01:30,2,3,23883,3786,20097,36.44%,15.85%
2020-01-01 00:01:30,2,4,639,11,628,0.98%,1.72%
2020-01-01 00:01:30,2,5,13720,1365,12355,20.94%,9.95%
2020-01-01 00:01:30,2,6,39,0,39,0.06%,0.00%
2020-01-01 00:01:30,2,7,4466,144,4322,6.81%,3.22%
2020-01-01 00:01:30,2,8,3393,78,3315,5.18%,2.30%
2020-01-01 00:01:30,2,9,13644,1341,12303,20.82%,9.83%
2020-01-01 00:01:30,2,10,2611,44,2567,3.98%,1.69%
2020-01-01 00:01:30,2,11,2616,44,2572,3.99%,1.68%
2020-01-01 00:01:30,2,12,13425,1295,12130,20.48%,9.65%
2020-01-01 00:01:30,3,1,1463,13,1450,2.23%,0.89%
2020-01-01 00:01:30,3,2,25578,4400,21178,39.03%,17.20%
2020-01-01 00:01:30,3,3,76363,31167,45196,116.52%,40.81%
2020-01-01 00:01:30,3,4,8718,546,8172,13.30%,6.26%
2020-01-01 00:01:30,3,5,47146,13517,33629,71.94%,28.67%
2020-01-01 00:01:30,3,6,9734,670,9064,14.85%,6.88%
2020-01-01 00:01:30,3,7,22218,3372,18846,33.90%,15.18%
2020-01-01 00:01:30,3,8,17628,2176,15452,26.90%,12.34%
2020-01-01 00:01:30,3,9,36520,8492,28028,55.73%,23.25%
2020-01-01 00:01:30,3,10,8762,553,8209,13.37%,6.31%
2020-01-01 00:01:30,3,11,1681,23,1658,2.57%,1.37%
2020-01-01 00:01:30,3,12,25006,4202,20804,38.16%,16.80%
2020-01-01 00:01:30,4,1,482,1,481,0.74%,0.21%
2020-01-01 00:01:30,4,2,300,0,300,0.46%,0.00%
2020-01-01 00:01:30,4,3,924,5,919,1.41%,0.54%
2020-01-01 00:01:30,4,4,28454,5482,22972,43.42%,19.27%
2020-01-01 00:01:30,4,5,18783,2454,16329,28.66%,13.07%
2020-01-01 00:01:30,4,6,24952,4249,20703,38.07%,17.03%
2020-01-01 00:01:30,4,7,5019,189,4830,7.66%,3.77%
2020-01-01 00:01:30,4,8,2859,60,2799,4.36%,2.10%
2020-01-01 00:01:30,4,9,16546,1905,14641,25.25%,11.51%
2020-01-01 00:01:30,4,10,2077,37,2040,3.17%,1.78%
2020-01-01 00:01:30,4,11,178,1,177,0.27%,0.56%
2020-01-01 00:01:30,4,12,12950,1190,11760,19.76%,9.19%
2020-01-01 00:01:30,5,1,2978,64,2914,4.54%,2.15%
2020-01-01 00:01:30,5,2,789,6,783,1.20%,0.76%
2020-01-01 00:01:30,5,3,623,3,620,0.95%,0.48%
2020-01-01 00:01:30,5,4,21891,3309,18582,33.40%,15.12%
2020-01-01 00:01:30,5,5,9605,711,8894,14.66%,7.40%
2020-01-01 00:01:30,5,6,15412,1688,13724,23.52%,10.95%
2020-01-01 00:01:30,5,7,5164,222,4942,7.88%,4.30%
2020-01-01 00:01:30,5,8,3456,109,3347,5.27%,3.15%
2020-01-01 00:01:30,5,9,8274,547,7727,12.63%,6.61%
2020-01-01 00:01:30,5,10,888,4,884,1.35%,0.45%
2020-01-01 00:01:30,5,11,677,6,671,1.03%,0.89%
2020-01-01 00:01:30,5,12,7122,418,6704,10.87%,5.87%
2020-01-01 00:01:30,6,1,1062,10,1052,1.62%,0.94%
2020-01-01 00:01:30,6,2,1118,13,1105,1.71%,1.16%
2020-01-01 00:01:30,6,3,2028,33,1995,3.09%,1.63%
2020-01-01 00:01:30,6,4,1209,13,1196,1.84%,1.08%
2020-01-01 00:01:30,6,5,12677,1236,11441,19.34%,9.75%
2020-01-01 00:01:30,6,6,3979,138,3841,6.07%,3.47%
2020-01-01 00:01:30,6,7,2280,54,2226,3.48%,2.37%
2020-01-01 00:01:30,6,8,1755,36,1719,2.68%,2.05%
2020-01-01 00:01:30,6,9,6324,341,5983,9.65%,5.39%
2020-01-01 00:01:30,6,10,1975,56,1919,3.01%,2.84%
2020-01-01 00:01:30,6,11,407,2,405,0.62%,0.49%
2020-01-01 00:01:30,6,12,4259,152,4107,6.50%,3.57%
2020-01-01 00:01:30,7,1,535,6,529,0.82%,1.12%
2020-01-01 00:01:30,7,2,151,0,151,0.23%,0.00%
2020-01-01 00:01:30,7,3,1244,12,1232,1.90%,0.96%
2020-01-01 00:01:30,7,4,1419,18,1401,2.17%,1.27%
2020-01-01 00:01:30,7,5,8375,525,7850,12.78%,6.27%
2020-01-01 00:01:30,7,6,12946,1227,11719,19.75%,9.48%
2020-01-01 00:01:30,7,7,3098,85,3013,4.73%,2.74%
2020-01-01 00:01:30,7,8,1052,5,1047,1.61%,0.48%
2020-01-01 00:01:30,7,9,7061,372,6689,10.77%,5.27%
2020-01-01 00:01:30,7,10,1527,11,1516,2.33%,0.72%
2020-01-01 00:01:30,7,11,101,0,101,0.15%,0.00%
2020-01-01 00:01:30,7,12,5514,234,5280,8.41%,4.24%
2020-01-01 00:01:30,8,1,401,1,400,0.61%,0.25%
2020-01-01 00:01:30,8,2,94,0,94,0.14%,0.00%
2020-01-01 00:01:30,8,3,1589,19,1570,2.42%,1.20%
2020-01-01 00:01:30,8,4,2553,58,2495,3.90%,2.27%
2020-01-01 00:01:30,8,5,8768,566,8202,13.38%,6.46%
2020-01-01 00:01:30,8,6,16617,1941,14676,25.36%,11.68%
2020-01-01 00:01:30,8,7,5234,222,5012,7.99%,4.24%
2020-01-01 00:01:30,8,8,2142,43,2099,3.27%,2.01%
2020-01-01 00:01:30,8,9,5995,271,5724,9.15%,4.52%
2020-01-01 00:01:30,8,10,1614,19,1595,2.46%,1.18%
2020-01-01 00:01:30,8,11,183,0,183,0.28%,0.00%
2020-01-01 00:01:30,8,12,4309,149,4160,6.58%,3.46%
2020-01-01 00:01:30,9,1,606,1,605,0.92%,0.17%
2020-01-01 00:01:30,9,2,2538,47,2491,3.87%,1.85%
2020-01-01 00:01:30,9,3,1363,15,1348,2.08%,1.10%
2020-01-01 00:01:30,9,4,9535,664,8871,14.55%,6.96%
2020-01-01 00:01:30,9,5,234,0,234,0.36%,0.00%
2020-01-01 00:01:30,9,6,10357,774,9583,15.80%,7.47%
2020-01-01 00:01:30,9,7,32419,6944,25475,49.47%,21.42%
2020-01-01 00:01:30,9,8,11967,1156,10811,18.26%,9.66%
2020-01-01 00:01:30,9,9,146,0,146,0.22%,0.00%
2020-01-01 00:01:30,9,10,4445,176,4269,6.78%,3.96%
2020-01-01 00:01:30,9,11,10677,931,9746,16.29%,8.72%
2020-01-01 00:01:30,9,12,5985,273,5712,9.13%,4.56%
2020-01-01 00:01:30,10,1,1236,206,1030,1.89%,16.67%
2020-01-01 00:01:30,10,2,2828,245,2583,4.32%,8.66%
2020-01-01 00:01:30,10,3,1445,23,1422,2.20%,1.59%
2020-01-01 00:01:30,10,4,4242,950,3292,6.47%,22.40%
2020-01-01 00:01:30,10,5,774,3,771,1.18%,0.39%
2020-01-01 00:01:30,10,6,6138,1051,5087,9.37%,17.12%
2020-01-01 00:01:30,10,7,11149,1784,9365,17.01%,16.00%
2020-01-01 00:01:30,10,8,27516,6520,20996,41.99%,23.70%
2020-01-01 00:01:30,10,9,785,6,779,1.20%,0.76%
2020-01-01 00:01:30,10,10,2304,43,2261,3.52%,1.87%
2020-01-01 00:01:30,10,11,12899,1566,11333,19.68%,12.14%
2020-01-01 00:01:30,10,12,9673,1072,8601,14.76%,11.08%
2020-01-01 00:01:30,11,1,2139,32,2107,3.26%,1.50%
2020-01-01 00:01:30,11,2,3676,104,3572,5.61%,2.83%
2020-01-01 00:01:30,11,3,1431,18,1413,2.18%,1.26%
2020-01-01 00:01:30,11,4,4495,146,4349,6.86%,3.25%
2020-01-01 00:01:30,11,5,154,0,154,0.23%,0.00%
2020-01-01 00:01:30,11,6,5218,199,5019,7.96%,3.81%
2020-01-01 00:01:30,11,7,10610,822,9788,16.19%,7.75%
2020-01-01 00:01:30,11,8,26513,4774,21739,40.46%,18.01%
2020-01-01 00:01:30,11,9,195,0,195,0.30%,0.00%
2020-01-01 00:01:30,11,10,2983,77,2906,4.55%,2.58%
2020-01-01 00:01:30,11,11,12261,1116,11145,18.71%,9.10%
2020-01-01 00:01:30,11,12,8911,591,8320,13.60%,6.63%
2020-01-01 00:01:30,12,1,44,0,44,0.07%,0.00%
2020-01-01 00:01:30,12,2,563,194,369,0.86%,34.46%
2020-01-01 00:01:30,12,3,2761,261,2500,4.21%,9.45%
2020-01-01 00:01:30,12,4,3132,60,3072,4.78%,1.92%
2020-01-01 00:01:30,12,5,9225,801,8424,14.08%,8.68%
2020-01-01 00:01:30,12,6,5527,198,5329,8.43%,3.58%
2020-01-01 00:01:30,12,7,2230,41,2189,3.40%,1.84%
2020-01-01 00:01:30,12,8,1356,279,1077,2.07%,20.58%
2020-01-01 00:01:30,12,9,21593,4200,17393,32.95%,19.45%
2020-01-01 00:01:30,12,10,3991,378,3613,6.09%,9.47%
2020-01-01 00:01:30,12,11,1524,282,1242,2.33%,18.50%
2020-01-01 00:01:30,12,12,7858,1002,6856,11.99%,12.75%
2020-01-01 00:01:30,13,1,2808,69,2739,4.28%,2.46%
2020-01-01 00:01:30,13,2,3134,80,3054,4.78%,2.55%
2020-01-01 00:01:30,13,3,849,7,842,1.30%,0.82%
2020-01-01 00:01:30,13,4,4824,541,4283,7.36%,11.21%
2020-01-01 00:01:30,13,5,7637,817,6820,11.65%,10.70%
2020-01-01 00:01:30,13,6,5678,597,5081,8.66%,10.51%
2020-01-01 00:01:30,13,7,5459,213,5246,8.33%,3.90%
2020-01-01 00:01:30,13,8,7753,420,7333,11.83%,5.42%
2020-01-01 00:01:30,13,9,8040,864,7176,12.27%,10.75%
2020-01-01 00:01:30,13,10,27665,5691,21974,42.21%,20.57%
2020-01-01 00:01:30,13,11,16579,2270,14309,25.30%,13.69%
2020-01-01 00:01:30,13,12,8298,921,7377,12.66%,11.10%
2020-01-01 00:01:30,14,1,417,3,414,0.64%,0.72%
2020-01-01 00:01:30,14,2,1570,24,1546,2.40%,1.53%
2020-01-01 00:01:30,14,3,965,10,955,1.47%,1.04%
2020-01-01 00:01:30,14,4,3973,118,3855,6.06%,2.97%
2020-01-01 00:01:30,14,5,1335,16,1319,2.04%,1.20%
2020-01-01 00:01:30,14,6,4434,151,4283,6.77%,3.41%
2020-01-01 00:01:30,14,7,12526,1143,11383,19.11%,9.13%
2020-01-01 00:01:30,14,8,14144,1415,12729,21.58%,10.00%
2020-01-01 00:01:30,14,9,1511,22,1489,2.31%,1.46%
2020-01-01 00:01:30,14,10,3815,103,3712,5.82%,2.70%
2020-01-01 00:01:30,14,11,25632,4383,21249,39.11%,17.10%
2020-01-01 00:01:30,14,12,7496,414,7082,11.44%,5.52%
2020-01-01 00:01:30,15,1,502,5,497,0.77%,1.00%
2020-01-01 00:01:30,15,2,155,0,155,0.24%,0.00%
2020-01-01 00:01:30,15,3,3859,98,3761,5.89%,2.54%
2020-01-01 00:01:30,15,4,5354,206,5148,8.17%,3.85%
2020-01-01 00:01:30,15,5,10386,757,9629,15.85%,7.29%
2020-01-01 00:01:30,15,6,5591,224,5367,8.53%,4.01%
2020-01-01 00:01:30,15,7,4167,134,4033,6.36%,3.22%
2020-01-01 00:01:30,15,8,6378,334,6044,9.73%,5.24%
2020-01-01 00:01:30,15,9,10587,788,9799,16.15%,7.44%
2020-01-01 00:01:30,15,10,4762,237,4525,7.27%,4.98%
2020-01-01 00:01:30,15,11,11263,1033,10230,17.19%,9.17%
2020-01-01 00:01:30,15,12,27919,5609,22310,42.60%,20.09%
2020-01-01 00:01:30,16,1,429,2,427,0.65%,0.47%
2020-01-01 00:01:30,16,2,208,1,207,0.32%,0.48%
2020-01-01 00:01:30,16,3,1075,11,1064,1.64%,1.02%
2020-01-01 00:01:30,16,4,4135,137,3998,6.31%,3.31%
2020-01-01 00:01:30,16,5,7774,486,7288,11.86%,6.25%
2020-01-01 00:01:30,16,6,4966,211,4755,7.58%,4.25%
2020-01-01 00:01:30,16,7,3121,63,3058,4.76%,2.02%
2020-01-01 00:01:30,16,8,6765,377,6388,10.32%,5.57%
2020-01-01 00:01:30,16,9,8110,530,7580,12.37%,6.54%
2020-01-01 00:01:30,16,10,1552,19,1533,2.37%,1.22%
2020-01-01 00:01:30,16,11,8546,587,7959,13.04%,6.87%
2020-01-01 00:01:30,16,12,24894,4276,20618,37.99%,17.18%
2020-01-01 00:01:40,1,1,18019,2304,15715,27.49%,12.79%
2020-01-01 00:01:40,1,2,5833,269,5564,8.90%,4.61%
2020-01-01 00:01:40,1,3,828,4,824,1.26%,0.48%
2020-01-01 00:01:40,1,4,11761,992,10769,17.95%,8.43%
2020-01-01 00:01:40,1,5,10824,870,9954,16.52%,8.04%
2020-01-01 00:01:40,1,6,10763,866,9897,16.42%,8.05%
2020-01-01 00:01:40,1,7,4969,197,4772,7.58%,3.96%
2020-01-01 00:01:40,1,8,3280,83,3197,5.00%,2.53%
2020-01-01 00:01:40,1,9,10725,861,9864,16.37%,8.03%
2020-01-01 00:01:40,1,10,2458,47,2411,3.75%,1.91%
2020-01-01 00:01:40,1,11,2548,50,2498,3.89%,1.96%
2020-01-01 00:01:40,1,12,10691,855,9836,16.31%,8.00%
2020-01-01 00:01:40,2,1,778,8,770,1.19%,1.03%
2020-01-01 00:01:40,2,2,28274,5319,22955,43.14%,18.81%
2020-01-01 00:01:40,2,3,22375,3381,18994,34.14%,15.11%
2020-01-01 00:01:40,2,4,530,7,523,0.81%,1.32%
2020-01-01 00:01:40,2,5,10651,840,9811,16.25%,7.89%
2020-01-01 00:01:40,2,6,24,0,24,0.04%,0.00%
2020-01-01 00:01:40,2,7,5104,181,4923,7.79%,3.55%
2020-01-01 00:01:40,2,8,3811,102,3709,5.82%,2.68%
2020-01-01 00:01:40,2,9,10571,832,9739,16.13%,7.87%
2020-01-01 00:01:40,2,10,2614,52,2562,3.99%,1.99%
2020-01-01 00:01:40,2,11,2624,52,2572,4.00%,1.98%
2020-01-01 00:01:40,2,12,10399,805,9594,15.87%,7.74%
2020-01-01 00:01:40,3,1,1664,22,1642,2.54%,1.32%
2020-01-01 00:01:40,3,2,28154,5212,22942,42.96%,18.51%
2020-01-01 00:01:40,3,3,69651,26716,42935,106.28%,38.36%
2020-01-01 00:01:40,3,4,5446,223,5223,8.31%,4.09%
2020-01-01 00:01:40,3,5,40514,10270,30244,61.82%,25.35%
2020-01-01 00:01:40,3,6,6447,302,6145,9.84%,4.68%
2020-01-01 00:01:40,3,7,24170,3931,20239,36.88%,16.26%
2020-01-01 00:01:40,3,8,18859,2444,16415,28.78%,12.96%
2020-01-01 00:01:40,3,9,33379,7191,26188,50.93%,21.54%
2020-01-01 00:01:40,3,10,4114,123,3991,6.28%,2.99%
2020-01-01 00:01:40,3,11,1937,31,1906,2.96%,1.60%
2020-01-01 00:01:40,3,12,25394,4328,21066,38.75%,17.04%
2020-01-01 00:01:40,4,1,550,0,550,0.84%,0.00%
2020-01-01 00:01:40,4,2,300,0,300,0.46%,0.00%
2020-01-01 00:01:40,4,3,860,6,854,1.31%,0.70%
2020-01-01 00:01:40,4,4,30415,6223,24192,46.41%,20.46%
2020-01-01 00:01:40,4,5,19353,2695,16658,29.53%,13.93%
2020-01-01 00:01:40,4,6,26469,4790,21679,40.39%,18.10%
2020-01-01 00:01:40,4,7,5789,255,5534,8.83%,4.40%
2020-01-01 00:01:40,4,8,3439,90,3349,5.25%,2.62%
2020-01-01 00:01:40,4,9,17119,2143,14976,26.12%,12.52%
2020-01-01 00:01:40,4,10,2099,29,2070,3.20%,1.38%
2020-01-01 00:01:40,4,11,163,0,163,0.25%,0.00%
2020-01-01 00:01:40,4,12,12876,1245,11631,19.65%,9.67%
2020-01-01 00:01:40,5,1,3298,95,3203,5.03%,2.88%
2020-01-01 00:01:40,5,2,867,7,860,1.32%,0.81%
2020-01-01 00:01:40,5,3,537,7,530,0.82%,1.30%
2020-01-01 00:01:40,5,4,23620,3815,19805,36.04%,16.15%
2020-01-01 00:01:40,5,5,10562,841,9721,16.12%,7.96%
2020-01-01 00:01:40,5,6,16221,1879,14342,24.75%,11.58%
2020-01-01 00:01:40,5,7,5033,207,4826,7.68%,4.11%
2020-01-01 00:01:40,5,8,3632,100,3532,5.54%,2.75%
2020-01-01 00:01:40,5,9,9926,729,9197,15.15%,7.34%
2020-01-01 00:01:40,5,10,1240,14,1226,1.89%,1.13%
2020-01-01 00:01:40,5,11,756,5,751,1.15%,0.66%
2020-01-01 00:01:40,5,12,8428,528,7900,12.86%,6.26%
2020-01-01 00:01:40,6,1,1150,9,1141,1.75%,0.78%
2020-01-01 00:01:40,6,2,1189,12,1177,1.81%,1.01%
2020-01-01 00:01:40,6,3,1690,24,1666,2.58%,1.42%
2020-01-01 00:01:40,6,4,1076,5,1071,1.64%,0.46%
2020-01-01 00:01:40,6,5,12285,1113,11172,18.75%,9.06%
2020-01-01 00:01:40,6,6,4893,182,4711,7.47%,3.72%
2020-01-01 00:01:40,6,7,3179,80,3099,4.85%,2.52%
2020-01-01 00:01:40,6,8,2625,48,2577,4.01%,1.83%
2020-01-01 00:01:40,6,9,5422,221,5201,8.27%,4.08%
2020-01-01 00:01:40,6,10,1565,19,1546,2.39%,1.21%
2020-01-01 00:01:40,6,11,395,1,394,0.60%,0.25%
2020-01-01 00:01:40,6,12,3787,107,3680,5.78%,2.83%
2020-01-01 00:01:40,7,1,522,8,514,0.80%,1.53%
2020-01-01 00:01:40,7,2,222,1,221,0.34%,0.45%
2020-01-01 00:01:40,7,3,713,6,707,1.09%,0.84%
2020-01-01 00:01:40,7,4,2166,50,2116,3.31%,2.31%
2020-01-01 00:01:40,7,5,9524,638,8886,14.53%,6.70%
2020-01-01 00:01:40,7,6,14923,1554,13369,22.77%,10.41%
2020-01-01 00:01:40,7,7,3180,91,3089,4.85%,2.86%
2020-01-01 00:01:40,7,8,1103,8,1095,1.68%,0.73%
2020-01-01 00:01:40,7,9,8708,529,8179,13.29%,6.07%
2020-01-01 00:01:40,7,10,2146,21,2125,3.27%,0.98%
2020-01-01 00:01:40,7,11,104,0,104,0.16%,0.00%
2020-01-01 00:01:40,7,12,6534,315,6219,9.97%,4.82%
2020-01-01 00:01:40,8,1,512,2,510,0.78%,0.39%
2020-01-01 00:01:40,8,2,172,0,172,0.26%,0.00%
2020-01-01 00:01:40,8,3,1582,21,1561,2.41%,1.33%
2020-01-01 00:01:40,8,4,2813,52,2761,4.29%,1.85%
2020-01-01 00:01:40,8,5,8306,514,7792,12.67%,6.19%
2020-01-01 00:01:40,8,6,20541,2940,17601,31.34%,14.31%
2020-01-01 00:01:40,8,7,9332,654,8678,14.24%,7.01%
2020-01-01 00:01:40,8,8,6113,280,5833,9.33%,4.58%
2020-01-01 00:01:40,8,9,5997,282,5715,9.15%,4.70%
2020-01-01 00:01:40,8,10,1674,20,1654,2.55%,1.19%
2020-01-01 00:01:40,8,11,102,0,102,0.16%,0.00%
2020-01-01 00:01:40,8,12,4308,145,4163,6.57%,3.37%
2020-01-01 00:01:40,9,1,431,1,430,0.66%,0.23%
2020-01-01 00:01:40,9,2,2154,33,2121,3.29%,1.53%
2020-01-01 00:01:40,9,3,1183,9,1174,1.81%,0.76%
2020-01-01 00:01:40,9,4,6174,270,5904,9.42%,4.37%
2020-01-01 00:01:40,9,5,247,0,247,0.38%,0.00%
2020-01-01 00:01:40,9,6,6990,351,6639,10.67%,5.02%
2020-01-01 00:01:40,9,7,26070,4617,21453,39.78%,17.71%
2020-01-01 00:01:40,9,8,10161,771,9390,15.50%,7.59%
2020-01-01 00:01:40,9,9,160,0,160,0.24%,0.00%
2020-01-01 00:01:40,9,10,2609,62,2547,3.98%,2.38%
2020-01-01 00:01:40,9,11,7946,491,7455,12.12%,6.18%
2020-01-01 00:01:40,9,12,5032,202,4830,7.68%,4.01%
2020-01-01 00:01:40,10,1,1264,255,1009,1.93%,20.17%
2020-01-01 00:01:40,10,2,2989,312,2677,4.56%,10.44%
2020-01-01 00:01:40,10,3,1523,28,1495,2.32%,1.84%
2020-01-01 00:01:40,10,4,4109,1213,2896,6.27%,29.52%
2020-01-01 00:01:40,10,5,699,41,658,1.07%,5.87%
2020-01-01 00:01:40,10,6,6091,1376,4715,9.29%,22.59%
2020-01-01 00:01:40,10,7,11736,2233,9503,17.91%,19.03%
2020-01-01 00:01:40,10,8,29321,7620,21701,44.74%,25.99%
2020-01-01 00:01:40,10,9,809,5,804,1.23%,0.62%
2020-01-01 00:01:40,10,10,2248,33,2215,3.43%,1.47%
2020-01-01 00:01:40,10,11,13909,1795,12114,21.22%,12.91%
2020-01-01 00:01:40,10,12,10882,1308,9574,16.60%,12.02%
2020-01-01 00:01:40,11,1,2058,38,2020,3.14%,1.85%
2020-01-01 00:01:40,11,2,2936,74,2862,4.48%,2.52%
2020-01-01 00:01:40,11,3,748,0,748,1.14%,0.00%
2020-01-01 00:01:40,11,4,3832,103,3729,5.85%,2.69%
2020-01-01 00:01:40,11,5,179,2,177,0.27%,1.12%
2020-01-01 00:01:40,11,6,4839,183,4656,7.38%,3.78%
2020-01-01 00:01:40,11,7,9484,699,8785,14.47%,7.37%
2020-01-01 00:01:40,11,8,24925,4262,20663,38.03%,17.10%
2020-01-01 00:01:40,11,9,328,0,328,0.50%,0.00%
2020-01-01 00:01:40,11,10,3788,113,3675,5.78%,2.98%
2020-01-01 00:01:40,11,11,11449,969,10480,17.47%,8.46%
2020-01-01 00:01:40,11,12,7106,385,6721,10.84%,5.42%
2020-01-01 00:01:40,12,1,28,0,28,0.04%,0.00%
2020-01-01 00:01:40,12,2,606,166,440,0.92%,27.39%
2020-01-01 00:01:40,12,3,3109,221,2888,4.74%,7.11%
2020-01-01 00:01:40,12,4,2854,79,2775,4.35%,2.77%
2020-01-01 00:01:40,12,5,9452,782,8670,14.42%,8.27%
2020-01-01 00:01:40,12,6,5636,245,5391,8.60%,4.35%
2020-01-01 00:01:40,12,7,2580,37,2543,3.94%,1.43%
2020-01-01 00:01:40,12,8,1747,312,1435,2.67%,17.86%
2020-01-01 00:01:40,12,9,23620,4629,18991,36.04%,19.60%
2020-01-01 00:01:40,12,10,4365,427,3938,6.66%,9.78%
2020-01-01 00:01:40,12,11,1900,318,1582,2.90%,16.74%
2020-01-01 00:01:40,12,12,8666,1132,7534,13.22%,13.06%
2020-01-01 00:01:40,13,1,2455,45,2410,3.75%,1.83%
2020-01-01 00:01:40,13,2,2797,68,2729,4.27%,2.43%
2020-01-01 00:01:40,13,3,1003,7,996,1.53%,0.70%
2020-01-01 00:01:40,13,4,5353,517,4836,8.17%,9.66%
2020-01-01 00:01:40,13,5,8357,933,7424,12.75%,11.16%
2020-01-01 00:01:40,13,6,6179,577,5602,9.43%,9.34%
2020-01-01 00:01:40,13,7,5163,234,4929,7.88%,4.53%
2020-01-01 00:01:40,13,8,7961,498,7463,12.15%,6.26%
2020-01-01 00:01:40,13,9,8686,971,7715,13.25%,11.18%
2020-01-01 00:01:40,13,10,29657,6485,23172,45.25%,21.87%
2020-01-01 00:01:40,13,11,17720,2641,15079,27.04%,14.90%
2020-01-01 00:01:40,13,12,9314,1088,8226,14.21%,11.68%
2020-01-01 00:01:40,14,1,221,0,221,0.34%,0.00%
2020-01-01 00:01:40,14,2,1200,22,1178,1.83%,1.83%
2020-01-01 00:01:40,14,3,750,14,736,1.14%,1.87%
2020-01-01 00:01:40,14,4,5295,201,5094,8.08%,3.80%
2020-01-01 00:01:40,14,5,1258,9,1249,1.92%,0.72%
2020-01-01 00:01:40,14,6,5693,229,5464,8.69%,4.02%
2020-01-01 00:01:40,14,7,13637,1301,12336,20.81%,9.54%
2020-01-01 00:01:40,14,8,15148,1621,13527,23.11%,10.70%
2020-01-01 00:01:40,14,9,1449,13,1436,2.21%,0.90%
2020-01-01 00:01:40,14,10,3816,107,3709,5.82%,2.80%
2020-01-01 00:01:40,14,11,27401,5077,22324,41.81%,18.53%
2020-01-01 00:01:40,14,12,8186,497,7689,12.49%,6.07%
2020-01-01 00:01:40,15,1,470,2,468,0.72%,0.43%
2020-01-01 00:01:40,15,2,166,1,165,0.25%,0.60%
2020-01-01 00:01:40,15,3,3701,94,3607,5.65%,2.54%
2020-01-01 00:01:40,15,4,5298,213,5085,8.08%,4.02%
2020-01-01 00:01:40,15,5,9847,725,9122,15.03%,7.36%
2020-01-01 00:01:40,15,6,5685,240,5445,8.67%,4.22%
2020-01-01 00:01:40,15,7,3866,113,3753,5.90%,2.92%
2020-01-01 00:01:40,15,8,5832,264,5568,8.90%,4.53%
2020-01-01 00:01:40,15,9,10090,754,9336,15.40%,7.47%
2020-01-01 00:01:40,15,10,4051,229,3822,6.18%,5.65%
2020-01-01 00:01:40,15,11,9977,807,9170,15.22%,8.09%
2020-01-01 00:01:40,15,12,25634,4884,20750,39.11%,19.05%
2020-01-01 00:01:40,16,1,396,0,396,0.60%,0.00%
2020-01-01 00:01:40,16,2,247,3,244,0.38%,1.21%
2020-01-01 00:01:40,16,3,1317,15,1302,2.01%,1.14%
2020-01-01 00:01:40,16,4,4731,181,4550,7.22%,3.83%
2020-01-01 00:01:40,16,5,8319,584,7735,12.69%,7.02%
2020-01-01 00:01:40,16,6,5731,259,5472,8.74%,4.52%
2020-01-01 00:01:40,16,7,3035,70,2965,4.63%,2.31%
2020-01-01 00:01:40,16,8,6934,419,6515,10.58%,6.04%
2020-01-01 00:01:40,16,9,8742,629,8113,13.34%,7.20%
2020-01-01 00:01:40,16,10,1463,15,1448,2.23%,1.03%
2020-01-01 00:01:40,16,11,8669,596,8073,13.23%,6.88%
2020-01-01 00:01:40,16,12,25563,4521,21042,39.01%,17.69%
2020-01-01 00:01:50,1,1,27224,4979,22245,41.54%,18.29%
2020-01-01 00:01:50,1,2,13371,1242,12129,20.40%,9.29%
2020-01-01 00:01:50,1,3,1472,13,1459,2.25%,0.88%
2020-01-01 00:01:50,1,4,13406,1349,12057,20.46%,10.06%
2020-01-01 00:01:50,1,5,12025,1126,10899,18.35%,9.36%
2020-01-01 00:01:50,1,6,12006,1119,10887,18.32%,9.32%
2020-01-01 00:01:50,1,7,11865,985,10880,18.10%,8.30%
2020-01-01 00:01:50,1,8,9565,641,8924,14.60%,6.70%
2020-01-01 00:01:50,1,9,11966,1113,10853,18.26%,9.30%
2020-01-01 00:01:50,1,10,8916,555,8361,13.60%,6.22%
2020-01-01 00:01:50,1,11,8984,568,8416,13.71%,6.32%
2020-01-01 00:01:50,1,12,11937,1108,10829,18.21%,9.28%
2020-01-01 00:01:50,2,1,501,2,499,0.76%,0.40%
2020-01-01 00:01:50,2,2,25051,4262,20789,38.22%,17.01%
2020-01-01 00:01:50,2,3,19306,2518,16788,29.46%,13.04%
2020-01-01 00:01:50,2,4,462,2,460,0.70%,0.43%
2020-01-01 00:01:50,2,5,11886,1030,10856,18.14%,8.67%
2020-01-01 00:01:50,2,6,32,0,32,0.05%,0.00%
2020-01-01 00:01:50,2,7,5220,218,5002,7.97%,4.18%
2020-01-01 00:01:50,2,8,4246,128,4118,6.48%,3.01%
2020-01-01 00:01:50,2,9,11748,1006,10742,17.93%,8.56%
2020-01-01 00:01:50,2,10,3231,69,3162,4.93%,2.14%
2020-01-01 00:01:50,2,11,3261,69,3192,4.98%,2.12%
2020-01-01 00:01:50,2,12,11556,977,10579,17.63%,8.45%
2020-01-01 00:01:50,3,1,1480,22,1458,2.26%,1.49%
2020-01-01 00:01:50,3,2,23468,3689,19779,35.81%,15.72%
2020-01-01 00:01:50,3,3,64412,23297,41115,98.28%,36.17%
2020-01-01 00:01:50,3,4,7465,414,7051,11.39%,5.55%
2020-01-01 00:01:50,3,5,40073,9994,30079,61.15%,24.94%
2020-01-01 00:01:50,3,6,8390,530,7860,12.80%,6.32%
2020-01-01 00:01:50,3,7,20255,2770,17485,30.91%,13.68%
2020-01-01 00:01:50,3,8,17053,2019,15034,26.02%,11.84%
2020-01-01 00:01:50,3,9,31225,6302,24923,47.65%,20.18%
2020-01-01 00:01:50,3,10,4386,142,4244,6.69%,3.24%
2020-01-01 00:01:50,3,11,2319,49,2270,3.54%,2.11%
2020-01-01 00:01:50,3,12,24494,4001,20493,37.37%,16.33%
2020-01-01 00:01:50,4,1,546,2,544,0.83%,0.37%
2020-01-01 00:01:50,4,2,299,0,299,0.46%,0.00%
2020-01-01 00:01:50,4,3,1053,11,1042,1.61%,1.04%
2020-01-01 00:01:50,4,4,27892,5177,22715,42.56%,18.56%
2020-01-01 00:01:50,4,5,17265,2125,15140,26.34%,12.31%
2020-01-01 00:01:50,4,6,24122,3929,20193,36.81%,16.29%
2020-01-01 00:01:50,4,7,5485,221,5264,8.37%,4.03%
2020-01-01 00:01:50,4,8,3157,75,3082,4.82%,2.38%
2020-01-01 00:01:50,4,9,15142,1636,13506,23.10%,10.80%
2020-01-01 00:01:50,4,10,1930,28,1902,2.94%,1.45%
2020-01-01 00:01:50,4,11,171,0,171,0.26%,0.00%
2020-01-01 00:01:50,4,12,12034,1036,10998,18.36%,8.61%
2020-01-01 00:01:50,5,1,2756,48,2708,4.21%,1.74%
2020-01-01 00:01:50,5,2,753,5,748,1.15%,0.66%
2020-01-01 00:01:50,5,3,563,1,562,0.86%,0.18%
2020-01-01 00:01:50,5,4,30523,6192,24331,46.57%,20.29%
2020-01-01 00:01:50,5,5,11555,1011,10544,17.63%,8.75%
2020-01-01 00:01:50,5,6,17396,2180,15216,26.54%,12.53%
2020-01-01 00:01:50,5,7,5203,221,4982,7.94%,4.25%
2020-01-01 00:01:50,5,8,4119,145,3974,6.29%,3.52%
2020-01-01 00:01:50,5,9,10781,883,9898,16.45%,8.19%
2020-01-01 00:01:50,5,10,1000,7,993,1.53%,0.70%
2020-01-01 00:01:50,5,11,781,6,775,1.19%,0.77%
2020-01-01 00:01:50,5,12,8919,621,8298,13.61%,6.96%
2020-01-01 00:01:50,6,1,1075,11,1064,1.64%,1.02%
2020-01-01 00:01:50,6,2,1143,14,1129,1.74%,1.22%
2020-01-01 00:01:50,6,3,1699,23,1676,2.59%,1.35%
2020-01-01 00:01:50,6,4,1494,10,1484,2.28%,0.67%
2020-01-01 00:01:50,6,5,14127,1377,12750,21.56%,9.75%
2020-01-01 00:01:50,6,6,4234,139,4095,6.46%,3.28%
2020-01-01 00:01:50,6,7,2245,52,2193,3.43%,2.32%
2020-01-01 00:01:50,6,8,1574,31,1543,2.40%,1.97%
2020-01-01 00:01:50,6,9,8004,444,7560,12.21%,5.55%
2020-01-01 00:01:50,6,10,2219,46,2173,3.39%,2.07%
2020-01-01 00:01:50,6,11,349,1,348,0.53%,0.29%
2020-01-01 00:01:50,6,12,5738,228,5510,8.76%,3.97%
2020-01-01 00:01:50,7,1,394,5,389,0.60%,1.27%
2020-01-01 00:01:50,7,2,180,0,180,0.27%,0.00%
2020-01-01 00:01:50,7,3,2106,20,2086,3.21%,0.95%
2020-01-01 00:01:50,7,4,1734,24,1710,2.65%,1.38%
2020-01-01 00:01:50,7,5,9033,653,8380,13.78%,7.23%
2020-01-01 00:01:50,7,6,13983,1476,12507,21.34%,10.56%
2020-01-01 00:01:50,7,7,3190,78,3112,4.87%,2.45%
2020-01-01 00:01:50,7,8,1128,6,1122,1.72%,0.53%
2020-01-01 00:01:50,7,9,6648,382,6266,10.14%,5.75%
2020-01-01 00:01:50,7,10,1399,18,1381,2.13%,1.29%
2020-01-01 00:01:50,7,11,129,0,129,0.20%,0.00%
2020-01-01 00:01:50,7,12,5259,236,5023,8.02%,4.49%
2020-01-01 00:01:50,8,1,430,0,430,0.66%,0.00%
2020-01-01 00:01:50,8,2,155,0,155,0.24%,0.00%
2020-01-01 00:01:50,8,3,1861,19,1842,2.84%,1.02%
2020-01-01 00:01:50,8,4,2892,59,2833,4.41%,2.04%
2020-01-01 00:01:50,8,5,8539,494,8045,13.03%,5.79%
2020-01-01 00:01:50,8,6,17012,1971,15041,25.96%,11.59%
2020-01-01 00:01:50,8,7,5526,222,5304,8.43%,4.02%
2020-01-01 00:01:50,8,8,2609,42,2567,3.98%,1.61%
2020-01-01 00:01:50,8,9,6514,286,6228,9.94%,4.39%
2020-01-01 00:01:50,8,10,1623,14,1609,2.48%,0.86%
2020-01-01 00:01:50,8,11,126,0,126,0.19%,0.00%
2020-01-01 00:01:50,8,12,4819,173,4646,7.35%,3.59%
2020-01-01 00:01:50,9,1,395,0,395,0.60%,0.00%
2020-01-01 00:01:50,9,2,2322,43,2279,3.54%,1.85%
2020-01-01 00:01:50,9,3,1233,16,1217,1.88%,1.30%
2020-01-01 00:01:50,9,4,8489,514,7975,12.95%,6.05%
2020-01-01 00:01:50,9,5,368,0,368,0.56%,0.00%
2020-01-01 00:01:50,9,6,9724,673,9051,14.84%,6.92%
2020-01-01 00:01:50,9,7,29848,5905,23943,45.54%,19.78%
2020-01-01 00:01:50,9,8,10079,754,9325,15.38%,7.48%
2020-01-01 00:01:50,9,9,277,0,277,0.42%,0.00%
2020-01-01 00:01:50,9,10,3795,128,3667,5.79%,3.37%
2020-01-01 00:01:50,9,11,8976,618,8358,13.70%,6.89%
2020-01-01 00:01:50,9,12,4871,196,4675,7.43%,4.02%
2020-01-01 00:01:50,10,1,1368,268,1100,2.09%,19.59%
2020-01-01 00:01:50,10,2,3170,324,2846,4.84%,10.22%
2020-01-01 00:01:50,10,3,1544,16,1528,2.36%,1.04%
2020-01-01 00:01:50,10,4,3933,1035,2898,6.00%,26.32%
2020-01-01 00:01:50,10,5,605,27,578,0.92%,4.46%
2020-01-01 00:01:50,10,6,6005,1183,4822,9.16%,19.70%
2020-01-01 00:01:50,10,7,11364,2001,9363,17.34%,17.61%
2020-01-01 00:01:50,10,8,27820,6986,20834,42.45%,25.11%
2020-01-01 00:01:50,10,9,933,7,926,1.42%,0.75%
2020-01-01 00:01:50,10,10,2399,48,2351,3.66%,2.00%
2020-01-01 00:01:50,10,11,12914,1552,11362,19.71%,12.02%
2020-01-01 00:01:50,10,12,9899,1091,8808,15.10%,11.02%
2020-01-01 00:01:50,11,1,1919,30,1889,2.93%,1.56%
2020-01-01 00:01:50,11,2,2811,58,2753,4.29%,2.06%
2020-01-01 00:01:50,11,3,713,4,709,1.09%,0.56%
2020-01-01 00:01:50,11,4,3221,77,3144,4.91%,2.39%
2020-01-01 00:01:50,11,5,531,2,529,0.81%,0.38%
2020-01-01 00:01:50,11,6,4421,160,4261,6.75%,3.62%
2020-01-01 00:01:50,11,7,8865,580,8285,13.53%,6.54%
2020-01-01 00:01:50,11,8,22750,3505,19245,34.71%,15.41%
2020-01-01 00:01:50,11,9,306,0,306,0.47%,0.00%
2020-01-01 00:01:50,11,10,3760,102,3658,5.74%,2.71%
2020-01-01 00:01:50,11,11,10635,792,9843,16.23%,7.45%
2020-01-01 00:01:50,11,12,6507,282,6225,9.93%,4.33%
2020-01-01 00:01:50,12,1,55,0,55,0.08%,0.00%
2020-01-01 00:01:50,12,2,679,193,486,1.04%,28.42%
2020-01-01 00:01:50,12,3,2618,226,2392,3.99%,8.63%
2020-01-01 00:01:50,12,4,2651,51,2600,4.05%,1.92%
2020-01-01 00:01:50,12,5,9904,878,9026,15.11%,8.87%
2020-01-01 00:01:50,12,6,5660,265,5395,8.64%,4.68%
2020-01-01 00:01:50,12,7,2867,61,2806,4.37%,2.13%
2020-01-01 00:01:50,12,8,1246,188,1058,1.90%,15.09%
2020-01-01 00:01:50,12,9,22694,4449,18245,34.63%,19.60%
2020-01-01 00:01:50,12,10,3529,271,3258,5.38%,7.68%
2020-01-01 00:01:50,12,11,1381,190,1191,2.11%,13.76%
2020-01-01 00:01:50,12,12,7577,1081,6496,11.56%,14.27%
2020-01-01 00:01:50,13,1,2145,41,2104,3.27%,1.91%
2020-01-01 00:01:50,13,2,2439,47,2392,3.72%,1.93%
2020-01-01 00:01:50,13,3,822,4,818,1.25%,0.49%
2020-01-01 00:01:50,13,4,4881,606,4275,7.45%,12.42%
2020-01-01 00:01:50,13,5,7396,904,6492,11.29%,12.22%
2020-01-01 00:01:50,13,6,5837,669,5168,8.91%,11.46%
2020-01-01 00:01:50,13,7,5007,185,4822,7.64%,3.69%
2020-01-01 00:01:50,13,8,7322,390,6932,11.17%,5.33%
2020-01-01 00:01:50,13,9,7781,944,6837,11.87%,12.13%
2020-01-01 00:01:50,13,10,26477,5428,21049,40.40%,20.50%
2020-01-01 00:01:50,13,11,16225,2217,14008,24.76%,13.66%
2020-01-01 00:01:50,13,12,8354,924,7430,12.75%,11.06%
2020-01-01 00:01:50,14,1,301,0,301,0.46%,0.00%
2020-01-01 00:01:50,14,2,1216,18,1198,1.86%,1.48%
2020-01-01 00:01:50,14,3,773,12,761,1.18%,1.55%
2020-01-01 00:01:50,14,4,7153,444,6709,10.91%,6.21%
2020-01-01 00:01:50,14,5,1219,12,1207,1.86%,0.98%
2020-01-01 00:01:50,14,6,7388,470,6918,11.27%,6.36%
2020-01-01 00:01:50,14,7,13766,1413,12353,21.01%,10.26%
2020-01-01 00:01:50,14,8,15138,1674,13464,23.10%,11.06%
2020-01-01 00:01:50,14,9,1445,12,1433,2.20%,0.83%
2020-01-01 00:01:50,14,10,3992,107,3885,6.09%,2.68%
2020-01-01 00:01:50,14,11,27353,5038,22315,41.74%,18.42%
2020-01-01 00:01:50,14,12,7947,459,7488,12.13%,5.78%
2020-01-01 00:01:50,15,1,692,2,690,1.06%,0.29%
2020-01-01 00:01:50,15,2,116,0,116,0.18%,0.00%
2020-01-01 00:01:50,15,3,3907,110,3797,5.96%,2.82%
2020-01-01 00:01:50,15,4,4530,226,4304,6.91%,4.99%
2020-01-01 00:01:50,15,5,9704,766,8938,14.81%,7.89%
2020-01-01 00:01:50,15,6,4806,246,4560,7.33%,5.12%
2020-01-01 00:01:50,15,7,3593,87,3506,5.48%,2.42%
2020-01-01 00:01:50,15,8,5390,191,5199,8.22%,3.54%
2020-01-01 00:01:50,15,9,10003,813,9190,15.26%,8.13%
2020-01-01 00:01:50,15,10,3887,161,3726,5.93%,4.14%
2020-01-01 00:01:50,15,11,9393,629,8764,14.33%,6.70%
2020-01-01 00:01:50,15,12,24752,4484,20268,37.77%,18.12%
2020-01-01 00:01:50,16,1,328,0,328,0.50%,0.00%
2020-01-01 00:01:50,16,2,213,1,212,0.33%,0.47%
2020-01-01 00:01:50,16,3,2198,45,2153,3.35%,2.05%
2020-01-01 00:01:50,16,4,4673,162,4511,7.13%,3.47%
2020-01-01 00:01:50,16,5,8766,627,8139,13.38%,7.15%
2020-01-01 00:01:50,16,6,5498,214,5284,8.39%,3.89%
2020-01-01 00:01:50,16,7,3236,84,3152,4.94%,2.60%
2020-01-01 00:01:50,16,8,6587,328,6259,10.05%,4.98%
2020-01-01 00:01:50,16,9,9250,697,8553,14.11%,7.54%
2020-01-01 00:01:50,16,10,3874,104,3770,5.91%,2.68%
2020-01-01 00:01:50,16,11,10726,827,9899,16.37%,7.71%
2020-01-01 00:01:50,16,12,28007,5265,22742,42.74%,18.80%
2020-01-01 00:02:00,1,1,22210,3366,18844,33.89%,15.16%
2020-01-01 00:02:00,1,2,6525,359,6166,9.96%,5.50%
2020-01-01 00:02:00,1,3,414,2,412,0.63%,0.48%
2020-01-01 00:02:00,1,4,15323,1658,13665,23.38%,10.82%
2020-01-01 00:02:00,1,5,14970,1567,13403,22.84%,10.47%
2020-01-01 00:02:00,1,6,14904,1547,13357,22.74%,10.38%
2020-01-01 00:02:00,1,7,6088,328,5760,9.29%,5.39%
2020-01-01 00:02:00,1,8,4231,149,4082,6.46%,3.52%
2020-01-01 00:02:00,1,9,14860,1540,13320,22.67%,10.36%
2020-01-01 00:02:00,1,10,3704,115,3589,5.65%,3.10%
2020-01-01 00:02:00,1,11,3759,120,3639,5.74%,3.19%
2020-01-01 00:02:00,1,12,14826,1532,13294,22.62%,10.33%
2020-01-01 00:02:00,2,1,700,9,691,1.07%,1.29%
2020-01-01 00:02:00,2,2,29037,5633,23404,44.31%,19.40%
2020-01-01 00:02:00,2,3,22401,3431,18970,34.18%,15.32%
2020-01-01 00:02:00,2,4,606,8,598,0.92%,1.32%
2020-01-01 00:02:00,2,5,14585,1534,13051,22.25%,10.52%
2020-01-01 00:02:00,2,6,26,0,26,0.04%,0.00%
2020-01-01 00:02:00,2,7,5929,249,5680,9.05%,4.20%
2020-01-01 00:02:00,2,8,5004,179,4825,7.64%,3.58%
2020-01-01 00:02:00,2,9,14427,1508,12919,22.01%,10.45%
2020-01-01 00:02:00,2,10,4313,131,4182,6.58%,3.04%
2020-01-01 00:02:00,2,11,4330,134,4196,6.61%,3.09%
2020-01-01 00:02:00,2,12,14269,1483,12786,21.77%,10.39%
2020-01-01 00:02:00,3,1,1834,35,1799,2.80%,1.91%
2020-01-01 00:02:00,3,2,24080,4005,20075,36.74%,16.63%
2020-01-01 00:02:00,3,3,71041,27696,43345,108.40%,38.99%
2020-01-01 00:02:00,3,4,8478,541,7937,12.94%,6.38%
2020-01-01 00:02:00,3,5,45483,12646,32837,69.40%,27.80%
2020-01-01 00:02:00,3,6,9606,690,8916,14.66%,7.18%
2020-01-01 00:02:00,3,7,20782,3029,17753,31.71%,14.58%
2020-01-01 00:02:00,3,8,15713,1775,13938,23.98%,11.30%
2020-01-01 00:02:00,3,9,35405,7960,27445,54.02%,22.48%
2020-01-01 00:02:00,3,10,4319,145,4174,6.59%,3.36%
2020-01-01 00:02:00,3,11,1998,26,1972,3.05%,1.30%
2020-01-01 00:02:00,3,12,28918,5460,23458,44.13%,18.88%
2020-01-01 00:02:00,4,1,473,1,472,0.72%,0.21%
2020-01-01 00:02:00,4,2,281,0,281,0.43%,0.00%
2020-01-01 00:02:00,4,3,1241,5,1236,1.89%,0.40%
2020-01-01 00:02:00,4,4,27519,5019,22500,41.99%,18.24%
2020-01-01 00:02:00,4,5,17752,2176,15576,27.09%,12.26%
2020-01-01 00:02:00,4,6,23862,3850,20012,36.41%,16.13%
2020-01-01 00:02:00,4,7,4875,177,4698,7.44%,3.63%
2020-01-01 00:02:00,4,8,2650,82,2568,4.04%,3.09%
2020-01-01 00:02:00,4,9,15390,1643,13747,23.48%,10.68%
2020-01-01 00:02:00,4,10,2146,31,2115,3.27%,1.44%
2020-01-01 00:02:00,4,11,127,0,127,0.19%,0.00%
2020-01-01 00:02:00,4,12,12590,1143,11447,19.21%,9.08%
2020-01-01 00:02:00,5,1,3104,51,3053,4.74%,1.64%
2020-01-01 00:02:00,5,2,752,6,746,1.15%,0.80%
2020-01-01 00:02:00,5,3,436,1,435,0.67%,0.23%
2020-01-01 00:02:00,5,4,25534,4370,21164,38.96%,17.11%
2020-01-01 00:02:00,5,5,11881,1016,10865,18.13%,8.55%
2020-01-01 00:02:00,5,6,17309,2142,15167,26.41%,12.38%
2020-01-01 00:02:00,5,7,4852,177,4675,7.40%,3.65%
2020-01-01 00:02:00,5,8,3783,104,3679,5.77%,2.75%
2020-01-01 00:02:00,5,9,11300,918,10382,17.24%,8.12%
2020-01-01 00:02:00,5,10,1486,24,1462,2.27%,1.62%
2020-01-01 00:02:00,5,11,925,6,919,1.41%,0.65%
2020-01-01 00:02:00,5,12,8868,545,8323,13.53%,6.15%
2020-01-01 00:02:00,6,1,1135,9,1126,1.73%,0.79%
2020-01-01 00:02:00,6,2,1241,13,1228,1.89%,1.05%
2020-01-01 00:02:00,6,3,1780,21,1759,2.72%,1.18%
2020-01-01 00:02:00,6,4,1410,8,1402,2.15%,0.57%
2020-01-01 00:02:00,6,5,16460,1923,14537,25.12%,11.68%
2020-01-01 00:02:00,6,6,3804,115,3689,5.80%,3.02%
2020-01-01 00:02:00,6,7,2036,37,1999,3.11%,1.82%
2020-01-01 00:02:00,6,8,1454,14,1440,2.22%,0.96%
2020-01-01 00:02:00,6,9,10477,797,9680,15.99%,7.61%
2020-01-01 00:02:00,6,10,2404,36,2368,3.67%,1.50%
2020-01-01 00:02:00,6,11,498,1,497,0.76%,0.20%
2020-01-01 00:02:00,6,12,7991,466,7525,12.19%,5.83%
2020-01-01 00:02:00,7,1,338,4,334,0.52%,1.18%
2020-01-01 00:02:00,7,2,219,1,218,0.33%,0.46%
2020-01-01 00:02:00,7,3,716,1,715,1.09%,0.14%
2020-01-01 00:02:00,7,4,1231,15,1216,1.88%,1.22%
2020-01-01 00:02:00,7,5,6882,356,6526,10.50%,5.17%
2020-01-01 00:02:00,7,6,11365,955,10410,17.34%,8.40%
2020-01-01 00:02:00,7,7,3232,90,3142,4.93%,2.78%
2020-01-01 00:02:00,7,8,1102,14,1088,1.68%,1.27%
2020-01-01 00:02:00,7,9,5994,277,5717,9.15%,4.62%
2020-01-01 00:02:00,7,10,1247,18,1229,1.90%,1.44%
2020-01-01 00:02:00,7,11,178,0,178,0.27%,0.00%
2020-01-01 00:02:00,7,12,4779,174,4605,7.29%,3.64%
2020-01-01 00:02:00,8,1,430,1,429,0.66%,0.23%
2020-01-01 00:02:00,8,2,106,1,105,0.16%,0.94%
2020-01-01 00:02:00,8,3,1859,20,1839,2.84%,1.08%
2020-01-01 00:02:00,8,4,2631,45,2586,4.01%,1.71%
2020-01-01 00:02:00,8,5,8267,476,7791,12.61%,5.76%
2020-01-01 00:02:00,8,6,15732,1734,13998,24.01%,11.02%
2020-01-01 00:02:00,8,7,4788,159,4629,7.31%,3.32%
2020-01-01 00:02:00,8,8,1586,20,1566,2.42%,1.26%
2020-01-01 00:02:00,8,9,6209,271,5938,9.47%,4.36%
2020-01-01 00:02:00,8,10,1637,16,1621,2.50%,0.98%
2020-01-01 00:02:00,8,11,178,0,178,0.27%,0.00%
2020-01-01 00:02:00,8,12,4424,152,4272,6.75%,3.44%
2020-01-01 00:02:00,9,1,1054,2,1052,1.61%,0.19%
2020-01-01 00:02:00,9,2,4776,174,4602,7.29%,3.64%
2020-01-01 00:02:00,9,3,3242,94,3148,4.95%,2.90%
2020-01-01 00:02:00,9,4,4487,138,4349,6.85%,3.08%
2020-01-01 00:02:00,9,5,369,2,367,0.56%,0.54%
2020-01-01 00:02:00,9,6,5328,203,5125,8.13%,3.81%
2020-01-01 00:02:00,9,7,27267,5080,22187,41.61%,18.63%
2020-01-01 00:02:00,9,8,10538,832,9706,16.08%,7.90%
2020-01-01 00:02:00,9,9,327,2,325,0.50%,0.61%
2020-01-01 00:02:00,9,10,2451,48,2403,3.74%,1.96%
2020-01-01 00:02:00,9,11,8128,459,7669,12.40%,5.65%
2020-01-01 00:02:00,9,12,5269,222,5047,8.04%,4.21%
2020-01-01 00:02:00,10,1,1438,318,1120,2.19%,22.11%
2020-01-01 00:02:00,10,2,4500,416,4084,6.87%,9.24%
2020-01-01 00:02:00,10,3,2799,48,2751,4.27%,1.71%
2020-01-01 00:02:00,10,4,4475,927,3548,6.83%,20.72%
2020-01-01 00:02:00,10,5,444,3,441,0.68%,0.68%
2020-01-01 00:02:00,10,6,6089,1047,5042,9.29%,17.19%
2020-01-01 00:02:00,10,7,12724,2097,10627,19.42%,16.48%
2020-01-01 00:02:00,10,8,29529,7517,22012,45.06%,25.46%
2020-01-01 00:02:00,10,9,853,5,848,1.30%,0.59%
2020-01-01 00:02:00,10,10,2963,78,2885,4.52%,2.63%
2020-01-01 00:02:00,10,11,12646,1492,11154,19.30%,11.80%
2020-01-01 00:02:00,10,12,9054,928,8126,13.82%,10.25%
2020-01-01 00:02:00,11,1,1860,27,1833,2.84%,1.45%
2020-01-01 00:02:00,11,2,4802,151,4651,7.33%,3.14%
2020-01-01 00:02:00,11,3,2714,50,2664,4.14%,1.84%
2020-01-01 00:02:00,11,4,3655,97,3558,5.58%,2.65%
2020-01-01 00:02:00,11,5,123,0,123,0.19%,0.00%
2020-01-01 00:02:00,11,6,4448,134,4314,6.79%,3.01%
2020-01-01 00:02:00,11,7,10904,833,10071,16.64%,7.64%
2020-01-01 00:02:00,11,8,24561,4070,20491,37.48%,16.57%
2020-01-01 00:02:00,11,9,247,0,247,0.38%,0.00%
2020-01-01 00:02:00,11,10,3487,96,3391,5.32%,2.75%
2020-01-01 00:02:00,11,11,10669,819,9850,16.28%,7.68%
2020-01-01 00:02:00,11,12,6906,361,6545,10.54%,5.23%
2020-01-01 00:02:00,12,1,40,0,40,0.06%,0.00%
2020-01-01 00:02:00,12,2,736,225,511,1.12%,30.57%
2020-01-01 00:02:00,12,3,2769,289,2480,4.23%,10.44%
2020-01-01 00:02:00,12,4,3154,74,3080,4.81%,2.35%
2020-01-01 00:02:00,12,5,10856,1088,9768,16.56%,10.02%
2020-01-01 00:02:00,12,6,6572,337,6235,10.03%,5.13%
2020-01-01 00:02:00,12,7,3288,104,3184,5.02%,3.16%
2020-01-01 00:02:00,12,8,980,192,788,1.50%,19.59%
2020-01-01 00:02:00,12,9,23621,4856,18765,36.04%,20.56%
2020-01-01 00:02:00,12,10,3445,268,3177,5.26%,7.78%
2020-01-01 00:02:00,12,11,1075,192,883,1.64%,17.86%
2020-01-01 00:02:00,12,12,7779,1158,6621,11.87%,14.89%
2020-01-01 00:02:00,13,1,1943,29,1914,2.96%,1.49%
2020-01-01 00:02:00,13,2,2308,40,2268,3.52%,1.73%
2020-01-01 00:02:00,13,3,659,4,655,1.01%,0.61%
2020-01-01 00:02:00,13,4,5100,461,4639,7.78%,9.04%
2020-01-01 00:02:00,13,5,7506,788,6718,11.45%,10.50%
2020-01-01 00:02:00,13,6,6126,548,5578,9.35%,8.95%
2020-01-01 00:02:00,13,7,5014,172,4842,7.65%,3.43%
2020-01-01 00:02:00,13,8,6958,341,6617,10.62%,4.90%
2020-01-01 00:02:00,13,9,7832,825,7007,11.95%,10.53%
2020-01-01 00:02:00,13,10,27784,5616,22168,42.40%,20.21%
2020-01-01 00:02:00,13,11,17679,2468,15211,26.98%,13.96%
2020-01-01 00:02:00,13,12,10111,1083,9028,15.43%,10.71%
2020-01-01 00:02:00,14,1,508,2,506,0.78%,0.39%
2020-01-01 00:02:00,14,2,1653,25,1628,2.52%,1.51%
2020-01-01 00:02:00,14,3,978,8,970,1.49%,0.82%
2020-01-01 00:02:00,14,4,4665,198,4467,7.12%,4.24%
2020-01-01 00:02:00,14,5,1378,13,1365,2.10%,0.94%
2020-01-01 00:02:00,14,6,4915,220,4695,7.50%,4.48%
2020-01-01 00:02:00,14,7,11252,1008,10244,17.17%,8.96%
2020-01-01 00:02:00,14,8,12712,1249,11463,19.40%,9.83%
2020-01-01 00:02:00,14,9,1729,22,1707,2.64%,1.27%
2020-01-01 00:02:00,14,10,4120,128,3992,6.29%,3.11%
2020-01-01 00:02:00,14,11,24272,4137,20135,37.04%,17.04%
2020-01-01 00:02:00,14,12,7168,388,6780,10.94%,5.41%
2020-01-01 00:02:00,15,1,533,3,530,0.81%,0.56%
2020-01-01 00:02:00,15,2,147,0,147,0.22%,0.00%
2020-01-01 00:02:00,15,3,3430,97,3333,5.23%,2.83%
2020-01-01 00:02:00,15,4,5249,226,5023,8.01%,4.31%
2020-01-01 00:02:00,15,5,10330,814,9516,15.76%,7.88%
2020-01-01 00:02:00,15,6,5481,248,5233,8.36%,4.52%
2020-01-01 00:02:00,15,7,4191,156,4035,6.39%,3.72%
2020-01-01 00:02:00,15,8,6126,315,5811,9.35%,5.14%
2020-01-01 00:02:00,15,9,10609,855,9754,16.19%,8.06%
2020-01-01 00:02:00,15,10,4672,151,4521,7.13%,3.23%
2020-01-01 00:02:00,15,11,10972,895,10077,16.74%,8.16%
2020-01-01 00:02:00,15,12,27712,5521,22191,42.29%,19.92%
2020-01-01 00:02:00,16,1,412,2,410,0.63%,0.49%
2020-01-01 00:02:00,16,2,246,3,243,0.38%,1.22%
2020-01-01 00:02:00,16,3,2318,33,2285,3.54%,1.42%
2020-01-01 00:02:00,16,4,3636,120,3516,5.55%,3.30%
2020-01-01 00:02:00,16,5,7760,516,7244,11.84%,6.65%
2020-01-01 00:02:00,16,6,4390,157,4233,6.70%,3.58%
2020-01-01 00:02:00,16,7,4060,120,3940,6.20%,2.96%
2020-01-01 00:02:00,16,8,8239,497,7742,12.57%,6.03%
2020-01-01 00:02:00,16,9,8196,560,7636,12.51%,6.83%
2020-01-01 00:02:00,16,10,1709,27,1682,2.61%,1.58%
2020-01-01 00:02:00,16,11,10135,746,9389,15.46%,7.36%
2020-01-01 00:02:00,16,12,26276,4709,21567,40.09%,17.92%
2020-01-01 00:02:10,1,1,15526,1788,13738,23.69%,11.52%
2020-01-01 00:02:10,1,2,6353,323,6030,9.69%,5.08%
2020-01-01 00:02:10,1,3,550,1,549,0.84%,0.18%
2020-01-01 00:02:10,1,4,8674,592,8082,13.24%,6.82%
2020-01-01 00:02:10,1,5,8403,558,7845,12.82%,6.64%
2020-01-01 00:02:10,1,6,8330,542,7788,12.71%,6.51%
2020-01-01 00:02:10,1,7,5786,263,5523,8.83%,4.55%
2020-01-01 00:02:10,1,8,4799,183,4616,7.32%,3.81%
2020-01-01 00:02:10,1,9,8290,539,7751,12.65%,6.50%
2020-01-01 00:02:10,1,10,4235,148,4087,6.46%,3.49%
2020-01-01 00:02:10,1,11,4324,154,4170,6.60%,3.56%
2020-01-01 00:02:10,1,12,8273,538,7735,12.62%,6.50%
2020-01-01 00:02:10,2,1,584,0,584,0.89%,0.00%
2020-01-01 00:02:10,2,2,26451,4741,21710,40.36%,17.92%
2020-01-01 00:02:10,2,3,21424,3229,18195,32.69%,15.07%
2020-01-01 00:02:10,2,4,513,0,513,0.78%,0.00%
2020-01-01 00:02:10,2,5,11964,1034,10930,18.26%,8.64%
2020-01-01 00:02:10,2,6,31,0,31,0.05%,0.00%
2020-01-01 00:02:10,2,7,4434,146,4288,6.77%,3.29%
2020-01-01 00:02:10,2,8,3221,90,3131,4.91%,2.79%
2020-01-01 00:02:10,2,9,11874,1015,10859,18.12%,8.55%
2020-01-01 00:02:10,2,10,2488,54,2434,3.80%,2.17%
2020-01-01 00:02:10,2,11,2506,54,2452,3.82%,2.15%
2020-01-01 00:02:10,2,12,11632,970,10662,17.75%,8.34%
2020-01-01 00:02:10,3,1,1249,5,1244,1.91%,0.40%
2020-01-01 00:02:10,3,2,22721,3514,19207,34.67%,15.47%
2020-01-01 00:02:10,3,3,67321,25238,42083,102.72%,37.49%
2020-01-01 00:02:10,3,4,7053,369,6684,10.76%,5.23%
2020-01-01 00:02:10,3,5,41470,10720,30750,63.28%,25.85%
2020-01-01 00:02:10,3,6,8122,485,7637,12.39%,5.97%
2020-01-01 00:02:10,3,7,19866,2708,17158,30.31%,13.63%
2020-01-01 00:02:10,3,8,16520,1838,14682,25.21%,11.13%
2020-01-01 00:02:10,3,9,32937,7103,25834,50.26%,21.57%
2020-01-01 00:02:10,3,10,6750,340,6410,10.30%,5.04%
2020-01-01 00:02:10,3,11,1723,15,1708,2.63%,0.87%
2020-01-01 00:02:10,3,12,23651,3799,19852,36.09%,16.06%
2020-01-01 00:02:10,4,1,506,2,504,0.77%,0.40%
2020-01-01 00:02:10,4,2,321,2,319,0.49%,0.62%
2020-01-01 00:02:10,4,3,1113,15,1098,1.70%,1.35%
2020-01-01 00:02:10,4,4,29223,5651,23572,44.59%,19.34%
2020-01-01 00:02:10,4,5,17992,2245,15747,27.45%,12.48%
2020-01-01 00:02:10,4,6,24787,4135,20652,37.82%,16.68%
2020-01-01 00:02:10,4,7,5497,273,5224,8.39%,4.97%
2020-01-01 00:02:10,4,8,2951,92,2859,4.50%,3.12%
2020-01-01 00:02:10,4,9,15592,1715,13877,23.79%,11.00%
2020-01-01 00:02:10,4,10,2066,29,2037,3.15%,1.40%
2020-01-01 00:02:10,4,11,144,0,144,0.22%,0.00%
2020-01-01 00:02:10,4,12,12692,1157,11535,19.37%,9.12%
2020-01-01 00:02:10,5,1,3056,62,2994,4.66%,2.03%
2020-01-01 00:02:10,5,2,812,1,811,1.24%,0.12%
2020-01-01 00:02:10,5,3,1995,29,1966,3.04%,1.45%
2020-01-01 00:02:10,5,4,24052,3953,20099,36.70%,16.44%
2020-01-01 00:02:10,5,5,11645,976,10669,17.77%,8.38%
2020-01-01 00:02:10,5,6,17081,2044,15037,26.06%,11.97%
2020-01-01 00:02:10,5,7,5006,196,4810,7.64%,3.92%
2020-01-01 00:02:10,5,8,3612,105,3507,5.51%,2.91%
2020-01-01 00:02:10,5,9,9482,672,8810,14.47%,7.09%
2020-01-01 00:02:10,5,10,1472,11,1461,2.25%,0.75%
2020-01-01 00:02:10,5,11,751,4,747,1.15%,0.53%
2020-01-01 00:02:10,5,12,7479,440,7039,11.41%,5.88%
2020-01-01 00:02:10,6,1,1107,11,1096,1.69%,0.99%
2020-01-01 00:02:10,6,2,1196,11,1185,1.82%,0.92%
2020-01-01 00:02:10,6,3,1589,21,1568,2.42%,1.32%
2020-01-01 00:02:10,6,4,1307,10,1297,1.99%,0.77%
2020-01-01 00:02:10,6,5,16798,1982,14816,25.63%,11.80%
2020-01-01 00:02:10,6,6,5158,183,4975,7.87%,3.55%
2020-01-01 00:02:10,6,7,3413,82,3331,5.21%,2.40%
2020-01-01 00:02:10,6,8,2654,53,2601,4.05%,2.00%
2020-01-01 00:02:10,6,9,9648,658,8990,14.72%,6.82%
2020-01-01 00:02:10,6,10,2345,50,2295,3.58%,2.13%
2020-01-01 00:02:10,6,11,560,4,556,0.85%,0.71%
2020-01-01 00:02:10,6,12,7265,399,6866,11.09%,5.49%
2020-01-01 00:02:10,7,1,585,3,582,0.89%,0.51%
2020-01-01 00:02:10,7,2,148,0,148,0.23%,0.00%
2020-01-01 00:02:10,7,3,759,4,755,1.16%,0.53%
2020-01-01 00:02:10,7,4,1872,29,1843,2.86%,1.55%
2020-01-01 00:02:10,7,5,8386,518,7868,12.80%,6.18%
2020-01-01 00:02:10,7,6,13323,1262,12061,20.33%,9.47%
2020-01-01 00:02:10,7,7,3029,58,2971,4.62%,1.91%
2020-01-01 00:02:10,7,8,1263,9,1254,1.93%,0.71%
2020-01-01 00:02:10,7,9,7408,406,7002,11.30%,5.48%
2020-01-01 00:02:10,7,10,2022,15,2007,3.09%,0.74%
2020-01-01 00:02:10,7,11,82,0,82,0.13%,0.00%
2020-01-01 00:02:10,7,12,5387,218,5169,8.22%,4.05%
2020-01-01 00:02:10,8,1,394,1,393,0.60%,0.25%
2020-01-01 00:02:10,8,2,96,1,95,0.15%,1.04%
2020-01-01 00:02:10,8,3,2139,30,2109,3.26%,1.40%
2020-01-01 00:02:10,8,4,2854,58,2796,4.35%,2.03%
2020-01-01 00:02:10,8,5,8752,544,8208,13.35%,6.22%
2020-01-01 00:02:10,8,6,16848,1980,14868,25.71%,11.75%
2020-01-01 00:02:10,8,7,5193,210,4983,7.92%,4.04%
2020-01-01 00:02:10,8,8,1960,33,1927,2.99%,1.68%
2020-01-01 00:02:10,8,9,6376,295,6081,9.73%,4.63%
2020-01-01 00:02:10,8,10,1937,28,1909,2.96%,1.45%
2020-01-01 00:02:10,8,11,193,2,191,0.29%,1.04%
2020-01-01 00:02:10,8,12,4416,160,4256,6.74%,3.62%
2020-01-01 00:02:10,9,1,413,0,413,0.63%,0.00%
2020-01-01 00:02:10,9,2,3557,97,3460,5.43%,2.73%
2020-01-01 00:02:10,9,3,2746,47,2699,4.19%,1.71%
2020-01-01 00:02:10,9,4,7701,415,7286,11.75%,5.39%
2020-01-01 00:02:10,9,5,278,1,277,0.42%,0.36%
2020-01-01 00:02:10,9,6,8581,516,8065,13.09%,6.01%
2020-01-01 00:02:10,9,7,31853,6670,25183,48.60%,20.94%
2020-01-01 00:02:10,9,8,13521,1330,12191,20.63%,9.84%
2020-01-01 00:02:10,9,9,242,1,241,0.37%,0.41%
2020-01-01 00:02:10,9,10,4850,215,4635,7.40%,4.43%
2020-01-01 00:02:10,9,11,11720,1037,10683,17.88%,8.85%
2020-01-01 00:02:10,9,12,6476,326,6150,9.88%,5.03%
2020-01-01 00:02:10,10,1,1294,316,978,1.97%,24.42%
2020-01-01 00:02:10,10,2,3267,381,2886,4.99%,11.66%
2020-01-01 00:02:10,10,3,1771,26,1745,2.70%,1.47%
2020-01-01 00:02:10,10,4,4398,1110,3288,6.71%,25.24%
2020-01-01 00:02:10,10,5,677,31,646,1.03%,4.58%
2020-01-01 00:02:10,10,6,6690,1289,5401,10.21%,19.27%
2020-01-01 00:02:10,10,7,12374,2259,10115,18.88%,18.26%
2020-01-01 00:02:10,10,8,30884,8245,22639,47.13%,26.70%
2020-01-01 00:02:10,10,9,686,5,681,1.05%,0.73%
2020-01-01 00:02:10,10,10,3095,58,3037,4.72%,1.87%
2020-01-01 00:02:10,10,11,14452,1936,12516,22.05%,13.40%
2020-01-01 00:02:10,10,12,10484,1284,9200,16.00%,12.25%
2020-01-01 00:02:10,11,1,2783,66,2717,4.25%,2.37%
2020-01-01 00:02:10,11,2,5132,209,4923,7.83%,4.07%
2020-01-01 00:02:10,11,3,2196,30,2166,3.35%,1.37%
2020-01-01 00:02:10,11,4,3272,85,3187,4.99%,2.60%
2020-01-01 00:02:10,11,5,194,0,194,0.30%,0.00%
2020-01-01 00:02:10,11,6,4226,144,4082,6.45%,3.41%
2020-01-01 00:02:10,11,7,11218,967,10251,17.12%,8.62%
2020-01-01 00:02:10,11,8,25569,4495,21074,39.02%,17.58%
2020-01-01 00:02:10,11,9,274,1,273,0.42%,0.36%
2020-01-01 00:02:10,11,10,3336,82,3254,5.09%,2.46%
2020-01-01 00:02:10,11,11,10553,810,9743,16.10%,7.68%
2020-01-01 00:02:10,11,12,6857,344,6513,10.46%,5.02%
2020-01-01 00:02:10,12,1,55,0,55,0.08%,0.00%
2020-01-01 00:02:10,12,2,686,200,486,1.05%,29.15%
2020-01-01 00:02:10,12,3,3469,268,3201,5.29%,7.73%
2020-01-01 00:02:10,12,4,3466,78,3388,5.29%,2.25%
2020-01-01 00:02:10,12,5,11217,1075,10142,17.12%,9.58%
2020-01-01 00:02:10,12,6,6597,299,6298,10.07%,4.53%
2020-01-01 00:02:10,12,7,2949,67,2882,4.50%,2.27%
2020-01-01 00:02:10,12,8,1379,308,1071,2.10%,22.34%
2020-01-01 00:02:10,12,9,23861,4858,19003,36.41%,20.36%
2020-01-01 00:02:10,12,10,4169,403,3766,6.36%,9.67%
2020-01-01 00:02:10,12,11,1720,317,1403,2.62%,18.43%
2020-01-01 00:02:10,12,12,7645,1207,6438,11.67%,15.79%
2020-01-01 00:02:10,13,1,2085,36,2049,3.18%,1.73%
2020-01-01 00:02:10,13,2,2393,46,2347,3.65%,1.92%
2020-01-01 00:02:10,13,3,871,5,866,1.33%,0.57%
2020-01-01 00:02:10,13,4,4899,454,4445,7.48%,9.27%
2020-01-01 00:02:10,13,5,7371,774,6597,11.25%,10.50%
2020-01-01 00:02:10,13,6,5766,517,5249,8.80%,8.97%
2020-01-01 00:02:10,13,7,4476,161,4315,6.83%,3.60%
2020-01-01 00:02:10,13,8,6387,321,6066,9.75%,5.03%
2020-01-01 00:02:10,13,9,7684,806,6878,11.72%,10.49%
2020-01-01 00:02:10,13,10,26285,5195,21090,40.11%,19.76%
2020-01-01 00:02:10,13,11,15898,2129,13769,24.26%,13.39%
2020-01-01 00:02:10,13,12,9052,912,8140,13.81%,10.08%
2020-01-01 00:02:10,14,1,196,0,196,0.30%,0.00%
2020-01-01 00:02:10,14,2,1405,11,1394,2.14%,0.78%
2020-01-01 00:02:10,14,3,1029,3,1026,1.57%,0.29%
2020-01-01 00:02:10,14,4,4232,128,4104,6.46%,3.02%
2020-01-01 00:02:10,14,5,1491,16,1475,2.28%,1.07%
2020-01-01 00:02:10,14,6,4549,142,4407,6.94%,3.12%
2020-01-01 00:02:10,14,7,11941,1024,10917,18.22%,8.58%
2020-01-01 00:02:10,14,8,13586,1311,12275,20.73%,9.65%
2020-01-01 00:02:10,14,9,1751,20,1731,2.67%,1.14%
2020-01-01 00:02:10,14,10,4461,156,4305,6.81%,3.50%
2020-01-01 00:02:10,14,11,27330,5051,22279,41.70%,18.48%
2020-01-01 00:02:10,14,12,9060,606,8454,13.82%,6.69%
2020-01-01 00:02:10,15,1,434,1,433,0.66%,0.23%
2020-01-01 00:02:10,15,2,101,0,101,0.15%,0.00%
2020-01-01 00:02:10,15,3,3807,103,3704,5.81%,2.71%
2020-01-01 00:02:10,15,4,5408,226,5182,8.25%,4.18%
2020-01-01 00:02:10,15,5,10373,764,9609,15.83%,7.37%
2020-01-01 00:02:10,15,6,5653,246,5407,8.63%,4.35%
2020-01-01 00:02:10,15,7,3751,104,3647,5.72%,2.77%
2020-01-01 00:02:10,15,8,6089,278,5811,9.29%,4.57%
2020-01-01 00:02:10,15,9,10643,808,9835,16.24%,7.59%
2020-01-01 00:02:10,15,10,4567,354,4213,6.97%,7.75%
2020-01-01 00:02:10,15,11,10800,1068,9732,16.48%,9.89%
2020-01-01 00:02:10,15,12,27055,5294,21761,41.28%,19.57%
2020-01-01 00:02:10,16,1,491,3,488,0.75%,0.61%
2020-01-01 00:02:10,16,2,273,3,270,0.42%,1.10%
2020-01-01 00:02:10,16,3,1815,35,1780,2.77%,1.93%
2020-01-01 00:02:10,16,4,4906,171,4735,7.49%,3.49%
2020-01-01 00:02:10,16,5,8729,625,8104,13.32%,7.16%
2020-01-01 00:02:10,16,6,5807,241,5566,8.86%,4.15%
2020-01-01 00:02:10,16,7,3496,109,3387,5.33%,3.12%
2020-01-01 00:02:10,16,8,8217,535,7682,12.54%,6.51%
2020-01-01 00:02:10,16,9,9226,686,8540,14.08%,7.44%
2020-01-01 00:02:10,16,10,1897,26,1871,2.89%,1.37%
2020-01-01 00:02:10,16,11,10331,817,9514,15.76%,7.91%
2020-01-01 00:02:10,16,12,27522,5146,22376,42.00%,18.70%
2020-01-01 00:02:20,1,1,22151,3377,18774,33.80%,15.25%
2020-01-01 00:02:20,1,2,7955,470,7485,12.14%,5.91%
2020-01-01 00:02:20,1,3,572,0,572,0.87%,0.00%
2020-01-01 00:02:20,1,4,13743,1346,12397,20.97%,9.79%
2020-01-01 00:02:20,1,5,13423,1270,12153,20.48%,9.46%
2020-01-01 00:02:20,1,6,13323,1255,12068,20.33%,9.42%
2020-01-01 00:02:20,1,7,7356,406,6950,11.22%,5.52%
2020-01-01 00:02:20,1,8,6826,347,6479,10.42%,5.08%
2020-01-01 00:02:20,1,9,13229,1235,11994,20.19%,9.34%
2020-01-01 00:02:20,1,10,6214,282,5932,9.48%,4.54%
2020-01-01 00:02:20,1,11,6303,288,6015,9.62%,4.57%
2020-01-01 00:02:20,1,12,13208,1227,11981,20.15%,9.29%
2020-01-01 00:02:20,2,1,943,3,940,1.44%,0.32%
2020-01-01 00:02:20,2,2,25864,4460,21404,39.47%,17.24%
2020-01-01 00:02:20,2,3,20144,2819,17325,30.74%,13.99%
2020-01-01 00:02:20,2,4,842,2,840,1.28%,0.24%
2020-01-01 00:02:20,2,5,11478,989,10489,17.51%,8.62%
2020-01-01 00:02:20,2,6,25,0,25,0.04%,0.00%
2020-01-01 00:02:20,2,7,4757,142,4615,7.26%,2.99%
2020-01-01 00:02:20,2,8,3770,89,3681,5.75%,2.36%
2020-01-01 00:02:20,2,9,11377,977,10400,17.36%,8.59%
2020-01-01 00:02:20,2,10,2921,53,2868,4.46%,1.81%
2020-01-01 00:02:20,2,11,2961,53,2908,4.52%,1.79%
2020-01-01 00:02:20,2,12,11196,949,10247,17.08%,8.48%
2020-01-01 00:02:20,3,1,1504,25,1479,2.29%,1.66%
2020-01-01 00:02:20,3,2,22922,3625,19297,34.98%,15.81%
2020-01-01 00:02:20,3,3,63804,22950,40854,97.36%,35.97%
2020-01-01 00:02:20,3,4,6242,302,5940,9.52%,4.84%
2020-01-01 00:02:20,3,5,37800,9081,28719,57.68%,24.02%
2020-01-01 00:02:20,3,6,7500,430,7070,11.44%,5.73%
2020-01-01 00:02:20,3,7,18388,2416,15972,28.06%,13.14%
2020-01-01 00:02:20,3,8,14433,1521,12912,22.02%,10.54%
2020-01-01 00:02:20,3,9,29963,5918,24045,45.72%,19.75%
2020-01-01 00:02:20,3,10,5247,195,5052,8.01%,3.72%
2020-01-01 00:02:20,3,11,1293,17,1276,1.97%,1.31%
2020-01-01 00:02:20,3,12,22893,3633,19260,34.93%,15.87%
2020-01-01 00:02:20,4,1,623,6,617,0.95%,0.96%
2020-01-01 00:02:20,4,2,387,1,386,0.59%,0.26%
2020-01-01 00:02:20,4,3,1093,9,1084,1.67%,0.82%
2020-01-01 00:02:20,4,4,29556,5892,23664,45.10%,19.94%
2020-01-01 00:02:20,4,5,18157,2352,15805,27.71%,12.95%
2020-01-01 00:02:20,4,6,25159,4288,20871,38.39%,17.04%
2020-01-01 00:02:20,4,7,5740,237,5503,8.76%,4.13%
2020-01-01 00:02:20,4,8,3096,69,3027,4.72%,2.23%
2020-01-01 00:02:20,4,9,15801,1784,14017,24.11%,11.29%
2020-01-01 00:02:20,4,10,1993,25,1968,3.04%,1.25%
2020-01-01 00:02:20,4,11,203,0,203,0.31%,0.00%
2020-01-01 00:02:20,4,12,13058,1237,11821,19.92%,9.47%
2020-01-01 00:02:20,5,1,2742,71,2671,4.18%,2.59%
2020-01-01 00:02:20,5,2,719,4,715,1.10%,0.56%
2020-01-01 00:02:20,5,3,408,0,408,0.62%,0.00%
2020-01-01 00:02:20,5,4,22334,3450,18884,34.08%,15.45%
2020-01-01 00:02:20,5,5,10216,746,9470,15.59%,7.30%
2020-01-01 00:02:20,5,6,15622,1735,13887,23.84%,11.11%
2020-01-01 00:02:20,5,7,5000,210,4790,7.63%,4.20%
2020-01-01 00:02:20,5,8,3842,118,3724,5.86%,3.07%
2020-01-01 00:02:20,5,9,9652,680,8972,14.73%,7.05%
2020-01-01 00:02:20,5,10,1474,18,1456,2.25%,1.22%
2020-01-01 00:02:20,5,11,815,4,811,1.24%,0.49%
2020-01-01 00:02:20,5,12,7860,439,7421,11.99%,5.59%
2020-01-01 00:02:20,6,1,1302,17,1285,1.99%,1.31%
2020-01-01 00:02:20,6,2,1399,24,1375,2.13%,1.72%
2020-01-01 00:02:20,6,3,2085,45,2040,3.18%,2.16%
2020-01-01 00:02:20,6,4,1507,46,1461,2.30%,3.05%
2020-01-01 00:02:20,6,5,17556,2187,15369,26.79%,12.46%
2020-01-01 00:02:20,6,6,4831,202,4629,7.37%,4.18%
2020-01-01 00:02:20,6,7,2758,57,2701,4.21%,2.07%
2020-01-01 00:02:20,6,8,2015,27,1988,3.07%,1.34%
2020-01-01 00:02:20,6,9,10342,753,9589,15.78%,7.28%
2020-01-01 00:02:20,6,10,2534,37,2497,3.87%,1.46%
2020-01-01 00:02:20,6,11,433,1,432,0.66%,0.23%
2020-01-01 00:02:20,6,12,7771,446,7325,11.86%,5.74%
2020-01-01 00:02:20,7,1,535,5,530,0.82%,0.93%
2020-01-01 00:02:20,7,2,178,1,177,0.27%,0.56%
2020-01-01 00:02:20,7,3,1158,8,1150,1.77%,0.69%
2020-01-01 00:02:20,7,4,1975,31,1944,3.01%,1.57%
2020-01-01 00:02:20,7,5,8251,517,7734,12.59%,6.27%
2020-01-01 00:02:20,7,6,13415,1314,12101,20.47%,9.80%
2020-01-01 00:02:20,7,7,3163,82,3081,4.83%,2.59%
2020-01-01 00:02:20,7,8,1162,9,1153,1.77%,0.77%
2020-01-01 00:02:20,7,9,6879,380,6499,10.50%,5.52%
2020-01-01 00:02:20,7,10,1330,8,1322,2.03%,0.60%
2020-01-01 00:02:20,7,11,77,0,77,0.12%,0.00%
2020-01-01 00:02:20,7,12,5564,253,5311,8.49%,4.55%
2020-01-01 00:02:20,8,1,444,1,443,0.68%,0.23%
2020-01-01 00:02:20,8,2,108,0,108,0.16%,0.00%
2020-01-01 00:02:20,8,3,2035,24,2011,3.11%,1.18%
2020-01-01 00:02:20,8,4,2796,60,2736,4.27%,2.15%
2020-01-01 00:02:20,8,5,8663,556,8107,13.22%,6.42%
2020-01-01 00:02:20,8,6,17353,2163,15190,26.48%,12.46%
2020-01-01 00:02:20,8,7,5852,280,5572,8.93%,4.78%
2020-01-01 00:02:20,8,8,2569,44,2525,3.92%,1.71%
2020-01-01 00:02:20,8,9,6439,308,6131,9.83%,4.78%
2020-01-01 00:02:20,8,10,1730,26,1704,2.64%,1.50%
2020-01-01 00:02:20,8,11,150,0,150,0.23%,0.00%
2020-01-01 00:02:20,8,12,4578,159,4419,6.99%,3.47%
2020-01-01 00:02:20,9,1,775,3,772,1.18%,0.39%
2020-01-01 00:02:20,9,2,5433,236,5197,8.29%,4.34%
2020-01-01 00:02:20,9,3,4079,137,3942,6.22%,3.36%
2020-01-01 00:02:20,9,4,6348,272,6076,9.69%,4.28%
2020-01-01 00:02:20,9,5,177,0,177,0.27%,0.00%
2020-01-01 00:02:20,9,6,7205,346,6859,10.99%,4.80%
2020-01-01 00:02:20,9,7,28474,5350,23124,43.45%,18.79%
2020-01-01 00:02:20,9,8,10218,819,9399,15.59%,8.02%
2020-01-01 00:02:20,9,9,146,0,146,0.22%,0.00%
2020-01-01 00:02:20,9,10,2595,43,2552,3.96%,1.66%
2020-01-01 00:02:20,9,11,9250,678,8572,14.11%,7.33%
2020-01-01 00:02:20,9,12,6258,269,5989,9.55%,4.30%
2020-01-01 00:02:20,10,1,1429,294,1135,2.18%,20.57%
2020-01-01 00:02:20,10,2,3279,363,2916,5.00%,11.07%
2020-01-01 00:02:20,10,3,1675,37,1638,2.56%,2.21%
2020-01-01 00:02:20,10,4,4276,1160,3116,6.52%,27.13%
2020-01-01 00:02:20,10,5,719,30,689,1.10%,4.17%
2020-01-01 00:02:20,10,6,6650,1350,5300,10.15%,20.30%
2020-01-01 00:02:20,10,7,11536,2142,9394,17.60%,18.57%
2020-01-01 00:02:20,10,8,30889,8293,22596,47.13%,26.85%
2020-01-01 00:02:20,10,9,619,3,616,0.94%,0.48%
2020-01-01 00:02:20,10,10,2369,44,2325,3.61%,1.86%
2020-01-01 00:02:20,10,11,14685,1989,12696,22.41%,13.54%
2020-01-01 00:02:20,10,12,11498,1420,10078,17.54%,12.35%
2020-01-01 00:02:20,11,1,2802,58,2744,4.28%,2.07%
2020-01-01 00:02:20,11,2,3839,119,3720,5.86%,3.10%
2020-01-01 00:02:20,11,3,829,3,826,1.26%,0.36%
2020-01-01 00:02:20,11,4,3103,73,3030,4.73%,2.35%
2020-01-01 00:02:20,11,5,292,1,291,0.45%,0.34%
2020-01-01 00:02:20,11,6,3980,124,3856,6.07%,3.12%
2020-01-01 00:02:20,11,7,9477,682,8795,14.46%,7.20%
2020-01-01 00:02:20,11,8,24216,4052,20164,36.95%,16.73%
2020-01-01 00:02:20,11,9,250,0,250,0.38%,0.00%
2020-01-01 00:02:20,11,10,3263,83,3180,4.98%,2.54%
2020-01-01 00:02:20,11,11,10692,856,9836,16.31%,8.01%
2020-01-01 00:02:20,11,12,7043,366,6677,10.75%,5.20%
2020-01-01 00:02:20,12,1,96,0,96,0.15%,0.00%
2020-01-01 00:02:20,12,2,733,196,537,1.12%,26.74%
2020-01-01 00:02:20,12,3,3513,272,3241,5.36%,7.74%
2020-01-01 00:02:20,12,4,3566,108,3458,5.44%,3.03%
2020-01-01 00:02:20,12,5,10621,997,9624,16.21%,9.39%
2020-01-01 00:02:20,12,6,6292,302,5990,9.60%,4.80%
2020-01-01 00:02:20,12,7,2557,51,2506,3.90%,1.99%
2020-01-01 00:02:20,12,8,1516,288,1228,2.31%,19.00%
2020-01-01 00:02:20,12,9,23421,4783,18638,35.74%,20.42%
2020-01-01 00:02:20,12,10,4600,423,4177,7.02%,9.20%
2020-01-01 00:02:20,12,11,1772,292,1480,2.70%,16.48%
2020-01-01 00:02:20,12,12,7675,1217,6458,11.71%,15.86%
2020-01-01 00:02:20,13,1,2295,45,2250,3.50%,1.96%
2020-01-01 00:02:20,13,2,2683,56,2627,4.09%,2.09%
2020-01-01 00:02:20,13,3,842,3,839,1.28%,0.36%
2020-01-01 00:02:20,13,4,4400,474,3926,6.71%,10.77%
2020-01-01 00:02:20,13,5,7142,799,6343,10.90%,11.19%
2020-01-01 00:02:20,13,6,5442,535,4907,8.30%,9.83%
2020-01-01 00:02:20,13,7,4904,196,4708,7.48%,4.00%
2020-01-01 00:02:20,13,8,7155,393,6762,10.92%,5.49%
2020-01-01 00:02:20,13,9,7536,842,6694,11.50%,11.17%
2020-01-01 00:02:20,13,10,27991,5796,22195,42.71%,20.71%
2020-01-01 00:02:20,13,11,17322,2445,14877,26.43%,14.11%
2020-01-01 00:02:20,13,12,9729,1050,8679,14.85%,10.79%
2020-01-01 00:02:20,14,1,226,1,225,0.34%,0.44%
2020-01-01 00:02:20,14,2,1528,17,1511,2.33%,1.11%
2020-01-01 00:02:20,14,3,1172,8,1164,1.79%,0.68%
2020-01-01 00:02:20,14,4,4094,119,3975,6.25%,2.91%
2020-01-01 00:02:20,14,5,1767,22,1745,2.70%,1.25%
2020-01-01 00:02:20,14,6,4388,134,4254,6.70%,3.05%
2020-01-01 00:02:20,14,7,12033,1020,11013,18.36%,8.48%
2020-01-01 00:02:20,14,8,13722,1358,12364,20.94%,9.90%
2020-01-01 00:02:20,14,9,2068,27,2041,3.16%,1.31%
2020-01-01 00:02:20,14,10,4965,159,4806,7.58%,3.20%
2020-01-01 00:02:20,14,11,28420,5383,23037,43.37%,18.94%
2020-01-01 00:02:20,14,12,9409,640,8769,14.36%,6.80%
2020-01-01 00:02:20,15,1,476,5,471,0.73%,1.05%
2020-01-01 00:02:20,15,2,134,0,134,0.20%,0.00%
2020-01-01 00:02:20,15,3,3953,125,3828,6.03%,3.16%
2020-01-01 00:02:20,15,4,5740,288,5452,8.76%,5.02%
2020-01-01 00:02:20,15,5,11234,945,10289,17.14%,8.41%
2020-01-01 00:02:20,15,6,6064,318,5746,9.25%,5.24%
2020-01-01 00:02:20,15,7,4008,152,3856,6.12%,3.79%
2020-01-01 00:02:20,15,8,6058,299,5759,9.24%,4.94%
2020-01-01 00:02:20,15,9,11503,983,10520,17.55%,8.55%
2020-01-01 00:02:20,15,10,4652,377,4275,7.10%,8.10%
2020-01-01 00:02:20,15,11,10849,1032,9817,16.55%,9.51%
2020-01-01 00:02:20,15,12,28006,5687,22319,42.73%,20.31%
2020-01-01 00:02:20,16,1,478,1,477,0.73%,0.21%
2020-01-01 00:02:20,16,2,266,1,265,0.41%,0.38%
2020-01-01 00:02:20,16,3,1906,37,1869,2.91%,1.94%
2020-01-01 00:02:20,16,4,4064,126,3938,6.20%,3.10%
2020-01-01 00:02:20,16,5,8098,572,7526,12.36%,7.06%
2020-01-01 00:02:20,16,6,5049,206,4843,7.70%,4.08%
2020-01-01 00:02:20,16,7,3286,101,3185,5.01%,3.07%
2020-01-01 00:02:20,16,8,7094,455,6639,10.82%,6.41%
2020-01-01 00:02:20,16,9,8608,628,7980,13.13%,7.30%
2020-01-01 00:02:20,16,10,1837,16,1821,2.80%,0.87%
2020-01-01 00:02:20,16,11,9186,686,8500,14.02%,7.47%
2020-01-01 00:02:20,16,12,26445,4737,21708,40.35%,17.91%
2020-01-01 00:02:30,1,1,25691,4439,21252,39.20%,17.28%
2020-01-01 00:02:30,1,2,14828,1589,13239,22.63%,10.72%
2020-01-01 00:02:30,1,3,1120,3,1117,1.71%,0.27%
2020-01-01 00:02:30,1,4,10433,797,9636,15.92%,7.64%
2020-01-01 00:02:30,1,5,10154,755,9399,15.49%,7.44%
2020-01-01 00:02:30,1,6,10105,754,9351,15.42%,7.46%
2020-01-01 00:02:30,1,7,13697,1374,12323,20.90%,10.03%
2020-01-01 00:02:30,1,8,12853,1221,11632,19.61%,9.50%
2020-01-01 00:02:30,1,9,10036,742,9294,15.31%,7.39%
2020-01-01 00:02:30,1,10,12428,1154,11274,18.96%,9.29%
2020-01-01 00:02:30,1,11,12550,1177,11373,19.15%,9.38%
2020-01-01 00:02:30,1,12,9997,735,9262,15.25%,7.35%
2020-01-01 00:02:30,2,1,1208,4,1204,1.84%,0.33%
2020-01-01 00:02:30,2,2,25857,4448,21409,39.45%,17.20%
2020-01-01 00:02:30,2,3,18622,2374,16248,28.41%,12.75%
2020-01-01 00:02:30,2,4,1162,3,1159,1.77%,0.26%
2020-01-01 00:02:30,2,5,13193,1235,11958,20.13%,9.36%
2020-01-01 00:02:30,2,6,28,0,28,0.04%,0.00%
2020-01-01 00:02:30,2,7,6007,283,5724,9.17%,4.71%
2020-01-01 00:02:30,2,8,4903,194,4709,7.48%,3.96%
2020-01-01 00:02:30,2,9,13083,1216,11867,19.96%,9.29%
2020-01-01 00:02:30,2,10,4193,147,4046,6.40%,3.51%
2020-01-01 00:02:30,2,11,4228,148,4080,6.45%,3.50%
2020-01-01 00:02:30,2,12,12900,1181,11719,19.68%,9.16%
2020-01-01 00:02:30,3,1,2003,46,1957,3.06%,2.30%
2020-01-01 00:02:30,3,2,25547,4376,21171,38.98%,17.13%
2020-01-01 00:02:30,3,3,68794,26278,42516,104.97%,38.20%
2020-01-01 00:02:30,3,4,5306,203,5103,8.10%,3.83%
2020-01-01 00:02:30,3,5,41103,10645,30458,62.72%,25.90%
2020-01-01 00:02:30,3,6,6894,354,6540,10.52%,5.13%
2020-01-01 00:02:30,3,7,20660,2915,17745,31.52%,14.11%
2020-01-01 00:02:30,3,8,16301,1857,14444,24.87%,11.39%
2020-01-01 00:02:30,3,9,33801,7482,26319,51.58%,22.14%
2020-01-01 00:02:30,3,10,6156,292,5864,9.39%,4.74%
2020-01-01 00:02:30,3,11,1990,44,1946,3.04%,2.21%
2020-01-01 00:02:30,3,12,25472,4324,21148,38.87%,16.98%
2020-01-01 00:02:30,4,1,507,5,502,0.77%,0.99%
2020-01-01 00:02:30,4,2,297,3,294,0.45%,1.01%
2020-01-01 00:02:30,4,3,1161,8,1153,1.77%,0.69%
2020-01-01 00:02:30,4,4,28370,5226,23144,43.29%,18.42%
2020-01-01 00:02:30,4,5,17533,2125,15408,26.75%,12.12%
2020-01-01 00:02:30,4,6,23607,3752,19855,36.02%,15.89%
2020-01-01 00:02:30,4,7,4842,167,4675,7.39%,3.45%
2020-01-01 00:02:30,4,8,2834,54,2780,4.32%,1.91%
2020-01-01 00:02:30,4,9,15103,1602,13501,23.05%,10.61%
2020-01-01 00:02:30,4,10,1956,26,1930,2.98%,1.33%
2020-01-01 00:02:30,4,11,217,0,217,0.33%,0.00%
2020-01-01 00:02:30,4,12,12509,1106,11403,19.09%,8.84%
2020-01-01 00:02:30,5,1,2758,58,2700,4.21%,2.10%
2020-01-01 00:02:30,5,2,866,8,858,1.32%,0.92%
2020-01-01 00:02:30,5,3,611,4,607,0.93%,0.65%
2020-01-01 00:02:30,5,4,20685,2971,17714,31.56%,14.36%
2020-01-01 00:02:30,5,5,9423,671,8752,14.38%,7.12%
2020-01-01 00:02:30,5,6,14537,1586,12951,22.18%,10.91%
2020-01-01 00:02:30,5,7,4634,193,4441,7.07%,4.16%
2020-01-01 00:02:30,5,8,3704,122,3582,5.65%,3.29%
2020-01-01 00:02:30,5,9,8608,563,8045,13.13%,6.54%
2020-01-01 00:02:30,5,10,967,11,956,1.48%,1.14%
2020-01-01 00:02:30,5,11,691,8,683,1.05%,1.16%
2020-01-01 00:02:30,5,12,7167,390,6777,10.94%,5.44%
2020-01-01 00:02:30,6,1,1157,4,1153,1.77%,0.35%
2020-01-01 00:02:30,6,2,1259,4,1255,1.92%,0.32%
2020-01-01 00:02:30,6,3,1743,17,1726,2.66%,0.98%
2020-01-01 00:02:30,6,4,1324,16,1308,2.02%,1.21%
2020-01-01 00:02:30,6,5,16547,1873,14674,25.25%,11.32%
2020-01-01 00:02:30,6,6,5077,203,4874,7.75%,4.00%
2020-01-01 00:02:30,6,7,3233,95,3138,4.93%,2.94%
2020-01-01 00:02:30,6,8,2676,68,2608,4.08%,2.54%
2020-01-01 00:02:30,6,9,9394,624,8770,14.33%,6.64%
2020-01-01 00:02:30,6,10,2853,55,2798,4.35%,1.93%
2020-01-01 00:02:30,6,11,390,1,389,0.60%,0.26%
2020-01-01 00:02:30,6,12,6468,310,6158,9.87%,4.79%
2020-01-01 00:02:30,7,1,449,0,449,0.69%,0.00%
2020-01-01 00:02:30,7,2,191,0,191,0.29%,0.00%
2020-01-01 00:02:30,7,3,1484,8,1476,2.26%,0.54%
2020-01-01 00:02:30,7,4,1768,32,1736,2.70%,1.81%
2020-01-01 00:02:30,7,5,7893,441,7452,12.04%,5.59%
2020-01-01 00:02:30,7,6,13142,1230,11912,20.05%,9.36%
2020-01-01 00:02:30,7,7,3445,88,3357,5.26%,2.55%
2020-01-01 00:02:30,7,8,1540,28,1512,2.35%,1.82%
2020-01-01 00:02:30,7,9,6260,283,5977,9.55%,4.52%
2020-01-01 00:02:30,7,10,1134,9,1125,1.73%,0.79%
2020-01-01 00:02:30,7,11,73,0,73,0.11%,0.00%
2020-01-01 00:02:30,7,12,5165,196,4969,7.88%,3.79%
2020-01-01 00:02:30,8,1,334,0,334,0.51%,0.00%
2020-01-01 00:02:30,8,2,125,0,125,0.19%,0.00%
2020-01-01 00:02:30,8,3,1575,19,1556,2.40%,1.21%
2020-01-01 00:02:30,8,4,2650,52,2598,4.04%,1.96%
2020-01-01 00:02:30,8,5,8029,456,7573,12.25%,5.68%
2020-01-01 00:02:30,8,6,15329,1645,13684,23.39%,10.73%
2020-01-01 00:02:30,8,7,4633,181,4452,7.07%,3.91%
2020-01-01 00:02:30,8,8,1654,27,1627,2.52%,1.63%
2020-01-01 00:02:30,8,9,6176,261,5915,9.42%,4.23%
2020-01-01 00:02:30,8,10,1663,32,1631,2.54%,1.92%
2020-01-01 00:02:30,8,11,201,0,201,0.31%,0.00%
2020-01-01 00:02:30,8,12,4407,119,4288,6.72%,2.70%
2020-01-01 00:02:30,9,1,1263,12,1251,1.93%,0.95%
2020-01-01 00:02:30,9,2,6021,283,5738,9.19%,4.70%
2020-01-01 00:02:30,9,3,4029,126,3903,6.15%,3.13%
2020-01-01 00:02:30,9,4,7585,424,7161,11.57%,5.59%
2020-01-01 00:02:30,9,5,571,3,568,0.87%,0.53%
2020-01-01 00:02:30,9,6,8636,542,8094,13.18%,6.28%
2020-01-01 00:02:30,9,7,35616,8154,27462,54.35%,22.89%
2020-01-01 00:02:30,9,8,11183,909,10274,17.06%,8.13%
2020-01-01 00:02:30,9,9,326,2,324,0.50%,0.61%
2020-01-01 00:02:30,9,10,4486,133,4353,6.85%,2.96%
2020-01-01 00:02:30,9,11,9853,713,9140,15.03%,7.24%
2020-01-01 00:02:30,9,12,5008,172,4836,7.64%,3.43%
2020-01-01 00:02:30,10,1,1225,277,948,1.87%,22.61%
2020-01-01 00:02:30,10,2,3064,326,2738,4.68%,10.64%
2020-01-01 00:02:30,10,3,1633,18,1615,2.49%,1.10%
2020-01-01 00:02:30,10,4,4306,994,3312,6.57%,23.08%
2020-01-01 00:02:30,10,5,692,25,667,1.06%,3.61%
2020-01-01 00:02:30,10,6,6295,1139,5156,9.61%,18.09%
2020-01-01 00:02:30,10,7,11183,1960,9223,17.06%,17.53%
2020-01-01 00:02:30,10,8,26760,6537,20223,40.83%,24.43%
2020-01-01 00:02:30,10,9,598,3,595,0.91%,0.50%
2020-01-01 00:02:30,10,10,2275,35,2240,3.47%,1.54%
2020-01-01 00:02:30,10,11,11604,1301,10303,17.71%,11.21%
2020-01-01 00:02:30,10,12,8748,910,7838,13.35%,10.40%
2020-01-01 00:02:30,11,1,2185,42,2143,3.33%,1.92%
2020-01-01 00:02:30,11,2,3259,77,3182,4.97%,2.36%
2020-01-01 00:02:30,11,3,907,4,903,1.38%,0.44%
2020-01-01 00:02:30,11,4,3495,198,3297,5.33%,5.67%
2020-01-01 00:02:30,11,5,321,0,321,0.49%,0.00%
2020-01-01 00:02:30,11,6,4355,240,4115,6.65%,5.51%
2020-01-01 00:02:30,11,7,9281,719,8562,14.16%,7.75%
2020-01-01 00:02:30,11,8,23008,3674,19334,35.11%,15.97%
2020-01-01 00:02:30,11,9,323,0,323,0.49%,0.00%
2020-01-01 00:02:30,11,10,3045,61,2984,4.65%,2.00%
2020-01-01 00:02:30,11,11,10482,800,9682,15.99%,7.63%
2020-01-01 00:02:30,11,12,7154,402,6752,10.92%,5.62%
2020-01-01 00:02:30,12,1,117,0,117,0.18%,0.00%
2020-01-01 00:02:30,12,2,573,172,401,0.87%,30.02%
2020-01-01 00:02:30,12,3,2600,207,2393,3.97%,7.96%
2020-01-01 00:02:30,12,4,2776,49,2727,4.24%,1.77%
2020-01-01 00:02:30,12,5,8854,754,8100,13.51%,8.52%
2020-01-01 00:02:30,12,6,5543,249,5294,8.46%,4.49%
2020-01-01 00:02:30,12,7,2531,57,2474,3.86%,2.25%
2020-01-01 00:02:30,12,8,1332,276,1056,2.03%,20.72%
2020-01-01 00:02:30,12,9,21361,4166,17195,32.59%,19.50%
2020-01-01 00:02:30,12,10,3856,354,3502,5.88%,9.18%
2020-01-01 00:02:30,12,11,1528,277,1251,2.33%,18.13%
2020-01-01 00:02:30,12,12,7379,1113,6266,11.26%,15.08%
2020-01-01 00:02:30,13,1,2050,35,2015,3.13%,1.71%
2020-01-01 00:02:30,13,2,2473,47,2426,3.77%,1.90%
2020-01-01 00:02:30,13,3,537,2,535,0.82%,0.37%
2020-01-01 00:02:30,13,4,4132,468,3664,6.30%,11.33%
2020-01-01 00:02:30,13,5,7064,811,6253,10.78%,11.48%
2020-01-01 00:02:30,13,6,5109,531,4578,7.80%,10.39%
2020-01-01 00:02:30,13,7,5077,185,4892,7.75%,3.64%
2020-01-01 00:02:30,13,8,7209,396,6813,11.00%,5.49%
2020-01-01 00:02:30,13,9,7313,835,6478,11.16%,11.42%
2020-01-01 00:02:30,13,10,26946,5357,21589,41.12%,19.88%
2020-01-01 00:02:30,13,11,16878,2198,14680,25.75%,13.02%
2020-01-01 00:02:30,13,12,9161,869,8292,13.98%,9.49%
2020-01-01 00:02:30,14,1,380,3,377,0.58%,0.79%
2020-01-01 00:02:30,14,2,1617,18,1599,2.47%,1.11%
2020-01-01 00:02:30,14,3,1092,5,1087,1.67%,0.46%
2020-01-01 00:02:30,14,4,4360,134,4226,6.65%,3.07%
2020-01-01 00:02:30,14,5,1431,16,1415,2.18%,1.12%
2020-01-01 00:02:30,14,6,4838,170,4668,7.38%,3.51%
2020-01-01 00:02:30,14,7,12133,1050,11083,18.51%,8.65%
2020-01-01 00:02:30,14,8,14254,1437,12817,21.75%,10.08%
2020-01-01 00:02:30,14,9,1673,22,1651,2.55%,1.32%
2020-01-01 00:02:30,14,10,4007,126,3881,6.11%,3.14%
2020-01-01 00:02:30,14,11,27053,4791,22262,41.28%,17.71%
2020-01-01 00:02:30,14,12,8499,499,8000,12.97%,5.87%
2020-01-01 00:02:30,15,1,523,2,521,0.80%,0.38%
2020-01-01 00:02:30,15,2,190,1,189,0.29%,0.53%
2020-01-01 00:02:30,15,3,6011,279,5732,9.17%,4.64%
2020-01-01 00:02:30,15,4,4961,224,4737,7.57%,4.52%
2020-01-01 00:02:30,15,5,12524,1266,11258,19.11%,10.11%
2020-01-01 00:02:30,15,6,5326,269,5057,8.13%,5.05%
2020-01-01 00:02:30,15,7,3879,151,3728,5.92%,3.89%
2020-01-01 00:02:30,15,8,5962,295,5667,9.10%,4.95%
2020-01-01 00:02:30,15,9,12750,1299,11451,19.45%,10.19%
2020-01-01 00:02:30,15,10,4609,223,4386,7.03%,4.84%
2020-01-01 00:02:30,15,11,10716,952,9764,16.35%,8.88%
2020-01-01 00:02:30,15,12,29225,6138,23087,44.59%,21.00%
2020-01-01 00:02:30,16,1,391,1,390,0.60%,0.26%
2020-01-01 00:02:30,16,2,286,0,286,0.44%,0.00%
2020-01-01 00:02:30,16,3,1128,14,1114,1.72%,1.24%
2020-01-01 00:02:30,16,4,3456,90,3366,5.27%,2.60%
2020-01-01 00:02:30,16,5,6810,385,6425,10.39%,5.65%
2020-01-01 00:02:30,16,6,4361,141,4220,6.65%,3.23%
2020-01-01 00:02:30,16,7,3747,123,3624,5.72%,3.28%
2020-01-01 00:02:30,16,8,7300,475,6825,11.14%,6.51%
2020-01-01 00:02:30,16,9,7188,428,6760,10.97%,5.95%
2020-01-01 00:02:30,16,10,2398,39,2359,3.66%,1.63%
2020-01-01 00:02:30,16,11,9947,770,9177,15.18%,7.74%
2020-01-01 00:02:30,16,12,25480,4457,21023,38.88%,17.49%
2020-01-01 00:02:40,1,1,23713,3806,19907,36.18%,16.05%
2020-01-01 00:02:40,1,2,10941,862,10079,16.69%,7.88%
2020-01-01 00:02:40,1,3,993,10,983,1.52%,1.01%
2020-01-01 00:02:40,1,4,12432,1142,11290,18.97%,9.19%
2020-01-01 00:02:40,1,5,11986,1072,10914,18.29%,8.94%
2020-01-01 00:02:40,1,6,11947,1066,10881,18.23%,8.92%
2020-01-01 00:02:40,1,7,9937,704,9233,15.16%,7.08%
2020-01-01 00:02:40,1,8,8922,568,8354,13.61%,6.37%
2020-01-01 00:02:40,1,9,11911,1059,10852,18.17%,8.89%
2020-01-01 00:02:40,1,10,8157,483,7674,12.45%,5.92%
2020-01-01 00:02:40,1,11,8379,512,7867,12.79%,6.11%
2020-01-01 00:02:40,1,12,11884,1052,10832,18.13%,8.85%
2020-01-01 00:02:40,2,1,640,3,637,0.98%,0.47%
2020-01-01 00:02:40,2,2,29324,5761,23563,44.74%,19.65%
2020-01-01 00:02:40,2,3,23524,3830,19694,35.89%,16.28%
2020-01-01 00:02:40,2,4,590,3,587,0.90%,0.51%
2020-01-01 00:02:40,2,5,13262,1306,11956,20.24%,9.85%
2020-01-01 00:02:40,2,6,45,0,45,0.07%,0.00%
2020-01-01 00:02:40,2,7,5139,191,4948,7.84%,3.72%
2020-01-01 00:02:40,2,8,4238,130,4108,6.47%,3.07%
2020-01-01 00:02:40,2,9,13212,1294,11918,20.16%,9.79%
2020-01-01 00:02:40,2,10,3580,87,3493,5.46%,2.43%
2020-01-01 00:02:40,2,11,3600,89,3511,5.49%,2.47%
2020-01-01 00:02:40,2,12,13052,1257,11795,19.92%,9.63%
2020-01-01 00:02:40,3,1,1460,15,1445,2.23%,1.03%
2020-01-01 00:02:40,3,2,21347,3192,18155,32.57%,14.95%
2020-01-01 00:02:40,3,3,66817,25176,41641,101.95%,37.68%
2020-01-01 00:02:40,3,4,8969,573,8396,13.69%,6.39%
2020-01-01 00:02:40,3,5,44113,12284,31829,67.31%,27.85%
2020-01-01 00:02:40,3,6,9996,711,9285,15.25%,7.11%
2020-01-01 00:02:40,3,7,18072,2312,15760,27.58%,12.79%
2020-01-01 00:02:40,3,8,14834,1601,13233,22.63%,10.79%
2020-01-01 00:02:40,3,9,33734,7691,26043,51.47%,22.80%
2020-01-01 00:02:40,3,10,4143,146,3997,6.32%,3.52%
2020-01-01 00:02:40,3,11,2169,45,2124,3.31%,2.07%
2020-01-01 00:02:40,3,12,25748,4790,20958,39.29%,18.60%
2020-01-01 00:02:40,4,1,590,3,587,0.90%,0.51%
2020-01-01 00:02:40,4,2,388,1,387,0.59%,0.26%
2020-01-01 00:02:40,4,3,722,1,721,1.10%,0.14%
2020-01-01 00:02:40,4,4,27728,5113,22615,42.31%,18.44%
2020-01-01 00:02:40,4,5,16763,1942,14821,25.58%,11.59%
2020-01-01 00:02:40,4,6,23489,3764,19725,35.84%,16.02%
2020-01-01 00:02:40,4,7,5205,174,5031,7.94%,3.34%
2020-01-01 00:02:40,4,8,2891,57,2834,4.41%,1.97%
2020-01-01 00:02:40,4,9,14841,1542,13299,22.65%,10.39%
2020-01-01 00:02:40,4,10,1925,19,1906,2.94%,0.99%
2020-01-01 00:02:40,4,11,209,0,209,0.32%,0.00%
2020-01-01 00:02:40,4,12,12304,1072,11232,18.77%,8.71%
2020-01-01 00:02:40,5,1,2683,52,2631,4.09%,1.94%
2020-01-01 00:02:40,5,2,1021,6,1015,1.56%,0.59%
2020-01-01 00:02:40,5,3,1672,24,1648,2.55%,1.44%
2020-01-01 00:02:40,5,4,20836,3127,17709,31.79%,15.01%
2020-01-01 00:02:40,5,5,10024,786,9238,15.30%,7.84%
2020-01-01 00:02:40,5,6,14139,1498,12641,21.57%,10.59%
2020-01-01 00:02:40,5,7,3630,111,3519,5.54%,3.06%
2020-01-01 00:02:40,5,8,2726,55,2671,4.16%,2.02%
2020-01-01 00:02:40,5,9,8200,538,7662,12.51%,6.56%
2020-01-01 00:02:40,5,10,1047,14,1033,1.60%,1.34%
2020-01-01 00:02:40,5,11,601,4,597,0.92%,0.67%
2020-01-01 00:02:40,5,12,6691,351,6340,10.21%,5.25%
2020-01-01 00:02:40,6,1,1183,14,1169,1.81%,1.18%
2020-01-01 00:02:40,6,2,1307,20,1287,1.99%,1.53%
2020-01-01 00:02:40,6,3,1955,41,1914,2.98%,2.10%
2020-01-01 00:02:40,6,4,1391,12,1379,2.12%,0.86%
2020-01-01 00:02:40,6,5,12831,1203,11628,19.58%,9.38%
2020-01-01 00:02:40,6,6,4188,131,4057,6.39%,3.13%
2020-01-01 00:02:40,6,7,2268,48,2220,3.46%,2.12%
2020-01-01 00:02:40,6,8,1803,33,1770,2.75%,1.83%
2020-01-01 00:02:40,6,9,6475,324,6151,9.88%,5.00%
2020-01-01 00:02:40,6,10,1930,33,1897,2.94%,1.71%
2020-01-01 00:02:40,6,11,452,1,451,0.69%,0.22%
2020-01-01 00:02:40,6,12,4470,168,4302,6.82%,3.76%
2020-01-01 00:02:40,7,1,497,0,497,0.76%,0.00%
2020-01-01 00:02:40,7,2,197,1,196,0.30%,0.51%
2020-01-01 00:02:40,7,3,1185,15,1170,1.81%,1.27%
2020-01-01 00:02:40,7,4,2344,40,2304,3.58%,1.71%
2020-01-01 00:02:40,7,5,7538,428,7110,11.50%,5.68%
2020-01-01 00:02:40,7,6,13708,1317,12391,20.92%,9.61%
2020-01-01 00:02:40,7,7,3781,117,3664,5.77%,3.09%
2020-01-01 00:02:40,7,8,1580,21,1559,2.41%,1.33%
2020-01-01 00:02:40,7,9,6149,265,5884,9.38%,4.31%
2020-01-01 00:02:40,7,10,1084,8,1076,1.65%,0.74%
2020-01-01 00:02:40,7,11,86,0,86,0.13%,0.00%
2020-01-01 00:02:40,7,12,5066,190,4876,7.73%,3.75%
2020-01-01 00:02:40,8,1,453,1,452,0.69%,0.22%
2020-01-01 00:02:40,8,2,102,0,102,0.16%,0.00%
2020-01-01 00:02:40,8,3,1688,16,1672,2.58%,0.95%
2020-01-01 00:02:40,8,4,2978,73,2905,4.54%,2.45%
2020-01-01 00:02:40,8,5,7790,448,7342,11.89%,5.75%
2020-01-01 00:02:40,8,6,14965,1655,13310,22.83%,11.06%
2020-01-01 00:02:40,8,7,4147,144,4003,6.33%,3.47%
2020-01-01 00:02:40,8,8,1505,12,1493,2.30%,0.80%
2020-01-01 00:02:40,8,9,5882,255,5627,8.98%,4.34%
2020-01-01 00:02:40,8,10,1663,18,1645,2.54%,1.08%
2020-01-01 00:02:40,8,11,146,0,146,0.22%,0.00%
2020-01-01 00:02:40,8,12,4195,146,4049,6.40%,3.48%
2020-01-01 00:02:40,9,1,644,2,642,0.98%,0.31%
2020-01-01 00:02:40,9,2,2529,46,2483,3.86%,1.82%
2020-01-01 00:02:40,9,3,1426,10,1416,2.18%,0.70%
2020-01-01 00:02:40,9,4,6009,269,5740,9.17%,4.48%
2020-01-01 00:02:40,9,5,947,8,939,1.45%,0.84%
2020-01-01 00:02:40,9,6,7734,471,7263,11.80%,6.09%
2020-01-01 00:02:40,9,7,30654,6282,24372,46.77%,20.49%
2020-01-01 00:02:40,9,8,11116,877,10239,16.96%,7.89%
2020-01-01 00:02:40,9,9,429,2,427,0.65%,0.47%
2020-01-01 00:02:40,9,10,4929,166,4763,7.52%,3.37%
2020-01-01 00:02:40,9,11,10038,729,9309,15.32%,7.26%
2020-01-01 00:02:40,9,12,4742,161,4581,7.24%,3.40%
2020-01-01 00:02:40,10,1,1441,254,1187,2.20%,17.63%
2020-01-01 00:02:40,10,2,3586,331,3255,5.47%,9.23%
2020-01-01 00:02:40,10,3,1980,33,1947,3.02%,1.67%
2020-01-01 00:02:40,10,4,4352,1004,3348,6.64%,23.07%
2020-01-01 00:02:40,10,5,861,56,805,1.31%,6.50%
2020-01-01 00:02:40,10,6,6584,1189,5395,10.05%,18.06%
2020-01-01 00:02:40,10,7,12237,2047,10190,18.67%,16.73%
2020-01-01 00:02:40,10,8,29591,7380,22211,45.15%,24.94%
2020-01-01 00:02:40,10,9,575,5,570,0.88%,0.87%
2020-01-01 00:02:40,10,10,2214,57,2157,3.38%,2.57%
2020-01-01 00:02:40,10,11,13381,1734,11647,20.42%,12.96%
2020-01-01 00:02:40,10,12,10591,1292,9299,16.16%,12.20%
2020-01-01 00:02:40,11,1,2333,40,2293,3.56%,1.71%
2020-01-01 00:02:40,11,2,3302,72,3230,5.04%,2.18%
2020-01-01 00:02:40,11,3,807,5,802,1.23%,0.62%
2020-01-01 00:02:40,11,4,8631,512,8119,13.17%,5.93%
2020-01-01 00:02:40,11,5,203,0,203,0.31%,0.00%
2020-01-01 00:02:40,11,6,9428,621,8807,14.39%,6.59%
2020-01-01 00:02:40,11,7,14434,1471,12963,22.02%,10.19%
2020-01-01 00:02:40,11,8,28352,5399,22953,43.26%,19.04%
2020-01-01 00:02:40,11,9,261,0,261,0.40%,0.00%
2020-01-01 00:02:40,11,10,3076,67,3009,4.69%,2.18%
2020-01-01 00:02:40,11,11,10404,784,9620,15.88%,7.54%
2020-01-01 00:02:40,11,12,6918,372,6546,10.56%,5.38%
2020-01-01 00:02:40,12,1,110,0,110,0.17%,0.00%
2020-01-01 00:02:40,12,2,462,128,334,0.70%,27.71%
2020-01-01 00:02:40,12,3,2667,171,2496,4.07%,6.41%
2020-01-01 00:02:40,12,4,3259,83,3176,4.97%,2.55%
2020-01-01 00:02:40,12,5,8411,758,7653,12.83%,9.01%
2020-01-01 00:02:40,12,6,5159,333,4826,7.87%,6.45%
2020-01-01 00:02:40,12,7,1603,30,1573,2.45%,1.87%
2020-01-01 00:02:40,12,8,1289,252,1037,1.97%,19.55%
2020-01-01 00:02:40,12,9,20973,4027,16946,32.00%,19.20%
2020-01-01 00:02:40,12,10,4296,353,3943,6.56%,8.22%
2020-01-01 00:02:40,12,11,1445,256,1189,2.20%,17.72%
2020-01-01 00:02:40,12,12,6627,1032,5595,10.11%,15.57%
2020-01-01 00:02:40,13,1,1952,37,1915,2.98%,1.90%
2020-01-01 00:02:40,13,2,2385,52,2333,3.64%,2.18%
2020-01-01 00:02:40,13,3,825,11,814,1.26%,1.33%
2020-01-01 00:02:40,13,4,4462,498,3964,6.81%,11.16%
2020-01-01 00:02:40,13,5,7985,971,7014,12.18%,12.16%
2020-01-01 00:02:40,13,6,5101,537,4564,7.78%,10.53%
2020-01-01 00:02:40,13,7,4828,163,4665,7.37%,3.38%
2020-01-01 00:02:40,13,8,6978,340,6638,10.65%,4.87%
2020-01-01 00:02:40,13,9,8269,1010,7259,12.62%,12.21%
2020-01-01 00:02:40,13,10,29157,6140,23017,44.49%,21.06%
2020-01-01 00:02:40,13,11,18629,2600,16029,28.43%,13.96%
2020-01-01 00:02:40,13,12,11223,1178,10045,17.12%,10.50%
2020-01-01 00:02:40,14,1,347,1,346,0.53%,0.29%
2020-01-01 00:02:40,14,2,1205,12,1193,1.84%,1.00%
2020-01-01 00:02:40,14,3,639,5,634,0.98%,0.78%
2020-01-01 00:02:40,14,4,3876,118,3758,5.91%,3.04%
2020-01-01 00:02:40,14,5,1526,20,1506,2.33%,1.31%
2020-01-01 00:02:40,14,6,4293,146,4147,6.55%,3.40%
2020-01-01 00:02:40,14,7,11199,938,10261,17.09%,8.38%
2020-01-01 00:02:40,14,8,12714,1233,11481,19.40%,9.70%
2020-01-01 00:02:40,14,9,1680,28,1652,2.56%,1.67%
2020-01-01 00:02:40,14,10,4266,147,4119,6.51%,3.45%
2020-01-01 00:02:40,14,11,27866,5317,22549,42.52%,19.08%
2020-01-01 00:02:40,14,12,10484,813,9671,16.00%,7.75%
2020-01-01 00:02:40,15,1,493,0,493,0.75%,0.00%
2020-01-01 00:02:40,15,2,108,0,108,0.16%,0.00%
2020-01-01 00:02:40,15,3,6520,323,6197,9.95%,4.95%
2020-01-01 00:02:40,15,4,4625,204,4421,7.06%,4.41%
2020-01-01 00:02:40,15,5,12039,1105,10934,18.37%,9.18%
2020-01-01 00:02:40,15,6,4909,252,4657,7.49%,5.13%
2020-01-01 00:02:40,15,7,3236,110,3126,4.94%,3.40%
2020-01-01 00:02:40,15,8,5316,257,5059,8.11%,4.83%
2020-01-01 00:02:40,15,9,12199,1135,11064,18.61%,9.30%
2020-01-01 00:02:40,15,10,5246,378,4868,8.00%,7.21%
2020-01-01 00:02:40,15,11,10677,1032,9645,16.29%,9.67%
2020-01-01 00:02:40,15,12,28488,5909,22579,43.47%,20.74%
2020-01-01 00:02:40,16,1,396,3,393,0.60%,0.76%
2020-01-01 00:02:40,16,2,237,4,233,0.36%,1.69%
2020-01-01 00:02:40,16,3,1236,12,1224,1.89%,0.97%
2020-01-01 00:02:40,16,4,3588,85,3503,5.47%,2.37%
2020-01-01 00:02:40,16,5,7215,419,6796,11.01%,5.81%
2020-01-01 00:02:40,16,6,4505,133,4372,6.87%,2.95%
2020-01-01 00:02:40,16,7,3469,96,3373,5.29%,2.77%
2020-01-01 00:02:40,16,8,6986,451,6535,10.66%,6.46%
2020-01-01 00:02:40,16,9,7688,479,7209,11.73%,6.23%
2020-01-01 00:02:40,16,10,2189,53,2136,3.34%,2.42%
2020-01-01 00:02:40,16,11,9394,760,8634,14.33%,8.09%
2020-01-01 00:02:40,16,12,24914,4236,20678,38.02%,17.00%
2020-01-01 00:02:50,1,1,19215,2523,16692,29.32%,13.13%
2020-01-01 00:02:50,1,2,8661,537,8124,13.22%,6.20%
2020-01-01 00:02:50,1,3,370,2,368,0.56%,0.54%
2020-01-01 00:02:50,1,4,9944,745,9199,15.17%,7.49%
2020-01-01 00:02:50,1,5,9511,683,8828,14.51%,7.18%
2020-01-01 00:02:50,1,6,9446,675,8771,14.41%,7.15%
2020-01-01 00:02:50,1,7,8267,498,7769,12.61%,6.02%
2020-01-01 00:02:50,1,8,7188,377,6811,10.97%,5.24%
2020-01-01 00:02:50,1,9,9402,670,8732,14.35%,7.13%
2020-01-01 00:02:50,1,10,6117,257,5860,9.33%,4.20%
2020-01-01 00:02:50,1,11,6209,266,5943,9.47%,4.28%
2020-01-01 00:02:50,1,12,9375,669,8706,14.31%,7.14%
2020-01-01 00:02:50,2,1,1070,10,1060,1.63%,0.93%
2020-01-01 00:02:50,2,2,29325,5663,23662,44.75%,19.31%
2020-01-01 00:02:50,2,3,23702,3818,19884,36.17%,16.11%
2020-01-01 00:02:50,2,4,998,8,990,1.52%,0.80%
2020-01-01 00:02:50,2,5,12037,1053,10984,18.37%,8.75%
2020-01-01 00:02:50,2,6,26,0,26,0.04%,0.00%
2020-01-01 00:02:50,2,7,4542,155,4387,6.93%,3.41%
2020-01-01 00:02:50,2,8,3227,73,3154,4.92%,2.26%
2020-01-01 00:02:50,2,9,11963,1044,10919,18.25%,8.73%
2020-01-01 00:02:50,2,10,2328,44,2284,3.55%,1.89%
2020-01-01 00:02:50,2,11,2348,45,2303,3.58%,1.92%
2020-01-01 00:02:50,2,12,11826,1020,10806,18.05%,8.63%
2020-01-01 00:02:50,3,1,1487,23,1464,2.27%,1.55%
2020-01-01 00:02:50,3,2,21179,3058,18121,32.32%,14.44%
2020-01-01 00:02:50,3,3,73983,29657,44326,112.89%,40.09%
2020-01-01 00:02:50,3,4,11068,926,10142,16.89%,8.37%
2020-01-01 00:02:50,3,5,49681,14937,34744,75.81%,30.07%
2020-01-01 00:02:50,3,6,12268,1125,11143,18.72%,9.17%
2020-01-01 00:02:50,3,7,17917,2267,15650,27.34%,12.65%
2020-01-01 00:02:50,3,8,14988,1644,13344,22.87%,10.97%
2020-01-01 00:02:50,3,9,37104,8727,28377,56.62%,23.52%
2020-01-01 00:02:50,3,10,5670,220,5450,8.65%,3.88%
2020-01-01 00:02:50,3,11,2155,23,2132,3.29%,1.07%
2020-01-01 00:02:50,3,12,27983,5149,22834,42.70%,18.40%
2020-01-01 00:02:50,4,1,569,3,566,0.87%,0.53%
2020-01-01 00:02:50,4,2,388,2,386,0.59%,0.52%
2020-01-01 00:02:50,4,3,728,8,720,1.11%,1.10%
2020-01-01 00:02:50,4,4,28689,5487,23202,43.78%,19.13%
2020-01-01 00:02:50,4,5,17536,2127,15409,26.76%,12.13%
2020-01-01 00:02:50,4,6,24226,4018,20208,36.97%,16.59%
2020-01-01 00:02:50,4,7,5177,206,4971,7.90%,3.98%
2020-01-01 00:02:50,4,8,2913,57,2856,4.44%,1.96%
2020-01-01 00:02:50,4,9,15744,1751,13993,24.02%,11.12%
2020-01-01 00:02:50,4,10,2200,42,2158,3.36%,1.91%
2020-01-01 00:02:50,4,11,223,0,223,0.34%,0.00%
2020-01-01 00:02:50,4,12,12653,1135,11518,19.31%,8.97%
2020-01-01 00:02:50,5,1,2726,53,2673,4.16%,1.94%
2020-01-01 00:02:50,5,2,626,5,621,0.96%,0.80%
2020-01-01 00:02:50,5,3,1648,18,1630,2.51%,1.09%
2020-01-01 00:02:50,5,4,21900,3323,18577,33.42%,15.17%
2020-01-01 00:02:50,5,5,10085,735,9350,15.39%,7.29%
2020-01-01 00:02:50,5,6,14660,1550,13110,22.37%,10.57%
2020-01-01 00:02:50,5,7,4166,137,4029,6.36%,3.29%
2020-01-01 00:02:50,5,8,3240,83,3157,4.94%,2.56%
2020-01-01 00:02:50,5,9,8269,497,7772,12.62%,6.01%
2020-01-01 00:02:50,5,10,899,8,891,1.37%,0.89%
2020-01-01 00:02:50,5,11,769,3,766,1.17%,0.39%
2020-01-01 00:02:50,5,12,7091,371,6720,10.82%,5.23%
2020-01-01 00:02:50,6,1,1342,12,1330,2.05%,0.89%
2020-01-01 00:02:50,6,2,1407,16,1391,2.15%,1.14%
2020-01-01 00:02:50,6,3,2053,28,2025,3.13%,1.36%
2020-01-01 00:02:50,6,4,1323,7,1316,2.02%,0.53%
2020-01-01 00:02:50,6,5,12106,1033,11073,18.47%,8.53%
2020-01-01 00:02:50,6,6,3818,103,3715,5.83%,2.70%
2020-01-01 00:02:50,6,7,2014,38,1976,3.07%,1.89%
2020-01-01 00:02:50,6,8,1529,24,1505,2.33%,1.57%
2020-01-01 00:02:50,6,9,6045,284,5761,9.22%,4.70%
2020-01-01 00:02:50,6,10,1746,35,1711,2.66%,2.00%
2020-01-01 00:02:50,6,11,495,5,490,0.76%,1.01%
2020-01-01 00:02:50,6,12,4227,139,4088,6.45%,3.29%
2020-01-01 00:02:50,7,1,607,3,604,0.93%,0.49%
2020-01-01 00:02:50,7,2,155,0,155,0.24%,0.00%
2020-01-01 00:02:50,7,3,783,5,778,1.19%,0.64%
2020-01-01 00:02:50,7,4,2443,48,2395,3.73%,1.96%
2020-01-01 00:02:50,7,5,7800,470,7330,11.90%,6.03%
2020-01-01 00:02:50,7,6,14181,1481,12700,21.64%,10.44%
2020-01-01 00:02:50,7,7,3860,115,3745,5.89%,2.98%
2020-01-01 00:02:50,7,8,1381,19,1362,2.11%,1.38%
2020-01-01 00:02:50,7,9,6851,361,6490,10.45%,5.27%
2020-01-01 00:02:50,7,10,1297,10,1287,1.98%,0.77%
2020-01-01 00:02:50,7,11,97,0,97,0.15%,0.00%
2020-01-01 00:02:50,7,12,5572,240,5332,8.50%,4.31%
2020-01-01 00:02:50,8,1,577,10,567,0.88%,1.73%
2020-01-01 00:02:50,8,2,80,0,80,0.12%,0.00%
2020-01-01 00:02:50,8,3,2268,36,2232,3.46%,1.59%
2020-01-01 00:02:50,8,4,2953,79,2874,4.51%,2.68%
2020-01-01 00:02:50,8,5,8912,561,8351,13.60%,6.29%
2020-01-01 00:02:50,8,6,16699,1954,14745,25.48%,11.70%
2020-01-01 00:02:50,8,7,4693,169,4524,7.16%,3.60%
2020-01-01 00:02:50,8,8,2134,31,2103,3.26%,1.45%
2020-01-01 00:02:50,8,9,6261,304,5957,9.55%,4.86%
2020-01-01 00:02:50,8,10,1604,16,1588,2.45%,1.00%
2020-01-01 00:02:50,8,11,186,0,186,0.28%,0.00%
2020-01-01 00:02:50,8,12,4673,163,4510,7.13%,3.49%
2020-01-01 00:02:50,9,1,1228,6,1222,1.87%,0.49%
2020-01-01 00:02:50,9,2,2793,45,2748,4.26%,1.61%
2020-01-01 00:02:50,9,3,1093,10,1083,1.67%,0.91%
2020-01-01 00:02:50,9,4,5169,203,4966,7.89%,3.93%
2020-01-01 00:02:50,9,5,593,2,591,0.90%,0.34%
2020-01-01 00:02:50,9,6,6431,302,6129,9.81%,4.70%
2020-01-01 00:02:50,9,7,27168,4886,22282,41.46%,17.98%
2020-01-01 00:02:50,9,8,11569,972,10597,17.65%,8.40%
2020-01-01 00:02:50,9,9,256,0,256,0.39%,0.00%
2020-01-01 00:02:50,9,10,4329,154,4175,6.61%,3.56%
2020-01-01 00:02:50,9,11,10384,805,9579,15.84%,7.75%
2020-01-01 00:02:50,9,12,5715,221,5494,8.72%,3.87%
2020-01-01 00:02:50,10,1,1327,261,1066,2.02%,19.67%
2020-01-01 00:02:50,10,2,4499,401,4098,6.86%,8.91%
2020-01-01 00:02:50,10,3,3028,83,2945,4.62%,2.74%
2020-01-01 00:02:50,10,4,4106,1123,2983,6.27%,27.35%
2020-01-01 00:02:50,10,5,836,77,759,1.28%,9.21%
2020-01-01 00:02:50,10,6,6395,1327,5068,9.76%,20.75%
2020-01-01 00:02:50,10,7,12369,2328,10041,18.87%,18.82%
2020-01-01 00:02:50,10,8,31429,8438,22991,47.96%,26.85%
2020-01-01 00:02:50,10,9,548,0,548,0.84%,0.00%
2020-01-01 00:02:50,10,10,2879,61,2818,4.39%,2.12%
2020-01-01 00:02:50,10,11,14676,1983,12693,22.39%,13.51%
2020-01-01 00:02:50,10,12,11002,1352,9650,16.79%,12.29%
2020-01-01 00:02:50,11,1,2756,82,2674,4.21%,2.98%
2020-01-01 00:02:50,11,2,4019,171,3848,6.13%,4.25%
2020-01-01 00:02:50,11,3,1075,36,1039,1.64%,3.35%
2020-01-01 00:02:50,11,4,3838,126,3712,5.86%,3.28%
2020-01-01 00:02:50,11,5,182,1,181,0.28%,0.55%
2020-01-01 00:02:50,11,6,4580,174,4406,6.99%,3.80%
2020-01-01 00:02:50,11,7,10481,866,9615,15.99%,8.26%
2020-01-01 00:02:50,11,8,24903,4289,20614,38.00%,17.22%
2020-01-01 00:02:50,11,9,259,0,259,0.40%,0.00%
2020-01-01 00:02:50,11,10,3668,101,3567,5.60%,2.75%
2020-01-01 00:02:50,11,11,10873,849,10024,16.59%,7.81%
2020-01-01 00:02:50,11,12,6609,334,6275,10.08%,5.05%
2020-01-01 00:02:50,12,1,42,0,42,0.06%,0.00%
2020-01-01 00:02:50,12,2,566,149,417,0.86%,26.33%
2020-01-01 00:02:50,12,3,3548,236,3312,5.41%,6.65%
2020-01-01 00:02:50,12,4,3638,114,3524,5.55%,3.13%
2020-01-01 00:02:50,12,5,10190,886,9304,15.55%,8.69%
2020-01-01 00:02:50,12,6,5475,252,5223,8.35%,4.60%
2020-01-01 00:02:50,12,7,1669,30,1639,2.55%,1.80%
2020-01-01 00:02:50,12,8,1536,295,1241,2.34%,19.21%
2020-01-01 00:02:50,12,9,23334,4601,18733,35.60%,19.72%
2020-01-01 00:02:50,12,10,5033,436,4597,7.68%,8.66%
2020-01-01 00:02:50,12,11,1878,300,1578,2.87%,15.97%
2020-01-01 00:02:50,12,12,7110,1075,6035,10.85%,15.12%
2020-01-01 00:02:50,13,1,2512,39,2473,3.83%,1.55%
2020-01-01 00:02:50,13,2,2966,62,2904,4.53%,2.09%
2020-01-01 00:02:50,13,3,1069,3,1066,1.63%,0.28%
2020-01-01 00:02:50,13,4,4656,524,4132,7.10%,11.25%
2020-01-01 00:02:50,13,5,7504,954,6550,11.45%,12.71%
2020-01-01 00:02:50,13,6,5411,568,4843,8.26%,10.50%
2020-01-01 00:02:50,13,7,5261,243,5018,8.03%,4.62%
2020-01-01 00:02:50,13,8,8064,525,7539,12.30%,6.51%
2020-01-01 00:02:50,13,9,7814,986,6828,11.92%,12.62%
2020-01-01 00:02:50,13,10,28068,5945,22123,42.83%,21.18%
2020-01-01 00:02:50,13,11,17372,2487,14885,26.51%,14.32%
2020-01-01 00:02:50,13,12,8878,901,7977,13.55%,10.15%
2020-01-01 00:02:50,14,1,423,4,419,0.65%,0.95%
2020-01-01 00:02:50,14,2,1571,21,1550,2.40%,1.34%
2020-01-01 00:02:50,14,3,875,9,866,1.34%,1.03%
2020-01-01 00:02:50,14,4,3786,109,3677,5.78%,2.88%
2020-01-01 00:02:50,14,5,1279,12,1267,1.95%,0.94%
2020-01-01 00:02:50,14,6,4309,143,4166,6.58%,3.32%
2020-01-01 00:02:50,14,7,12464,1090,11374,19.02%,8.75%
2020-01-01 00:02:50,14,8,13837,1321,12516,21.11%,9.55%
2020-01-01 00:02:50,14,9,1474,14,1460,2.25%,0.95%
2020-01-01 00:02:50,14,10,4328,137,4191,6.60%,3.17%
2020-01-01 00:02:50,14,11,29089,5753,23336,44.39%,19.78%
2020-01-01 00:02:50,14,12,10595,878,9717,16.17%,8.29%
2020-01-01 00:02:50,15,1,563,0,563,0.86%,0.00%
2020-01-01 00:02:50,15,2,129,0,129,0.20%,0.00%
2020-01-01 00:02:50,15,3,3968,117,3851,6.05%,2.95%
2020-01-01 00:02:50,15,4,4580,214,4366,6.99%,4.67%
2020-01-01 00:02:50,15,5,9369,704,8665,14.30%,7.51%
2020-01-01 00:02:50,15,6,4848,239,4609,7.40%,4.93%
2020-01-01 00:02:50,15,7,3627,96,3531,5.53%,2.65%
2020-01-01 00:02:50,15,8,6161,293,5868,9.40%,4.76%
2020-01-01 00:02:50,15,9,9581,738,8843,14.62%,7.70%
2020-01-01 00:02:50,15,10,4283,418,3865,6.54%,9.76%
2020-01-01 00:02:50,15,11,10577,1074,9503,16.14%,10.15%
2020-01-01 00:02:50,15,12,25579,5038,20541,39.03%,19.70%
2020-01-01 00:02:50,16,1,484,0,484,0.74%,0.00%
2020-01-01 00:02:50,16,2,281,4,277,0.43%,1.42%
2020-01-01 00:02:50,16,3,1367,25,1342,2.09%,1.83%
2020-01-01 00:02:50,16,4,4043,136,3907,6.17%,3.36%
2020-01-01 00:02:50,16,5,7314,481,6833,11.16%,6.58%
2020-01-01 00:02:50,16,6,5050,201,4849,7.71%,3.98%
2020-01-01 00:02:50,16,7,2899,68,2831,4.42%,2.35%
2020-01-01 00:02:50,16,8,6611,377,6234,10.09%,5.70%
2020-01-01 00:02:50,16,9,7902,544,7358,12.06%,6.88%
2020-01-01 00:02:50,16,10,1610,16,1594,2.46%,0.99%
2020-01-01 00:02:50,16,11,8494,578,7916,12.96%,6.80%
2020-01-01 00:02:50,16,12,24238,4005,20233,36.98%,16.52%
2020-01-01 00:03:00,1,1,18800,2394,16406,28.69%,12.73%
2020-01-01 00:03:00,1,2,9217,624,8593,14.06%,6.77%
2020-01-01 00:03:00,1,3,346,1,345,0.53%,0.29%
2020-01-01 00:03:00,1,4,9133,592,8541,13.94%,6.48%
2020-01-01 00:03:00,1,5,8756,559,8197,13.36%,6.38%
2020-01-01 00:03:00,1,6,8701,546,8155,13.28%,6.28%
2020-01-01 00:03:00,1,7,8855,577,8278,13.51%,6.52%
2020-01-01 00:03:00,1,8,6530,295,6235,9.96%,4.52%
2020-01-01 00:03:00,1,9,8666,544,8122,13.22%,6.28%
2020-01-01 00:03:00,1,10,5665,214,5451,8.64%,3.78%
2020-01-01 00:03:00,1,11,5731,222,5509,8.74%,3.87%
2020-01-01 00:03:00,1,12,8405,519,7886,12.83%,6.17%
2020-01-01 00:03:00,2,1,792,2,790,1.21%,0.25%
2020-01-01 00:03:00,2,2,23477,3782,19695,35.82%,16.11%
2020-01-01 00:03:00,2,3,18847,2488,16359,28.76%,13.20%
2020-01-01 00:03:00,2,4,706,1,705,1.08%,0.14%
2020-01-01 00:03:00,2,5,11756,1015,10741,17.94%,8.63%
2020-01-01 00:03:00,2,6,40,0,40,0.06%,0.00%
2020-01-01 00:03:00,2,7,3814,108,3706,5.82%,2.83%
2020-01-01 00:03:00,2,8,2465,47,2418,3.76%,1.91%
2020-01-01 00:03:00,2,9,11718,1005,10713,17.88%,8.58%
2020-01-01 00:03:00,2,10,1792,18,1774,2.73%,1.00%
2020-01-01 00:03:00,2,11,1801,19,1782,2.75%,1.05%
2020-01-01 00:03:00,2,12,11518,979,10539,17.58%,8.50%
2020-01-01 00:03:00,3,1,1601,19,1582,2.44%,1.19%
2020-01-01 00:03:00,3,2,22898,3666,19232,34.94%,16.01%
2020-01-01 00:03:00,3,3,69171,26492,42679,105.55%,38.30%
2020-01-01 00:03:00,3,4,7382,393,6989,11.26%,5.32%
2020-01-01 00:03:00,3,5,45152,12459,32693,68.90%,27.59%
2020-01-01 00:03:00,3,6,8828,560,8268,13.47%,6.34%
2020-01-01 00:03:00,3,7,19358,2657,16701,29.54%,13.73%
2020-01-01 00:03:00,3,8,15318,1694,13624,23.37%,11.06%
2020-01-01 00:03:00,3,9,35977,8321,27656,54.90%,23.13%
2020-01-01 00:03:00,3,10,7462,434,7028,11.39%,5.82%
2020-01-01 00:03:00,3,11,2132,42,2090,3.25%,1.97%
2020-01-01 00:03:00,3,12,24784,4159,20625,37.82%,16.78%
2020-01-01 00:03:00,4,1,526,2,524,0.80%,0.38%
2020-01-01 00:03:00,4,2,337,0,337,0.51%,0.00%
2020-01-01 00:03:00,4,3,619,3,616,0.94%,0.48%
2020-01-01 00:03:00,4,4,28224,5223,23001,43.07%,18.51%
2020-01-01 00:03:00,4,5,16966,1991,14975,25.89%,11.74%
2020-01-01 00:03:00,4,6,23892,3783,20109,36.46%,15.83%
2020-01-01 00:03:00,4,7,5394,199,5195,8.23%,3.69%
2020-01-01 00:03:00,4,8,2936,60,2876,4.48%,2.04%
2020-01-01 00:03:00,4,9,14963,1549,13414,22.83%,10.35%
2020-01-01 00:03:00,4,10,2036,25,2011,3.11%,1.23%
2020-01-01 00:03:00,4,11,204,0,204,0.31%,0.00%
2020-01-01 00:03:00,4,12,12335,1068,11267,18.82%,8.66%
2020-01-01 00:03:00,5,1,2650,62,2588,4.04%,2.34%
2020-01-01 00:03:00,5,2,759,3,756,1.16%,0.40%
2020-01-01 00:03:00,5,3,890,6,884,1.36%,0.67%
2020-01-01 00:03:00,5,4,25877,4430,21447,39.49%,17.12%
2020-01-01 00:03:00,5,5,9583,634,8949,14.62%,6.62%
2020-01-01 00:03:00,5,6,15118,1544,13574,23.07%,10.21%
2020-01-01 00:03:00,5,7,5102,175,4927,7.79%,3.43%
2020-01-01 00:03:00,5,8,3273,70,3203,4.99%,2.14%
2020-01-01 00:03:00,5,9,8576,500,8076,13.09%,5.83%
2020-01-01 00:03:00,5,10,1011,10,1001,1.54%,0.99%
2020-01-01 00:03:00,5,11,560,1,559,0.85%,0.18%
2020-01-01 00:03:00,5,12,7258,363,6895,11.07%,5.00%
2020-01-01 00:03:00,6,1,1047,10,1037,1.60%,0.96%
2020-01-01 00:03:00,6,2,1106,11,1095,1.69%,0.99%
2020-01-01 00:03:00,6,3,1730,25,1705,2.64%,1.45%
2020-01-01 00:03:00,6,4,1089,9,1080,1.66%,0.83%
2020-01-01 00:03:00,6,5,14044,1439,12605,21.43%,10.25%
2020-01-01 00:03:00,6,6,5412,229,5183,8.26%,4.23%
2020-01-01 00:03:00,6,7,3870,111,3759,5.91%,2.87%
2020-01-01 00:03:00,6,8,3457,87,3370,5.27%,2.52%
2020-01-01 00:03:00,6,9,6609,303,6306,10.08%,4.58%
2020-01-01 00:03:00,6,10,2081,27,2054,3.18%,1.30%
2020-01-01 00:03:00,6,11,412,2,410,0.63%,0.49%
2020-01-01 00:03:00,6,12,4464,147,4317,6.81%,3.29%
2020-01-01 00:03:00,7,1,575,1,574,0.88%,0.17%
2020-01-01 00:03:00,7,2,152,0,152,0.23%,0.00%
2020-01-01 00:03:00,7,3,795,3,792,1.21%,0.38%
2020-01-01 00:03:00,7,4,2089,33,2056,3.19%,1.58%
2020-01-01 00:03:00,7,5,7743,422,7321,11.81%,5.45%
2020-01-01 00:03:00,7,6,13134,1250,11884,20.04%,9.52%
2020-01-01 00:03:00,7,7,3247,64,3183,4.95%,1.97%
2020-01-01 00:03:00,7,8,1438,16,1422,2.19%,1.11%
2020-01-01 00:03:00,7,9,6702,324,6378,10.23%,4.83%
2020-01-01 00:03:00,7,10,992,7,985,1.51%,0.71%
2020-01-01 00:03:00,7,11,97,0,97,0.15%,0.00%
2020-01-01 00:03:00,7,12,5740,248,5492,8.76%,4.32%
2020-01-01 00:03:00,8,1,704,1,703,1.07%,0.14%
2020-01-01 00:03:00,8,2,92,0,92,0.14%,0.00%
2020-01-01 00:03:00,8,3,1916,13,1903,2.92%,0.68%
2020-01-01 00:03:00,8,4,3076,59,3017,4.69%,1.92%
2020-01-01 00:03:00,8,5,9118,580,8538,13.91%,6.36%
2020-01-01 00:03:00,8,6,17882,2190,15692,27.29%,12.25%
2020-01-01 00:03:00,8,7,5577,237,5340,8.51%,4.25%
2020-01-01 00:03:00,8,8,2754,73,2681,4.20%,2.65%
2020-01-01 00:03:00,8,9,6713,335,6378,10.24%,4.99%
2020-01-01 00:03:00,8,10,1719,13,1706,2.62%,0.76%
2020-01-01 00:03:00,8,11,213,0,213,0.33%,0.00%
2020-01-01 00:03:00,8,12,4969,193,4776,7.58%,3.88%
2020-01-01 00:03:00,9,1,375,0,375,0.57%,0.00%
2020-01-01 00:03:00,9,2,1827,23,1804,2.79%,1.26%
2020-01-01 00:03:00,9,3,1066,11,1055,1.63%,1.03%
2020-01-01 00:03:00,9,4,8105,489,7616,12.37%,6.03%
2020-01-01 00:03:00,9,5,524,1,523,0.80%,0.19%
2020-01-01 00:03:00,9,6,9279,631,8648,14.16%,6.80%
2020-01-01 00:03:00,9,7,30485,6172,24313,46.52%,20.25%
2020-01-01 00:03:00,9,8,14247,1519,12728,21.74%,10.66%
2020-01-01 00:03:00,9,9,161,0,161,0.25%,0.00%
2020-01-01 00:03:00,9,10,4043,113,3930,6.17%,2.79%
2020-01-01 00:03:00,9,11,12070,1065,11005,18.42%,8.82%
2020-01-01 00:03:00,9,12,7752,457,7295,11.83%,5.90%
2020-01-01 00:03:00,10,1,1515,246,1269,2.31%,16.24%
2020-01-01 00:03:00,10,2,3665,315,3350,5.59%,8.59%
2020-01-01 00:03:00,10,3,1998,30,1968,3.05%,1.50%
2020-01-01 00:03:00,10,4,4003,854,3149,6.11%,21.33%
2020-01-01 00:03:00,10,5,903,80,823,1.38%,8.86%
2020-01-01 00:03:00,10,6,6116,1038,5078,9.33%,16.97%
2020-01-01 00:03:00,10,7,11283,1822,9461,17.22%,16.15%
2020-01-01 00:03:00,10,8,31091,8093,22998,47.44%,26.03%
2020-01-01 00:03:00,10,9,749,7,742,1.14%,0.93%
2020-01-01 00:03:00,10,10,2963,80,2883,4.52%,2.70%
2020-01-01 00:03:00,10,11,14692,1862,12830,22.42%,12.67%
2020-01-01 00:03:00,10,12,10687,1171,9516,16.31%,10.96%
2020-01-01 00:03:00,11,1,2791,61,2730,4.26%,2.19%
2020-01-01 00:03:00,11,2,3905,112,3793,5.96%,2.87%
2020-01-01 00:03:00,11,3,929,8,921,1.42%,0.86%
2020-01-01 00:03:00,11,4,3168,87,3081,4.83%,2.75%
2020-01-01 00:03:00,11,5,198,0,198,0.30%,0.00%
2020-01-01 00:03:00,11,6,4091,140,3951,6.24%,3.42%
2020-01-01 00:03:00,11,7,9819,707,9112,14.98%,7.20%
2020-01-01 00:03:00,11,8,24328,3999,20329,37.12%,16.44%
2020-01-01 00:03:00,11,9,167,1,166,0.25%,0.60%
2020-01-01 00:03:00,11,10,3841,112,3729,5.86%,2.92%
2020-01-01 00:03:00,11,11,10658,818,9840,16.26%,7.67%
2020-01-01 00:03:00,11,12,6239,297,5942,9.52%,4.76%
2020-01-01 00:03:00,12,1,41,0,41,0.06%,0.00%
2020-01-01 00:03:00,12,2,519,145,374,0.79%,27.94%
2020-01-01 00:03:00,12,3,2969,201,2768,4.53%,6.77%
2020-01-01 00:03:00,12,4,3122,63,3059,4.76%,2.02%
2020-01-01 00:03:00,12,5,9560,793,8767,14.59%,8.29%
2020-01-01 00:03:00,12,6,5025,174,4851,7.67%,3.46%
2020-01-01 00:03:00,12,7,1754,27,1727,2.68%,1.54%
2020-01-01 00:03:00,12,8,1517,314,1203,2.31%,20.70%
2020-01-01 00:03:00,12,9,23317,4536,18781,35.58%,19.45%
2020-01-01 00:03:00,12,10,5047,483,4564,7.70%,9.57%
2020-01-01 00:03:00,12,11,2133,334,1799,3.25%,15.66%
2020-01-01 00:03:00,12,12,7793,1135,6658,11.89%,14.56%
2020-01-01 00:03:00,13,1,2470,45,2425,3.77%,1.82%
2020-01-01 00:03:00,13,2,2765,58,2707,4.22%,2.10%
2020-01-01 00:03:00,13,3,926,8,918,1.41%,0.86%
2020-01-01 00:03:00,13,4,4986,634,4352,7.61%,12.72%
2020-01-01 00:03:00,13,5,7440,959,6481,11.35%,12.89%
2020-01-01 00:03:00,13,6,5513,662,4851,8.41%,12.01%
2020-01-01 00:03:00,13,7,4727,178,4549,7.21%,3.77%
2020-01-01 00:03:00,13,8,8014,459,7555,12.23%,5.73%
2020-01-01 00:03:00,13,9,7687,981,6706,11.73%,12.76%
2020-01-01 00:03:00,13,10,28708,6132,22576,43.80%,21.36%
2020-01-01 00:03:00,13,11,18429,2689,15740,28.12%,14.59%
2020-01-01 00:03:00,13,12,10033,1135,8898,15.31%,11.31%
2020-01-01 00:03:00,14,1,214,0,214,0.33%,0.00%
2020-01-01 00:03:00,14,2,1691,26,1665,2.58%,1.54%
2020-01-01 00:03:00,14,3,1209,12,1197,1.84%,0.99%
2020-01-01 00:03:00,14,4,4006,121,3885,6.11%,3.02%
2020-01-01 00:03:00,14,5,1133,6,1127,1.73%,0.53%
2020-01-01 00:03:00,14,6,4369,146,4223,6.67%,3.34%
2020-01-01 00:03:00,14,7,12279,1089,11190,18.74%,8.87%
2020-01-01 00:03:00,14,8,14020,1412,12608,21.39%,10.07%
2020-01-01 00:03:00,14,9,1400,14,1386,2.14%,1.00%
2020-01-01 00:03:00,14,10,4007,106,3901,6.11%,2.65%
2020-01-01 00:03:00,14,11,26730,4763,21967,40.79%,17.82%
2020-01-01 00:03:00,14,12,8329,522,7807,12.71%,6.27%
2020-01-01 00:03:00,15,1,484,2,482,0.74%,0.41%
2020-01-01 00:03:00,15,2,177,0,177,0.27%,0.00%
2020-01-01 00:03:00,15,3,4435,142,4293,6.77%,3.20%
2020-01-01 00:03:00,15,4,5797,377,5420,8.85%,6.50%
2020-01-01 00:03:00,15,5,11232,978,10254,17.14%,8.71%
2020-01-01 00:03:00,15,6,6063,406,5657,9.25%,6.70%
2020-01-01 00:03:00,15,7,3910,100,3810,5.97%,2.56%
2020-01-01 00:03:00,15,8,7165,332,6833,10.93%,4.63%
2020-01-01 00:03:00,15,9,11456,1008,10448,17.48%,8.80%
2020-01-01 00:03:00,15,10,4933,325,4608,7.53%,6.59%
2020-01-01 00:03:00,15,11,12201,1164,11037,18.62%,9.54%
2020-01-01 00:03:00,15,12,29370,6133,23237,44.82%,20.88%
2020-01-01 00:03:00,16,1,523,3,520,0.80%,0.57%
2020-01-01 00:03:00,16,2,310,0,310,0.47%,0.00%
2020-01-01 00:03:00,16,3,1291,13,1278,1.97%,1.01%
2020-01-01 00:03:00,16,4,4041,115,3926,6.17%,2.85%
2020-01-01 00:03:00,16,5,7354,459,6895,11.22%,6.24%
2020-01-01 00:03:00,16,6,4975,184,4791,7.59%,3.70%
2020-01-01 00:03:00,16,7,3317,95,3222,5.06%,2.86%
2020-01-01 00:03:00,16,8,7952,546,7406,12.13%,6.87%
2020-01-01 00:03:00,16,9,7943,506,7437,12.12%,6.37%
2020-01-01 00:03:00,16,10,1565,17,1548,2.39%,1.09%
2020-01-01 00:03:00,16,11,9724,762,8962,14.84%,7.84%
2020-01-01 00:03:00,16,12,25290,4322,20968,38.59%,17.09%
2020-01-01 00:03:10,1,1,13886,1392,12494,21.19%,10.02%
2020-01-01 00:03:10,1,2,5135,207,4928,7.84%,4.03%
2020-01-01 00:03:10,1,3,333,0,333,0.51%,0.00%
2020-01-01 00:03:10,1,4,8330,494,7836,12.71%,5.93%
2020-01-01 00:03:10,1,5,8134,478,7656,12.41%,5.88%
2020-01-01 00:03:10,1,6,8071,472,7599,12.32%,5.85%
2020-01-01 00:03:10,1,7,4792,188,4604,7.31%,3.92%
2020-01-01 00:03:10,1,8,3736,104,3632,5.70%,2.78%
2020-01-01 00:03:10,1,9,8038,466,7572,12.27%,5.80%
2020-01-01 00:03:10,1,10,3112,62,3050,4.75%,1.99%
2020-01-01 00:03:10,1,11,3170,67,3103,4.84%,2.11%
2020-01-01 00:03:10,1,12,7888,450,7438,12.04%,5.70%
2020-01-01 00:03:10,2,1,283,1,282,0.43%,0.35%
2020-01-01 00:03:10,2,2,25401,4401,21000,38.76%,17.33%
2020-01-01 00:03:10,2,3,20851,2997,17854,31.82%,14.37%
2020-01-01 00:03:10,2,4,218,1,217,0.33%,0.46%
2020-01-01 00:03:10,2,5,11507,972,10535,17.56%,8.45%
2020-01-01 00:03:10,2,6,25,0,25,0.04%,0.00%
2020-01-01 00:03:10,2,7,4255,153,4102,6.49%,3.60%
2020-01-01 00:03:10,2,8,3437,95,3342,5.24%,2.76%
2020-01-01 00:03:10,2,9,11431,959,10472,17.44%,8.39%
2020-01-01 00:03:10,2,10,2715,45,2670,4.14%,1.66%
2020-01-01 00:03:10,2,11,2726,45,2681,4.16%,1.65%
2020-01-01 00:03:10,2,12,11260,927,10333,17.18%,8.23%
2020-01-01 00:03:10,3,1,1558,21,1537,2.38%,1.35%
2020-01-01 00:03:10,3,2,26866,4835,22031,40.99%,18.00%
2020-01-01 00:03:10,3,3,74876,30332,44544,114.25%,40.51%
2020-01-01 00:03:10,3,4,8645,519,8126,13.19%,6.00%
2020-01-01 00:03:10,3,5,45830,12870,32960,69.93%,28.08%
2020-01-01 00:03:10,3,6,10364,784,9580,15.81%,7.56%
2020-01-01 00:03:10,3,7,23371,3730,19641,35.66%,15.96%
2020-01-01 00:03:10,3,8,18268,2351,15917,27.87%,12.87%
2020-01-01 00:03:10,3,9,35189,7999,27190,53.69%,22.73%
2020-01-01 00:03:10,3,10,5184,205,4979,7.91%,3.95%
2020-01-01 00:03:10,3,11,1948,32,1916,2.97%,1.64%
2020-01-01 00:03:10,3,12,25998,4614,21384,39.67%,17.75%
2020-01-01 00:03:10,4,1,452,0,452,0.69%,0.00%
2020-01-01 00:03:10,4,2,269,0,269,0.41%,0.00%
2020-01-01 00:03:10,4,3,856,5,851,1.31%,0.58%
2020-01-01 00:03:10,4,4,29716,5998,23718,45.34%,20.18%
2020-01-01 00:03:10,4,5,17774,2305,15469,27.12%,12.97%
2020-01-01 00:03:10,4,6,25524,4449,21075,38.95%,17.43%
2020-01-01 00:03:10,4,7,6224,311,5913,9.50%,5.00%
2020-01-01 00:03:10,4,8,2916,60,2856,4.45%,2.06%
2020-01-01 00:03:10,4,9,15596,1821,13775,23.80%,11.68%
2020-01-01 00:03:10,4,10,2239,54,2185,3.42%,2.41%
2020-01-01 00:03:10,4,11,141,0,141,0.22%,0.00%
2020-01-01 00:03:10,4,12,12666,1222,11444,19.33%,9.65%
2020-01-01 00:03:10,5,1,3247,92,3155,4.95%,2.83%
2020-01-01 00:03:10,5,2,1066,10,1056,1.63%,0.94%
2020-01-01 00:03:10,5,3,675,6,669,1.03%,0.89%
2020-01-01 00:03:10,5,4,22762,3440,19322,34.73%,15.11%
2020-01-01 00:03:10,5,5,9553,666,8887,14.58%,6.97%
2020-01-01 00:03:10,5,6,14951,1545,13406,22.81%,10.33%
2020-01-01 00:03:10,5,7,4914,169,4745,7.50%,3.44%
2020-01-01 00:03:10,5,8,3565,86,3479,5.44%,2.41%
2020-01-01 00:03:10,5,9,8745,570,8175,13.34%,6.52%
2020-01-01 00:03:10,5,10,974,8,966,1.49%,0.82%
2020-01-01 00:03:10,5,11,721,5,716,1.10%,0.69%
2020-01-01 00:03:10,5,12,7247,396,6851,11.06%,5.46%
2020-01-01 00:03:10,6,1,1163,9,1154,1.77%,0.77%
2020-01-01 00:03:10,6,2,1214,11,1203,1.85%,0.91%
2020-01-01 00:03:10,6,3,1882,29,1853,2.87%,1.54%
2020-01-01 00:03:10,6,4,1241,9,1232,1.89%,0.73%
2020-01-01 00:03:10,6,5,15136,1593,13543,23.10%,10.52%
2020-01-01 00:03:10,6,6,4023,109,3914,6.14%,2.71%
2020-01-01 00:03:10,6,7,2208,41,2167,3.37%,1.86%
2020-01-01 00:03:10,6,8,1729,27,1702,2.64%,1.56%
2020-01-01 00:03:10,6,9,8917,593,8324,13.61%,6.65%
2020-01-01 00:03:10,6,10,2745,49,2696,4.19%,1.79%
2020-01-01 00:03:10,6,11,539,4,535,0.82%,0.74%
2020-01-01 00:03:10,6,12,6085,289,5796,9.28%,4.75%
2020-01-01 00:03:10,7,1,436,2,434,0.67%,0.46%
2020-01-01 00:03:10,7,2,169,0,169,0.26%,0.00%
2020-01-01 00:03:10,7,3,1340,9,1331,2.04%,0.67%
2020-01-01 00:03:10,7,4,1507,15,1492,2.30%,1.00%
2020-01-01 00:03:10,7,5,9048,610,8438,13.81%,6.74%
2020-01-01 00:03:10,7,6,14465,1507,12958,22.07%,10.42%
2020-01-01 00:03:10,7,7,3860,146,3714,5.89%,3.78%
2020-01-01 00:03:10,7,8,1587,23,1564,2.42%,1.45%
2020-01-01 00:03:10,7,9,7623,431,7192,11.63%,5.65%
2020-01-01 00:03:10,7,10,1419,13,1406,2.17%,0.92%
2020-01-01 00:03:10,7,11,92,1,91,0.14%,1.09%
2020-01-01 00:03:10,7,12,6229,285,5944,9.50%,4.58%
2020-01-01 00:03:10,8,1,446,0,446,0.68%,0.00%
2020-01-01 00:03:10,8,2,103,0,103,0.16%,0.00%
2020-01-01 00:03:10,8,3,1460,22,1438,2.23%,1.51%
2020-01-01 00:03:10,8,4,2737,53,2684,4.18%,1.94%
2020-01-01 00:03:10,8,5,8132,479,7653,12.41%,5.89%
2020-01-01 00:03:10,8,6,16425,1876,14549,25.06%,11.42%
2020-01-01 00:03:10,8,7,5506,217,5289,8.40%,3.94%
2020-01-01 00:03:10,8,8,2096,33,2063,3.20%,1.57%
2020-01-01 00:03:10,8,9,6429,298,6131,9.81%,4.64%
2020-01-01 00:03:10,8,10,1764,20,1744,2.69%,1.13%
2020-01-01 00:03:10,8,11,273,0,273,0.42%,0.00%
2020-01-01 00:03:10,8,12,4647,158,4489,7.09%,3.40%
2020-01-01 00:03:10,9,1,854,0,854,1.30%,0.00%
2020-01-01 00:03:10,9,2,3030,62,2968,4.62%,2.05%
2020-01-01 00:03:10,9,3,1859,28,1831,2.84%,1.51%
2020-01-01 00:03:10,9,4,6177,365,5812,9.43%,5.91%
2020-01-01 00:03:10,9,5,313,1,312,0.48%,0.32%
2020-01-01 00:03:10,9,6,7168,485,6683,10.94%,6.77%
2020-01-01 00:03:10,9,7,30270,6187,24083,46.19%,20.44%
2020-01-01 00:03:10,9,8,12361,1146,11215,18.86%,9.27%
2020-01-01 00:03:10,9,9,242,0,242,0.37%,0.00%
2020-01-01 00:03:10,9,10,4082,150,3932,6.23%,3.67%
2020-01-01 00:03:10,9,11,11012,929,10083,16.80%,8.44%
2020-01-01 00:03:10,9,12,6678,348,6330,10.19%,5.21%
2020-01-01 00:03:10,10,1,1332,194,1138,2.03%,14.56%
2020-01-01 00:03:10,10,2,3128,229,2899,4.77%,7.32%
2020-01-01 00:03:10,10,3,1638,9,1629,2.50%,0.55%
2020-01-01 00:03:10,10,4,4068,799,3269,6.21%,19.64%
2020-01-01 00:03:10,10,5,540,0,540,0.82%,0.00%
2020-01-01 00:03:10,10,6,6182,954,5228,9.43%,15.43%
2020-01-01 00:03:10,10,7,11355,1736,9619,17.33%,15.29%
2020-01-01 00:03:10,10,8,30826,7719,23107,47.04%,25.04%
2020-01-01 00:03:10,10,9,1012,10,1002,1.54%,0.99%
2020-01-01 00:03:10,10,10,3421,79,3342,5.22%,2.31%
2020-01-01 00:03:10,10,11,15403,2121,13282,23.50%,13.77%
2020-01-01 00:03:10,10,12,11072,1345,9727,16.89%,12.15%
2020-01-01 00:03:10,11,1,2794,62,2732,4.26%,2.22%
2020-01-01 00:03:10,11,2,3869,118,3751,5.90%,3.05%
2020-01-01 00:03:10,11,3,871,7,864,1.33%,0.80%
2020-01-01 00:03:10,11,4,4911,213,4698,7.49%,4.34%
2020-01-01 00:03:10,11,5,170,0,170,0.26%,0.00%
2020-01-01 00:03:10,11,6,5716,270,5446,8.72%,4.72%
2020-01-01 00:03:10,11,7,11524,919,10605,17.58%,7.97%
2020-01-01 00:03:10,11,8,24633,4028,20605,37.59%,16.35%
2020-01-01 00:03:10,11,9,192,0,192,0.29%,0.00%
2020-01-01 00:03:10,11,10,2845,51,2794,4.34%,1.79%
2020-01-01 00:03:10,11,11,9563,718,8845,14.59%,7.51%
2020-01-01 00:03:10,11,12,6352,329,6023,9.69%,5.18%
2020-01-01 00:03:10,12,1,50,0,50,0.08%,0.00%
2020-01-01 00:03:10,12,2,574,221,353,0.88%,38.50%
2020-01-01 00:03:10,12,3,2591,286,2305,3.95%,11.04%
2020-01-01 00:03:10,12,4,2805,63,2742,4.28%,2.25%
2020-01-01 00:03:10,12,5,8861,796,8065,13.52%,8.98%
2020-01-01 00:03:10,12,6,5362,197,5165,8.18%,3.67%
2020-01-01 00:03:10,12,7,2412,23,2389,3.68%,0.95%
2020-01-01 00:03:10,12,8,1287,218,1069,1.96%,16.94%
2020-01-01 00:03:10,12,9,21455,4173,17282,32.74%,19.45%
2020-01-01 00:03:10,12,10,3722,314,3408,5.68%,8.44%
2020-01-01 00:03:10,12,11,1526,225,1301,2.33%,14.74%
2020-01-01 00:03:10,12,12,7769,1112,6657,11.85%,14.31%
2020-01-01 00:03:10,13,1,2237,38,2199,3.41%,1.70%
2020-01-01 00:03:10,13,2,2554,54,2500,3.90%,2.11%
2020-01-01 00:03:10,13,3,837,6,831,1.28%,0.72%
2020-01-01 00:03:10,13,4,4775,421,4354,7.29%,8.82%
2020-01-01 00:03:10,13,5,7048,680,6368,10.75%,9.65%
2020-01-01 00:03:10,13,6,5392,463,4929,8.23%,8.59%
2020-01-01 00:03:10,13,7,5093,209,4884,7.77%,4.10%
2020-01-01 00:03:10,13,8,7412,428,6984,11.31%,5.77%
2020-01-01 00:03:10,13,9,7394,708,6686,11.28%,9.58%
2020-01-01 00:03:10,13,10,26456,5236,21220,40.37%,19.79%
2020-01-01 00:03:10,13,11,16698,2325,14373,25.48%,13.92%
2020-01-01 00:03:10,13,12,8747,907,7840,13.35%,10.37%
2020-01-01 00:03:10,14,1,321,0,321,0.49%,0.00%
2020-01-01 00:03:10,14,2,1484,16,1468,2.26%,1.08%
2020-01-01 00:03:10,14,3,954,8,946,1.46%,0.84%
2020-01-01 00:03:10,14,4,5056,185,4871,7.71%,3.66%
2020-01-01 00:03:10,14,5,1654,22,1632,2.52%,1.33%
2020-01-01 00:03:10,14,6,5443,212,5231,8.31%,3.89%
2020-01-01 00:03:10,14,7,13314,1312,12002,20.32%,9.85%
2020-01-01 00:03:10,14,8,15169,1688,13481,23.15%,11.13%
2020-01-01 00:03:10,14,9,1861,29,1832,2.84%,1.56%
2020-01-01 00:03:10,14,10,4422,175,4247,6.75%,3.96%
2020-01-01 00:03:10,14,11,27898,5162,22736,42.57%,18.50%
2020-01-01 00:03:10,14,12,8108,467,7641,12.37%,5.76%
2020-01-01 00:03:10,15,1,542,2,540,0.83%,0.37%
2020-01-01 00:03:10,15,2,225,0,225,0.34%,0.00%
2020-01-01 00:03:10,15,3,3881,113,3768,5.92%,2.91%
2020-01-01 00:03:10,15,4,6935,359,6576,10.58%,5.18%
2020-01-01 00:03:10,15,5,12004,1033,10971,18.32%,8.61%
2020-01-01 00:03:10,15,6,7168,380,6788,10.94%,5.30%
2020-01-01 00:03:10,15,7,3829,109,3720,5.84%,2.85%
2020-01-01 00:03:10,15,8,5743,265,5478,8.76%,4.61%
2020-01-01 00:03:10,15,9,12260,1071,11189,18.71%,8.74%
2020-01-01 00:03:10,15,10,4765,170,4595,7.27%,3.57%
2020-01-01 00:03:10,15,11,10654,823,9831,16.26%,7.72%
2020-01-01 00:03:10,15,12,28992,5792,23200,44.24%,19.98%
2020-01-01 00:03:10,16,1,499,3,496,0.76%,0.60%
2020-01-01 00:03:10,16,2,263,0,263,0.40%,0.00%
2020-01-01 00:03:10,16,3,1145,10,1135,1.75%,0.87%
2020-01-01 00:03:10,16,4,5227,176,5051,7.98%,3.37%
2020-01-01 00:03:10,16,5,8451,529,7922,12.90%,6.26%
2020-01-01 00:03:10,16,6,6061,239,5822,9.25%,3.94%
2020-01-01 00:03:10,16,7,3447,102,3345,5.26%,2.96%
2020-01-01 00:03:10,16,8,8575,557,8018,13.08%,6.50%
2020-01-01 00:03:10,16,9,8825,566,8259,13.47%,6.41%
2020-01-01 00:03:10,16,10,1663,19,1644,2.54%,1.14%
2020-01-01 00:03:10,16,11,10399,814,9585,15.87%,7.83%
2020-01-01 00:03:10,16,12,26707,4803,21904,40.75%,17.98%
2020-01-01 00:03:20,1,1,20815,2981,17834,31.76%,14.32%
2020-01-01 00:03:20,1,2,7418,386,7032,11.32%,5.20%
2020-01-01 00:03:20,1,3,745,2,743,1.14%,0.27%
2020-01-01 00:03:20,1,4,13094,1272,11822,19.98%,9.71%
2020-01-01 00:03:20,1,5,12792,1222,11570,19.52%,9.55%
2020-01-01 00:03:20,1,6,12743,1218,11525,19.44%,9.56%
2020-01-01 00:03:20,1,7,6650,324,6326,10.15%,4.87%
2020-01-01 00:03:20,1,8,4770,181,4589,7.28%,3.79%
2020-01-01 00:03:20,1,9,12684,1207,11477,19.35%,9.52%
2020-01-01 00:03:20,1,10,3917,125,3792,5.98%,3.19%
2020-01-01 00:03:20,1,11,4001,134,3867,6.11%,3.35%
2020-01-01 00:03:20,1,12,12649,1199,11450,19.30%,9.48%
2020-01-01 00:03:20,2,1,884,2,882,1.35%,0.23%
2020-01-01 00:03:20,2,2,26230,4630,21600,40.02%,17.65%
2020-01-01 00:03:20,2,3,21051,3086,17965,32.12%,14.66%
2020-01-01 00:03:20,2,4,752,1,751,1.15%,0.13%
2020-01-01 00:03:20,2,5,11973,1010,10963,18.27%,8.44%
2020-01-01 00:03:20,2,6,27,0,27,0.04%,0.00%
2020-01-01 00:03:20,2,7,4278,127,4151,6.53%,2.97%
2020-01-01 00:03:20,2,8,3251,80,3171,4.96%,2.46%
2020-01-01 00:03:20,2,9,11914,1003,10911,18.18%,8.42%
2020-01-01 00:03:20,2,10,2494,45,2449,3.81%,1.80%
2020-01-01 00:03:20,2,11,2503,45,2458,3.82%,1.80%
2020-01-01 00:03:20,2,12,11729,984,10745,17.90%,8.39%
2020-01-01 00:03:20,3,1,1525,16,1509,2.33%,1.05%
2020-01-01 00:03:20,3,2,23895,3882,20013,36.46%,16.25%
2020-01-01 00:03:20,3,3,68937,26195,42742,105.19%,38.00%
2020-01-01 00:03:20,3,4,6057,248,5809,9.24%,4.09%
2020-01-01 00:03:20,3,5,43680,11609,32071,66.65%,26.58%
2020-01-01 00:03:20,3,6,7472,399,7073,11.40%,5.34%
2020-01-01 00:03:20,3,7,20309,2851,17458,30.99%,14.04%
2020-01-01 00:03:20,3,8,15311,1605,13706,23.36%,10.48%
2020-01-01 00:03:20,3,9,35876,8046,27830,54.74%,22.43%
2020-01-01 00:03:20,3,10,9649,679,8970,14.72%,7.04%
2020-01-01 00:03:20,3,11,1639,17,1622,2.50%,1.04%
2020-01-01 00:03:20,3,12,22791,3472,19319,34.78%,15.23%
2020-01-01 00:03:20,4,1,530,3,527,0.81%,0.57%
2020-01-01 00:03:20,4,2,330,2,328,0.50%,0.61%
2020-01-01 00:03:20,4,3,950,4,946,1.45%,0.42%
2020-01-01 00:03:20,4,4,29903,5941,23962,45.63%,19.87%
2020-01-01 00:03:20,4,5,18424,2370,16054,28.11%,12.86%
2020-01-01 00:03:20,4,6,25858,4519,21339,39.46%,17.48%
2020-01-01 00:03:20,4,7,5791,242,5549,8.84%,4.18%
2020-01-01 00:03:20,4,8,2972,56,2916,4.53%,1.88%
2020-01-01 00:03:20,4,9,16127,1842,14285,24.61%,11.42%
2020-01-01 00:03:20,4,10,2192,31,2161,3.34%,1.41%
2020-01-01 00:03:20,4,11,192,1,191,0.29%,0.52%
2020-01-01 00:03:20,4,12,13173,1283,11890,20.10%,9.74%
2020-01-01 00:03:20,5,1,2858,51,2807,4.36%,1.78%
2020-01-01 00:03:20,5,2,864,4,860,1.32%,0.46%
2020-01-01 00:03:20,5,3,711,1,710,1.08%,0.14%
2020-01-01 00:03:20,5,4,24454,4026,20428,37.31%,16.46%
2020-01-01 00:03:20,5,5,9254,615,8639,14.12%,6.65%
2020-01-01 00:03:20,5,6,15287,1639,13648,23.33%,10.72%
2020-01-01 00:03:20,5,7,5467,238,5229,8.34%,4.35%
2020-01-01 00:03:20,5,8,4179,153,4026,6.38%,3.66%
2020-01-01 00:03:20,5,9,8377,508,7869,12.78%,6.06%
2020-01-01 00:03:20,5,10,817,7,810,1.25%,0.86%
2020-01-01 00:03:20,5,11,794,8,786,1.21%,1.01%
2020-01-01 00:03:20,5,12,6970,350,6620,10.64%,5.02%
2020-01-01 00:03:20,6,1,1026,6,1020,1.57%,0.58%
2020-01-01 00:03:20,6,2,1169,6,1163,1.78%,0.51%
2020-01-01 00:03:20,6,3,1917,30,1887,2.93%,1.56%
2020-01-01 00:03:20,6,4,1440,30,1410,2.20%,2.08%
2020-01-01 00:03:20,6,5,15471,1747,13724,23.61%,11.29%
2020-01-01 00:03:20,6,6,4336,156,4180,6.62%,3.60%
2020-01-01 00:03:20,6,7,2350,41,2309,3.59%,1.74%
2020-01-01 00:03:20,6,8,1750,27,1723,2.67%,1.54%
2020-01-01 00:03:20,6,9,8804,585,8219,13.43%,6.64%
2020-01-01 00:03:20,6,10,1929,30,1899,2.94%,1.56%
2020-01-01 00:03:20,6,11,435,1,434,0.66%,0.23%
2020-01-01 00:03:20,6,12,6812,344,6468,10.39%,5.05%
2020-01-01 00:03:20,7,1,400,1,399,0.61%,0.25%
2020-01-01 00:03:20,7,2,186,0,186,0.28%,0.00%
2020-01-01 00:03:20,7,3,766,7,759,1.17%,0.91%
2020-01-01 00:03:20,7,4,1405,17,1388,2.14%,1.21%
2020-01-01 00:03:20,7,5,7031,364,6667,10.73%,5.18%
2020-01-01 00:03:20,7,6,12445,1120,11325,18.99%,9.00%
2020-01-01 00:03:20,7,7,3964,133,3831,6.05%,3.36%
2020-01-01 00:03:20,7,8,1660,23,1637,2.53%,1.39%
2020-01-01 00:03:20,7,9,6125,272,5853,9.35%,4.44%
2020-01-01 00:03:20,7,10,1126,10,1116,1.72%,0.89%
2020-01-01 00:03:20,7,11,114,0,114,0.17%,0.00%
2020-01-01 00:03:20,7,12,5049,198,4851,7.70%,3.92%
2020-01-01 00:03:20,8,1,410,2,408,0.63%,0.49%
2020-01-01 00:03:20,8,2,98,0,98,0.15%,0.00%
2020-01-01 00:03:20,8,3,1455,10,1445,2.22%,0.69%
2020-01-01 00:03:20,8,4,2536,56,2480,3.87%,2.21%
2020-01-01 00:03:20,8,5,8314,499,7815,12.69%,6.00%
2020-01-01 00:03:20,8,6,16683,1969,14714,25.46%,11.80%
2020-01-01 00:03:20,8,7,5783,275,5508,8.82%,4.76%
2020-01-01 00:03:20,8,8,2028,42,1986,3.09%,2.07%
2020-01-01 00:03:20,8,9,6568,332,6236,10.02%,5.05%
2020-01-01 00:03:20,8,10,1747,29,1718,2.67%,1.66%
2020-01-01 00:03:20,8,11,202,0,202,0.31%,0.00%
2020-01-01 00:03:20,8,12,4779,183,4596,7.29%,3.83%
2020-01-01 00:03:20,9,1,1923,74,1849,2.93%,3.85%
2020-01-01 00:03:20,9,2,3631,131,3500,5.54%,3.61%
2020-01-01 00:03:20,9,3,1304,7,1297,1.99%,0.54%
2020-01-01 00:03:20,9,4,4168,119,4049,6.36%,2.86%
2020-01-01 00:03:20,9,5,455,0,455,0.69%,0.00%
2020-01-01 00:03:20,9,6,5237,191,5046,7.99%,3.65%
2020-01-01 00:03:20,9,7,25899,4402,21497,39.52%,17.00%
2020-01-01 00:03:20,9,8,9809,656,9153,14.97%,6.69%
2020-01-01 00:03:20,9,9,332,0,332,0.51%,0.00%
2020-01-01 00:03:20,9,10,2313,40,2273,3.53%,1.73%
2020-01-01 00:03:20,9,11,8501,484,8017,12.97%,5.69%
2020-01-01 00:03:20,9,12,5806,237,5569,8.86%,4.08%
2020-01-01 00:03:20,10,1,1431,282,1149,2.18%,19.71%
2020-01-01 00:03:20,10,2,3058,341,2717,4.67%,11.15%
2020-01-01 00:03:20,10,3,1430,12,1418,2.18%,0.84%
2020-01-01 00:03:20,10,4,4781,935,3846,7.30%,19.56%
2020-01-01 00:03:20,10,5,727,20,707,1.11%,2.75%
2020-01-01 00:03:20,10,6,6819,1085,5734,10.40%,15.91%
2020-01-01 00:03:20,10,7,12258,2037,10221,18.70%,16.62%
2020-01-01 00:03:20,10,8,30204,7683,22521,46.09%,25.44%
2020-01-01 00:03:20,10,9,856,12,844,1.31%,1.40%
2020-01-01 00:03:20,10,10,2440,50,2390,3.72%,2.05%
2020-01-01 00:03:20,10,11,13573,1833,11740,20.71%,13.50%
2020-01-01 00:03:20,10,12,10511,1367,9144,16.04%,13.01%
2020-01-01 00:03:20,11,1,2361,35,2326,3.60%,1.48%
2020-01-01 00:03:20,11,2,3612,98,3514,5.51%,2.71%
2020-01-01 00:03:20,11,3,1066,12,1054,1.63%,1.13%
2020-01-01 00:03:20,11,4,8413,515,7898,12.84%,6.12%
2020-01-01 00:03:20,11,5,191,2,189,0.29%,1.05%
2020-01-01 00:03:20,11,6,9274,618,8656,14.15%,6.66%
2020-01-01 00:03:20,11,7,14760,1555,13205,22.52%,10.54%
2020-01-01 00:03:20,11,8,29863,5888,23975,45.57%,19.72%
2020-01-01 00:03:20,11,9,148,0,148,0.23%,0.00%
2020-01-01 00:03:20,11,10,4289,129,4160,6.54%,3.01%
2020-01-01 00:03:20,11,11,11439,935,10504,17.45%,8.17%
2020-01-01 00:03:20,11,12,6867,374,6493,10.48%,5.45%
2020-01-01 00:03:20,12,1,45,0,45,0.07%,0.00%
2020-01-01 00:03:20,12,2,615,205,410,0.94%,33.33%
2020-01-01 00:03:20,12,3,2803,270,2533,4.28%,9.63%
2020-01-01 00:03:20,12,4,2988,58,2930,4.56%,1.94%
2020-01-01 00:03:20,12,5,8739,705,8034,13.33%,8.07%
2020-01-01 00:03:20,12,6,5106,170,4936,7.79%,3.33%
2020-01-01 00:03:20,12,7,1973,26,1947,3.01%,1.32%
2020-01-01 00:03:20,12,8,1291,261,1030,1.97%,20.22%
2020-01-01 00:03:20,12,9,21187,4006,17181,32.33%,18.91%
2020-01-01 00:03:20,12,10,3975,356,3619,6.07%,8.96%
2020-01-01 00:03:20,12,11,1717,265,1452,2.62%,15.43%
2020-01-01 00:03:20,12,12,7261,1059,6202,11.08%,14.58%
2020-01-01 00:03:20,13,1,2780,49,2731,4.24%,1.76%
2020-01-01 00:03:20,13,2,3136,62,3074,4.79%,1.98%
2020-01-01 00:03:20,13,3,580,0,580,0.89%,0.00%
2020-01-01 00:03:20,13,4,5108,501,4607,7.79%,9.81%
2020-01-01 00:03:20,13,5,7565,798,6767,11.54%,10.55%
2020-01-01 00:03:20,13,6,5807,548,5259,8.86%,9.44%
2020-01-01 00:03:20,13,7,5737,237,5500,8.75%,4.13%
2020-01-01 00:03:20,13,8,7881,456,7425,12.03%,5.79%
2020-01-01 00:03:20,13,9,7862,828,7034,12.00%,10.53%
2020-01-01 00:03:20,13,10,27011,5408,21603,41.22%,20.02%
2020-01-01 00:03:20,13,11,16785,2331,14454,25.61%,13.89%
2020-01-01 00:03:20,13,12,8387,856,7531,12.80%,10.21%
2020-01-01 00:03:20,14,1,420,1,419,0.64%,0.24%
2020-01-01 00:03:20,14,2,1681,20,1661,2.57%,1.19%
2020-01-01 00:03:20,14,3,1070,7,1063,1.63%,0.65%
2020-01-01 00:03:20,14,4,4770,195,4575,7.28%,4.09%
2020-01-01 00:03:20,14,5,1542,17,1525,2.35%,1.10%
2020-01-01 00:03:20,14,6,5233,233,5000,7.98%,4.45%
2020-01-01 00:03:20,14,7,13084,1220,11864,19.96%,9.32%
2020-01-01 00:03:20,14,8,14702,1525,13177,22.43%,10.37%
2020-01-01 00:03:20,14,9,1779,27,1752,2.71%,1.52%
2020-01-01 00:03:20,14,10,4753,162,4591,7.25%,3.41%
2020-01-01 00:03:20,14,11,27793,5016,22777,42.41%,18.05%
2020-01-01 00:03:20,14,12,8063,438,7625,12.30%,5.43%
2020-01-01 00:03:20,15,1,552,1,551,0.84%,0.18%
2020-01-01 00:03:20,15,2,201,1,200,0.31%,0.50%
2020-01-01 00:03:20,15,3,3871,101,3770,5.91%,2.61%
2020-01-01 00:03:20,15,4,5275,239,5036,8.05%,4.53%
2020-01-01 00:03:20,15,5,10180,775,9405,15.53%,7.61%
2020-01-01 00:03:20,15,6,5600,283,5317,8.54%,5.05%
2020-01-01 00:03:20,15,7,3524,94,3430,5.38%,2.67%
2020-01-01 00:03:20,15,8,6224,297,5927,9.50%,4.77%
2020-01-01 00:03:20,15,9,10506,813,9693,16.03%,7.74%
2020-01-01 00:03:20,15,10,4153,156,3997,6.34%,3.76%
2020-01-01 00:03:20,15,11,10517,849,9668,16.05%,8.07%
2020-01-01 00:03:20,15,12,26859,5174,21685,40.98%,19.26%
2020-01-01 00:03:20,16,1,599,6,593,0.91%,1.00%
2020-01-01 00:03:20,16,2,222,0,222,0.34%,0.00%
2020-01-01 00:03:20,16,3,934,8,926,1.43%,0.86%
2020-01-01 00:03:20,16,4,4412,167,4245,6.73%,3.79%
2020-01-01 00:03:20,16,5,7499,511,6988,11.44%,6.81%
2020-01-01 00:03:20,16,6,5287,238,5049,8.07%,4.50%
2020-01-01 00:03:20,16,7,3603,89,3514,5.50%,2.47%
2020-01-01 00:03:20,16,8,8000,540,7460,12.21%,6.75%
2020-01-01 00:03:20,16,9,7939,559,7380,12.11%,7.04%
2020-01-01 00:03:20,16,10,1813,21,1792,2.77%,1.16%
2020-01-01 00:03:20,16,11,9996,782,9214,15.25%,7.82%
2020-01-01 00:03:20,16,12,26115,4872,21243,39.85%,18.66%
2020-01-01 00:03:30,1,1,18734,2533,16201,28.59%,13.52%
2020-01-01 00:03:30,1,2,6376,305,6071,9.73%,4.78%
2020-01-01 00:03:30,1,3,431,1,430,0.66%,0.23%
2020-01-01 00:03:30,1,4,11988,1066,10922,18.29%,8.89%
2020-01-01 00:03:30,1,5,11718,1027,10691,17.88%,8.76%
2020-01-01 00:03:30,1,6,11631,1012,10619,17.75%,8.70%
2020-01-01 00:03:30,1,7,5934,269,5665,9.05%,4.53%
2020-01-01 00:03:30,1,8,4809,179,4630,7.34%,3.72%
2020-01-01 00:03:30,1,9,11611,1010,10601,17.72%,8.70%
2020-01-01 00:03:30,1,10,4110,133,3977,6.27%,3.24%
2020-01-01 00:03:30,1,11,4206,139,4067,6.42%,3.30%
2020-01-01 00:03:30,1,12,11582,1006,10576,17.67%,8.69%
2020-01-01 00:03:30,2,1,1213,16,1197,1.85%,1.32%
2020-01-01 00:03:30,2,2,26612,4809,21803,40.61%,18.07%
2020-01-01 00:03:30,2,3,20684,3022,17662,31.56%,14.61%
2020-01-01 00:03:30,2,4,1103,14,1089,1.68%,1.27%
2020-01-01 00:03:30,2,5,12160,1110,11050,18.55%,9.13%
2020-01-01 00:03:30,2,6,42,0,42,0.06%,0.00%
2020-01-01 00:03:30,2,7,4692,160,4532,7.16%,3.41%
2020-01-01 00:03:30,2,8,3407,85,3322,5.20%,2.49%
2020-01-01 00:03:30,2,9,12112,1098,11014,18.48%,9.07%
2020-01-01 00:03:30,2,10,2784,48,2736,4.25%,1.72%
2020-01-01 00:03:30,2,11,2797,48,2749,4.27%,1.72%
2020-01-01 00:03:30,2,12,11964,1075,10889,18.26%,8.99%
2020-01-01 00:03:30,3,1,1690,24,1666,2.58%,1.42%
2020-01-01 00:03:30,3,2,22176,3376,18800,33.84%,15.22%
2020-01-01 00:03:30,3,3,81173,34530,46643,123.86%,42.54%
2020-01-01 00:03:30,3,4,11326,846,10480,17.28%,7.47%
2020-01-01 00:03:30,3,5,57112,18974,38138,87.15%,33.22%
2020-01-01 00:03:30,3,6,12211,984,11227,18.63%,8.06%
2020-01-01 00:03:30,3,7,18648,2437,16211,28.45%,13.07%
2020-01-01 00:03:30,3,8,15388,1692,13696,23.48%,11.00%
2020-01-01 00:03:30,3,9,44585,12224,32361,68.03%,27.42%
2020-01-01 00:03:30,3,10,13895,1457,12438,21.20%,10.49%
2020-01-01 00:03:30,3,11,1695,19,1676,2.59%,1.12%
2020-01-01 00:03:30,3,12,26224,4528,21696,40.01%,17.27%
2020-01-01 00:03:30,4,1,568,1,567,0.87%,0.18%
2020-01-01 00:03:30,4,2,389,0,389,0.59%,0.00%
2020-01-01 00:03:30,4,3,923,6,917,1.41%,0.65%
2020-01-01 00:03:30,4,4,27886,5153,22733,42.55%,18.48%
2020-01-01 00:03:30,4,5,17031,2065,14966,25.99%,12.12%
2020-01-01 00:03:30,4,6,23481,3732,19749,35.83%,15.89%
2020-01-01 00:03:30,4,7,5063,191,4872,7.73%,3.77%
2020-01-01 00:03:30,4,8,2792,61,2731,4.26%,2.18%
2020-01-01 00:03:30,4,9,14874,1573,13301,22.70%,10.58%
2020-01-01 00:03:30,4,10,1939,37,1902,2.96%,1.91%
2020-01-01 00:03:30,4,11,231,0,231,0.35%,0.00%
2020-01-01 00:03:30,4,12,12153,1083,11070,18.54%,8.91%
2020-01-01 00:03:30,5,1,2765,65,2700,4.22%,2.35%
2020-01-01 00:03:30,5,2,1143,6,1137,1.74%,0.52%
2020-01-01 00:03:30,5,3,1072,9,1063,1.64%,0.84%
2020-01-01 00:03:30,5,4,24011,3931,20080,36.64%,16.37%
2020-01-01 00:03:30,5,5,10153,729,9424,15.49%,7.18%
2020-01-01 00:03:30,5,6,16930,1963,14967,25.83%,11.59%
2020-01-01 00:03:30,5,7,6419,315,6104,9.79%,4.91%
2020-01-01 00:03:30,5,8,3271,92,3179,4.99%,2.81%
2020-01-01 00:03:30,5,9,8934,550,8384,13.63%,6.16%
2020-01-01 00:03:30,5,10,1108,6,1102,1.69%,0.54%
2020-01-01 00:03:30,5,11,381,0,381,0.58%,0.00%
2020-01-01 00:03:30,5,12,7719,413,7306,11.78%,5.35%
2020-01-01 00:03:30,6,1,1033,9,1024,1.58%,0.87%
2020-01-01 00:03:30,6,2,1170,13,1157,1.79%,1.11%
2020-01-01 00:03:30,6,3,1706,21,1685,2.60%,1.23%
2020-01-01 00:03:30,6,4,902,6,896,1.38%,0.67%
2020-01-01 00:03:30,6,5,11999,1100,10899,18.31%,9.17%
2020-01-01 00:03:30,6,6,4133,146,3987,6.31%,3.53%
2020-01-01 00:03:30,6,7,2811,75,2736,4.29%,2.67%
2020-01-01 00:03:30,6,8,2013,56,1957,3.07%,2.78%
2020-01-01 00:03:30,6,9,5920,284,5636,9.03%,4.80%
2020-01-01 00:03:30,6,10,1677,23,1654,2.56%,1.37%
2020-01-01 00:03:30,6,11,329,1,328,0.50%,0.30%
2020-01-01 00:03:30,6,12,4201,155,4046,6.41%,3.69%
2020-01-01 00:03:30,7,1,480,10,470,0.73%,2.08%
2020-01-01 00:03:30,7,2,180,0,180,0.27%,0.00%
2020-01-01 00:03:30,7,3,916,2,914,1.40%,0.22%
2020-01-01 00:03:30,7,4,2271,47,2224,3.47%,2.07%
2020-01-01 00:03:30,7,5,7712,403,7309,11.77%,5.23%
2020-01-01 00:03:30,7,6,13320,1300,12020,20.32%,9.76%
2020-01-01 00:03:30,7,7,3302,112,3190,5.04%,3.39%
2020-01-01 00:03:30,7,8,1610,18,1592,2.46%,1.12%
2020-01-01 00:03:30,7,9,6516,306,6210,9.94%,4.70%
2020-01-01 00:03:30,7,10,1407,21,1386,2.15%,1.49%
2020-01-01 00:03:30,7,11,82,0,82,0.13%,0.00%
2020-01-01 00:03:30,7,12,5163,199,4964,7.88%,3.85%
2020-01-01 00:03:30,8,1,406,0,406,0.62%,0.00%
2020-01-01 00:03:30,8,2,95,0,95,0.14%,0.00%
2020-01-01 00:03:30,8,3,1728,21,1707,2.64%,1.22%
2020-01-01 00:03:30,8,4,2917,53,2864,4.45%,1.82%
2020-01-01 00:03:30,8,5,8634,533,8101,13.17%,6.17%
2020-01-01 00:03:30,8,6,16655,1985,14670,25.41%,11.92%
2020-01-01 00:03:30,8,7,4935,189,4746,7.53%,3.83%
2020-01-01 00:03:30,8,8,2097,35,2062,3.20%,1.67%
2020-01-01 00:03:30,8,9,6676,300,6376,10.19%,4.49%
2020-01-01 00:03:30,8,10,1676,14,1662,2.56%,0.84%
2020-01-01 00:03:30,8,11,161,0,161,0.25%,0.00%
2020-01-01 00:03:30,8,12,4949,158,4791,7.55%,3.19%
2020-01-01 00:03:30,9,1,323,0,323,0.49%,0.00%
2020-01-01 00:03:30,9,2,2390,42,2348,3.65%,1.76%
2020-01-01 00:03:30,9,3,1680,23,1657,2.56%,1.37%
2020-01-01 00:03:30,9,4,7077,360,6717,10.80%,5.09%
2020-01-01 00:03:30,9,5,502,1,501,0.77%,0.20%
2020-01-01 00:03:30,9,6,8275,497,7778,12.63%,6.01%
2020-01-01 00:03:30,9,7,25335,4352,20983,38.66%,17.18%
2020-01-01 00:03:30,9,8,8216,494,7722,12.54%,6.01%
2020-01-01 00:03:30,9,9,332,0,332,0.51%,0.00%
2020-01-01 00:03:30,9,10,2187,25,2162,3.34%,1.14%
2020-01-01 00:03:30,9,11,7028,377,6651,10.72%,5.36%
2020-01-01 00:03:30,9,12,4642,172,4470,7.08%,3.71%
2020-01-01 00:03:30,10,1,1203,328,875,1.84%,27.27%
2020-01-01 00:03:30,10,2,3606,400,3206,5.50%,11.09%
2020-01-01 00:03:30,10,3,2269,36,2233,3.46%,1.59%
2020-01-01 00:03:30,10,4,4620,1063,3557,7.05%,23.01%
2020-01-01 00:03:30,10,5,978,70,908,1.49%,7.16%
2020-01-01 00:03:30,10,6,6474,1245,5229,9.88%,19.23%
2020-01-01 00:03:30,10,7,12213,2226,9987,18.64%,18.23%
2020-01-01 00:03:30,10,8,29977,7846,22131,45.74%,26.17%
2020-01-01 00:03:30,10,9,828,6,822,1.26%,0.72%
2020-01-01 00:03:30,10,10,2470,60,2410,3.77%,2.43%
2020-01-01 00:03:30,10,11,13696,1871,11825,20.90%,13.66%
2020-01-01 00:03:30,10,12,10562,1403,9159,16.12%,13.28%
2020-01-01 00:03:30,11,1,2230,44,2186,3.40%,1.97%
2020-01-01 00:03:30,11,2,3030,73,2957,4.62%,2.41%
2020-01-01 00:03:30,11,3,599,5,594,0.91%,0.83%
2020-01-01 00:03:30,11,4,3441,77,3364,5.25%,2.24%
2020-01-01 00:03:30,11,5,199,1,198,0.30%,0.50%
2020-01-01 00:03:30,11,6,4318,138,4180,6.59%,3.20%
2020-01-01 00:03:30,11,7,9178,607,8571,14.00%,6.61%
2020-01-01 00:03:30,11,8,23196,3630,19566,35.39%,15.65%
2020-01-01 00:03:30,11,9,210,1,209,0.32%,0.48%
2020-01-01 00:03:30,11,10,2878,48,2830,4.39%,1.67%
2020-01-01 00:03:30,11,11,9902,711,9191,15.11%,7.18%
2020-01-01 00:03:30,11,12,6661,349,6312,10.16%,5.24%
2020-01-01 00:03:30,12,1,48,0,48,0.07%,0.00%
2020-01-01 00:03:30,12,2,529,161,368,0.81%,30.43%
2020-01-01 00:03:30,12,3,3056,211,2845,4.66%,6.90%
2020-01-01 00:03:30,12,4,2998,76,2922,4.57%,2.54%
2020-01-01 00:03:30,12,5,8691,664,8027,13.26%,7.64%
2020-01-01 00:03:30,12,6,4881,175,4706,7.45%,3.59%
2020-01-01 00:03:30,12,7,1676,13,1663,2.56%,0.78%
2020-01-01 00:03:30,12,8,1282,263,1019,1.96%,20.51%
2020-01-01 00:03:30,12,9,21822,4011,17811,33.30%,18.38%
2020-01-01 00:03:30,12,10,4447,395,4052,6.79%,8.88%
2020-01-01 00:03:30,12,11,1511,270,1241,2.31%,17.87%
2020-01-01 00:03:30,12,12,7309,951,6358,11.15%,13.01%
2020-01-01 00:03:30,13,1,1790,32,1758,2.73%,1.79%
2020-01-01 00:03:30,13,2,2102,43,2059,3.21%,2.05%
2020-01-01 00:03:30,13,3,468,2,466,0.71%,0.43%
2020-01-01 00:03:30,13,4,4124,605,3519,6.29%,14.67%
2020-01-01 00:03:30,13,5,6101,797,5304,9.31%,13.06%
2020-01-01 00:03:30,13,6,4784,642,4142,7.30%,13.42%
2020-01-01 00:03:30,13,7,4465,151,4314,6.81%,3.38%
2020-01-01 00:03:30,13,8,7273,376,6897,11.10%,5.17%
2020-01-01 00:03:30,13,9,6420,818,5602,9.80%,12.74%
2020-01-01 00:03:30,13,10,26264,5308,20956,40.08%,20.21%
2020-01-01 00:03:30,13,11,17427,2487,14940,26.59%,14.27%
2020-01-01 00:03:30,13,12,9681,1060,8621,14.77%,10.95%
2020-01-01 00:03:30,14,1,282,0,282,0.43%,0.00%
2020-01-01 00:03:30,14,2,1126,15,1111,1.72%,1.33%
2020-01-01 00:03:30,14,3,628,10,618,0.96%,1.59%
2020-01-01 00:03:30,14,4,3686,102,3584,5.62%,2.77%
2020-01-01 00:03:30,14,5,1474,15,1459,2.25%,1.02%
2020-01-01 00:03:30,14,6,3946,118,3828,6.02%,2.99%
2020-01-01 00:03:30,14,7,11091,893,10198,16.92%,8.05%
2020-01-01 00:03:30,14,8,12574,1152,11422,19.19%,9.16%
2020-01-01 00:03:30,14,9,1875,30,1845,2.86%,1.60%
2020-01-01 00:03:30,14,10,4255,128,4127,6.49%,3.01%
2020-01-01 00:03:30,14,11,25191,4313,20878,38.44%,17.12%
2020-01-01 00:03:30,14,12,8030,448,7582,12.25%,5.58%
2020-01-01 00:03:30,15,1,557,3,554,0.85%,0.54%
2020-01-01 00:03:30,15,2,168,0,168,0.26%,0.00%
2020-01-01 00:03:30,15,3,6869,355,6514,10.48%,5.17%
2020-01-01 00:03:30,15,4,5601,268,5333,8.55%,4.78%
2020-01-01 00:03:30,15,5,13877,1389,12488,21.17%,10.01%
2020-01-01 00:03:30,15,6,5892,321,5571,8.99%,5.45%
2020-01-01 00:03:30,15,7,3404,86,3318,5.19%,2.53%
2020-01-01 00:03:30,15,8,5571,230,5341,8.50%,4.13%
2020-01-01 00:03:30,15,9,14038,1422,12616,21.42%,10.13%
2020-01-01 00:03:30,15,10,4649,254,4395,7.09%,5.46%
2020-01-01 00:03:30,15,11,10384,848,9536,15.84%,8.17%
2020-01-01 00:03:30,15,12,32246,7121,25125,49.20%,22.08%
2020-01-01 00:03:30,16,1,435,1,434,0.66%,0.23%
2020-01-01 00:03:30,16,2,283,0,283,0.43%,0.00%
2020-01-01 00:03:30,16,3,1353,13,1340,2.06%,0.96%
2020-01-01 00:03:30,16,4,4645,198,4447,7.09%,4.26%
2020-01-01 00:03:30,16,5,8186,557,7629,12.49%,6.80%
2020-01-01 00:03:30,16,6,5406,249,5157,8.25%,4.61%
2020-01-01 00:03:30,16,7,3541,78,3463,5.40%,2.20%
2020-01-01 00:03:30,16,8,7498,445,7053,11.44%,5.93%
2020-01-01 00:03:30,16,9,8555,590,7965,13.05%,6.90%
2020-01-01 00:03:30,16,10,1814,32,1782,2.77%,1.76%
2020-01-01 00:03:30,16,11,9502,702,8800,14.50%,7.39%
2020-01-01 00:03:30,16,12,25434,4426,21008,38.81%,17.40%
2020-01-01 00:03:40,1,1,18681,2435,16246,28.50%,13.03%
2020-01-01 00:03:40,1,2,6597,331,6266,10.07%,5.02%
2020-01-01 00:03:40,1,3,732,3,729,1.12%,0.41%
2020-01-01 00:03:40,1,4,11596,1011,10585,17.69%,8.72%
2020-01-01 00:03:40,1,5,11336,968,10368,17.30%,8.54%
2020-01-01 00:03:40,1,6,11281,955,10326,17.21%,8.47%
2020-01-01 00:03:40,1,7,5849,256,5593,8.92%,4.38%
2020-01-01 00:03:40,1,8,4337,140,4197,6.62%,3.23%
2020-01-01 00:03:40,1,9,11224,944,10280,17.13%,8.41%
2020-01-01 00:03:40,1,10,3774,107,3667,5.76%,2.84%
2020-01-01 00:03:40,1,11,3913,114,3799,5.97%,2.91%
2020-01-01 00:03:40,1,12,11209,943,10266,17.10%,8.41%
2020-01-01 00:03:40,2,1,2914,67,2847,4.45%,2.30%
2020-01-01 00:03:40,2,2,28564,5554,23010,43.59%,19.44%
2020-01-01 00:03:40,2,3,18734,2506,16228,28.59%,13.38%
2020-01-01 00:03:40,2,4,2840,64,2776,4.33%,2.25%
2020-01-01 00:03:40,2,5,11031,955,10076,16.83%,8.66%
2020-01-01 00:03:40,2,6,61,0,61,0.09%,0.00%
2020-01-01 00:03:40,2,7,6878,369,6509,10.49%,5.36%
2020-01-01 00:03:40,2,8,5539,238,5301,8.45%,4.30%
2020-01-01 00:03:40,2,9,10979,949,10030,16.75%,8.64%
2020-01-01 00:03:40,2,10,4481,161,4320,6.84%,3.59%
2020-01-01 00:03:40,2,11,4503,163,4340,6.87%,3.62%
2020-01-01 00:03:40,2,12,10801,921,9880,16.48%,8.53%
2020-01-01 00:03:40,3,1,1966,27,1939,3.00%,1.37%
2020-01-01 00:03:40,3,2,28003,5198,22805,42.73%,18.56%
2020-01-01 00:03:40,3,3,74046,29776,44270,112.99%,40.21%
2020-01-01 00:03:40,3,4,6637,323,6314,10.13%,4.87%
2020-01-01 00:03:40,3,5,44189,12158,32031,67.43%,27.51%
2020-01-01 00:03:40,3,6,7459,406,7053,11.38%,5.44%
2020-01-01 00:03:40,3,7,24282,3946,20336,37.05%,16.25%
2020-01-01 00:03:40,3,8,16988,2007,14981,25.92%,11.81%
2020-01-01 00:03:40,3,9,36178,8524,27654,55.20%,23.56%
2020-01-01 00:03:40,3,10,5571,226,5345,8.50%,4.06%
2020-01-01 00:03:40,3,11,1731,18,1713,2.64%,1.04%
2020-01-01 00:03:40,3,12,26134,4652,21482,39.88%,17.80%
2020-01-01 00:03:40,4,1,536,4,532,0.82%,0.75%
2020-01-01 00:03:40,4,2,319,1,318,0.49%,0.31%
2020-01-01 00:03:40,4,3,636,29,607,0.97%,4.56%
2020-01-01 00:03:40,4,4,27881,5201,22680,42.54%,18.65%
2020-01-01 00:03:40,4,5,17690,2256,15434,26.99%,12.75%
2020-01-01 00:03:40,4,6,24147,4039,20108,36.85%,16.73%
2020-01-01 00:03:40,4,7,5047,189,4858,7.70%,3.74%
2020-01-01 00:03:40,4,8,2805,48,2757,4.28%,1.71%
2020-01-01 00:03:40,4,9,15776,1784,13992,24.07%,11.31%
2020-01-01 00:03:40,4,10,1983,23,1960,3.03%,1.16%
2020-01-01 00:03:40,4,11,217,0,217,0.33%,0.00%
2020-01-01 00:03:40,4,12,12385,1130,11255,18.90%,9.12%
2020-01-01 00:03:40,5,1,2751,63,2688,4.20%,2.29%
2020-01-01 00:03:40,5,2,713,5,708,1.09%,0.70%
2020-01-01 00:03:40,5,3,1095,13,1082,1.67%,1.19%
2020-01-01 00:03:40,5,4,25682,4469,21213,39.19%,17.40%
2020-01-01 00:03:40,5,5,11198,979,10219,17.09%,8.74%
2020-01-01 00:03:40,5,6,16143,1907,14236,24.63%,11.81%
2020-01-01 00:03:40,5,7,4567,186,4381,6.97%,4.07%
2020-01-01 00:03:40,5,8,3354,96,3258,5.12%,2.86%
2020-01-01 00:03:40,5,9,9939,787,9152,15.17%,7.92%
2020-01-01 00:03:40,5,10,1338,15,1323,2.04%,1.12%
2020-01-01 00:03:40,5,11,443,2,441,0.68%,0.45%
2020-01-01 00:03:40,5,12,8383,557,7826,12.79%,6.64%
2020-01-01 00:03:40,6,1,1207,11,1196,1.84%,0.91%
2020-01-01 00:03:40,6,2,1260,11,1249,1.92%,0.87%
2020-01-01 00:03:40,6,3,1778,24,1754,2.71%,1.35%
2020-01-01 00:03:40,6,4,1200,24,1176,1.83%,2.00%
2020-01-01 00:03:40,6,5,13269,1247,12022,20.25%,9.40%
2020-01-01 00:03:40,6,6,4939,203,4736,7.54%,4.11%
2020-01-01 00:03:40,6,7,3167,94,3073,4.83%,2.97%
2020-01-01 00:03:40,6,8,2331,54,2277,3.56%,2.32%
2020-01-01 00:03:40,6,9,6315,287,6028,9.64%,4.54%
2020-01-01 00:03:40,6,10,1780,22,1758,2.72%,1.24%
2020-01-01 00:03:40,6,11,347,1,346,0.53%,0.29%
2020-01-01 00:03:40,6,12,4463,140,4323,6.81%,3.14%
2020-01-01 00:03:40,7,1,622,0,622,0.95%,0.00%
2020-01-01 00:03:40,7,2,284,0,284,0.43%,0.00%
2020-01-01 00:03:40,7,3,1003,7,996,1.53%,0.70%
2020-01-01 00:03:40,7,4,1869,26,1843,2.85%,1.39%
2020-01-01 00:03:40,7,5,7792,442,7350,11.89%,5.67%
2020-01-01 00:03:40,7,6,13075,1238,11837,19.95%,9.47%
2020-01-01 00:03:40,7,7,3367,109,3258,5.14%,3.24%
2020-01-01 00:03:40,7,8,1313,16,1297,2.00%,1.22%
2020-01-01 00:03:40,7,9,6642,313,6329,10.13%,4.71%
2020-01-01 00:03:40,7,10,1659,17,1642,2.53%,1.02%
2020-01-01 00:03:40,7,11,97,0,97,0.15%,0.00%
2020-01-01 00:03:40,7,12,4922,192,4730,7.51%,3.90%
2020-01-01 00:03:40,8,1,481,1,480,0.73%,0.21%
2020-01-01 00:03:40,8,2,163,0,163,0.25%,0.00%
2020-01-01 00:03:40,8,3,1664,13,1651,2.54%,0.78%
2020-01-01 00:03:40,8,4,3412,89,3323,5.21%,2.61%
2020-01-01 00:03:40,8,5,8092,484,7608,12.35%,5.98%
2020-01-01 00:03:40,8,6,16541,1925,14616,25.24%,11.64%
2020-01-01 00:03:40,8,7,4758,171,4587,7.26%,3.59%
2020-01-01 00:03:40,8,8,2144,29,2115,3.27%,1.35%
2020-01-01 00:03:40,8,9,6195,285,5910,9.45%,4.60%
2020-01-01 00:03:40,8,10,1620,18,1602,2.47%,1.11%
2020-01-01 00:03:40,8,11,159,0,159,0.24%,0.00%
2020-01-01 00:03:40,8,12,4561,176,4385,6.96%,3.86%
2020-01-01 00:03:40,9,1,560,2,558,0.85%,0.36%
2020-01-01 00:03:40,9,2,2312,29,2283,3.53%,1.25%
2020-01-01 00:03:40,9,3,1294,7,1287,1.97%,0.54%
2020-01-01 00:03:40,9,4,5035,234,4801,7.68%,4.65%
2020-01-01 00:03:40,9,5,333,0,333,0.51%,0.00%
2020-01-01 00:03:40,9,6,6090,322,5768,9.29%,5.29%
2020-01-01 00:03:40,9,7,28182,5152,23030,43.00%,18.28%
2020-01-01 00:03:40,9,8,10818,820,9998,16.51%,7.58%
2020-01-01 00:03:40,9,9,185,0,185,0.28%,0.00%
2020-01-01 00:03:40,9,10,3408,63,3345,5.20%,1.85%
2020-01-01 00:03:40,9,11,9643,654,8989,14.71%,6.78%
2020-01-01 00:03:40,9,12,5995,274,5721,9.15%,4.57%
2020-01-01 00:03:40,10,1,1154,192,962,1.76%,16.64%
2020-01-01 00:03:40,10,2,3687,278,3409,5.63%,7.54%
2020-01-01 00:03:40,10,3,2334,46,2288,3.56%,1.97%
2020-01-01 00:03:40,10,4,4241,1100,3141,6.47%,25.94%
2020-01-01 00:03:40,10,5,767,54,713,1.17%,7.04%
2020-01-01 00:03:40,10,6,6246,1270,4976,9.53%,20.33%
2020-01-01 00:03:40,10,7,11629,2033,9596,17.74%,17.48%
2020-01-01 00:03:40,10,8,29562,7591,21971,45.11%,25.68%
2020-01-01 00:03:40,10,9,830,8,822,1.27%,0.96%
2020-01-01 00:03:40,10,10,2661,47,2614,4.06%,1.77%
2020-01-01 00:03:40,10,11,13563,1814,11749,20.70%,13.37%
2020-01-01 00:03:40,10,12,10394,1302,9092,15.86%,12.53%
2020-01-01 00:03:40,11,1,2563,43,2520,3.91%,1.68%
2020-01-01 00:03:40,11,2,3648,96,3552,5.57%,2.63%
2020-01-01 00:03:40,11,3,953,11,942,1.45%,1.15%
2020-01-01 00:03:40,11,4,7000,343,6657,10.68%,4.90%
2020-01-01 00:03:40,11,5,219,1,218,0.33%,0.46%
2020-01-01 00:03:40,11,6,8026,446,7580,12.25%,5.56%
2020-01-01 00:03:40,11,7,13894,1334,12560,21.20%,9.60%
2020-01-01 00:03:40,11,8,28119,5191,22928,42.91%,18.46%
2020-01-01 00:03:40,11,9,179,0,179,0.27%,0.00%
2020-01-01 00:03:40,11,10,3354,91,3263,5.12%,2.71%
2020-01-01 00:03:40,11,11,10308,774,9534,15.73%,7.51%
2020-01-01 00:03:40,11,12,6532,312,6220,9.97%,4.78%
2020-01-01 00:03:40,12,1,54,0,54,0.08%,0.00%
2020-01-01 00:03:40,12,2,559,149,410,0.85%,26.65%
2020-01-01 00:03:40,12,3,3117,228,2889,4.76%,7.31%
2020-01-01 00:03:40,12,4,3395,72,3323,5.18%,2.12%
2020-01-01 00:03:40,12,5,9705,765,8940,14.81%,7.88%
2020-01-01 00:03:40,12,6,5836,219,5617,8.91%,3.75%
2020-01-01 00:03:40,12,7,2238,43,2195,3.41%,1.92%
2020-01-01 00:03:40,12,8,1639,282,1357,2.50%,17.21%
2020-01-01 00:03:40,12,9,22663,4218,18445,34.58%,18.61%
2020-01-01 00:03:40,12,10,4369,402,3967,6.67%,9.20%
2020-01-01 00:03:40,12,11,1784,283,1501,2.72%,15.86%
2020-01-01 00:03:40,12,12,8012,1061,6951,12.23%,13.24%
2020-01-01 00:03:40,13,1,2049,46,2003,3.13%,2.24%
2020-01-01 00:03:40,13,2,2393,62,2331,3.65%,2.59%
2020-01-01 00:03:40,13,3,698,7,691,1.07%,1.00%
2020-01-01 00:03:40,13,4,4286,481,3805,6.54%,11.22%
2020-01-01 00:03:40,13,5,6326,742,5584,9.65%,11.73%
2020-01-01 00:03:40,13,6,4941,526,4415,7.54%,10.65%
2020-01-01 00:03:40,13,7,4417,157,4260,6.74%,3.55%
2020-01-01 00:03:40,13,8,6450,309,6141,9.84%,4.79%
2020-01-01 00:03:40,13,9,6702,775,5927,10.23%,11.56%
2020-01-01 00:03:40,13,10,26051,5127,20924,39.75%,19.68%
2020-01-01 00:03:40,13,11,16789,2274,14515,25.62%,13.54%
2020-01-01 00:03:40,13,12,9855,1037,8818,15.04%,10.52%
2020-01-01 00:03:40,14,1,218,0,218,0.33%,0.00%
2020-01-01 00:03:40,14,2,1128,9,1119,1.72%,0.80%
2020-01-01 00:03:40,14,3,670,3,667,1.02%,0.45%
2020-01-01 00:03:40,14,4,4377,143,4234,6.68%,3.27%
2020-01-01 00:03:40,14,5,1506,14,1492,2.30%,0.93%
2020-01-01 00:03:40,14,6,4638,163,4475,7.08%,3.51%
2020-01-01 00:03:40,14,7,12136,1060,11076,18.52%,8.73%
2020-01-01 00:03:40,14,8,13662,1338,12324,20.85%,9.79%
2020-01-01 00:03:40,14,9,1820,17,1803,2.78%,0.93%
2020-01-01 00:03:40,14,10,4113,100,4013,6.28%,2.43%
2020-01-01 00:03:40,14,11,25754,4498,21256,39.30%,17.47%
2020-01-01 00:03:40,14,12,7750,455,7295,11.83%,5.87%
2020-01-01 00:03:40,15,1,567,4,563,0.87%,0.71%
2020-01-01 00:03:40,15,2,232,2,230,0.35%,0.86%
2020-01-01 00:03:40,15,3,4220,137,4083,6.44%,3.25%
2020-01-01 00:03:40,15,4,5924,248,5676,9.04%,4.19%
2020-01-01 00:03:40,15,5,10835,818,10017,16.53%,7.55%
2020-01-01 00:03:40,15,6,6214,271,5943,9.48%,4.36%
2020-01-01 00:03:40,15,7,3621,99,3522,5.53%,2.73%
2020-01-01 00:03:40,15,8,5319,216,5103,8.12%,4.06%
2020-01-01 00:03:40,15,9,11000,847,10153,16.78%,7.70%
2020-01-01 00:03:40,15,10,4513,174,4339,6.89%,3.86%
2020-01-01 00:03:40,15,11,9984,746,9238,15.23%,7.47%
2020-01-01 00:03:40,15,12,26517,4993,21524,40.46%,18.83%
2020-01-01 00:03:40,16,1,539,4,535,0.82%,0.74%
2020-01-01 00:03:40,16,2,269,0,269,0.41%,0.00%
2020-01-01 00:03:40,16,3,1388,7,1381,2.12%,0.50%
2020-01-01 00:03:40,16,4,3961,179,3782,6.04%,4.52%
2020-01-01 00:03:40,16,5,7206,470,6736,11.00%,6.52%
2020-01-01 00:03:40,16,6,4647,218,4429,7.09%,4.69%
2020-01-01 00:03:40,16,7,3911,110,3801,5.97%,2.81%
2020-01-01 00:03:40,16,8,8072,609,7463,12.32%,7.54%
2020-01-01 00:03:40,16,9,7671,513,7158,11.71%,6.69%
2020-01-01 00:03:40,16,10,1757,30,1727,2.68%,1.71%
2020-01-01 00:03:40,16,11,10085,846,9239,15.39%,8.39%
2020-01-01 00:03:40,16,12,25360,4430,20930,38.70%,17.47%
2020-01-01 00:03:50,1,1,18209,2317,15892,27.78%,12.72%
2020-01-01 00:03:50,1,2,5518,238,5280,8.42%,4.31%
2020-01-01 00:03:50,1,3,524,3,521,0.80%,0.57%
2020-01-01 00:03:50,1,4,12272,1099,11173,18.73%,8.96%
2020-01-01 00:03:50,1,5,12010,1054,10956,18.33%,8.78%
2020-01-01 00:03:50,1,6,11917,1045,10872,18.18%,8.77%
2020-01-01 00:03:50,1,7,4971,180,4791,7.59%,3.62%
2020-01-01 00:03:50,1,8,4304,121,4183,6.57%,2.81%
2020-01-01 00:03:50,1,9,11877,1039,10838,18.12%,8.75%
2020-01-01 00:03:50,1,10,3721,92,3629,5.68%,2.47%
2020-01-01 00:03:50,1,11,3962,106,3856,6.05%,2.68%
2020-01-01 00:03:50,1,12,11857,1033,10824,18.09%,8.71%
2020-01-01 00:03:50,2,1,719,1,718,1.10%,0.14%
2020-01-01 00:03:50,2,2,23544,3668,19876,35.93%,15.58%
2020-01-01 00:03:50,2,3,17985,2159,15826,27.44%,12.00%
2020-01-01 00:03:50,2,4,668,1,667,1.02%,0.15%
2020-01-01 00:03:50,2,5,10207,707,9500,15.57%,6.93%
2020-01-01 00:03:50,2,6,29,0,29,0.04%,0.00%
2020-01-01 00:03:50,2,7,4810,164,4646,7.34%,3.41%
2020-01-01 00:03:50,2,8,3285,78,3207,5.01%,2.37%
2020-01-01 00:03:50,2,9,10122,697,9425,15.44%,6.89%
2020-01-01 00:03:50,2,10,2520,45,2475,3.85%,1.79%
2020-01-01 00:03:50,2,11,2537,45,2492,3.87%,1.77%
2020-01-01 00:03:50,2,12,10005,682,9323,15.27%,6.82%
2020-01-01 00:03:50,3,1,1569,13,1556,2.39%,0.83%
2020-01-01 00:03:50,3,2,26042,4371,21671,39.74%,16.78%
2020-01-01 00:03:50,3,3,70302,27139,43163,107.27%,38.60%
2020-01-01 00:03:50,3,4,9703,623,9080,14.81%,6.42%
2020-01-01 00:03:50,3,5,43461,11659,31802,66.32%,26.83%
2020-01-01 00:03:50,3,6,11166,804,10362,17.04%,7.20%
2020-01-01 00:03:50,3,7,22407,3311,19096,34.19%,14.78%
2020-01-01 00:03:50,3,8,18205,2222,15983,27.78%,12.21%
2020-01-01 00:03:50,3,9,31869,6644,25225,48.63%,20.85%
2020-01-01 00:03:50,3,10,5860,274,5586,8.94%,4.68%
2020-01-01 00:03:50,3,11,2273,31,2242,3.47%,1.36%
2020-01-01 00:03:50,3,12,22804,3546,19258,34.80%,15.55%
2020-01-01 00:03:50,4,1,552,2,550,0.84%,0.36%
2020-01-01 00:03:50,4,2,345,1,344,0.53%,0.29%
2020-01-01 00:03:50,4,3,946,9,937,1.44%,0.95%
2020-01-01 00:03:50,4,4,28613,5368,23245,43.66%,18.76%
2020-01-01 00:03:50,4,5,17598,2158,15440,26.85%,12.26%
2020-01-01 00:03:50,4,6,24594,4089,20505,37.53%,16.63%
2020-01-01 00:03:50,4,7,5426,200,5226,8.28%,3.69%
2020-01-01 00:03:50,4,8,3016,74,2942,4.60%,2.45%
2020-01-01 00:03:50,4,9,15319,1669,13650,23.37%,10.89%
2020-01-01 00:03:50,4,10,1887,26,1861,2.88%,1.38%
2020-01-01 00:03:50,4,11,275,0,275,0.42%,0.00%
2020-01-01 00:03:50,4,12,12716,1145,11571,19.40%,9.00%
2020-01-01 00:03:50,5,1,2923,55,2868,4.46%,1.88%
2020-01-01 00:03:50,5,2,997,8,989,1.52%,0.80%
2020-01-01 00:03:50,5,3,1934,27,1907,2.95%,1.40%
2020-01-01 00:03:50,5,4,24656,4103,20553,37.62%,16.64%
2020-01-01 00:03:50,5,5,10449,799,9650,15.94%,7.65%
2020-01-01 00:03:50,5,6,16429,1914,14515,25.07%,11.65%
2020-01-01 00:03:50,5,7,5366,216,5150,8.19%,4.03%
2020-01-01 00:03:50,5,8,4535,143,4392,6.92%,3.15%
2020-01-01 00:03:50,5,9,8313,510,7803,12.68%,6.13%
2020-01-01 00:03:50,5,10,1158,13,1145,1.77%,1.12%
2020-01-01 00:03:50,5,11,654,5,649,1.00%,0.76%
2020-01-01 00:03:50,5,12,6941,363,6578,10.59%,5.23%
2020-01-01 00:03:50,6,1,1075,10,1065,1.64%,0.93%
2020-01-01 00:03:50,6,2,1174,13,1161,1.79%,1.11%
2020-01-01 00:03:50,6,3,1663,25,1638,2.54%,1.50%
2020-01-01 00:03:50,6,4,1390,11,1379,2.12%,0.79%
2020-01-01 00:03:50,6,5,12717,1181,11536,19.40%,9.29%
2020-01-01 00:03:50,6,6,4184,127,4057,6.38%,3.04%
2020-01-01 00:03:50,6,7,2271,54,2217,3.47%,2.38%
2020-01-01 00:03:50,6,8,1833,39,1794,2.80%,2.13%
2020-01-01 00:03:50,6,9,6569,331,6238,10.02%,5.04%
2020-01-01 00:03:50,6,10,2227,41,2186,3.40%,1.84%
2020-01-01 00:03:50,6,11,467,0,467,0.71%,0.00%
2020-01-01 00:03:50,6,12,4255,135,4120,6.49%,3.17%
2020-01-01 00:03:50,7,1,436,1,435,0.67%,0.23%
2020-01-01 00:03:50,7,2,202,0,202,0.31%,0.00%
2020-01-01 00:03:50,7,3,687,3,684,1.05%,0.44%
2020-01-01 00:03:50,7,4,2124,37,2087,3.24%,1.74%
2020-01-01 00:03:50,7,5,7021,371,6650,10.71%,5.28%
2020-01-01 00:03:50,7,6,13112,1253,11859,20.01%,9.56%
2020-01-01 00:03:50,7,7,3940,118,3822,6.01%,2.99%
2020-01-01 00:03:50,7,8,2084,45,2039,3.18%,2.16%
2020-01-01 00:03:50,7,9,6068,284,5784,9.26%,4.68%
2020-01-01 00:03:50,7,10,1141,11,1130,1.74%,0.96%
2020-01-01 00:03:50,7,11,54,0,54,0.08%,0.00%
2020-01-01 00:03:50,7,12,4941,211,4730,7.54%,4.27%
2020-01-01 00:03:50,8,1,512,2,510,0.78%,0.39%
2020-01-01 00:03:50,8,2,110,0,110,0.17%,0.00%
2020-01-01 00:03:50,8,3,1689,15,1674,2.58%,0.89%
2020-01-01 00:03:50,8,4,3005,63,2942,4.59%,2.10%
2020-01-01 00:03:50,8,5,8568,563,8005,13.07%,6.57%
2020-01-01 00:03:50,8,6,15148,1623,13525,23.11%,10.71%
2020-01-01 00:03:50,8,7,3507,91,3416,5.35%,2.59%
2020-01-01 00:03:50,8,8,1381,12,1369,2.11%,0.87%
2020-01-01 00:03:50,8,9,6624,347,6277,10.11%,5.24%
2020-01-01 00:03:50,8,10,1940,38,1902,2.96%,1.96%
2020-01-01 00:03:50,8,11,99,0,99,0.15%,0.00%
2020-01-01 00:03:50,8,12,4660,147,4513,7.11%,3.15%
2020-01-01 00:03:50,9,1,778,6,772,1.19%,0.77%
2020-01-01 00:03:50,9,2,2780,52,2728,4.24%,1.87%
2020-01-01 00:03:50,9,3,1501,10,1491,2.29%,0.67%
2020-01-01 00:03:50,9,4,7624,427,7197,11.63%,5.60%
2020-01-01 00:03:50,9,5,787,2,785,1.20%,0.25%
2020-01-01 00:03:50,9,6,9480,649,8831,14.47%,6.85%
2020-01-01 00:03:50,9,7,33407,7247,26160,50.98%,21.69%
2020-01-01 00:03:50,9,8,12382,1097,11285,18.89%,8.86%
2020-01-01 00:03:50,9,9,357,0,357,0.54%,0.00%
2020-01-01 00:03:50,9,10,2963,65,2898,4.52%,2.19%
2020-01-01 00:03:50,9,11,11392,918,10474,17.38%,8.06%
2020-01-01 00:03:50,9,12,8094,454,7640,12.35%,5.61%
2020-01-01 00:03:50,10,1,1225,267,958,1.87%,21.80%
2020-01-01 00:03:50,10,2,3422,322,3100,5.22%,9.41%
2020-01-01 00:03:50,10,3,2003,27,1976,3.06%,1.35%
2020-01-01 00:03:50,10,4,4026,1116,2910,6.14%,27.72%
2020-01-01 00:03:50,10,5,933,56,877,1.42%,6.00%
2020-01-01 00:03:50,10,6,5708,1245,4463,8.71%,21.81%
2020-01-01 00:03:50,10,7,10748,1988,8760,16.40%,18.50%
2020-01-01 00:03:50,10,8,28366,6934,21432,43.28%,24.44%
2020-01-01 00:03:50,10,9,552,2,550,0.84%,0.36%
2020-01-01 00:03:50,10,10,3221,85,3136,4.91%,2.64%
2020-01-01 00:03:50,10,11,13436,1607,11829,20.50%,11.96%
2020-01-01 00:03:50,10,12,9533,1009,8524,14.55%,10.58%
2020-01-01 00:03:50,11,1,2325,40,2285,3.55%,1.72%
2020-01-01 00:03:50,11,2,3300,79,3221,5.04%,2.39%
2020-01-01 00:03:50,11,3,827,3,824,1.26%,0.36%
2020-01-01 00:03:50,11,4,9025,587,8438,13.77%,6.50%
2020-01-01 00:03:50,11,5,230,0,230,0.35%,0.00%
2020-01-01 00:03:50,11,6,9866,697,9169,15.05%,7.06%
2020-01-01 00:03:50,11,7,14689,1510,13179,22.41%,10.28%
2020-01-01 00:03:50,11,8,29649,5843,23806,45.24%,19.71%
2020-01-01 00:03:50,11,9,323,1,322,0.49%,0.31%
2020-01-01 00:03:50,11,10,3186,75,3111,4.86%,2.35%
2020-01-01 00:03:50,11,11,10823,852,9971,16.51%,7.87%
2020-01-01 00:03:50,11,12,7105,375,6730,10.84%,5.28%
2020-01-01 00:03:50,12,1,59,0,59,0.09%,0.00%
2020-01-01 00:03:50,12,2,479,122,357,0.73%,25.47%
2020-01-01 00:03:50,12,3,2601,168,2433,3.97%,6.46%
2020-01-01 00:03:50,12,4,2993,68,2925,4.57%,2.27%
2020-01-01 00:03:50,12,5,8448,615,7833,12.89%,7.28%
2020-01-01 00:03:50,12,6,5079,201,4878,7.75%,3.96%
2020-01-01 00:03:50,12,7,1942,32,1910,2.96%,1.65%
2020-01-01 00:03:50,12,8,1394,194,1200,2.13%,13.92%
2020-01-01 00:03:50,12,9,21017,3830,17187,32.07%,18.22%
2020-01-01 00:03:50,12,10,4381,298,4083,6.68%,6.80%
2020-01-01 00:03:50,12,11,1625,197,1428,2.48%,12.12%
2020-01-01 00:03:50,12,12,7300,1060,6240,11.14%,14.52%
2020-01-01 00:03:50,13,1,1774,21,1753,2.71%,1.18%
2020-01-01 00:03:50,13,2,2151,32,2119,3.28%,1.49%
2020-01-01 00:03:50,13,3,597,6,591,0.91%,1.01%
2020-01-01 00:03:50,13,4,5081,519,4562,7.75%,10.21%
2020-01-01 00:03:50,13,5,7138,875,6263,10.89%,12.26%
2020-01-01 00:03:50,13,6,5738,592,5146,8.76%,10.32%
2020-01-01 00:03:50,13,7,4269,154,4115,6.51%,3.61%
2020-01-01 00:03:50,13,8,6788,371,6417,10.36%,5.47%
2020-01-01 00:03:50,13,9,7468,906,6562,11.40%,12.13%
2020-01-01 00:03:50,13,10,26371,5244,21127,40.24%,19.89%
2020-01-01 00:03:50,13,11,16581,2167,14414,25.30%,13.07%
2020-01-01 00:03:50,13,12,9437,883,8554,14.40%,9.36%
2020-01-01 00:03:50,14,1,270,2,268,0.41%,0.74%
2020-01-01 00:03:50,14,2,1470,21,1449,2.24%,1.43%
2020-01-01 00:03:50,14,3,992,5,987,1.51%,0.50%
2020-01-01 00:03:50,14,4,3987,109,3878,6.08%,2.73%
2020-01-01 00:03:50,14,5,1352,10,1342,2.06%,0.74%
2020-01-01 00:03:50,14,6,4311,128,4183,6.58%,2.97%
2020-01-01 00:03:50,14,7,11703,974,10729,17.86%,8.32%
2020-01-01 00:03:50,14,8,13254,1260,11994,20.22%,9.51%
2020-01-01 00:03:50,14,9,1647,15,1632,2.51%,0.91%
2020-01-01 00:03:50,14,10,4579,129,4450,6.99%,2.82%
2020-01-01 00:03:50,14,11,27257,4938,22319,41.59%,18.12%
2020-01-01 00:03:50,14,12,9034,554,8480,13.78%,6.13%
2020-01-01 00:03:50,15,1,536,2,534,0.82%,0.37%
2020-01-01 00:03:50,15,2,142,0,142,0.22%,0.00%
2020-01-01 00:03:50,15,3,6745,351,6394,10.29%,5.20%
2020-01-01 00:03:50,15,4,5082,222,4860,7.75%,4.37%
2020-01-01 00:03:50,15,5,12608,1166,11442,19.24%,9.25%
2020-01-01 00:03:50,15,6,5387,241,5146,8.22%,4.47%
2020-01-01 00:03:50,15,7,3397,79,3318,5.18%,2.33%
2020-01-01 00:03:50,15,8,5149,207,4942,7.86%,4.02%
2020-01-01 00:03:50,15,9,12781,1192,11589,19.50%,9.33%
2020-01-01 00:03:50,15,10,7170,498,6672,10.94%,6.95%
2020-01-01 00:03:50,15,11,12549,1213,11336,19.15%,9.67%
2020-01-01 00:03:50,15,12,31159,6805,24354,47.54%,21.84%
2020-01-01 00:03:50,16,1,440,2,438,0.67%,0.45%
2020-01-01 00:03:50,16,2,221,0,221,0.34%,0.00%
2020-01-01 00:03:50,16,3,1395,18,1377,2.13%,1.29%
2020-01-01 00:03:50,16,4,4684,166,4518,7.15%,3.54%
2020-01-01 00:03:50,16,5,8511,560,7951,12.99%,6.58%
2020-01-01 00:03:50,16,6,5474,217,5257,8.35%,3.96%
2020-01-01 00:03:50,16,7,3402,83,3319,5.19%,2.44%
2020-01-01 00:03:50,16,8,7273,462,6811,11.10%,6.35%
2020-01-01 00:03:50,16,9,9008,614,8394,13.75%,6.82%
2020-01-01 00:03:50,16,10,1551,20,1531,2.37%,1.29%
2020-01-01 00:03:50,16,11,9026,641,8385,13.77%,7.10%
2020-01-01 00:03:50,16,12,26362,4702,21660,40.23%,17.84%
2020-01-01 00:04:00,1,1,22100,3261,18839,33.72%,14.76%
2020-01-01 00:04:00,1,2,10502,765,9737,16.02%,7.28%
2020-01-01 00:04:00,1,3,2345,37,2308,3.58%,1.58%
2020-01-01 00:04:00,1,4,11033,916,10117,16.84%,8.30%
2020-01-01 00:04:00,1,5,10758,861,9897,16.42%,8.00%
2020-01-01 00:04:00,1,6,10661,848,9813,16.27%,7.95%
2020-01-01 00:04:00,1,7,8143,469,7674,12.43%,5.76%
2020-01-01 00:04:00,1,8,5458,201,5257,8.33%,3.68%
2020-01-01 00:04:00,1,9,10615,838,9777,16.20%,7.89%
2020-01-01 00:04:00,1,10,4531,147,4384,6.91%,3.24%
2020-01-01 00:04:00,1,11,4629,151,4478,7.06%,3.26%
2020-01-01 00:04:00,1,12,10580,832,9748,16.14%,7.86%
2020-01-01 00:04:00,2,1,705,1,704,1.08%,0.14%
2020-01-01 00:04:00,2,2,23295,3763,19532,35.55%,16.15%
2020-01-01 00:04:00,2,3,19003,2514,16489,29.00%,13.23%
2020-01-01 00:04:00,2,4,650,1,649,0.99%,0.15%
2020-01-01 00:04:00,2,5,10800,828,9972,16.48%,7.67%
2020-01-01 00:04:00,2,6,71,0,71,0.11%,0.00%
2020-01-01 00:04:00,2,7,3571,101,3470,5.45%,2.83%
2020-01-01 00:04:00,2,8,2490,49,2441,3.80%,1.97%
2020-01-01 00:04:00,2,9,10714,822,9892,16.35%,7.67%
2020-01-01 00:04:00,2,10,1661,21,1640,2.53%,1.26%
2020-01-01 00:04:00,2,11,1696,23,1673,2.59%,1.36%
2020-01-01 00:04:00,2,12,10469,785,9684,15.97%,7.50%
2020-01-01 00:04:00,3,1,1490,14,1476,2.27%,0.94%
2020-01-01 00:04:00,3,2,24788,4175,20613,37.82%,16.84%
2020-01-01 00:04:00,3,3,80517,34182,46335,122.86%,42.45%
2020-01-01 00:04:00,3,4,7308,380,6928,11.15%,5.20%
2020-01-01 00:04:00,3,5,53190,16821,36369,81.16%,31.62%
2020-01-01 00:04:00,3,6,9362,612,8750,14.29%,6.54%
2020-01-01 00:04:00,3,7,21443,3151,18292,32.72%,14.69%
2020-01-01 00:04:00,3,8,17131,2076,15055,26.14%,12.12%
2020-01-01 00:04:00,3,9,43251,11742,31509,66.00%,27.15%
2020-01-01 00:04:00,3,10,11565,931,10634,17.65%,8.05%
2020-01-01 00:04:00,3,11,1939,30,1909,2.96%,1.55%
2020-01-01 00:04:00,3,12,27572,5153,22419,42.07%,18.69%
2020-01-01 00:04:00,4,1,564,4,560,0.86%,0.71%
2020-01-01 00:04:00,4,2,363,0,363,0.55%,0.00%
2020-01-01 00:04:00,4,3,699,6,693,1.07%,0.86%
2020-01-01 00:04:00,4,4,27859,5197,22662,42.51%,18.65%
2020-01-01 00:04:00,4,5,17159,2111,15048,26.18%,12.30%
2020-01-01 00:04:00,4,6,23630,3834,19796,36.06%,16.23%
2020-01-01 00:04:00,4,7,5048,208,4840,7.70%,4.12%
2020-01-01 00:04:00,4,8,3099,71,3028,4.73%,2.29%
2020-01-01 00:04:00,4,9,14909,1598,13311,22.75%,10.72%
2020-01-01 00:04:00,4,10,1898,19,1879,2.90%,1.00%
2020-01-01 00:04:00,4,11,251,0,251,0.38%,0.00%
2020-01-01 00:04:00,4,12,12249,1116,11133,18.69%,9.11%
2020-01-01 00:04:00,5,1,2513,34,2479,3.83%,1.35%
2020-01-01 00:04:00,5,2,611,2,609,0.93%,0.33%
2020-01-01 00:04:00,5,3,453,2,451,0.69%,0.44%
2020-01-01 00:04:00,5,4,22529,3425,19104,34.38%,15.20%
2020-01-01 00:04:00,5,5,9418,645,8773,14.37%,6.85%
2020-01-01 00:04:00,5,6,14232,1447,12785,21.72%,10.17%
2020-01-01 00:04:00,5,7,4337,144,4193,6.62%,3.32%
2020-01-01 00:04:00,5,8,3156,78,3078,4.82%,2.47%
2020-01-01 00:04:00,5,9,8800,567,8233,13.43%,6.44%
2020-01-01 00:04:00,5,10,1030,10,1020,1.57%,0.97%
2020-01-01 00:04:00,5,11,482,3,479,0.74%,0.62%
2020-01-01 00:04:00,5,12,7525,427,7098,11.48%,5.67%
2020-01-01 00:04:00,6,1,1137,8,1129,1.73%,0.70%
2020-01-01 00:04:00,6,2,1202,8,1194,1.83%,0.67%
2020-01-01 00:04:00,6,3,1928,22,1906,2.94%,1.14%
2020-01-01 00:04:00,6,4,1321,12,1309,2.02%,0.91%
2020-01-01 00:04:00,6,5,12936,1285,11651,19.74%,9.93%
2020-01-01 00:04:00,6,6,4653,181,4472,7.10%,3.89%
2020-01-01 00:04:00,6,7,2915,87,2828,4.45%,2.98%
2020-01-01 00:04:00,6,8,1996,50,1946,3.05%,2.51%
2020-01-01 00:04:00,6,9,6030,261,5769,9.20%,4.33%
2020-01-01 00:04:00,6,10,1799,26,1773,2.75%,1.45%
2020-01-01 00:04:00,6,11,406,1,405,0.62%,0.25%
2020-01-01 00:04:00,6,12,4179,132,4047,6.38%,3.16%
2020-01-01 00:04:00,7,1,501,20,481,0.76%,3.99%
2020-01-01 00:04:00,7,2,144,0,144,0.22%,0.00%
2020-01-01 00:04:00,7,3,665,2,663,1.01%,0.30%
2020-01-01 00:04:00,7,4,2430,64,2366,3.71%,2.63%
2020-01-01 00:04:00,7,5,7377,359,7018,11.26%,4.87%
2020-01-01 00:04:00,7,6,13042,1229,11813,19.90%,9.42%
2020-01-01 00:04:00,7,7,3185,80,3105,4.86%,2.51%
2020-01-01 00:04:00,7,8,1483,19,1464,2.26%,1.28%
2020-01-01 00:04:00,7,9,6649,299,6350,10.15%,4.50%
2020-01-01 00:04:00,7,10,1099,8,1091,1.68%,0.73%
2020-01-01 00:04:00,7,11,103,1,102,0.16%,0.97%
2020-01-01 00:04:00,7,12,5542,225,5317,8.46%,4.06%
2020-01-01 00:04:00,8,1,521,0,521,0.79%,0.00%
2020-01-01 00:04:00,8,2,122,0,122,0.19%,0.00%
2020-01-01 00:04:00,8,3,2272,31,2241,3.47%,1.36%
2020-01-01 00:04:00,8,4,2658,58,2600,4.06%,2.18%
2020-01-01 00:04:00,8,5,8939,588,8351,13.64%,6.58%
2020-01-01 00:04:00,8,6,16357,1923,14434,24.96%,11.76%
2020-01-01 00:04:00,8,7,4682,181,4501,7.14%,3.87%
2020-01-01 00:04:00,8,8,1804,22,1782,2.75%,1.22%
2020-01-01 00:04:00,8,9,6137,289,5848,9.36%,4.71%
2020-01-01 00:04:00,8,10,1599,23,1576,2.44%,1.44%
2020-01-01 00:04:00,8,11,148,0,148,0.23%,0.00%
2020-01-01 00:04:00,8,12,4527,165,4362,6.91%,3.64%
2020-01-01 00:04:00,9,1,785,2,783,1.20%,0.25%
2020-01-01 00:04:00,9,2,2115,31,2084,3.23%,1.47%
2020-01-01 00:04:00,9,3,986,10,976,1.50%,1.01%
2020-01-01 00:04:00,9,4,8833,536,8297,13.48%,6.07%
2020-01-01 00:04:00,9,5,599,1,598,0.91%,0.17%
2020-01-01 00:04:00,9,6,10085,696,9389,15.39%,6.90%
2020-01-01 00:04:00,9,7,31117,6232,24885,47.48%,20.03%
2020-01-01 00:04:00,9,8,12897,1207,11690,19.68%,9.36%
2020-01-01 00:04:00,9,9,141,0,141,0.22%,0.00%
2020-01-01 00:04:00,9,10,5274,286,4988,8.05%,5.42%
2020-01-01 00:04:00,9,11,11934,1051,10883,18.21%,8.81%
2020-01-01 00:04:00,9,12,6318,265,6053,9.64%,4.19%
2020-01-01 00:04:00,10,1,1465,266,1199,2.24%,18.16%
2020-01-01 00:04:00,10,2,4621,380,4241,7.05%,8.22%
2020-01-01 00:04:00,10,3,3060,73,2987,4.67%,2.39%
2020-01-01 00:04:00,10,4,3969,994,2975,6.06%,25.04%
2020-01-01 00:04:00,10,5,1164,115,1049,1.78%,9.88%
2020-01-01 00:04:00,10,6,6442,1257,5185,9.83%,19.51%
2020-01-01 00:04:00,10,7,12329,2167,10162,18.81%,17.58%
2020-01-01 00:04:00,10,8,30327,7961,22366,46.28%,26.25%
2020-01-01 00:04:00,10,9,439,0,439,0.67%,0.00%
2020-01-01 00:04:00,10,10,2352,40,2312,3.59%,1.70%
2020-01-01 00:04:00,10,11,13656,1615,12041,20.84%,11.83%
2020-01-01 00:04:00,10,12,10584,1096,9488,16.15%,10.36%
2020-01-01 00:04:00,11,1,2177,38,2139,3.32%,1.75%
2020-01-01 00:04:00,11,2,2912,65,2847,4.44%,2.23%
2020-01-01 00:04:00,11,3,578,1,577,0.88%,0.17%
2020-01-01 00:04:00,11,4,3019,68,2951,4.61%,2.25%
2020-01-01 00:04:00,11,5,277,0,277,0.42%,0.00%
2020-01-01 00:04:00,11,6,4079,124,3955,6.22%,3.04%
2020-01-01 00:04:00,11,7,8917,606,8311,13.61%,6.80%
2020-01-01 00:04:00,11,8,24462,4143,20319,37.33%,16.94%
2020-01-01 00:04:00,11,9,369,2,367,0.56%,0.54%
2020-01-01 00:04:00,11,10,3073,73,3000,4.69%,2.38%
2020-01-01 00:04:00,11,11,11364,933,10431,17.34%,8.21%
2020-01-01 00:04:00,11,12,7825,445,7380,11.94%,5.69%
2020-01-01 00:04:00,12,1,119,0,119,0.18%,0.00%
2020-01-01 00:04:00,12,2,583,113,470,0.89%,19.38%
2020-01-01 00:04:00,12,3,3032,185,2847,4.63%,6.10%
2020-01-01 00:04:00,12,4,3014,75,2939,4.60%,2.49%
2020-01-01 00:04:00,12,5,9723,818,8905,14.84%,8.41%
2020-01-01 00:04:00,12,6,4711,152,4559,7.19%,3.23%
2020-01-01 00:04:00,12,7,1565,18,1547,2.39%,1.15%
2020-01-01 00:04:00,12,8,1344,315,1029,2.05%,23.44%
2020-01-01 00:04:00,12,9,21694,4077,17617,33.10%,18.79%
2020-01-01 00:04:00,12,10,4534,455,4079,6.92%,10.04%
2020-01-01 00:04:00,12,11,1562,318,1244,2.38%,20.36%
2020-01-01 00:04:00,12,12,6980,986,5994,10.65%,14.13%
2020-01-01 00:04:00,13,1,2297,41,2256,3.50%,1.78%
2020-01-01 00:04:00,13,2,2574,54,2520,3.93%,2.10%
2020-01-01 00:04:00,13,3,1024,10,1014,1.56%,0.98%
2020-01-01 00:04:00,13,4,4955,657,4298,7.56%,13.26%
2020-01-01 00:04:00,13,5,7435,975,6460,11.34%,13.11%
2020-01-01 00:04:00,13,6,5458,701,4757,8.33%,12.84%
2020-01-01 00:04:00,13,7,4590,161,4429,7.00%,3.51%
2020-01-01 00:04:00,13,8,8268,526,7742,12.62%,6.36%
2020-01-01 00:04:00,13,9,7757,1005,6752,11.84%,12.96%
2020-01-01 00:04:00,13,10,28752,6155,22597,43.87%,21.41%
2020-01-01 00:04:00,13,11,18351,2675,15676,28.00%,14.58%
2020-01-01 00:04:00,13,12,9781,1022,8759,14.92%,10.45%
2020-01-01 00:04:00,14,1,246,0,246,0.38%,0.00%
2020-01-01 00:04:00,14,2,1646,19,1627,2.51%,1.15%
2020-01-01 00:04:00,14,3,1057,6,1051,1.61%,0.57%
2020-01-01 00:04:00,14,4,3455,87,3368,5.27%,2.52%
2020-01-01 00:04:00,14,5,1137,21,1116,1.73%,1.85%
2020-01-01 00:04:00,14,6,3698,100,3598,5.64%,2.70%
2020-01-01 00:04:00,14,7,11154,921,10233,17.02%,8.26%
2020-01-01 00:04:00,14,8,12862,1172,11690,19.63%,9.11%
2020-01-01 00:04:00,14,9,1303,23,1280,1.99%,1.77%
2020-01-01 00:04:00,14,10,3902,114,3788,5.95%,2.92%
2020-01-01 00:04:00,14,11,26265,4561,21704,40.08%,17.37%
2020-01-01 00:04:00,14,12,9147,578,8569,13.96%,6.32%
2020-01-01 00:04:00,15,1,559,3,556,0.85%,0.54%
2020-01-01 00:04:00,15,2,135,0,135,0.21%,0.00%
2020-01-01 00:04:00,15,3,4026,138,3888,6.14%,3.43%
2020-01-01 00:04:00,15,4,4724,217,4507,7.21%,4.59%
2020-01-01 00:04:00,15,5,9575,731,8844,14.61%,7.63%
2020-01-01 00:04:00,15,6,4924,231,4693,7.51%,4.69%
2020-01-01 00:04:00,15,7,3551,95,3456,5.42%,2.68%
2020-01-01 00:04:00,15,8,5473,250,5223,8.35%,4.57%
2020-01-01 00:04:00,15,9,9791,766,9025,14.94%,7.82%
2020-01-01 00:04:00,15,10,4295,336,3959,6.55%,7.82%
2020-01-01 00:04:00,15,11,9865,919,8946,15.05%,9.32%
2020-01-01 00:04:00,15,12,24586,4715,19871,37.52%,19.18%
2020-01-01 00:04:00,16,1,415,3,412,0.63%,0.72%
2020-01-01 00:04:00,16,2,314,0,314,0.48%,0.00%
2020-01-01 00:04:00,16,3,1455,16,1439,2.22%,1.10%
2020-01-01 00:04:00,16,4,3892,128,3764,5.94%,3.29%
2020-01-01 00:04:00,16,5,7039,412,6627,10.74%,5.85%
2020-01-01 00:04:00,16,6,4618,167,4451,7.05%,3.62%
2020-01-01 00:04:00,16,7,3343,93,3250,5.10%,2.78%
2020-01-01 00:04:00,16,8,7133,443,6690,10.88%,6.21%
2020-01-01 00:04:00,16,9,7649,490,7159,11.67%,6.41%
2020-01-01 00:04:00,16,10,1493,10,1483,2.28%,0.67%
2020-01-01 00:04:00,16,11,8795,622,8173,13.42%,7.07%
2020-01-01 00:04:00,16,12,24107,4040,20067,36.78%,16.76%
2020-01-01 00:04:10,1,1,20397,2785,17612,31.12%,13.65%
2020-01-01 00:04:10,1,2,5682,248,5434,8.67%,4.36%
2020-01-01 00:04:10,1,3,437,2,435,0.67%,0.46%
2020-01-01 00:04:10,1,4,14396,1427,12969,21.97%,9.91%
2020-01-01 00:04:10,1,5,14079,1370,12709,21.48%,9.73%
2020-01-01 00:04:10,1,6,14016,1355,12661,21.39%,9.67%
2020-01-01 00:04:10,1,7,5226,214,5012,7.97%,4.09%
2020-01-01 00:04:10,1,8,4623,157,4466,7.05%,3.40%
2020-01-01 00:04:10,1,9,13995,1349,12646,21.35%,9.64%
2020-01-01 00:04:10,1,10,3802,103,3699,5.80%,2.71%
2020-01-01 00:04:10,1,11,3845,105,3740,5.87%,2.73%
2020-01-01 00:04:10,1,12,13954,1343,12611,21.29%,9.62%
2020-01-01 00:04:10,2,1,448,13,435,0.68%,2.90%
2020-01-01 00:04:10,2,2,25548,4356,21192,38.98%,17.05%
2020-01-01 00:04:10,2,3,20262,2839,17423,30.92%,14.01%
2020-01-01 00:04:10,2,4,381,13,368,0.58%,3.41%
2020-01-01 00:04:10,2,5,11579,971,10608,17.67%,8.39%
2020-01-01 00:04:10,2,6,66,0,66,0.10%,0.00%
2020-01-01 00:04:10,2,7,4830,177,4653,7.37%,3.66%
2020-01-01 00:04:10,2,8,3965,116,3849,6.05%,2.93%
2020-01-01 00:04:10,2,9,11471,949,10522,17.50%,8.27%
2020-01-01 00:04:10,2,10,3113,71,3042,4.75%,2.28%
2020-01-01 00:04:10,2,11,3138,71,3067,4.79%,2.26%
2020-01-01 00:04:10,2,12,11315,918,10397,17.27%,8.11%
2020-01-01 00:04:10,3,1,2665,48,2617,4.07%,1.80%
2020-01-01 00:04:10,3,2,26651,4827,21824,40.67%,18.11%
2020-01-01 00:04:10,3,3,71695,28261,43434,109.40%,39.42%
2020-01-01 00:04:10,3,4,7246,391,6855,11.06%,5.40%
2020-01-01 00:04:10,3,5,42788,11346,31442,65.29%,26.52%
2020-01-01 00:04:10,3,6,8115,495,7620,12.38%,6.10%
2020-01-01 00:04:10,3,7,22102,3418,18684,33.72%,15.46%
2020-01-01 00:04:10,3,8,16446,1946,14500,25.09%,11.83%
2020-01-01 00:04:10,3,9,34244,7545,26699,52.25%,22.03%
2020-01-01 00:04:10,3,10,8103,469,7634,12.36%,5.79%
2020-01-01 00:04:10,3,11,1810,26,1784,2.76%,1.44%
2020-01-01 00:04:10,3,12,23537,3755,19782,35.91%,15.95%
2020-01-01 00:04:10,4,1,540,4,536,0.82%,0.74%
2020-01-01 00:04:10,4,2,331,2,329,0.51%,0.60%
2020-01-01 00:04:10,4,3,922,8,914,1.41%,0.87%
2020-01-01 00:04:10,4,4,28497,5342,23155,43.48%,18.75%
2020-01-01 00:04:10,4,5,17866,2189,15677,27.26%,12.25%
2020-01-01 00:04:10,4,6,24959,4180,20779,38.08%,16.75%
2020-01-01 00:04:10,4,7,5658,221,5437,8.63%,3.91%
2020-01-01 00:04:10,4,8,2719,43,2676,4.15%,1.58%
2020-01-01 00:04:10,4,9,15623,1675,13948,23.84%,10.72%
2020-01-01 00:04:10,4,10,1856,41,1815,2.83%,2.21%
2020-01-01 00:04:10,4,11,74,0,74,0.11%,0.00%
2020-01-01 00:04:10,4,12,12706,1097,11609,19.39%,8.63%
2020-01-01 00:04:10,5,1,2675,66,2609,4.08%,2.47%
2020-01-01 00:04:10,5,2,557,2,555,0.85%,0.36%
2020-01-01 00:04:10,5,3,2142,33,2109,3.27%,1.54%
2020-01-01 00:04:10,5,4,30530,6291,24239,46.59%,20.61%
2020-01-01 00:04:10,5,5,12078,1050,11028,18.43%,8.69%
2020-01-01 00:04:10,5,6,18545,2471,16074,28.30%,13.32%
2020-01-01 00:04:10,5,7,5854,295,5559,8.93%,5.04%
2020-01-01 00:04:10,5,8,4002,134,3868,6.11%,3.35%
2020-01-01 00:04:10,5,9,9185,618,8567,14.02%,6.73%
2020-01-01 00:04:10,5,10,919,9,910,1.40%,0.98%
2020-01-01 00:04:10,5,11,892,5,887,1.36%,0.56%
2020-01-01 00:04:10,5,12,7824,453,7371,11.94%,5.79%
2020-01-01 00:04:10,6,1,1064,21,1043,1.62%,1.97%
2020-01-01 00:04:10,6,2,1184,24,1160,1.81%,2.03%
2020-01-01 00:04:10,6,3,1595,28,1567,2.43%,1.76%
2020-01-01 00:04:10,6,4,1669,16,1653,2.55%,0.96%
2020-01-01 00:04:10,6,5,16230,1884,14346,24.77%,11.61%
2020-01-01 00:04:10,6,6,4130,163,3967,6.30%,3.95%
2020-01-01 00:04:10,6,7,2082,65,2017,3.18%,3.12%
2020-01-01 00:04:10,6,8,1557,53,1504,2.38%,3.40%
2020-01-01 00:04:10,6,9,10098,709,9389,15.41%,7.02%
2020-01-01 00:04:10,6,10,2150,29,2121,3.28%,1.35%
2020-01-01 00:04:10,6,11,394,0,394,0.60%,0.00%
2020-01-01 00:04:10,6,12,7814,438,7376,11.92%,5.61%
2020-01-01 00:04:10,7,1,530,4,526,0.81%,0.75%
2020-01-01 00:04:10,7,2,221,0,221,0.34%,0.00%
2020-01-01 00:04:10,7,3,1299,7,1292,1.98%,0.54%
2020-01-01 00:04:10,7,4,1681,18,1663,2.57%,1.07%
2020-01-01 00:04:10,7,5,7551,443,7108,11.52%,5.87%
2020-01-01 00:04:10,7,6,12903,1231,11672,19.69%,9.54%
2020-01-01 00:04:10,7,7,3602,82,3520,5.50%,2.28%
2020-01-01 00:04:10,7,8,1279,15,1264,1.95%,1.17%
2020-01-01 00:04:10,7,9,6183,301,5882,9.43%,4.87%
2020-01-01 00:04:10,7,10,1563,22,1541,2.38%,1.41%
2020-01-01 00:04:10,7,11,90,0,90,0.14%,0.00%
2020-01-01 00:04:10,7,12,4671,202,4469,7.13%,4.32%
2020-01-01 00:04:10,8,1,368,1,367,0.56%,0.27%
2020-01-01 00:04:10,8,2,28,0,28,0.04%,0.00%
2020-01-01 00:04:10,8,3,1139,6,1133,1.74%,0.53%
2020-01-01 00:04:10,8,4,2290,38,2252,3.49%,1.66%
2020-01-01 00:04:10,8,5,7816,528,7288,11.93%,6.76%
2020-01-01 00:04:10,8,6,15237,1699,13538,23.25%,11.15%
2020-01-01 00:04:10,8,7,5076,199,4877,7.75%,3.92%
2020-01-01 00:04:10,8,8,2215,40,2175,3.38%,1.81%
2020-01-01 00:04:10,8,9,6150,357,5793,9.38%,5.80%
2020-01-01 00:04:10,8,10,1788,31,1757,2.73%,1.73%
2020-01-01 00:04:10,8,11,328,1,327,0.50%,0.30%
2020-01-01 00:04:10,8,12,4255,138,4117,6.49%,3.24%
2020-01-01 00:04:10,9,1,217,1,216,0.33%,0.46%
2020-01-01 00:04:10,9,2,1946,32,1914,2.97%,1.64%
2020-01-01 00:04:10,9,3,1481,22,1459,2.26%,1.49%
2020-01-01 00:04:10,9,4,5696,237,5459,8.69%,4.16%
2020-01-01 00:04:10,9,5,301,0,301,0.46%,0.00%
2020-01-01 00:04:10,9,6,6681,329,6352,10.19%,4.92%
2020-01-01 00:04:10,9,7,29864,5799,24065,45.57%,19.42%
2020-01-01 00:04:10,9,8,14735,1530,13205,22.48%,10.38%
2020-01-01 00:04:10,9,9,282,0,282,0.43%,0.00%
2020-01-01 00:04:10,9,10,5962,251,5711,9.10%,4.21%
2020-01-01 00:04:10,9,11,13254,1254,12000,20.22%,9.46%
2020-01-01 00:04:10,9,12,6792,327,6465,10.36%,4.81%
2020-01-01 00:04:10,10,1,1064,221,843,1.62%,20.77%
2020-01-01 00:04:10,10,2,2502,261,2241,3.82%,10.43%
2020-01-01 00:04:10,10,3,1217,16,1201,1.86%,1.31%
2020-01-01 00:04:10,10,4,4142,785,3357,6.32%,18.95%
2020-01-01 00:04:10,10,5,518,2,516,0.79%,0.39%
2020-01-01 00:04:10,10,6,6228,923,5305,9.50%,14.82%
2020-01-01 00:04:10,10,7,10814,1628,9186,16.50%,15.05%
2020-01-01 00:04:10,10,8,27906,6880,21026,42.58%,24.65%
2020-01-01 00:04:10,10,9,540,1,539,0.82%,0.19%
2020-01-01 00:04:10,10,10,2340,51,2289,3.57%,2.18%
2020-01-01 00:04:10,10,11,12974,1689,11285,19.80%,13.02%
2020-01-01 00:04:10,10,12,10099,1213,8886,15.41%,12.01%
2020-01-01 00:04:10,11,1,2144,38,2106,3.27%,1.77%
2020-01-01 00:04:10,11,2,3277,82,3195,5.00%,2.50%
2020-01-01 00:04:10,11,3,944,7,937,1.44%,0.74%
2020-01-01 00:04:10,11,4,4931,199,4732,7.52%,4.04%
2020-01-01 00:04:10,11,5,306,1,305,0.47%,0.33%
2020-01-01 00:04:10,11,6,5886,271,5615,8.98%,4.60%
2020-01-01 00:04:10,11,7,11074,919,10155,16.90%,8.30%
2020-01-01 00:04:10,11,8,25222,4351,20871,38.49%,17.25%
2020-01-01 00:04:10,11,9,223,0,223,0.34%,0.00%
2020-01-01 00:04:10,11,10,3575,107,3468,5.46%,2.99%
2020-01-01 00:04:10,11,11,10830,842,9988,16.53%,7.77%
2020-01-01 00:04:10,11,12,6662,312,6350,10.17%,4.68%
2020-01-01 00:04:10,12,1,47,0,47,0.07%,0.00%
2020-01-01 00:04:10,12,2,667,217,450,1.02%,32.53%
2020-01-01 00:04:10,12,3,2670,265,2405,4.07%,9.93%
2020-01-01 00:04:10,12,4,2986,84,2902,4.56%,2.81%
2020-01-01 00:04:10,12,5,8609,773,7836,13.14%,8.98%
2020-01-01 00:04:10,12,6,5097,222,4875,7.78%,4.36%
2020-01-01 00:04:10,12,7,2013,40,1973,3.07%,1.99%
2020-01-01 00:04:10,12,8,1298,331,967,1.98%,25.50%
2020-01-01 00:04:10,12,9,23639,4839,18800,36.07%,20.47%
2020-01-01 00:04:10,12,10,4287,414,3873,6.54%,9.66%
2020-01-01 00:04:10,12,11,1775,338,1437,2.71%,19.04%
2020-01-01 00:04:10,12,12,10086,1416,8670,15.39%,14.04%
2020-01-01 00:04:10,13,1,2627,59,2568,4.01%,2.25%
2020-01-01 00:04:10,13,2,2981,72,2909,4.55%,2.42%
2020-01-01 00:04:10,13,3,495,2,493,0.76%,0.40%
2020-01-01 00:04:10,13,4,6021,490,5531,9.19%,8.14%
2020-01-01 00:04:10,13,5,8865,924,7941,13.53%,10.42%
2020-01-01 00:04:10,13,6,7074,583,6491,10.79%,8.24%
2020-01-01 00:04:10,13,7,5505,243,5262,8.40%,4.41%
2020-01-01 00:04:10,13,8,7699,439,7260,11.75%,5.70%
2020-01-01 00:04:10,13,9,9166,964,8202,13.99%,10.52%
2020-01-01 00:04:10,13,10,27744,5742,22002,42.33%,20.70%
2020-01-01 00:04:10,13,11,16302,2145,14157,24.87%,13.16%
2020-01-01 00:04:10,13,12,8050,771,7279,12.28%,9.58%
2020-01-01 00:04:10,14,1,475,0,475,0.72%,0.00%
2020-01-01 00:04:10,14,2,1520,16,1504,2.32%,1.05%
2020-01-01 00:04:10,14,3,840,3,837,1.28%,0.36%
2020-01-01 00:04:10,14,4,4135,135,4000,6.31%,3.26%
2020-01-01 00:04:10,14,5,1700,23,1677,2.59%,1.35%
2020-01-01 00:04:10,14,6,4367,147,4220,6.66%,3.37%
2020-01-01 00:04:10,14,7,11740,981,10759,17.91%,8.36%
2020-01-01 00:04:10,14,8,12835,1169,11666,19.58%,9.11%
2020-01-01 00:04:10,14,9,1905,27,1878,2.91%,1.42%
2020-01-01 00:04:10,14,10,4130,118,4012,6.30%,2.86%
2020-01-01 00:04:10,14,11,24656,4046,20610,37.62%,16.41%
2020-01-01 00:04:10,14,12,7518,438,7080,11.47%,5.83%
2020-01-01 00:04:10,15,1,404,0,404,0.62%,0.00%
2020-01-01 00:04:10,15,2,295,2,293,0.45%,0.68%
2020-01-01 00:04:10,15,3,4017,122,3895,6.13%,3.04%
2020-01-01 00:04:10,15,4,5746,233,5513,8.77%,4.05%
2020-01-01 00:04:10,15,5,10348,749,9599,15.79%,7.24%
2020-01-01 00:04:10,15,6,5991,262,5729,9.14%,4.37%
2020-01-01 00:04:10,15,7,3556,119,3437,5.43%,3.35%
2020-01-01 00:04:10,15,8,5032,212,4820,7.68%,4.21%
2020-01-01 00:04:10,15,9,10616,792,9824,16.20%,7.46%
2020-01-01 00:04:10,15,10,3867,125,3742,5.90%,3.23%
2020-01-01 00:04:10,15,11,9181,674,8507,14.01%,7.34%
2020-01-01 00:04:10,15,12,24824,4516,20308,37.88%,18.19%
2020-01-01 00:04:10,16,1,486,4,482,0.74%,0.82%
2020-01-01 00:04:10,16,2,212,0,212,0.32%,0.00%
2020-01-01 00:04:10,16,3,1148,11,1137,1.75%,0.96%
2020-01-01 00:04:10,16,4,4174,150,4024,6.37%,3.59%
2020-01-01 00:04:10,16,5,7357,502,6855,11.23%,6.82%
2020-01-01 00:04:10,16,6,4967,201,4766,7.58%,4.05%
2020-01-01 00:04:10,16,7,3535,111,3424,5.39%,3.14%
2020-01-01 00:04:10,16,8,7668,468,7200,11.70%,6.10%
2020-01-01 00:04:10,16,9,7799,549,7250,11.90%,7.04%
2020-01-01 00:04:10,16,10,1710,18,1692,2.61%,1.05%
2020-01-01 00:04:10,16,11,9584,697,8887,14.62%,7.27%
2020-01-01 00:04:10,16,12,25003,4363,20640,38.15%,17.45%
2020-01-01 00:04:20,1,1,16521,1907,14614,25.21%,11.54%
2020-01-01 00:04:20,1,2,5600,217,5383,8.54%,3.88%
2020-01-01 00:04:20,1,3,589,4,585,0.90%,0.68%
2020-01-01 00:04:20,1,4,10525,805,9720,16.06%,7.65%
2020-01-01 00:04:20,1,5,10360,781,9579,15.81%,7.54%
2020-01-01 00:04:20,1,6,10277,765,9512,15.68%,7.44%
2020-01-01 00:04:20,1,7,4993,177,4816,7.62%,3.54%
2020-01-01 00:04:20,1,8,4214,113,4101,6.43%,2.68%
2020-01-01 00:04:20,1,9,10249,762,9487,15.64%,7.43%
2020-01-01 00:04:20,1,10,3719,78,3641,5.67%,2.10%
2020-01-01 00:04:20,1,11,3776,80,3696,5.76%,2.12%
2020-01-01 00:04:20,1,12,10206,761,9445,15.57%,7.46%
2020-01-01 00:04:20,2,1,354,0,354,0.54%,0.00%
2020-01-01 00:04:20,2,2,31086,6272,24814,47.43%,20.18%
2020-01-01 00:04:20,2,3,26173,4528,21645,39.94%,17.30%
2020-01-01 00:04:20,2,4,219,0,219,0.33%,0.00%
2020-01-01 00:04:20,2,5,15409,1680,13729,23.51%,10.90%
2020-01-01 00:04:20,2,6,64,0,64,0.10%,0.00%
2020-01-01 00:04:20,2,7,4550,180,4370,6.94%,3.96%
2020-01-01 00:04:20,2,8,3777,117,3660,5.76%,3.10%
2020-01-01 00:04:20,2,9,15312,1664,13648,23.36%,10.87%
2020-01-01 00:04:20,2,10,2986,79,2907,4.56%,2.65%
2020-01-01 00:04:20,2,11,3004,80,2924,4.58%,2.66%
2020-01-01 00:04:20,2,12,15157,1636,13521,23.13%,10.79%
2020-01-01 00:04:20,3,1,1459,10,1449,2.23%,0.69%
2020-01-01 00:04:20,3,2,26312,4668,21644,40.15%,17.74%
2020-01-01 00:04:20,3,3,75349,30618,44731,114.97%,40.63%
2020-01-01 00:04:20,3,4,7851,464,7387,11.98%,5.91%
2020-01-01 00:04:20,3,5,47744,13875,33869,72.85%,29.06%
2020-01-01 00:04:20,3,6,9267,659,8608,14.14%,7.11%
2020-01-01 00:04:20,3,7,23023,3620,19403,35.13%,15.72%
2020-01-01 00:04:20,3,8,17055,2054,15001,26.02%,12.04%
2020-01-01 00:04:20,3,9,38048,9184,28864,58.06%,24.14%
2020-01-01 00:04:20,3,10,6534,318,6216,9.97%,4.87%
2020-01-01 00:04:20,3,11,1278,11,1267,1.95%,0.86%
2020-01-01 00:04:20,3,12,28513,5362,23151,43.51%,18.81%
2020-01-01 00:04:20,4,1,471,3,468,0.72%,0.64%
2020-01-01 00:04:20,4,2,263,0,263,0.40%,0.00%
2020-01-01 00:04:20,4,3,781,3,778,1.19%,0.38%
2020-01-01 00:04:20,4,4,26923,4883,22040,41.08%,18.14%
2020-01-01 00:04:20,4,5,16467,1913,14554,25.13%,11.62%
2020-01-01 00:04:20,4,6,23520,3817,19703,35.89%,16.23%
2020-01-01 00:04:20,4,7,5391,210,5181,8.23%,3.90%
2020-01-01 00:04:20,4,8,3014,64,2950,4.60%,2.12%
2020-01-01 00:04:20,4,9,14482,1488,12994,22.10%,10.27%
2020-01-01 00:04:20,4,10,1946,27,1919,2.97%,1.39%
2020-01-01 00:04:20,4,11,168,0,168,0.26%,0.00%
2020-01-01 00:04:20,4,12,11812,1001,10811,18.02%,8.47%
2020-01-01 00:04:20,5,1,3085,66,3019,4.71%,2.14%
2020-01-01 00:04:20,5,2,1102,9,1093,1.68%,0.82%
2020-01-01 00:04:20,5,3,1348,6,1342,2.06%,0.45%
2020-01-01 00:04:20,5,4,24673,4171,20502,37.65%,16.91%
2020-01-01 00:04:20,5,5,10242,774,9468,15.63%,7.56%
2020-01-01 00:04:20,5,6,15280,1678,13602,23.32%,10.98%
2020-01-01 00:04:20,5,7,4575,171,4404,6.98%,3.74%
2020-01-01 00:04:20,5,8,3226,84,3142,4.92%,2.60%
2020-01-01 00:04:20,5,9,8725,571,8154,13.31%,6.54%
2020-01-01 00:04:20,5,10,1005,6,999,1.53%,0.60%
2020-01-01 00:04:20,5,11,669,4,665,1.02%,0.60%
2020-01-01 00:04:20,5,12,7441,433,7008,11.35%,5.82%
2020-01-01 00:04:20,6,1,1145,10,1135,1.75%,0.87%
2020-01-01 00:04:20,6,2,1240,10,1230,1.89%,0.81%
2020-01-01 00:04:20,6,3,1549,14,1535,2.36%,0.90%
2020-01-01 00:04:20,6,4,1407,6,1401,2.15%,0.43%
2020-01-01 00:04:20,6,5,14644,1509,13135,22.34%,10.30%
2020-01-01 00:04:20,6,6,4392,131,4261,6.70%,2.98%
2020-01-01 00:04:20,6,7,2310,51,2259,3.52%,2.21%
2020-01-01 00:04:20,6,8,1837,40,1797,2.80%,2.18%
2020-01-01 00:04:20,6,9,8165,506,7659,12.46%,6.20%
2020-01-01 00:04:20,6,10,3248,78,3170,4.96%,2.40%
2020-01-01 00:04:20,6,11,463,1,462,0.71%,0.22%
2020-01-01 00:04:20,6,12,4857,184,4673,7.41%,3.79%
2020-01-01 00:04:20,7,1,342,1,341,0.52%,0.29%
2020-01-01 00:04:20,7,2,136,0,136,0.21%,0.00%
2020-01-01 00:04:20,7,3,1481,14,1467,2.26%,0.95%
2020-01-01 00:04:20,7,4,1531,19,1512,2.34%,1.24%
2020-01-01 00:04:20,7,5,8784,483,8301,13.40%,5.50%
2020-01-01 00:04:20,7,6,13016,1162,11854,19.86%,8.93%
2020-01-01 00:04:20,7,7,2612,44,2568,3.99%,1.68%
2020-01-01 00:04:20,7,8,962,6,956,1.47%,0.62%
2020-01-01 00:04:20,7,9,7129,322,6807,10.88%,4.52%
2020-01-01 00:04:20,7,10,1766,16,1750,2.69%,0.91%
2020-01-01 00:04:20,7,11,84,0,84,0.13%,0.00%
2020-01-01 00:04:20,7,12,5374,195,5179,8.20%,3.63%
2020-01-01 00:04:20,8,1,430,1,429,0.66%,0.23%
2020-01-01 00:04:20,8,2,72,0,72,0.11%,0.00%
2020-01-01 00:04:20,8,3,1380,24,1356,2.11%,1.74%
2020-01-01 00:04:20,8,4,3084,61,3023,4.71%,1.98%
2020-01-01 00:04:20,8,5,7438,415,7023,11.35%,5.58%
2020-01-01 00:04:20,8,6,16093,1912,14181,24.56%,11.88%
2020-01-01 00:04:20,8,7,5498,246,5252,8.39%,4.47%
2020-01-01 00:04:20,8,8,2102,32,2070,3.21%,1.52%
2020-01-01 00:04:20,8,9,5842,244,5598,8.91%,4.18%
2020-01-01 00:04:20,8,10,1707,25,1682,2.60%,1.46%
2020-01-01 00:04:20,8,11,259,0,259,0.40%,0.00%
2020-01-01 00:04:20,8,12,4136,130,4006,6.31%,3.14%
2020-01-01 00:04:20,9,1,2278,12,2266,3.48%,0.53%
2020-01-01 00:04:20,9,2,7781,427,7354,11.87%,5.49%
2020-01-01 00:04:20,9,3,5015,182,4833,7.65%,3.63%
2020-01-01 00:04:20,9,4,7637,423,7214,11.65%,5.54%
2020-01-01 00:04:20,9,5,286,0,286,0.44%,0.00%
2020-01-01 00:04:20,9,6,8264,504,7760,12.61%,6.10%
2020-01-01 00:04:20,9,7,35031,7987,27044,53.45%,22.80%
2020-01-01 00:04:20,9,8,9815,734,9081,14.98%,7.48%
2020-01-01 00:04:20,9,9,161,0,161,0.25%,0.00%
2020-01-01 00:04:20,9,10,2168,36,2132,3.31%,1.66%
2020-01-01 00:04:20,9,11,8325,539,7786,12.70%,6.47%
2020-01-01 00:04:20,9,12,5813,261,5552,8.87%,4.49%
2020-01-01 00:04:20,10,1,1225,175,1050,1.87%,14.29%
2020-01-01 00:04:20,10,2,2541,221,2320,3.88%,8.70%
2020-01-01 00:04:20,10,3,1099,14,1085,1.68%,1.27%
2020-01-01 00:04:20,10,4,4186,630,3556,6.39%,15.05%
2020-01-01 00:04:20,10,5,651,0,651,0.99%,0.00%
2020-01-01 00:04:20,10,6,6158,755,5403,9.40%,12.26%
2020-01-01 00:04:20,10,7,10457,1436,9021,15.96%,13.73%
2020-01-01 00:04:20,10,8,29312,7074,22238,44.73%,24.13%
2020-01-01 00:04:20,10,9,544,1,543,0.83%,0.18%
2020-01-01 00:04:20,10,10,2762,57,2705,4.21%,2.06%
2020-01-01 00:04:20,10,11,14144,1902,12242,21.58%,13.45%
2020-01-01 00:04:20,10,12,10928,1381,9547,16.67%,12.64%
2020-01-01 00:04:20,11,1,2448,36,2412,3.74%,1.47%
2020-01-01 00:04:20,11,2,3434,81,3353,5.24%,2.36%
2020-01-01 00:04:20,11,3,876,8,868,1.34%,0.91%
2020-01-01 00:04:20,11,4,3382,82,3300,5.16%,2.42%
2020-01-01 00:04:20,11,5,175,1,174,0.27%,0.57%
2020-01-01 00:04:20,11,6,4240,135,4105,6.47%,3.18%
2020-01-01 00:04:20,11,7,9681,674,9007,14.77%,6.96%
2020-01-01 00:04:20,11,8,21762,3343,18419,33.21%,15.36%
2020-01-01 00:04:20,11,9,261,0,261,0.40%,0.00%
2020-01-01 00:04:20,11,10,2570,68,2502,3.92%,2.65%
2020-01-01 00:04:20,11,11,9315,632,8683,14.21%,6.78%
2020-01-01 00:04:20,11,12,6359,302,6057,9.70%,4.75%
2020-01-01 00:04:20,12,1,87,0,87,0.13%,0.00%
2020-01-01 00:04:20,12,2,725,212,513,1.11%,29.24%
2020-01-01 00:04:20,12,3,2435,237,2198,3.72%,9.73%
2020-01-01 00:04:20,12,4,2728,61,2667,4.16%,2.24%
2020-01-01 00:04:20,12,5,8534,656,7878,13.02%,7.69%
2020-01-01 00:04:20,12,6,5282,192,5090,8.06%,3.63%
2020-01-01 00:04:20,12,7,2422,53,2369,3.70%,2.19%
2020-01-01 00:04:20,12,8,952,334,618,1.45%,35.08%
2020-01-01 00:04:20,12,9,21379,4257,17122,32.62%,19.91%
2020-01-01 00:04:20,12,10,3560,419,3141,5.43%,11.77%
2020-01-01 00:04:20,12,11,1113,334,779,1.70%,30.01%
2020-01-01 00:04:20,12,12,8601,1352,7249,13.12%,15.72%
2020-01-01 00:04:20,13,1,2416,69,2347,3.69%,2.86%
2020-01-01 00:04:20,13,2,2739,80,2659,4.18%,2.92%
2020-01-01 00:04:20,13,3,583,6,577,0.89%,1.03%
2020-01-01 00:04:20,13,4,4914,453,4461,7.50%,9.22%
2020-01-01 00:04:20,13,5,6765,637,6128,10.32%,9.42%
2020-01-01 00:04:20,13,6,5442,479,4963,8.30%,8.80%
2020-01-01 00:04:20,13,7,5525,272,5253,8.43%,4.92%
2020-01-01 00:04:20,13,8,7485,447,7038,11.42%,5.97%
2020-01-01 00:04:20,13,9,7163,675,6488,10.93%,9.42%
2020-01-01 00:04:20,13,10,27403,5557,21846,41.81%,20.28%
2020-01-01 00:04:20,13,11,17509,2539,14970,26.72%,14.50%
2020-01-01 00:04:20,13,12,9587,1067,8520,14.63%,11.13%
2020-01-01 00:04:20,14,1,284,0,284,0.43%,0.00%
2020-01-01 00:04:20,14,2,1326,15,1311,2.02%,1.13%
2020-01-01 00:04:20,14,3,831,10,821,1.27%,1.20%
2020-01-01 00:04:20,14,4,4108,124,3984,6.27%,3.02%
2020-01-01 00:04:20,14,5,1314,10,1304,2.01%,0.76%
2020-01-01 00:04:20,14,6,4326,139,4187,6.60%,3.21%
2020-01-01 00:04:20,14,7,11147,818,10329,17.01%,7.34%
2020-01-01 00:04:20,14,8,12660,1061,11599,19.32%,8.38%
2020-01-01 00:04:20,14,9,1579,18,1561,2.41%,1.14%
2020-01-01 00:04:20,14,10,4332,152,4180,6.61%,3.51%
2020-01-01 00:04:20,14,11,25052,4118,20934,38.23%,16.44%
2020-01-01 00:04:20,14,12,7795,442,7353,11.89%,5.67%
2020-01-01 00:04:20,15,1,576,4,572,0.88%,0.69%
2020-01-01 00:04:20,15,2,286,1,285,0.44%,0.35%
2020-01-01 00:04:20,15,3,4602,172,4430,7.02%,3.74%
2020-01-01 00:04:20,15,4,4376,169,4207,6.68%,3.86%
2020-01-01 00:04:20,15,5,10761,875,9886,16.42%,8.13%
2020-01-01 00:04:20,15,6,4625,185,4440,7.06%,4.00%
2020-01-01 00:04:20,15,7,3817,129,3688,5.82%,3.38%
2020-01-01 00:04:20,15,8,5324,224,5100,8.12%,4.21%
2020-01-01 00:04:20,15,9,10972,905,10067,16.74%,8.25%
2020-01-01 00:04:20,15,10,3718,119,3599,5.67%,3.20%
2020-01-01 00:04:20,15,11,9184,659,8525,14.01%,7.18%
2020-01-01 00:04:20,15,12,26158,4876,21282,39.91%,18.64%
2020-01-01 00:04:20,16,1,337,1,336,0.51%,0.30%
2020-01-01 00:04:20,16,2,201,0,201,0.31%,0.00%
2020-01-01 00:04:20,16,3,1995,33,1962,3.04%,1.65%
2020-01-01 00:04:20,16,4,4332,159,4173,6.61%,3.67%
2020-01-01 00:04:20,16,5,8153,573,7580,12.44%,7.03%
2020-01-01 00:04:20,16,6,5065,202,4863,7.73%,3.99%
2020-01-01 00:04:20,16,7,3174,77,3097,4.84%,2.43%
2020-01-01 00:04:20,16,8,7425,490,6935,11.33%,6.60%
2020-01-01 00:04:20,16,9,8474,622,7852,12.93%,7.34%
2020-01-01 00:04:20,16,10,1625,21,1604,2.48%,1.29%
2020-01-01 00:04:20,16,11,9196,729,8467,14.03%,7.93%
2020-01-01 00:04:20,16,12,25540,4600,20940,38.97%,18.01%
2020-01-01 00:04:30,1,1,19550,2641,16909,29.83%,13.51%
2020-01-01 00:04:30,1,2,8587,508,8079,13.10%,5.92%
2020-01-01 00:04:30,1,3,1004,3,1001,1.53%,0.30%
2020-01-01 00:04:30,1,4,10470,800,9670,15.98%,7.64%
2020-01-01 00:04:30,1,5,10161,762,9399,15.50%,7.50%
2020-01-01 00:04:30,1,6,10155,760,9395,15.50%,7.48%
2020-01-01 00:04:30,1,7,7572,397,7175,11.55%,5.24%
2020-01-01 00:04:30,1,8,5687,209,5478,8.68%,3.68%
2020-01-01 00:04:30,1,9,10122,758,9364,15.44%,7.49%
2020-01-01 00:04:30,1,10,5153,182,4971,7.86%,3.53%
2020-01-01 00:04:30,1,11,5212,184,5028,7.95%,3.53%
2020-01-01 00:04:30,1,12,10094,756,9338,15.40%,7.49%
2020-01-01 00:04:30,2,1,473,1,472,0.72%,0.21%
2020-01-01 00:04:30,2,2,30858,6342,24516,47.09%,20.55%
2020-01-01 00:04:30,2,3,25344,4389,20955,38.67%,17.32%
2020-01-01 00:04:30,2,4,361,0,361,0.55%,0.00%
2020-01-01 00:04:30,2,5,15681,1768,13913,23.93%,11.27%
2020-01-01 00:04:30,2,6,40,0,40,0.06%,0.00%
2020-01-01 00:04:30,2,7,5013,192,4821,7.65%,3.83%
2020-01-01 00:04:30,2,8,3647,94,3553,5.56%,2.58%
2020-01-01 00:04:30,2,9,15532,1732,13800,23.70%,11.15%
2020-01-01 00:04:30,2,10,2960,62,2898,4.52%,2.09%
2020-01-01 00:04:30,2,11,2978,63,2915,4.54%,2.12%
2020-01-01 00:04:30,2,12,15359,1689,13670,23.44%,11.00%
2020-01-01 00:04:30,3,1,1590,12,1578,2.43%,0.75%
2020-01-01 00:04:30,3,2,22647,3426,19221,34.56%,15.13%
2020-01-01 00:04:30,3,3,69189,26358,42831,105.57%,38.10%
2020-01-01 00:04:30,3,4,4783,172,4611,7.30%,3.60%
2020-01-01 00:04:30,3,5,45796,12857,32939,69.88%,28.07%
2020-01-01 00:04:30,3,6,5860,241,5619,8.94%,4.11%
2020-01-01 00:04:30,3,7,19679,2626,17053,30.03%,13.34%
2020-01-01 00:04:30,3,8,17084,2007,15077,26.07%,11.75%
2020-01-01 00:04:30,3,9,39331,9811,29520,60.01%,24.94%
2020-01-01 00:04:30,3,10,5849,246,5603,8.92%,4.21%
2020-01-01 00:04:30,3,11,1765,30,1735,2.69%,1.70%
2020-01-01 00:04:30,3,12,30023,5946,24077,45.81%,19.80%
2020-01-01 00:04:30,4,1,583,2,581,0.89%,0.34%
2020-01-01 00:04:30,4,2,393,0,393,0.60%,0.00%
2020-01-01 00:04:30,4,3,622,4,618,0.95%,0.64%
2020-01-01 00:04:30,4,4,27342,5000,22342,41.72%,18.29%
2020-01-01 00:04:30,4,5,16823,2006,14817,25.67%,11.92%
2020-01-01 00:04:30,4,6,23319,3757,19562,35.58%,16.11%
2020-01-01 00:04:30,4,7,5009,184,4825,7.64%,3.67%
2020-01-01 00:04:30,4,8,2915,63,2852,4.45%,2.16%
2020-01-01 00:04:30,4,9,14865,1590,13275,22.68%,10.70%
2020-01-01 00:04:30,4,10,1973,29,1944,3.01%,1.47%
2020-01-01 00:04:30,4,11,263,0,263,0.40%,0.00%
2020-01-01 00:04:30,4,12,12308,1108,11200,18.78%,9.00%
2020-01-01 00:04:30,5,1,3060,73,2987,4.67%,2.39%
2020-01-01 00:04:30,5,2,1047,10,1037,1.60%,0.96%
2020-01-01 00:04:30,5,3,586,7,579,0.89%,1.19%
2020-01-01 00:04:30,5,4,21027,3045,17982,32.08%,14.48%
2020-01-01 00:04:30,5,5,9069,610,8459,13.84%,6.73%
2020-01-01 00:04:30,5,6,13768,1390,12378,21.01%,10.10%
2020-01-01 00:04:30,5,7,4248,146,4102,6.48%,3.44%
2020-01-01 00:04:30,5,8,3227,76,3151,4.92%,2.36%
2020-01-01 00:04:30,5,9,8351,507,7844,12.74%,6.07%
2020-01-01 00:04:30,5,10,1295,11,1284,1.98%,0.85%
2020-01-01 00:04:30,5,11,636,3,633,0.97%,0.47%
2020-01-01 00:04:30,5,12,6855,361,6494,10.46%,5.27%
2020-01-01 00:04:30,6,1,1296,14,1282,1.98%,1.08%
2020-01-01 00:04:30,6,2,1615,22,1593,2.46%,1.36%
2020-01-01 00:04:30,6,3,2246,35,2211,3.43%,1.56%
2020-01-01 00:04:30,6,4,1073,8,1065,1.64%,0.75%
2020-01-01 00:04:30,6,5,13017,1234,11783,19.86%,9.48%
2020-01-01 00:04:30,6,6,4947,190,4757,7.55%,3.84%
2020-01-01 00:04:30,6,7,3247,84,3163,4.95%,2.59%
2020-01-01 00:04:30,6,8,2741,60,2681,4.18%,2.19%
2020-01-01 00:04:30,6,9,5503,268,5235,8.40%,4.87%
2020-01-01 00:04:30,6,10,1880,24,1856,2.87%,1.28%
2020-01-01 00:04:30,6,11,372,0,372,0.57%,0.00%
2020-01-01 00:04:30,6,12,3587,145,3442,5.47%,4.04%
2020-01-01 00:04:30,7,1,411,5,406,0.63%,1.22%
2020-01-01 00:04:30,7,2,331,0,331,0.51%,0.00%
2020-01-01 00:04:30,7,3,488,7,481,0.74%,1.43%
2020-01-01 00:04:30,7,4,2126,54,2072,3.24%,2.54%
2020-01-01 00:04:30,7,5,6998,358,6640,10.68%,5.12%
2020-01-01 00:04:30,7,6,12986,1227,11759,19.82%,9.45%
2020-01-01 00:04:30,7,7,3821,117,3704,5.83%,3.06%
2020-01-01 00:04:30,7,8,1580,23,1557,2.41%,1.46%
2020-01-01 00:04:30,7,9,6116,271,5845,9.33%,4.43%
2020-01-01 00:04:30,7,10,1071,5,1066,1.63%,0.47%
2020-01-01 00:04:30,7,11,72,0,72,0.11%,0.00%
2020-01-01 00:04:30,7,12,5046,172,4874,7.70%,3.41%
2020-01-01 00:04:30,8,1,575,2,573,0.88%,0.35%
2020-01-01 00:04:30,8,2,58,0,58,0.09%,0.00%
2020-01-01 00:04:30,8,3,1621,23,1598,2.47%,1.42%
2020-01-01 00:04:30,8,4,3013,55,2958,4.60%,1.83%
2020-01-01 00:04:30,8,5,9241,602,8639,14.10%,6.51%
2020-01-01 00:04:30,8,6,17290,2099,15191,26.38%,12.14%
2020-01-01 00:04:30,8,7,4971,199,4772,7.59%,4.00%
2020-01-01 00:04:30,8,8,2043,34,2009,3.12%,1.66%
2020-01-01 00:04:30,8,9,7398,400,6998,11.29%,5.41%
2020-01-01 00:04:30,8,10,1703,18,1685,2.60%,1.06%
2020-01-01 00:04:30,8,11,132,0,132,0.20%,0.00%
2020-01-01 00:04:30,8,12,5747,246,5501,8.77%,4.28%
2020-01-01 00:04:30,9,1,463,2,461,0.71%,0.43%
2020-01-01 00:04:30,9,2,2217,45,2172,3.38%,2.03%
2020-01-01 00:04:30,9,3,1343,12,1331,2.05%,0.89%
2020-01-01 00:04:30,9,4,5966,257,5709,9.10%,4.31%
2020-01-01 00:04:30,9,5,582,2,580,0.89%,0.34%
2020-01-01 00:04:30,9,6,7335,403,6932,11.19%,5.49%
2020-01-01 00:04:30,9,7,30176,6029,24147,46.04%,19.98%
2020-01-01 00:04:30,9,8,13268,1276,11992,20.25%,9.62%
2020-01-01 00:04:30,9,9,264,0,264,0.40%,0.00%
2020-01-01 00:04:30,9,10,5334,202,5132,8.14%,3.79%
2020-01-01 00:04:30,9,11,11742,1010,10732,17.92%,8.60%
2020-01-01 00:04:30,9,12,5951,277,5674,9.08%,4.65%
2020-01-01 00:04:30,10,1,1445,217,1228,2.20%,15.02%
2020-01-01 00:04:30,10,2,3294,277,3017,5.03%,8.41%
2020-01-01 00:04:30,10,3,1712,20,1692,2.61%,1.17%
2020-01-01 00:04:30,10,4,3919,1129,2790,5.98%,28.81%
2020-01-01 00:04:30,10,5,967,112,855,1.48%,11.58%
2020-01-01 00:04:30,10,6,5905,1343,4562,9.01%,22.74%
2020-01-01 00:04:30,10,7,10515,1967,8548,16.04%,18.71%
2020-01-01 00:04:30,10,8,28324,7211,21113,43.22%,25.46%
2020-01-01 00:04:30,10,9,653,2,651,1.00%,0.31%
2020-01-01 00:04:30,10,10,2072,34,2038,3.16%,1.64%
2020-01-01 00:04:30,10,11,13835,1686,12149,21.11%,12.19%
2020-01-01 00:04:30,10,12,10937,1241,9696,16.69%,11.35%
2020-01-01 00:04:30,11,1,2453,43,2410,3.74%,1.75%
2020-01-01 00:04:30,11,2,6003,273,5730,9.16%,4.55%
2020-01-01 00:04:30,11,3,3392,91,3301,5.18%,2.68%
2020-01-01 00:04:30,11,4,3336,111,3225,5.09%,3.33%
2020-01-01 00:04:30,11,5,337,1,336,0.51%,0.30%
2020-01-01 00:04:30,11,6,4638,190,4448,7.08%,4.10%
2020-01-01 00:04:30,11,7,12360,1157,11203,18.86%,9.36%
2020-01-01 00:04:30,11,8,27153,4999,22154,41.43%,18.41%
2020-01-01 00:04:30,11,9,155,1,154,0.24%,0.65%
2020-01-01 00:04:30,11,10,2776,55,2721,4.24%,1.98%
2020-01-01 00:04:30,11,11,10365,744,9621,15.82%,7.18%
2020-01-01 00:04:30,11,12,7003,321,6682,10.69%,4.58%
2020-01-01 00:04:30,12,1,50,0,50,0.08%,0.00%
2020-01-01 00:04:30,12,2,483,115,368,0.74%,23.81%
2020-01-01 00:04:30,12,3,3352,190,3162,5.11%,5.67%
2020-01-01 00:04:30,12,4,2680,55,2625,4.09%,2.05%
2020-01-01 00:04:30,12,5,8333,584,7749,12.72%,7.01%
2020-01-01 00:04:30,12,6,4334,144,4190,6.61%,3.32%
2020-01-01 00:04:30,12,7,1539,23,1516,2.35%,1.49%
2020-01-01 00:04:30,12,8,1941,335,1606,2.96%,17.26%
2020-01-01 00:04:30,12,9,23025,4496,18529,35.13%,19.53%
2020-01-01 00:04:30,12,10,4730,452,4278,7.22%,9.56%
2020-01-01 00:04:30,12,11,2309,343,1966,3.52%,14.85%
2020-01-01 00:04:30,12,12,9279,1425,7854,14.16%,15.36%
2020-01-01 00:04:30,13,1,2011,30,1981,3.07%,1.49%
2020-01-01 00:04:30,13,2,2411,44,2367,3.68%,1.82%
2020-01-01 00:04:30,13,3,694,1,693,1.06%,0.14%
2020-01-01 00:04:30,13,4,4999,806,4193,7.63%,16.12%
2020-01-01 00:04:30,13,5,7644,1186,6458,11.66%,15.52%
2020-01-01 00:04:30,13,6,5567,838,4729,8.49%,15.05%
2020-01-01 00:04:30,13,7,4447,140,4307,6.79%,3.15%
2020-01-01 00:04:30,13,8,6530,316,6214,9.96%,4.84%
2020-01-01 00:04:30,13,9,7935,1217,6718,12.11%,15.34%
2020-01-01 00:04:30,13,10,27573,5699,21874,42.07%,20.67%
2020-01-01 00:04:30,13,11,17478,2267,15211,26.67%,12.97%
2020-01-01 00:04:30,13,12,10525,961,9564,16.06%,9.13%
2020-01-01 00:04:30,14,1,188,1,187,0.29%,0.53%
2020-01-01 00:04:30,14,2,1074,8,1066,1.64%,0.74%
2020-01-01 00:04:30,14,3,720,6,714,1.10%,0.83%
2020-01-01 00:04:30,14,4,3937,168,3769,6.01%,4.27%
2020-01-01 00:04:30,14,5,841,5,836,1.28%,0.59%
2020-01-01 00:04:30,14,6,4293,188,4105,6.55%,4.38%
2020-01-01 00:04:30,14,7,11587,986,10601,17.68%,8.51%
2020-01-01 00:04:30,14,8,13528,1371,12157,20.64%,10.13%
2020-01-01 00:04:30,14,9,1047,11,1036,1.60%,1.05%
2020-01-01 00:04:30,14,10,4069,151,3918,6.21%,3.71%
2020-01-01 00:04:30,14,11,26609,4877,21732,40.60%,18.33%
2020-01-01 00:04:30,14,12,8635,507,8128,13.18%,5.87%
2020-01-01 00:04:30,15,1,610,3,607,0.93%,0.49%
2020-01-01 00:04:30,15,2,154,0,154,0.23%,0.00%
2020-01-01 00:04:30,15,3,6967,322,6645,10.63%,4.62%
2020-01-01 00:04:30,15,4,4649,318,4331,7.09%,6.84%
2020-01-01 00:04:30,15,5,12594,1261,11333,19.22%,10.01%
2020-01-01 00:04:30,15,6,4895,382,4513,7.47%,7.80%
2020-01-01 00:04:30,15,7,3584,95,3489,5.47%,2.65%
2020-01-01 00:04:30,15,8,5533,247,5286,8.44%,4.46%
2020-01-01 00:04:30,15,9,12752,1294,11458,19.46%,10.15%
2020-01-01 00:04:30,15,10,5828,426,5402,8.89%,7.31%
2020-01-01 00:04:30,15,11,11629,1137,10492,17.74%,9.78%
2020-01-01 00:04:30,15,12,29749,6458,23291,45.39%,21.71%
2020-01-01 00:04:30,16,1,390,1,389,0.60%,0.26%
2020-01-01 00:04:30,16,2,231,0,231,0.35%,0.00%
2020-01-01 00:04:30,16,3,1218,15,1203,1.86%,1.23%
2020-01-01 00:04:30,16,4,4108,108,4000,6.27%,2.63%
2020-01-01 00:04:30,16,5,7990,517,7473,12.19%,6.47%
2020-01-01 00:04:30,16,6,5123,192,4931,7.82%,3.75%
2020-01-01 00:04:30,16,7,3483,96,3387,5.31%,2.76%
2020-01-01 00:04:30,16,8,7443,495,6948,11.36%,6.65%
2020-01-01 00:04:30,16,9,8392,557,7835,12.81%,6.64%
2020-01-01 00:04:30,16,10,1537,18,1519,2.35%,1.17%
2020-01-01 00:04:30,16,11,9204,719,8485,14.04%,7.81%
2020-01-01 00:04:30,16,12,26010,4604,21406,39.69%,17.70%
2020-01-01 00:04:40,1,1,20864,3081,17783,31.84%,14.77%
2020-01-01 00:04:40,1,2,9763,682,9081,14.90%,6.99%
2020-01-01 00:04:40,1,3,516,5,511,0.79%,0.97%
2020-01-01 00:04:40,1,4,10831,896,9935,16.53%,8.27%
2020-01-01 00:04:40,1,5,10488,853,9635,16.00%,8.13%
2020-01-01 00:04:40,1,6,10455,846,9609,15.95%,8.09%
2020-01-01 00:04:40,1,7,9235,613,8622,14.09%,6.64%
2020-01-01 00:04:40,1,8,6466,302,6164,9.87%,4.67%
2020-01-01 00:04:40,1,9,10392,837,9555,15.86%,8.05%
2020-01-01 00:04:40,1,10,5844,249,5595,8.92%,4.26%
2020-01-01 00:04:40,1,11,5949,261,5688,9.08%,4.39%
2020-01-01 00:04:40,1,12,10368,835,9533,15.82%,8.05%
2020-01-01 00:04:40,2,1,557,2,555,0.85%,0.36%
2020-01-01 00:04:40,2,2,34054,7444,26610,51.96%,21.86%
2020-01-01 00:04:40,2,3,28458,5393,23065,43.42%,18.95%
2020-01-01 00:04:40,2,4,437,0,437,0.67%,0.00%
2020-01-01 00:04:40,2,5,16865,2002,14863,25.73%,11.87%
2020-01-01 00:04:40,2,6,37,0,37,0.06%,0.00%
2020-01-01 00:04:40,2,7,5024,161,4863,7.67%,3.20%
2020-01-01 00:04:40,2,8,3857,87,3770,5.89%,2.26%
2020-01-01 00:04:40,2,9,16455,1897,14558,25.11%,11.53%
2020-01-01 00:04:40,2,10,2592,43,2549,3.96%,1.66%
2020-01-01 00:04:40,2,11,2604,43,2561,3.97%,1.65%
2020-01-01 00:04:40,2,12,16170,1837,14333,24.67%,11.36%
2020-01-01 00:04:40,3,1,1764,20,1744,2.69%,1.13%
2020-01-01 00:04:40,3,2,22670,3502,19168,34.59%,15.45%
2020-01-01 00:04:40,3,3,65845,24434,41411,100.47%,37.11%
2020-01-01 00:04:40,3,4,5716,227,5489,8.72%,3.97%
2020-01-01 00:04:40,3,5,41714,10928,30786,63.65%,26.20%
2020-01-01 00:04:40,3,6,6428,290,6138,9.81%,4.51%
2020-01-01 00:04:40,3,7,19343,2595,16748,29.52%,13.42%
2020-01-01 00:04:40,3,8,16465,1913,14552,25.12%,11.62%
2020-01-01 00:04:40,3,9,34901,7897,27004,53.25%,22.63%
2020-01-01 00:04:40,3,10,5262,215,5047,8.03%,4.09%
2020-01-01 00:04:40,3,11,2512,45,2467,3.83%,1.79%
2020-01-01 00:04:40,3,12,26606,4818,21788,40.60%,18.11%
2020-01-01 00:04:40,4,1,522,1,521,0.80%,0.19%
2020-01-01 00:04:40,4,2,266,0,266,0.41%,0.00%
2020-01-01 00:04:40,4,3,1031,10,1021,1.57%,0.97%
2020-01-01 00:04:40,4,4,28049,5188,22861,42.80%,18.50%
2020-01-01 00:04:40,4,5,18536,2326,16210,28.28%,12.55%
2020-01-01 00:04:40,4,6,24233,3929,20304,36.98%,16.21%
2020-01-01 00:04:40,4,7,4332,140,4192,6.61%,3.23%
2020-01-01 00:04:40,4,8,2952,66,2886,4.50%,2.24%
2020-01-01 00:04:40,4,9,16346,1846,14500,24.94%,11.29%
2020-01-01 00:04:40,4,10,2337,50,2287,3.57%,2.14%
2020-01-01 00:04:40,4,11,162,1,161,0.25%,0.62%
2020-01-01 00:04:40,4,12,13202,1209,11993,20.14%,9.16%
2020-01-01 00:04:40,5,1,2784,52,2732,4.25%,1.87%
2020-01-01 00:04:40,5,2,998,9,989,1.52%,0.90%
2020-01-01 00:04:40,5,3,2402,35,2367,3.67%,1.46%
2020-01-01 00:04:40,5,4,27300,4968,22332,41.66%,18.20%
2020-01-01 00:04:40,5,5,11779,1018,10761,17.97%,8.64%
2020-01-01 00:04:40,5,6,18204,2341,15863,27.78%,12.86%
2020-01-01 00:04:40,5,7,5855,275,5580,8.93%,4.70%
2020-01-01 00:04:40,5,8,4850,196,4654,7.40%,4.04%
2020-01-01 00:04:40,5,9,9109,613,8496,13.90%,6.73%
2020-01-01 00:04:40,5,10,1338,20,1318,2.04%,1.49%
2020-01-01 00:04:40,5,11,1218,19,1199,1.86%,1.56%
2020-01-01 00:04:40,5,12,7485,425,7060,11.42%,5.68%
2020-01-01 00:04:40,6,1,990,3,987,1.51%,0.30%
2020-01-01 00:04:40,6,2,1095,7,1088,1.67%,0.64%
2020-01-01 00:04:40,6,3,1382,10,1372,2.11%,0.72%
2020-01-01 00:04:40,6,4,1387,13,1374,2.12%,0.94%
2020-01-01 00:04:40,6,5,16500,1836,14664,25.18%,11.13%
2020-01-01 00:04:40,6,6,4900,168,4732,7.48%,3.43%
2020-01-01 00:04:40,6,7,2867,64,2803,4.37%,2.23%
2020-01-01 00:04:40,6,8,2280,47,2233,3.48%,2.06%
2020-01-01 00:04:40,6,9,9963,700,9263,15.20%,7.03%
2020-01-01 00:04:40,6,10,1969,39,1930,3.00%,1.98%
2020-01-01 00:04:40,6,11,467,0,467,0.71%,0.00%
2020-01-01 00:04:40,6,12,7928,447,7481,12.10%,5.64%
2020-01-01 00:04:40,7,1,467,4,463,0.71%,0.86%
2020-01-01 00:04:40,7,2,139,0,139,0.21%,0.00%
2020-01-01 00:04:40,7,3,1500,7,1493,2.29%,0.47%
2020-01-01 00:04:40,7,4,1524,20,1504,2.33%,1.31%
2020-01-01 00:04:40,7,5,7923,453,7470,12.09%,5.72%
2020-01-01 00:04:40,7,6,13296,1257,12039,20.29%,9.45%
2020-01-01 00:04:40,7,7,3826,114,3712,5.84%,2.98%
2020-01-01 00:04:40,7,8,1175,18,1157,1.79%,1.53%
2020-01-01 00:04:40,7,9,6288,293,5995,9.59%,4.66%
2020-01-01 00:04:40,7,10,1363,9,1354,2.08%,0.66%
2020-01-01 00:04:40,7,11,124,0,124,0.19%,0.00%
2020-01-01 00:04:40,7,12,4924,196,4728,7.51%,3.98%
2020-01-01 00:04:40,8,1,442,4,438,0.67%,0.90%
2020-01-01 00:04:40,8,2,62,0,62,0.09%,0.00%
2020-01-01 00:04:40,8,3,1389,16,1373,2.12%,1.15%
2020-01-01 00:04:40,8,4,2725,60,2665,4.16%,2.20%
2020-01-01 00:04:40,8,5,7951,476,7475,12.13%,5.99%
2020-01-01 00:04:40,8,6,16227,1842,14385,24.76%,11.35%
2020-01-01 00:04:40,8,7,5482,240,5242,8.36%,4.38%
2020-01-01 00:04:40,8,8,2081,39,2042,3.18%,1.87%
2020-01-01 00:04:40,8,9,6126,272,5854,9.35%,4.44%
2020-01-01 00:04:40,8,10,1771,17,1754,2.70%,0.96%
2020-01-01 00:04:40,8,11,323,0,323,0.49%,0.00%
2020-01-01 00:04:40,8,12,4252,147,4105,6.49%,3.46%
2020-01-01 00:04:40,9,1,300,0,300,0.46%,0.00%
2020-01-01 00:04:40,9,2,1859,28,1831,2.84%,1.51%
2020-01-01 00:04:40,9,3,1165,10,1155,1.78%,0.86%
2020-01-01 00:04:40,9,4,6860,335,6525,10.47%,4.88%
2020-01-01 00:04:40,9,5,744,5,739,1.14%,0.67%
2020-01-01 00:04:40,9,6,8430,515,7915,12.86%,6.11%
2020-01-01 00:04:40,9,7,26655,4830,21825,40.67%,18.12%
2020-01-01 00:04:40,9,8,9725,729,8996,14.84%,7.50%
2020-01-01 00:04:40,9,9,217,0,217,0.33%,0.00%
2020-01-01 00:04:40,9,10,3276,77,3199,5.00%,2.35%
2020-01-01 00:04:40,9,11,8684,575,8109,13.25%,6.62%
2020-01-01 00:04:40,9,12,5148,208,4940,7.86%,4.04%
2020-01-01 00:04:40,10,1,1304,428,876,1.99%,32.82%
2020-01-01 00:04:40,10,2,3727,503,3224,5.69%,13.50%
2020-01-01 00:04:40,10,3,2272,41,2231,3.47%,1.80%
2020-01-01 00:04:40,10,4,4241,910,3331,6.47%,21.46%
2020-01-01 00:04:40,10,5,642,9,633,0.98%,1.40%
2020-01-01 00:04:40,10,6,5899,1018,4881,9.00%,17.26%
2020-01-01 00:04:40,10,7,11514,1963,9551,17.57%,17.05%
2020-01-01 00:04:40,10,8,27664,6847,20817,42.21%,24.75%
2020-01-01 00:04:40,10,9,669,4,665,1.02%,0.60%
2020-01-01 00:04:40,10,10,2232,47,2185,3.41%,2.11%
2020-01-01 00:04:40,10,11,12803,1685,11118,19.54%,13.16%
2020-01-01 00:04:40,10,12,9763,1218,8545,14.90%,12.48%
2020-01-01 00:04:40,11,1,2420,54,2366,3.69%,2.23%
2020-01-01 00:04:40,11,2,3457,91,3366,5.27%,2.63%
2020-01-01 00:04:40,11,3,915,9,906,1.40%,0.98%
2020-01-01 00:04:40,11,4,3346,89,3257,5.11%,2.66%
2020-01-01 00:04:40,11,5,549,2,547,0.84%,0.36%
2020-01-01 00:04:40,11,6,4725,174,4551,7.21%,3.68%
2020-01-01 00:04:40,11,7,10096,720,9376,15.41%,7.13%
2020-01-01 00:04:40,11,8,24467,3955,20512,37.33%,16.16%
2020-01-01 00:04:40,11,9,253,0,253,0.39%,0.00%
2020-01-01 00:04:40,11,10,3187,78,3109,4.86%,2.45%
2020-01-01 00:04:40,11,11,9970,716,9254,15.21%,7.18%
2020-01-01 00:04:40,11,12,6569,311,6258,10.02%,4.73%
2020-01-01 00:04:40,12,1,30,0,30,0.05%,0.00%
2020-01-01 00:04:40,12,2,716,262,454,1.09%,36.59%
2020-01-01 00:04:40,12,3,3343,332,3011,5.10%,9.93%
2020-01-01 00:04:40,12,4,3122,65,3057,4.76%,2.08%
2020-01-01 00:04:40,12,5,10188,946,9242,15.55%,9.29%
2020-01-01 00:04:40,12,6,6130,233,5897,9.35%,3.80%
2020-01-01 00:04:40,12,7,2876,53,2823,4.39%,1.84%
2020-01-01 00:04:40,12,8,1299,202,1097,1.98%,15.55%
2020-01-01 00:04:40,12,9,21843,4163,17680,33.33%,19.06%
2020-01-01 00:04:40,12,10,3985,301,3684,6.08%,7.55%
2020-01-01 00:04:40,12,11,1524,207,1317,2.33%,13.58%
2020-01-01 00:04:40,12,12,7045,857,6188,10.75%,12.16%
2020-01-01 00:04:40,13,1,2230,43,2187,3.40%,1.93%
2020-01-01 00:04:40,13,2,2609,60,2549,3.98%,2.30%
2020-01-01 00:04:40,13,3,896,11,885,1.37%,1.23%
2020-01-01 00:04:40,13,4,5000,552,4448,7.63%,11.04%
2020-01-01 00:04:40,13,5,7305,898,6407,11.15%,12.29%
2020-01-01 00:04:40,13,6,5703,601,5102,8.70%,10.54%
2020-01-01 00:04:40,13,7,4946,171,4775,7.55%,3.46%
2020-01-01 00:04:40,13,8,6889,343,6546,10.51%,4.98%
2020-01-01 00:04:40,13,9,7619,929,6690,11.63%,12.19%
2020-01-01 00:04:40,13,10,26956,5474,21482,41.13%,20.31%
2020-01-01 00:04:40,13,11,16432,2148,14284,25.07%,13.07%
2020-01-01 00:04:40,13,12,8929,914,8015,13.62%,10.24%
2020-01-01 00:04:40,14,1,499,2,497,0.76%,0.40%
2020-01-01 00:04:40,14,2,1941,42,1899,2.96%,2.16%
2020-01-01 00:04:40,14,3,1211,28,1183,1.85%,2.31%
2020-01-01 00:04:40,14,4,5884,254,5630,8.98%,4.32%
2020-01-01 00:04:40,14,5,1418,16,1402,2.16%,1.13%
2020-01-01 00:04:40,14,6,6429,305,6124,9.81%,4.74%
2020-01-01 00:04:40,14,7,14043,1400,12643,21.43%,9.97%
2020-01-01 00:04:40,14,8,15388,1654,13734,23.48%,10.75%
2020-01-01 00:04:40,14,9,1653,20,1633,2.52%,1.21%
2020-01-01 00:04:40,14,10,4239,130,4109,6.47%,3.07%
2020-01-01 00:04:40,14,11,26801,4706,22095,40.90%,17.56%
2020-01-01 00:04:40,14,12,6860,349,6511,10.47%,5.09%
2020-01-01 00:04:40,15,1,397,0,397,0.61%,0.00%
2020-01-01 00:04:40,15,2,169,0,169,0.26%,0.00%
2020-01-01 00:04:40,15,3,4856,196,4660,7.41%,4.04%
2020-01-01 00:04:40,15,4,4681,156,4525,7.14%,3.33%
2020-01-01 00:04:40,15,5,10353,762,9591,15.80%,7.36%
2020-01-01 00:04:40,15,6,4885,175,4710,7.45%,3.58%
2020-01-01 00:04:40,15,7,3619,100,3519,5.52%,2.76%
2020-01-01 00:04:40,15,8,5276,249,5027,8.05%,4.72%
2020-01-01 00:04:40,15,9,10553,780,9773,16.10%,7.39%
2020-01-01 00:04:40,15,10,4241,165,4076,6.47%,3.89%
2020-01-01 00:04:40,15,11,9650,721,8929,14.72%,7.47%
2020-01-01 00:04:40,15,12,25935,4795,21140,39.57%,18.49%
2020-01-01 00:04:40,16,1,316,0,316,0.48%,0.00%
2020-01-01 00:04:40,16,2,260,0,260,0.40%,0.00%
2020-01-01 00:04:40,16,3,1450,12,1438,2.21%,0.83%
2020-01-01 00:04:40,16,4,4149,167,3982,6.33%,4.03%
2020-01-01 00:04:40,16,5,7861,539,7322,11.99%,6.86%
2020-01-01 00:04:40,16,6,5009,229,4780,7.64%,4.57%
2020-01-01 00:04:40,16,7,3464,96,3368,5.29%,2.77%
2020-01-01 00:04:40,16,8,7534,436,7098,11.50%,5.79%
2020-01-01 00:04:40,16,9,8282,590,7692,12.64%,7.12%
2020-01-01 00:04:40,16,10,2084,28,2056,3.18%,1.34%
2020-01-01 00:04:40,16,11,9838,700,9138,15.01%,7.12%
2020-01-01 00:04:40,16,12,27490,5104,22386,41.95%,18.57%
2020-01-01 00:04:50,1,1,21136,3127,18009,32.25%,14.79%
2020-01-01 00:04:50,1,2,8923,558,8365,13.62%,6.25%
2020-01-01 00:04:50,1,3,409,1,408,0.62%,0.24%
2020-01-01 00:04:50,1,4,11764,1060,10704,17.95%,9.01%
2020-01-01 00:04:50,1,5,11450,1019,10431,17.47%,8.90%
2020-01-01 00:04:50,1,6,11414,1016,10398,17.42%,8.90%
2020-01-01 00:04:50,1,7,8501,518,7983,12.97%,6.09%
2020-01-01 00:04:50,1,8,7013,344,6669,10.70%,4.91%
2020-01-01 00:04:50,1,9,11352,1005,10347,17.32%,8.85%
2020-01-01 00:04:50,1,10,6449,287,6162,9.84%,4.45%
2020-01-01 00:04:50,1,11,6533,295,6238,9.97%,4.52%
2020-01-01 00:04:50,1,12,11327,1001,10326,17.28%,8.84%
2020-01-01 00:04:50,2,1,1500,9,1491,2.29%,0.60%
2020-01-01 00:04:50,2,2,27594,5094,22500,42.11%,18.46%
2020-01-01 00:04:50,2,3,20380,2843,17537,31.10%,13.95%
2020-01-01 00:04:50,2,4,1404,8,1396,2.14%,0.57%
2020-01-01 00:04:50,2,5,13305,1226,12079,20.30%,9.21%
2020-01-01 00:04:50,2,6,28,0,28,0.04%,0.00%
2020-01-01 00:04:50,2,7,5699,251,5448,8.70%,4.40%
2020-01-01 00:04:50,2,8,4589,155,4434,7.00%,3.38%
2020-01-01 00:04:50,2,9,13093,1191,11902,19.98%,9.10%
2020-01-01 00:04:50,2,10,3639,89,3550,5.55%,2.45%
2020-01-01 00:04:50,2,11,3686,93,3593,5.62%,2.52%
2020-01-01 00:04:50,2,12,12912,1145,11767,19.70%,8.87%
2020-01-01 00:04:50,3,1,1536,11,1525,2.34%,0.72%
2020-01-01 00:04:50,3,2,25342,4327,21015,38.67%,17.07%
2020-01-01 00:04:50,3,3,65311,24144,41167,99.66%,36.97%
2020-01-01 00:04:50,3,4,6603,344,6259,10.08%,5.21%
2020-01-01 00:04:50,3,5,38008,9252,28756,58.00%,24.34%
2020-01-01 00:04:50,3,6,7977,484,7493,12.17%,6.07%
2020-01-01 00:04:50,3,7,22175,3379,18796,33.84%,15.24%
2020-01-01 00:04:50,3,8,18158,2314,15844,27.71%,12.74%
2020-01-01 00:04:50,3,9,29377,5798,23579,44.83%,19.74%
2020-01-01 00:04:50,3,10,4576,167,4409,6.98%,3.65%
2020-01-01 00:04:50,3,11,2605,60,2545,3.97%,2.30%
2020-01-01 00:04:50,3,12,21881,3316,18565,33.39%,15.15%
2020-01-01 00:04:50,4,1,551,5,546,0.84%,0.91%
2020-01-01 00:04:50,4,2,372,2,370,0.57%,0.54%
2020-01-01 00:04:50,4,3,992,11,981,1.51%,1.11%
2020-01-01 00:04:50,4,4,28366,5310,23056,43.28%,18.72%
2020-01-01 00:04:50,4,5,18397,2345,16052,28.07%,12.75%
2020-01-01 00:04:50,4,6,24432,4005,20427,37.28%,16.39%
2020-01-01 00:04:50,4,7,4891,166,4725,7.46%,3.39%
2020-01-01 00:04:50,4,8,2827,53,2774,4.31%,1.87%
2020-01-01 00:04:50,4,9,16043,1783,14260,24.48%,11.11%
2020-01-01 00:04:50,4,10,1981,42,1939,3.02%,2.12%
2020-01-01 00:04:50,4,11,141,0,141,0.22%,0.00%
2020-01-01 00:04:50,4,12,13237,1215,12022,20.20%,9.18%
2020-01-01 00:04:50,5,1,3015,69,2946,4.60%,2.29%
2020-01-01 00:04:50,5,2,930,3,927,1.42%,0.32%
2020-01-01 00:04:50,5,3,555,3,552,0.85%,0.54%
2020-01-01 00:04:50,5,4,24425,4088,20337,37.27%,16.74%
2020-01-01 00:04:50,5,5,11189,940,10249,17.07%,8.40%
2020-01-01 00:04:50,5,6,17273,2081,15192,26.36%,12.05%
2020-01-01 00:04:50,5,7,5401,218,5183,8.24%,4.04%
2020-01-01 00:04:50,5,8,4149,122,4027,6.33%,2.94%
2020-01-01 00:04:50,5,9,10478,817,9661,15.99%,7.80%
2020-01-01 00:04:50,5,10,1247,12,1235,1.90%,0.96%
2020-01-01 00:04:50,5,11,1075,7,1068,1.64%,0.65%
2020-01-01 00:04:50,5,12,8964,616,8348,13.68%,6.87%
2020-01-01 00:04:50,6,1,1029,14,1015,1.57%,1.36%
2020-01-01 00:04:50,6,2,1105,14,1091,1.69%,1.27%
2020-01-01 00:04:50,6,3,1707,28,1679,2.60%,1.64%
2020-01-01 00:04:50,6,4,1356,15,1341,2.07%,1.11%
2020-01-01 00:04:50,6,5,18360,2325,16035,28.02%,12.66%
2020-01-01 00:04:50,6,6,4533,193,4340,6.92%,4.26%
2020-01-01 00:04:50,6,7,2820,80,2740,4.30%,2.84%
2020-01-01 00:04:50,6,8,2302,61,2241,3.51%,2.65%
2020-01-01 00:04:50,6,9,11689,967,10722,17.84%,8.27%
2020-01-01 00:04:50,6,10,3111,62,3049,4.75%,1.99%
2020-01-01 00:04:50,6,11,457,1,456,0.70%,0.22%
2020-01-01 00:04:50,6,12,8526,554,7972,13.01%,6.50%
2020-01-01 00:04:50,7,1,391,3,388,0.60%,0.77%
2020-01-01 00:04:50,7,2,198,5,193,0.30%,2.53%
2020-01-01 00:04:50,7,3,1454,16,1438,2.22%,1.10%
2020-01-01 00:04:50,7,4,1466,20,1446,2.24%,1.36%
2020-01-01 00:04:50,7,5,8535,585,7950,13.02%,6.85%
2020-01-01 00:04:50,7,6,13349,1297,12052,20.37%,9.72%
2020-01-01 00:04:50,7,7,3320,90,3230,5.07%,2.71%
2020-01-01 00:04:50,7,8,1016,10,1006,1.55%,0.98%
2020-01-01 00:04:50,7,9,6963,385,6578,10.62%,5.53%
2020-01-01 00:04:50,7,10,1343,16,1327,2.05%,1.19%
2020-01-01 00:04:50,7,11,121,1,120,0.18%,0.83%
2020-01-01 00:04:50,7,12,5661,248,5413,8.64%,4.38%
2020-01-01 00:04:50,8,1,427,1,426,0.65%,0.23%
2020-01-01 00:04:50,8,2,104,0,104,0.16%,0.00%
2020-01-01 00:04:50,8,3,1726,21,1705,2.63%,1.22%
2020-01-01 00:04:50,8,4,2502,50,2452,3.82%,2.00%
2020-01-01 00:04:50,8,5,8410,525,7885,12.83%,6.24%
2020-01-01 00:04:50,8,6,16181,1842,14339,24.69%,11.38%
2020-01-01 00:04:50,8,7,5242,191,5051,8.00%,3.64%
2020-01-01 00:04:50,8,8,1974,31,1943,3.01%,1.57%
2020-01-01 00:04:50,8,9,6434,295,6139,9.82%,4.59%
2020-01-01 00:04:50,8,10,1715,15,1700,2.62%,0.87%
2020-01-01 00:04:50,8,11,252,0,252,0.38%,0.00%
2020-01-01 00:04:50,8,12,4448,140,4308,6.79%,3.15%
2020-01-01 00:04:50,9,1,544,1,543,0.83%,0.18%
2020-01-01 00:04:50,9,2,2881,58,2823,4.40%,2.01%
2020-01-01 00:04:50,9,3,1510,10,1500,2.30%,0.66%
2020-01-01 00:04:50,9,4,7785,434,7351,11.88%,5.57%
2020-01-01 00:04:50,9,5,587,2,585,0.90%,0.34%
2020-01-01 00:04:50,9,6,8829,551,8278,13.47%,6.24%
2020-01-01 00:04:50,9,7,28125,5234,22891,42.92%,18.61%
2020-01-01 00:04:50,9,8,10092,735,9357,15.40%,7.28%
2020-01-01 00:04:50,9,9,220,0,220,0.34%,0.00%
2020-01-01 00:04:50,9,10,2800,81,2719,4.27%,2.89%
2020-01-01 00:04:50,9,11,8654,566,8088,13.20%,6.54%
2020-01-01 00:04:50,9,12,5534,219,5315,8.44%,3.96%
2020-01-01 00:04:50,10,1,1081,310,771,1.65%,28.68%
2020-01-01 00:04:50,10,2,2821,360,2461,4.30%,12.76%
2020-01-01 00:04:50,10,3,1413,21,1392,2.16%,1.49%
2020-01-01 00:04:50,10,4,4810,1118,3692,7.34%,23.24%
2020-01-01 00:04:50,10,5,720,5,715,1.10%,0.69%
2020-01-01 00:04:50,10,6,6828,1262,5566,10.42%,18.48%
2020-01-01 00:04:50,10,7,11735,2189,9546,17.91%,18.65%
2020-01-01 00:04:50,10,8,29280,7501,21779,44.68%,25.62%
2020-01-01 00:04:50,10,9,681,2,679,1.04%,0.29%
2020-01-01 00:04:50,10,10,2269,28,2241,3.46%,1.23%
2020-01-01 00:04:50,10,11,12351,1393,10958,18.85%,11.28%
2020-01-01 00:04:50,10,12,9259,937,8322,14.13%,10.12%
2020-01-01 00:04:50,11,1,2181,28,2153,3.33%,1.28%
2020-01-01 00:04:50,11,2,3409,83,3326,5.20%,2.43%
2020-01-01 00:04:50,11,3,1075,10,1065,1.64%,0.93%
2020-01-01 00:04:50,11,4,3771,172,3599,5.75%,4.56%
2020-01-01 00:04:50,11,5,465,0,465,0.71%,0.00%
2020-01-01 00:04:50,11,6,4749,235,4514,7.25%,4.95%
2020-01-01 00:04:50,11,7,10094,810,9284,15.40%,8.02%
2020-01-01 00:04:50,11,8,24876,4280,20596,37.96%,17.21%
2020-01-01 00:04:50,11,9,475,3,472,0.72%,0.63%
2020-01-01 00:04:50,11,10,3725,114,3611,5.68%,3.06%
2020-01-01 00:04:50,11,11,10937,939,9998,16.69%,8.59%
2020-01-01 00:04:50,11,12,6958,398,6560,10.62%,5.72%
2020-01-01 00:04:50,12,1,38,0,38,0.06%,0.00%
2020-01-01 00:04:50,12,2,724,238,486,1.10%,32.87%
2020-01-01 00:04:50,12,3,2866,284,2582,4.37%,9.91%
2020-01-01 00:04:50,12,4,2775,100,2675,4.23%,3.60%
2020-01-01 00:04:50,12,5,10005,1020,8985,15.27%,10.19%
2020-01-01 00:04:50,12,6,6367,407,5960,9.72%,6.39%
2020-01-01 00:04:50,12,7,3415,117,3298,5.21%,3.43%
2020-01-01 00:04:50,12,8,1519,285,1234,2.32%,18.76%
2020-01-01 00:04:50,12,9,22472,4586,17886,34.29%,20.41%
2020-01-01 00:04:50,12,10,4218,401,3817,6.44%,9.51%
2020-01-01 00:04:50,12,11,1708,287,1421,2.61%,16.80%
2020-01-01 00:04:50,12,12,7624,1091,6533,11.63%,14.31%
2020-01-01 00:04:50,13,1,2567,53,2514,3.92%,2.06%
2020-01-01 00:04:50,13,2,2988,67,2921,4.56%,2.24%
2020-01-01 00:04:50,13,3,779,5,774,1.19%,0.64%
2020-01-01 00:04:50,13,4,4269,460,3809,6.51%,10.78%
2020-01-01 00:04:50,13,5,7136,862,6274,10.89%,12.08%
2020-01-01 00:04:50,13,6,5093,515,4578,7.77%,10.11%
2020-01-01 00:04:50,13,7,5824,254,5570,8.89%,4.36%
2020-01-01 00:04:50,13,8,7788,434,7354,11.88%,5.57%
2020-01-01 00:04:50,13,9,7499,903,6596,11.44%,12.04%
2020-01-01 00:04:50,13,10,28201,5934,22267,43.03%,21.04%
2020-01-01 00:04:50,13,11,17673,2472,15201,26.97%,13.99%
2020-01-01 00:04:50,13,12,9152,944,8208,13.96%,10.31%
2020-01-01 00:04:50,14,1,416,2,414,0.63%,0.48%
2020-01-01 00:04:50,14,2,1785,24,1761,2.72%,1.34%
2020-01-01 00:04:50,14,3,1173,8,1165,1.79%,0.68%
2020-01-01 00:04:50,14,4,4038,98,3940,6.16%,2.43%
2020-01-01 00:04:50,14,5,1389,30,1359,2.12%,2.16%
2020-01-01 00:04:50,14,6,4306,114,4192,6.57%,2.65%
2020-01-01 00:04:50,14,7,11388,948,10440,17.38%,8.32%
2020-01-01 00:04:50,14,8,12938,1210,11728,19.74%,9.35%
2020-01-01 00:04:50,14,9,1671,39,1632,2.55%,2.33%
2020-01-01 00:04:50,14,10,4191,151,4040,6.39%,3.60%
2020-01-01 00:04:50,14,11,25401,4404,20997,38.76%,17.34%
2020-01-01 00:04:50,14,12,8032,487,7545,12.26%,6.06%
2020-01-01 00:04:50,15,1,443,0,443,0.68%,0.00%
2020-01-01 00:04:50,15,2,207,0,207,0.32%,0.00%
2020-01-01 00:04:50,15,3,3985,115,3870,6.08%,2.89%
2020-01-01 00:04:50,15,4,6278,346,5932,9.58%,5.51%
2020-01-01 00:04:50,15,5,12182,1117,11065,18.59%,9.17%
2020-01-01 00:04:50,15,6,6556,368,6188,10.00%,5.61%
2020-01-01 00:04:50,15,7,4201,156,4045,6.41%,3.71%
2020-01-01 00:04:50,15,8,5835,274,5561,8.90%,4.70%
2020-01-01 00:04:50,15,9,12449,1176,11273,19.00%,9.45%
2020-01-01 00:04:50,15,10,4422,157,4265,6.75%,3.55%
2020-01-01 00:04:50,15,11,10383,835,9548,15.84%,8.04%
2020-01-01 00:04:50,15,12,29699,6259,23440,45.32%,21.07%
2020-01-01 00:04:50,16,1,444,1,443,0.68%,0.23%
2020-01-01 00:04:50,16,2,256,0,256,0.39%,0.00%
2020-01-01 00:04:50,16,3,1187,2,1185,1.81%,0.17%
2020-01-01 00:04:50,16,4,4226,156,4070,6.45%,3.69%
2020-01-01 00:04:50,16,5,7712,530,7182,11.77%,6.87%
2020-01-01 00:04:50,16,6,5106,208,4898,7.79%,4.07%
2020-01-01 00:04:50,16,7,4027,126,3901,6.14%,3.13%
2020-01-01 00:04:50,16,8,8795,615,8180,13.42%,6.99%
2020-01-01 00:04:50,16,9,8100,576,7524,12.36%,7.11%
2020-01-01 00:04:50,16,10,1711,15,1696,2.61%,0.88%
2020-01-01 00:04:50,16,11,10710,863,9847,16.34%,8.06%
2020-01-01 00:04:50,16,12,27132,5070,22062,41.40%,18.69%
2020-01-01 00:05:00,1,1,21374,3140,18234,32.61%,14.69%
2020-01-01 00:05:00,1,2,8078,498,7580,12.33%,6.16%
2020-01-01 00:05:00,1,3,1264,17,1247,1.93%,1.34%
2020-01-01 00:05:00,1,4,12910,1211,11699,19.70%,9.38%
2020-01-01 00:05:00,1,5,12783,1188,11595,19.51%,9.29%
2020-01-01 00:05:00,1,6,12716,1176,11540,19.40%,9.25%
2020-01-01 00:05:00,1,7,6796,356,6440,10.37%,5.24%
2020-01-01 00:05:00,1,8,6113,297,5816,9.33%,4.86%
2020-01-01 00:05:00,1,9,12681,1171,11510,19.35%,9.23%
2020-01-01 00:05:00,1,10,5409,223,5186,8.25%,4.12%
2020-01-01 00:05:00,1,11,5474,228,5246,8.35%,4.17%
2020-01-01 00:05:00,1,12,12655,1164,11491,19.31%,9.20%
2020-01-01 00:05:00,2,1,2646,51,2595,4.04%,1.93%
2020-01-01 00:05:00,2,2,28985,5524,23461,44.23%,19.06%
2020-01-01 00:05:00,2,3,22087,3219,18868,33.70%,14.57%
2020-01-01 00:05:00,2,4,2554,49,2505,3.90%,1.92%
2020-01-01 00:05:00,2,5,14385,1359,13026,21.95%,9.45%
2020-01-01 00:05:00,2,6,41,0,41,0.06%,0.00%
2020-01-01 00:05:00,2,7,4232,134,4098,6.46%,3.17%
2020-01-01 00:05:00,2,8,3051,75,2976,4.66%,2.46%
2020-01-01 00:05:00,2,9,14306,1340,12966,21.83%,9.37%
2020-01-01 00:05:00,2,10,2308,40,2268,3.52%,1.73%
2020-01-01 00:05:00,2,11,2321,41,2280,3.54%,1.77%
2020-01-01 00:05:00,2,12,14135,1311,12824,21.57%,9.27%
2020-01-01 00:05:00,3,1,1522,16,1506,2.32%,1.05%
2020-01-01 00:05:00,3,2,22112,3311,18801,33.74%,14.97%
2020-01-01 00:05:00,3,3,72005,28230,43775,109.87%,39.21%
2020-01-01 00:05:00,3,4,6990,339,6651,10.67%,4.85%
2020-01-01 00:05:00,3,5,48769,14331,34438,74.42%,29.39%
2020-01-01 00:05:00,3,6,8183,481,7702,12.49%,5.88%
2020-01-01 00:05:00,3,7,18818,2423,16395,28.71%,12.88%
2020-01-01 00:05:00,3,8,15406,1622,13784,23.51%,10.53%
2020-01-01 00:05:00,3,9,40253,10155,30098,61.42%,25.23%
2020-01-01 00:05:00,3,10,6809,367,6442,10.39%,5.39%
2020-01-01 00:05:00,3,11,1556,15,1541,2.37%,0.96%
2020-01-01 00:05:00,3,12,30291,6042,24249,46.22%,19.95%
2020-01-01 00:05:00,4,1,1633,23,1610,2.49%,1.41%
2020-01-01 00:05:00,4,2,260,3,257,0.40%,1.15%
2020-01-01 00:05:00,4,3,1646,21,1625,2.51%,1.28%
2020-01-01 00:05:00,4,4,29092,5521,23571,44.39%,18.98%
2020-01-01 00:05:00,4,5,17698,2189,15509,27.01%,12.37%
2020-01-01 00:05:00,4,6,24042,3851,20191,36.69%,16.02%
2020-01-01 00:05:00,4,7,5229,210,5019,7.98%,4.02%
2020-01-01 00:05:00,4,8,2561,53,2508,3.91%,2.07%
2020-01-01 00:05:00,4,9,14730,1518,13212,22.48%,10.31%
2020-01-01 00:05:00,4,10,1816,29,1787,2.77%,1.60%
2020-01-01 00:05:00,4,11,132,0,132,0.20%,0.00%
2020-01-01 00:05:00,4,12,12126,1032,11094,18.50%,8.51%
2020-01-01 00:05:00,5,1,2594,50,2544,3.96%,1.93%
2020-01-01 00:05:00,5,2,598,1,597,0.91%,0.17%
2020-01-01 00:05:00,5,3,386,1,385,0.59%,0.26%
2020-01-01 00:05:00,5,4,21178,3137,18041,32.32%,14.81%
2020-01-01 00:05:00,5,5,9897,753,9144,15.10%,7.61%
2020-01-01 00:05:00,5,6,14370,1547,12823,21.93%,10.77%
2020-01-01 00:05:00,5,7,3994,130,3864,6.09%,3.25%
2020-01-01 00:05:00,5,8,3173,88,3085,4.84%,2.77%
2020-01-01 00:05:00,5,9,9424,689,8735,14.38%,7.31%
2020-01-01 00:05:00,5,10,1037,8,1029,1.58%,0.77%
2020-01-01 00:05:00,5,11,853,8,845,1.30%,0.94%
2020-01-01 00:05:00,5,12,8050,519,7531,12.28%,6.45%
2020-01-01 00:05:00,6,1,953,5,948,1.45%,0.52%
2020-01-01 00:05:00,6,2,1131,7,1124,1.73%,0.62%
2020-01-01 00:05:00,6,3,1554,16,1538,2.37%,1.03%
2020-01-01 00:05:00,6,4,1670,35,1635,2.55%,2.10%
2020-01-01 00:05:00,6,5,13782,1343,12439,21.03%,9.74%
2020-01-01 00:05:00,6,6,4615,181,4434,7.04%,3.92%
2020-01-01 00:05:00,6,7,2315,49,2266,3.53%,2.12%
2020-01-01 00:05:00,6,8,1904,35,1869,2.91%,1.84%
2020-01-01 00:05:00,6,9,7156,400,6756,10.92%,5.59%
2020-01-01 00:05:00,6,10,2095,35,2060,3.20%,1.67%
2020-01-01 00:05:00,6,11,427,1,426,0.65%,0.23%
2020-01-01 00:05:00,6,12,4971,196,4775,7.59%,3.94%
2020-01-01 00:05:00,7,1,493,2,491,0.75%,0.41%
2020-01-01 00:05:00,7,2,85,0,85,0.13%,0.00%
2020-01-01 00:05:00,7,3,1737,13,1724,2.65%,0.75%
2020-01-01 00:05:00,7,4,2044,26,2018,3.12%,1.27%
2020-01-01 00:05:00,7,5,8320,460,7860,12.70%,5.53%
2020-01-01 00:05:00,7,6,13561,1284,12277,20.69%,9.47%
2020-01-01 00:05:00,7,7,3120,93,3027,4.76%,2.98%
2020-01-01 00:05:00,7,8,1115,16,1099,1.70%,1.43%
2020-01-01 00:05:00,7,9,6504,302,6202,9.92%,4.64%
2020-01-01 00:05:00,7,10,1272,13,1259,1.94%,1.02%
2020-01-01 00:05:00,7,11,72,0,72,0.11%,0.00%
2020-01-01 00:05:00,7,12,5247,203,5044,8.01%,3.87%
2020-01-01 00:05:00,8,1,479,0,479,0.73%,0.00%
2020-01-01 00:05:00,8,2,115,0,115,0.18%,0.00%
2020-01-01 00:05:00,8,3,1264,13,1251,1.93%,1.03%
2020-01-01 00:05:00,8,4,2626,56,2570,4.01%,2.13%
2020-01-01 00:05:00,8,5,8919,593,8326,13.61%,6.65%
2020-01-01 00:05:00,8,6,16666,1942,14724,25.43%,11.65%
2020-01-01 00:05:00,8,7,5073,184,4889,7.74%,3.63%
2020-01-01 00:05:00,8,8,1971,26,1945,3.01%,1.32%
2020-01-01 00:05:00,8,9,7433,416,7017,11.34%,5.60%
2020-01-01 00:05:00,8,10,2569,53,2516,3.92%,2.06%
2020-01-01 00:05:00,8,11,272,1,271,0.42%,0.37%
2020-01-01 00:05:00,8,12,4820,171,4649,7.35%,3.55%
2020-01-01 00:05:00,9,1,627,2,625,0.96%,0.32%
2020-01-01 00:05:00,9,2,2624,45,2579,4.00%,1.71%
2020-01-01 00:05:00,9,3,1424,14,1410,2.17%,0.98%
2020-01-01 00:05:00,9,4,6666,373,6293,10.17%,5.60%
2020-01-01 00:05:00,9,5,362,4,358,0.55%,1.10%
2020-01-01 00:05:00,9,6,7590,459,7131,11.58%,6.05%
2020-01-01 00:05:00,9,7,32508,7031,25477,49.60%,21.63%
2020-01-01 00:05:00,9,8,9416,653,8763,14.37%,6.94%
2020-01-01 00:05:00,9,9,218,1,217,0.33%,0.46%
2020-01-01 00:05:00,9,10,2414,45,2369,3.68%,1.86%
2020-01-01 00:05:00,9,11,8072,485,7587,12.32%,6.01%
2020-01-01 00:05:00,9,12,5301,223,5078,8.09%,4.21%
2020-01-01 00:05:00,10,1,1422,184,1238,2.17%,12.94%
2020-01-01 00:05:00,10,2,4378,305,4073,6.68%,6.97%
2020-01-01 00:05:00,10,3,2782,54,2728,4.24%,1.94%
2020-01-01 00:05:00,10,4,3725,962,2763,5.68%,25.83%
2020-01-01 00:05:00,10,5,600,3,597,0.92%,0.50%
2020-01-01 00:05:00,10,6,5536,1052,4484,8.45%,19.00%
2020-01-01 00:05:00,10,7,11653,1900,9753,17.78%,16.30%
2020-01-01 00:05:00,10,8,28354,6899,21455,43.26%,24.33%
2020-01-01 00:05:00,10,9,664,1,663,1.01%,0.15%
2020-01-01 00:05:00,10,10,1860,23,1837,2.84%,1.24%
2020-01-01 00:05:00,10,11,12440,1621,10819,18.98%,13.03%
2020-01-01 00:05:00,10,12,10123,1288,8835,15.45%,12.72%
2020-01-01 00:05:00,11,1,2352,52,2300,3.59%,2.21%
2020-01-01 00:05:00,11,2,3478,101,3377,5.31%,2.90%
2020-01-01 00:05:00,11,3,934,2,932,1.43%,0.21%
2020-01-01 00:05:00,11,4,6216,291,5925,9.48%,4.68%
2020-01-01 00:05:00,11,5,352,1,351,0.54%,0.28%
2020-01-01 00:05:00,11,6,7105,371,6734,10.84%,5.22%
2020-01-01 00:05:00,11,7,12276,1073,11203,18.73%,8.74%
2020-01-01 00:05:00,11,8,25759,4496,21263,39.31%,17.45%
2020-01-01 00:05:00,11,9,251,1,250,0.38%,0.40%
2020-01-01 00:05:00,11,10,2921,90,2831,4.46%,3.08%
2020-01-01 00:05:00,11,11,9892,736,9156,15.09%,7.44%
2020-01-01 00:05:00,11,12,6709,339,6370,10.24%,5.05%
2020-01-01 00:05:00,12,1,74,0,74,0.11%,0.00%
2020-01-01 00:05:00,12,2,708,213,495,1.08%,30.08%
2020-01-01 00:05:00,12,3,2978,274,2704,4.54%,9.20%
2020-01-01 00:05:00,12,4,2832,67,2765,4.32%,2.37%
2020-01-01 00:05:00,12,5,9183,781,8402,14.01%,8.50%
2020-01-01 00:05:00,12,6,5544,236,5308,8.46%,4.26%
2020-01-01 00:05:00,12,7,2382,43,2339,3.63%,1.81%
2020-01-01 00:05:00,12,8,1012,287,725,1.54%,28.36%
2020-01-01 00:05:00,12,9,21589,4191,17398,32.94%,19.41%
2020-01-01 00:05:00,12,10,3824,386,3438,5.83%,10.09%
2020-01-01 00:05:00,12,11,1240,290,950,1.89%,23.39%
2020-01-01 00:05:00,12,12,7747,1064,6683,11.82%,13.73%
2020-01-01 00:05:00,13,1,2389,52,2337,3.65%,2.18%
2020-01-01 00:05:00,13,2,2674,60,2614,4.08%,2.24%
2020-01-01 00:05:00,13,3,620,2,618,0.95%,0.32%
2020-01-01 00:05:00,13,4,5669,585,5084,8.65%,10.32%
2020-01-01 00:05:00,13,5,8024,891,7133,12.24%,11.10%
2020-01-01 00:05:00,13,6,6301,634,5667,9.61%,10.06%
2020-01-01 00:05:00,13,7,5125,202,4923,7.82%,3.94%
2020-01-01 00:05:00,13,8,7448,415,7033,11.36%,5.57%
2020-01-01 00:05:00,13,9,8296,914,7382,12.66%,11.02%
2020-01-01 00:05:00,13,10,27538,5890,21648,42.02%,21.39%
2020-01-01 00:05:00,13,11,16473,2444,14029,25.14%,14.84%
2020-01-01 00:05:00,13,12,8481,1058,7423,12.94%,12.47%
2020-01-01 00:05:00,14,1,239,0,239,0.36%,0.00%
2020-01-01 00:05:00,14,2,1125,7,1118,1.72%,0.62%
2020-01-01 00:05:00,14,3,734,4,730,1.12%,0.54%
2020-01-01 00:05:00,14,4,4736,167,4569,7.23%,3.53%
2020-01-01 00:05:00,14,5,1256,15,1241,1.92%,1.19%
2020-01-01 00:05:00,14,6,5024,193,4831,7.67%,3.84%
2020-01-01 00:05:00,14,7,11589,897,10692,17.68%,7.74%
2020-01-01 00:05:00,14,8,13117,1172,11945,20.01%,8.93%
2020-01-01 00:05:00,14,9,1476,18,1458,2.25%,1.22%
2020-01-01 00:05:00,14,10,4019,128,3891,6.13%,3.18%
2020-01-01 00:05:00,14,11,25177,4268,20909,38.42%,16.95%
2020-01-01 00:05:00,14,12,7856,471,7385,11.99%,6.00%
2020-01-01 00:05:00,15,1,500,2,498,0.76%,0.40%
2020-01-01 00:05:00,15,2,137,1,136,0.21%,0.73%
2020-01-01 00:05:00,15,3,3684,110,3574,5.62%,2.99%
2020-01-01 00:05:00,15,4,4929,232,4697,7.52%,4.71%
2020-01-01 00:05:00,15,5,10411,835,9576,15.89%,8.02%
2020-01-01 00:05:00,15,6,5168,247,4921,7.89%,4.78%
2020-01-01 00:05:00,15,7,4096,139,3957,6.25%,3.39%
2020-01-01 00:05:00,15,8,6005,316,5689,9.16%,5.26%
2020-01-01 00:05:00,15,9,10666,868,9798,16.28%,8.14%
2020-01-01 00:05:00,15,10,3856,203,3653,5.88%,5.26%
2020-01-01 00:05:00,15,11,9974,785,9189,15.22%,7.87%
2020-01-01 00:05:00,15,12,26722,5065,21657,40.77%,18.95%
2020-01-01 00:05:00,16,1,461,2,459,0.70%,0.43%
2020-01-01 00:05:00,16,2,267,2,265,0.41%,0.75%
2020-01-01 00:05:00,16,3,1395,19,1376,2.13%,1.36%
2020-01-01 00:05:00,16,4,4419,155,4264,6.74%,3.51%
2020-01-01 00:05:00,16,5,8122,546,7576,12.39%,6.72%
2020-01-01 00:05:00,16,6,5100,202,4898,7.78%,3.96%
2020-01-01 00:05:00,16,7,3219,74,3145,4.91%,2.30%
2020-01-01 00:05:00,16,8,7467,464,7003,11.39%,6.21%
2020-01-01 00:05:00,16,9,8680,602,8078,13.24%,6.94%
2020-01-01 00:05:00,16,10,1800,30,1770,2.75%,1.67%
2020-01-01 00:05:00,16,11,9465,720,8745,14.44%,7.61%
2020-01-01 00:05:00,16,12,25635,4507,21128,39.12%,17.58%
2020-01-01 00:05:10,1,1,14159,1464,12695,21.60%,10.34%
2020-01-01 00:05:10,1,2,5693,256,5437,8.69%,4.50%
2020-01-01 00:05:10,1,3,823,7,816,1.26%,0.85%
2020-01-01 00:05:10,1,4,7928,488,7440,12.10%,6.16%
2020-01-01 00:05:10,1,5,7584,459,7125,11.57%,6.05%
2020-01-01 00:05:10,1,6,7511,447,7064,11.46%,5.95%
2020-01-01 00:05:10,1,7,4858,189,4669,7.41%,3.89%
2020-01-01 00:05:10,1,8,4066,130,3936,6.20%,3.20%
2020-01-01 00:05:10,1,9,7462,444,7018,11.39%,5.95%
2020-01-01 00:05:10,1,10,3541,105,3436,5.40%,2.97%
2020-01-01 00:05:10,1,11,3608,107,3501,5.51%,2.97%
2020-01-01 00:05:10,1,12,7424,442,6982,11.33%,5.95%
2020-01-01 00:05:10,2,1,987,2,985,1.51%,0.20%
2020-01-01 00:05:10,2,2,28096,5232,22864,42.87%,18.62%
2020-01-01 00:05:10,2,3,22033,3282,18751,33.62%,14.90%
2020-01-01 00:05:10,2,4,902,2,900,1.38%,0.22%
2020-01-01 00:05:10,2,5,12189,1096,11093,18.60%,8.99%
2020-01-01 00:05:10,2,6,75,0,75,0.11%,0.00%
2020-01-01 00:05:10,2,7,5063,195,4868,7.73%,3.85%
2020-01-01 00:05:10,2,8,4157,138,4019,6.34%,3.32%
2020-01-01 00:05:10,2,9,12128,1088,11040,18.51%,8.97%
2020-01-01 00:05:10,2,10,2950,64,2886,4.50%,2.17%
2020-01-01 00:05:10,2,11,2956,64,2892,4.51%,2.17%
2020-01-01 00:05:10,2,12,11962,1062,10900,18.25%,8.88%
2020-01-01 00:05:10,3,1,1485,12,1473,2.27%,0.81%
2020-01-01 00:05:10,3,2,21742,3205,18537,33.18%,14.74%
2020-01-01 00:05:10,3,3,74105,29617,44488,113.08%,39.97%
2020-01-01 00:05:10,3,4,13096,1213,11883,19.98%,9.26%
2020-01-01 00:05:10,3,5,50277,15100,35177,76.72%,30.03%
2020-01-01 00:05:10,3,6,14397,1466,12931,21.97%,10.18%
2020-01-01 00:05:10,3,7,18560,2398,16162,28.32%,12.92%
2020-01-01 00:05:10,3,8,15180,1654,13526,23.16%,10.90%
2020-01-01 00:05:10,3,9,35540,8057,27483,54.23%,22.67%
2020-01-01 00:05:10,3,10,6207,283,5924,9.47%,4.56%
2020-01-01 00:05:10,3,11,1982,29,1953,3.02%,1.46%
2020-01-01 00:05:10,3,12,25545,4345,21200,38.98%,17.01%
2020-01-01 00:05:10,4,1,735,6,729,1.12%,0.82%
2020-01-01 00:05:10,4,2,560,2,558,0.85%,0.36%
2020-01-01 00:05:10,4,3,1012,9,1003,1.54%,0.89%
2020-01-01 00:05:10,4,4,27846,5116,22730,42.49%,18.37%
2020-01-01 00:05:10,4,5,16875,1967,14908,25.75%,11.66%
2020-01-01 00:05:10,4,6,23553,3730,19823,35.94%,15.84%
2020-01-01 00:05:10,4,7,5018,178,4840,7.66%,3.55%
2020-01-01 00:05:10,4,8,2782,55,2727,4.24%,1.98%
2020-01-01 00:05:10,4,9,14709,1550,13159,22.44%,10.54%
2020-01-01 00:05:10,4,10,1880,30,1850,2.87%,1.60%
2020-01-01 00:05:10,4,11,231,0,231,0.35%,0.00%
2020-01-01 00:05:10,4,12,11958,1049,10909,18.25%,8.77%
2020-01-01 00:05:10,5,1,2876,67,2809,4.39%,2.33%
2020-01-01 00:05:10,5,2,789,4,785,1.20%,0.51%
2020-01-01 00:05:10,5,3,479,1,478,0.73%,0.21%
2020-01-01 00:05:10,5,4,23376,3697,19679,35.67%,15.82%
2020-01-01 00:05:10,5,5,10067,707,9360,15.36%,7.02%
2020-01-01 00:05:10,5,6,14482,1458,13024,22.10%,10.07%
2020-01-01 00:05:10,5,7,3934,124,3810,6.00%,3.15%
2020-01-01 00:05:10,5,8,3027,80,2947,4.62%,2.64%
2020-01-01 00:05:10,5,9,9434,627,8807,14.40%,6.65%
2020-01-01 00:05:10,5,10,1379,22,1357,2.10%,1.60%
2020-01-01 00:05:10,5,11,706,2,704,1.08%,0.28%
2020-01-01 00:05:10,5,12,7876,426,7450,12.02%,5.41%
2020-01-01 00:05:10,6,1,1192,10,1182,1.82%,0.84%
2020-01-01 00:05:10,6,2,1297,16,1281,1.98%,1.23%
2020-01-01 00:05:10,6,3,1675,19,1656,2.56%,1.13%
2020-01-01 00:05:10,6,4,1078,7,1071,1.64%,0.65%
2020-01-01 00:05:10,6,5,12388,1106,11282,18.90%,8.93%
2020-01-01 00:05:10,6,6,4058,118,3940,6.19%,2.91%
2020-01-01 00:05:10,6,7,2388,42,2346,3.64%,1.76%
2020-01-01 00:05:10,6,8,1839,31,1808,2.81%,1.69%
2020-01-01 00:05:10,6,9,6397,285,6112,9.76%,4.46%
2020-01-01 00:05:10,6,10,2047,30,2017,3.12%,1.47%
2020-01-01 00:05:10,6,11,531,1,530,0.81%,0.19%
2020-01-01 00:05:10,6,12,4285,144,4141,6.54%,3.36%
2020-01-01 00:05:10,7,1,524,1,523,0.80%,0.19%
2020-01-01 00:05:10,7,2,168,0,168,0.26%,0.00%
2020-01-01 00:05:10,7,3,1090,3,1087,1.66%,0.28%
2020-01-01 00:05:10,7,4,2181,42,2139,3.33%,1.93%
2020-01-01 00:05:10,7,5,8350,538,7812,12.74%,6.44%
2020-01-01 00:05:10,7,6,14896,1571,13325,22.73%,10.55%
2020-01-01 00:05:10,7,7,4312,142,4170,6.58%,3.29%
2020-01-01 00:05:10,7,8,1456,22,1434,2.22%,1.51%
2020-01-01 00:05:10,7,9,6830,367,6463,10.42%,5.37%
2020-01-01 00:05:10,7,10,1212,13,1199,1.85%,1.07%
2020-01-01 00:05:10,7,11,79,0,79,0.12%,0.00%
2020-01-01 00:05:10,7,12,5619,246,5373,8.57%,4.38%
2020-01-01 00:05:10,8,1,437,2,435,0.67%,0.46%
2020-01-01 00:05:10,8,2,81,0,81,0.12%,0.00%
2020-01-01 00:05:10,8,3,1716,17,1699,2.62%,0.99%
2020-01-01 00:05:10,8,4,2672,54,2618,4.08%,2.02%
2020-01-01 00:05:10,8,5,8680,597,8083,13.24%,6.88%
2020-01-01 00:05:10,8,6,16650,2051,14599,25.41%,12.32%
2020-01-01 00:05:10,8,7,5212,222,4990,7.95%,4.26%
2020-01-01 00:05:10,8,8,2591,58,2533,3.95%,2.24%
2020-01-01 00:05:10,8,9,6750,370,6380,10.30%,5.48%
2020-01-01 00:05:10,8,10,2120,36,2084,3.23%,1.70%
2020-01-01 00:05:10,8,11,134,0,134,0.20%,0.00%
2020-01-01 00:05:10,8,12,4608,181,4427,7.03%,3.93%
2020-01-01 00:05:10,9,1,641,2,639,0.98%,0.31%
2020-01-01 00:05:10,9,2,2340,43,2297,3.57%,1.84%
2020-01-01 00:05:10,9,3,1219,9,1210,1.86%,0.74%
2020-01-01 00:05:10,9,4,5283,219,5064,8.06%,4.15%
2020-01-01 00:05:10,9,5,311,0,311,0.47%,0.00%
2020-01-01 00:05:10,9,6,6226,290,5936,9.50%,4.66%
2020-01-01 00:05:10,9,7,29977,5885,24092,45.74%,19.63%
2020-01-01 00:05:10,9,8,12772,1170,11602,19.49%,9.16%
2020-01-01 00:05:10,9,9,112,0,112,0.17%,0.00%
2020-01-01 00:05:10,9,10,6515,343,6172,9.94%,5.26%
2020-01-01 00:05:10,9,11,11639,995,10644,17.76%,8.55%
2020-01-01 00:05:10,9,12,4834,167,4667,7.38%,3.45%
2020-01-01 00:05:10,10,1,1367,209,1158,2.09%,15.29%
2020-01-01 00:05:10,10,2,3378,289,3089,5.15%,8.56%
2020-01-01 00:05:10,10,3,1880,37,1843,2.87%,1.97%
2020-01-01 00:05:10,10,4,3761,1314,2447,5.74%,34.94%
2020-01-01 00:05:10,10,5,716,51,665,1.09%,7.12%
2020-01-01 00:05:10,10,6,5915,1456,4459,9.03%,24.62%
2020-01-01 00:05:10,10,7,10880,2153,8727,16.60%,19.79%
2020-01-01 00:05:10,10,8,27673,6999,20674,42.23%,25.29%
2020-01-01 00:05:10,10,9,746,2,744,1.14%,0.27%
2020-01-01 00:05:10,10,10,2255,38,2217,3.44%,1.69%
2020-01-01 00:05:10,10,11,13068,1769,11299,19.94%,13.54%
2020-01-01 00:05:10,10,12,10233,1299,8934,15.61%,12.69%
2020-01-01 00:05:10,11,1,2492,67,2425,3.80%,2.69%
2020-01-01 00:05:10,11,2,6096,285,5811,9.30%,4.68%
2020-01-01 00:05:10,11,3,3331,75,3256,5.08%,2.25%
2020-01-01 00:05:10,11,4,3093,74,3019,4.72%,2.39%
2020-01-01 00:05:10,11,5,146,0,146,0.22%,0.00%
2020-01-01 00:05:10,11,6,4065,133,3932,6.20%,3.27%
2020-01-01 00:05:10,11,7,16494,1851,14643,25.17%,11.22%
2020-01-01 00:05:10,11,8,30245,5940,24305,46.15%,19.64%
2020-01-01 00:05:10,11,9,252,2,250,0.38%,0.79%
2020-01-01 00:05:10,11,10,3195,99,3096,4.88%,3.10%
2020-01-01 00:05:10,11,11,10019,728,9291,15.29%,7.27%
2020-01-01 00:05:10,11,12,6417,280,6137,9.79%,4.36%
2020-01-01 00:05:10,12,1,94,0,94,0.14%,0.00%
2020-01-01 00:05:10,12,2,615,174,441,0.94%,28.29%
2020-01-01 00:05:10,12,3,2680,223,2457,4.09%,8.32%
2020-01-01 00:05:10,12,4,3453,112,3341,5.27%,3.24%
2020-01-01 00:05:10,12,5,8759,718,8041,13.37%,8.20%
2020-01-01 00:05:10,12,6,5344,221,5123,8.15%,4.14%
2020-01-01 00:05:10,12,7,1624,17,1607,2.48%,1.05%
2020-01-01 00:05:10,12,8,1409,312,1097,2.15%,22.14%
2020-01-01 00:05:10,12,9,23359,4745,18614,35.64%,20.31%
2020-01-01 00:05:10,12,10,4583,451,4132,6.99%,9.84%
2020-01-01 00:05:10,12,11,1559,319,1240,2.38%,20.46%
2020-01-01 00:05:10,12,12,9124,1380,7744,13.92%,15.12%
2020-01-01 00:05:10,13,1,2237,43,2194,3.41%,1.92%
2020-01-01 00:05:10,13,2,2590,60,2530,3.95%,2.32%
2020-01-01 00:05:10,13,3,1180,29,1151,1.80%,2.46%
2020-01-01 00:05:10,13,4,5430,482,4948,8.29%,8.88%
2020-01-01 00:05:10,13,5,8530,961,7569,13.02%,11.27%
2020-01-01 00:05:10,13,6,6371,559,5812,9.72%,8.77%
2020-01-01 00:05:10,13,7,4532,155,4377,6.92%,3.42%
2020-01-01 00:05:10,13,8,6930,357,6573,10.57%,5.15%
2020-01-01 00:05:10,13,9,8853,1003,7850,13.51%,11.33%
2020-01-01 00:05:10,13,10,27773,5786,21987,42.38%,20.83%
2020-01-01 00:05:10,13,11,16317,2205,14112,24.90%,13.51%
2020-01-01 00:05:10,13,12,9078,970,8108,13.85%,10.69%
2020-01-01 00:05:10,14,1,172,0,172,0.26%,0.00%
2020-01-01 00:05:10,14,2,1029,7,1022,1.57%,0.68%
2020-01-01 00:05:10,14,3,644,2,642,0.98%,0.31%
2020-01-01 00:05:10,14,4,4073,149,3924,6.21%,3.66%
2020-01-01 00:05:10,14,5,1200,9,1191,1.83%,0.75%
2020-01-01 00:05:10,14,6,4406,169,4237,6.72%,3.84%
2020-01-01 00:05:10,14,7,11684,1029,10655,17.83%,8.81%
2020-01-01 00:05:10,14,8,13345,1351,11994,20.36%,10.12%
2020-01-01 00:05:10,14,9,1385,16,1369,2.11%,1.16%
2020-01-01 00:05:10,14,10,4059,117,3942,6.19%,2.88%
2020-01-01 00:05:10,14,11,29366,5777,23589,44.81%,19.67%
2020-01-01 00:05:10,14,12,11677,981,10696,17.82%,8.40%
2020-01-01 00:05:10,15,1,509,3,506,0.78%,0.59%
2020-01-01 00:05:10,15,2,128,0,128,0.20%,0.00%
2020-01-01 00:05:10,15,3,3859,126,3733,5.89%,3.27%
2020-01-01 00:05:10,15,4,5563,291,5272,8.49%,5.23%
2020-01-01 00:05:10,15,5,10499,858,9641,16.02%,8.17%
2020-01-01 00:05:10,15,6,5845,314,5531,8.92%,5.37%
2020-01-01 00:05:10,15,7,3519,108,3411,5.37%,3.07%
2020-01-01 00:05:10,15,8,5577,243,5334,8.51%,4.36%
2020-01-01 00:05:10,15,9,10724,898,9826,16.36%,8.37%
2020-01-01 00:05:10,15,10,4235,255,3980,6.46%,6.02%
2020-01-01 00:05:10,15,11,10081,831,9250,15.38%,8.24%
2020-01-01 00:05:10,15,12,26176,4955,21221,39.94%,18.93%
2020-01-01 00:05:10,16,1,498,4,494,0.76%,0.80%
2020-01-01 00:05:10,16,2,248,0,248,0.38%,0.00%
2020-01-01 00:05:10,16,3,1443,10,1433,2.20%,0.69%
2020-01-01 00:05:10,16,4,3327,77,3250,5.08%,2.31%
2020-01-01 00:05:10,16,5,6499,369,6130,9.92%,5.68%
2020-01-01 00:05:10,16,6,3934,98,3836,6.00%,2.49%
2020-01-01 00:05:10,16,7,3134,79,3055,4.78%,2.52%
2020-01-01 00:05:10,16,8,6954,413,6541,10.61%,5.94%
2020-01-01 00:05:10,16,9,7020,417,6603,10.71%,5.94%
2020-01-01 00:05:10,16,10,2009,37,1972,3.07%,1.84%
2020-01-01 00:05:10,16,11,9133,659,8474,13.94%,7.22%
2020-01-01 00:05:10,16,12,23847,3977,19870,36.39%,16.68%
2020-01-01 00:05:20,1,1,15119,1697,13422,23.07%,11.22%
2020-01-01 00:05:20,1,2,6429,290,6139,9.81%,4.51%
2020-01-01 00:05:20,1,3,447,2,445,0.68%,0.45%
2020-01-01 00:05:20,1,4,8265,553,7712,12.61%,6.69%
2020-01-01 00:05:20,1,5,7837,498,7339,11.96%,6.35%
2020-01-01 00:05:20,1,6,7751,489,7262,11.83%,6.31%
2020-01-01 00:05:20,1,7,5970,241,5729,9.11%,4.04%
2020-01-01 00:05:20,1,8,4113,110,4003,6.28%,2.67%
2020-01-01 00:05:20,1,9,7710,484,7226,11.76%,6.28%
2020-01-01 00:05:20,1,10,3577,70,3507,5.46%,1.96%
2020-01-01 00:05:20,1,11,3665,77,3588,5.59%,2.10%
2020-01-01 00:05:20,1,12,7312,441,6871,11.16%,6.03%
2020-01-01 00:05:20,2,1,979,6,973,1.49%,0.61%
2020-01-01 00:05:20,2,2,29616,5881,23735,45.19%,19.86%
2020-01-01 00:05:20,2,3,23584,3910,19674,35.99%,16.58%
2020-01-01 00:05:20,2,4,812,4,808,1.24%,0.49%
2020-01-01 00:05:20,2,5,13420,1274,12146,20.48%,9.49%
2020-01-01 00:05:20,2,6,58,0,58,0.09%,0.00%
2020-01-01 00:05:20,2,7,5037,184,4853,7.69%,3.65%
2020-01-01 00:05:20,2,8,3695,92,3603,5.64%,2.49%
2020-01-01 00:05:20,2,9,13357,1256,12101,20.38%,9.40%
2020-01-01 00:05:20,2,10,2951,53,2898,4.50%,1.80%
2020-01-01 00:05:20,2,11,2958,53,2905,4.51%,1.79%
2020-01-01 00:05:20,2,12,13141,1216,11925,20.05%,9.25%
2020-01-01 00:05:20,3,1,1603,16,1587,2.45%,1.00%
2020-01-01 00:05:20,3,2,22348,3409,18939,34.10%,15.25%
2020-01-01 00:05:20,3,3,63999,23185,40814,97.65%,36.23%
2020-01-01 00:05:20,3,4,6963,342,6621,10.62%,4.91%
2020-01-01 00:05:20,3,5,39494,9868,29626,60.26%,24.99%
2020-01-01 00:05:20,3,6,8054,451,7603,12.29%,5.60%
2020-01-01 00:05:20,3,7,18749,2456,16293,28.61%,13.10%
2020-01-01 00:05:20,3,8,15283,1631,13652,23.32%,10.67%
2020-01-01 00:05:20,3,9,31102,6400,24702,47.46%,20.58%
2020-01-01 00:05:20,3,10,4899,161,4738,7.48%,3.29%
2020-01-01 00:05:20,3,11,2292,42,2250,3.50%,1.83%
2020-01-01 00:05:20,3,12,23160,3683,19477,35.34%,15.90%
2020-01-01 00:05:20,4,1,518,2,516,0.79%,0.39%
2020-01-01 00:05:20,4,2,286,1,285,0.44%,0.35%
2020-01-01 00:05:20,4,3,717,2,715,1.09%,0.28%
2020-01-01 00:05:20,4,4,28446,5369,23077,43.41%,18.87%
2020-01-01 00:05:20,4,5,17050,2049,15001,26.02%,12.02%
2020-01-01 00:05:20,4,6,24058,3932,20126,36.71%,16.34%
2020-01-01 00:05:20,4,7,5450,220,5230,8.32%,4.04%
2020-01-01 00:05:20,4,8,3295,60,3235,5.03%,1.82%
2020-01-01 00:05:20,4,9,15073,1642,13431,23.00%,10.89%
2020-01-01 00:05:20,4,10,2007,35,1972,3.06%,1.74%
2020-01-01 00:05:20,4,11,165,0,165,0.25%,0.00%
2020-01-01 00:05:20,4,12,12403,1129,11274,18.93%,9.10%
2020-01-01 00:05:20,5,1,3222,71,3151,4.92%,2.20%
2020-01-01 00:05:20,5,2,967,10,957,1.48%,1.03%
2020-01-01 00:05:20,5,3,445,2,443,0.68%,0.45%
2020-01-01 00:05:20,5,4,24218,4062,20156,36.95%,16.77%
2020-01-01 00:05:20,5,5,9002,625,8377,13.74%,6.94%
2020-01-01 00:05:20,5,6,13573,1384,12189,20.71%,10.20%
2020-01-01 00:05:20,5,7,4060,141,3919,6.20%,3.47%
2020-01-01 00:05:20,5,8,2952,71,2881,4.50%,2.41%
2020-01-01 00:05:20,5,9,8367,542,7825,12.77%,6.48%
2020-01-01 00:05:20,5,10,887,6,881,1.35%,0.68%
2020-01-01 00:05:20,5,11,747,5,742,1.14%,0.67%
2020-01-01 00:05:20,5,12,7260,419,6841,11.08%,5.77%
2020-01-01 00:05:20,6,1,1101,14,1087,1.68%,1.27%
2020-01-01 00:05:20,6,2,1166,16,1150,1.78%,1.37%
2020-01-01 00:05:20,6,3,1769,26,1743,2.70%,1.47%
2020-01-01 00:05:20,6,4,1646,21,1625,2.51%,1.28%
2020-01-01 00:05:20,6,5,14443,1473,12970,22.04%,10.20%
2020-01-01 00:05:20,6,6,4578,152,4426,6.99%,3.32%
2020-01-01 00:05:20,6,7,2239,44,2195,3.42%,1.97%
2020-01-01 00:05:20,6,8,1792,38,1754,2.73%,2.12%
2020-01-01 00:05:20,6,9,7836,457,7379,11.96%,5.83%
2020-01-01 00:05:20,6,10,2425,39,2386,3.70%,1.61%
2020-01-01 00:05:20,6,11,477,2,475,0.73%,0.42%
2020-01-01 00:05:20,6,12,5330,192,5138,8.13%,3.60%
2020-01-01 00:05:20,7,1,473,1,472,0.72%,0.21%
2020-01-01 00:05:20,7,2,138,1,137,0.21%,0.72%
2020-01-01 00:05:20,7,3,980,6,974,1.50%,0.61%
2020-01-01 00:05:20,7,4,2245,39,2206,3.43%,1.74%
2020-01-01 00:05:20,7,5,8847,572,8275,13.50%,6.47%
2020-01-01 00:05:20,7,6,14555,1580,12975,22.21%,10.86%
2020-01-01 00:05:20,7,7,3423,84,3339,5.22%,2.45%
2020-01-01 00:05:20,7,8,1252,19,1233,1.91%,1.52%
2020-01-01 00:05:20,7,9,7661,443,7218,11.69%,5.78%
2020-01-01 00:05:20,7,10,1220,12,1208,1.86%,0.98%
2020-01-01 00:05:20,7,11,77,0,77,0.12%,0.00%
2020-01-01 00:05:20,7,12,6480,311,6169,9.89%,4.80%
2020-01-01 00:05:20,8,1,368,0,368,0.56%,0.00%
2020-01-01 00:05:20,8,2,96,0,96,0.15%,0.00%
2020-01-01 00:05:20,8,3,2047,40,2007,3.12%,1.95%
2020-01-01 00:05:20,8,4,3121,81,3040,4.76%,2.60%
2020-01-01 00:05:20,8,5,8023,488,7535,12.24%,6.08%
2020-01-01 00:05:20,8,6,15787,1790,13997,24.09%,11.34%
2020-01-01 00:05:20,8,7,4589,150,4439,7.00%,3.27%
2020-01-01 00:05:20,8,8,1765,23,1742,2.69%,1.30%
2020-01-01 00:05:20,8,9,5739,264,5475,8.76%,4.60%
2020-01-01 00:05:20,8,10,1406,13,1393,2.15%,0.92%
2020-01-01 00:05:20,8,11,165,0,165,0.25%,0.00%
2020-01-01 00:05:20,8,12,4155,148,4007,6.34%,3.56%
2020-01-01 00:05:20,9,1,1574,25,1549,2.40%,1.59%
2020-01-01 00:05:20,9,2,3540,93,3447,5.40%,2.63%
2020-01-01 00:05:20,9,3,1573,14,1559,2.40%,0.89%
2020-01-01 00:05:20,9,4,7451,399,7052,11.37%,5.35%
2020-01-01 00:05:20,9,5,186,0,186,0.28%,0.00%
2020-01-01 00:05:20,9,6,8661,548,8113,13.22%,6.33%
2020-01-01 00:05:20,9,7,31532,6634,24898,48.11%,21.04%
2020-01-01 00:05:20,9,8,10333,782,9551,15.77%,7.57%
2020-01-01 00:05:20,9,9,107,0,107,0.16%,0.00%
2020-01-01 00:05:20,9,10,3801,109,3692,5.80%,2.87%
2020-01-01 00:05:20,9,11,9162,638,8524,13.98%,6.96%
2020-01-01 00:05:20,9,12,5086,216,4870,7.76%,4.25%
2020-01-01 00:05:20,10,1,1324,187,1137,2.02%,14.12%
2020-01-01 00:05:20,10,2,4902,354,4548,7.48%,7.22%
2020-01-01 00:05:20,10,3,3431,93,3338,5.24%,2.71%
2020-01-01 00:05:20,10,4,3809,928,2881,5.81%,24.36%
2020-01-01 00:05:20,10,5,947,20,927,1.45%,2.11%
2020-01-01 00:05:20,10,6,5960,1067,4893,9.09%,17.90%
2020-01-01 00:05:20,10,7,12820,2083,10737,19.56%,16.25%
2020-01-01 00:05:20,10,8,31126,7882,23244,47.49%,25.32%
2020-01-01 00:05:20,10,9,935,12,923,1.43%,1.28%
2020-01-01 00:05:20,10,10,2884,72,2812,4.40%,2.50%
2020-01-01 00:05:20,10,11,13821,1741,12080,21.09%,12.60%
2020-01-01 00:05:20,10,12,10191,1145,9046,15.55%,11.24%
2020-01-01 00:05:20,11,1,2167,32,2135,3.31%,1.48%
2020-01-01 00:05:20,11,2,4805,170,4635,7.33%,3.54%
2020-01-01 00:05:20,11,3,2440,42,2398,3.72%,1.72%
2020-01-01 00:05:20,11,4,4920,219,4701,7.51%,4.45%
2020-01-01 00:05:20,11,5,193,0,193,0.29%,0.00%
2020-01-01 00:05:20,11,6,5698,283,5415,8.69%,4.97%
2020-01-01 00:05:20,11,7,17212,2083,15129,26.26%,12.10%
2020-01-01 00:05:20,11,8,30842,6306,24536,47.06%,20.45%
2020-01-01 00:05:20,11,9,217,0,217,0.33%,0.00%
2020-01-01 00:05:20,11,10,2840,47,2793,4.33%,1.65%
2020-01-01 00:05:20,11,11,9891,655,9236,15.09%,6.62%
2020-01-01 00:05:20,11,12,6619,279,6340,10.10%,4.22%
2020-01-01 00:05:20,12,1,52,1,51,0.08%,1.92%
2020-01-01 00:05:20,12,2,631,203,428,0.96%,32.17%
2020-01-01 00:05:20,12,3,2488,240,2248,3.80%,9.65%
2020-01-01 00:05:20,12,4,3097,74,3023,4.73%,2.39%
2020-01-01 00:05:20,12,5,8708,709,7999,13.29%,8.14%
2020-01-01 00:05:20,12,6,5237,186,5051,7.99%,3.55%
2020-01-01 00:05:20,12,7,1952,30,1922,2.98%,1.54%
2020-01-01 00:05:20,12,8,1450,292,1158,2.21%,20.14%
2020-01-01 00:05:20,12,9,22275,4314,17961,33.99%,19.37%
2020-01-01 00:05:20,12,10,4420,410,4010,6.74%,9.28%
2020-01-01 00:05:20,12,11,1877,300,1577,2.86%,15.98%
2020-01-01 00:05:20,12,12,8319,1182,7137,12.69%,14.21%
2020-01-01 00:05:20,13,1,2164,32,2132,3.30%,1.48%
2020-01-01 00:05:20,13,2,2390,40,2350,3.65%,1.67%
2020-01-01 00:05:20,13,3,1165,8,1157,1.78%,0.69%
2020-01-01 00:05:20,13,4,6344,680,5664,9.68%,10.72%
2020-01-01 00:05:20,13,5,9423,1087,8336,14.38%,11.54%
2020-01-01 00:05:20,13,6,7071,738,6333,10.79%,10.44%
2020-01-01 00:05:20,13,7,4572,163,4409,6.98%,3.57%
2020-01-01 00:05:20,13,8,7024,370,6654,10.72%,5.27%
2020-01-01 00:05:20,13,9,9638,1111,8527,14.71%,11.53%
2020-01-01 00:05:20,13,10,28221,5875,22346,43.06%,20.82%
2020-01-01 00:05:20,13,11,16106,2094,14012,24.58%,13.00%
2020-01-01 00:05:20,13,12,8720,877,7843,13.31%,10.06%
2020-01-01 00:05:20,14,1,281,0,281,0.43%,0.00%
2020-01-01 00:05:20,14,2,1846,30,1816,2.82%,1.63%
2020-01-01 00:05:20,14,3,1313,20,1293,2.00%,1.52%
2020-01-01 00:05:20,14,4,3841,89,3752,5.86%,2.32%
2020-01-01 00:05:20,14,5,1506,13,1493,2.30%,0.86%
2020-01-01 00:05:20,14,6,4241,112,4129,6.47%,2.64%
2020-01-01 00:05:20,14,7,12872,1238,11634,19.64%,9.62%
2020-01-01 00:05:20,14,8,14450,1529,12921,22.05%,10.58%
2020-01-01 00:05:20,14,9,1677,14,1663,2.56%,0.83%
2020-01-01 00:05:20,14,10,3923,99,3824,5.99%,2.52%
2020-01-01 00:05:20,14,11,27107,4916,22191,41.36%,18.14%
2020-01-01 00:05:20,14,12,8543,515,8028,13.04%,6.03%
2020-01-01 00:05:20,15,1,594,1,593,0.91%,0.17%
2020-01-01 00:05:20,15,2,228,0,228,0.35%,0.00%
2020-01-01 00:05:20,15,3,4795,166,4629,7.32%,3.46%
2020-01-01 00:05:20,15,4,6293,276,6017,9.60%,4.39%
2020-01-01 00:05:20,15,5,12397,1074,11323,18.92%,8.66%
2020-01-01 00:05:20,15,6,6524,292,6232,9.95%,4.48%
2020-01-01 00:05:20,15,7,3715,119,3596,5.67%,3.20%
2020-01-01 00:05:20,15,8,5504,245,5259,8.40%,4.45%
2020-01-01 00:05:20,15,9,12610,1114,11496,19.24%,8.83%
2020-01-01 00:05:20,15,10,4156,159,3997,6.34%,3.83%
2020-01-01 00:05:20,15,11,9855,768,9087,15.04%,7.79%
2020-01-01 00:05:20,15,12,27793,5399,22394,42.41%,19.43%
2020-01-01 00:05:20,16,1,451,5,446,0.69%,1.11%
2020-01-01 00:05:20,16,2,264,0,264,0.40%,0.00%
2020-01-01 00:05:20,16,3,1401,18,1383,2.14%,1.28%
2020-01-01 00:05:20,16,4,4672,141,4531,7.13%,3.02%
2020-01-01 00:05:20,16,5,7956,486,7470,12.14%,6.11%
2020-01-01 00:05:20,16,6,5373,194,5179,8.20%,3.61%
2020-01-01 00:05:20,16,7,3694,118,3576,5.64%,3.19%
2020-01-01 00:05:20,16,8,7006,443,6563,10.69%,6.32%
2020-01-01 00:05:20,16,9,8344,542,7802,12.73%,6.50%
2020-01-01 00:05:20,16,10,1542,19,1523,2.35%,1.23%
2020-01-01 00:05:20,16,11,8750,668,8082,13.35%,7.63%
2020-01-01 00:05:20,16,12,24846,4360,20486,37.91%,17.55%
2020-01-01 00:05:30,1,1,22609,3535,19074,34.50%,15.64%
2020-01-01 00:05:30,1,2,8932,614,8318,13.63%,6.87%
2020-01-01 00:05:30,1,3,745,3,742,1.14%,0.40%
2020-01-01 00:05:30,1,4,13188,1246,11942,20.12%,9.45%
2020-01-01 00:05:30,1,5,12739,1161,11578,19.44%,9.11%
2020-01-01 00:05:30,1,6,12699,1158,11541,19.38%,9.12%
2020-01-01 00:05:30,1,7,8171,521,7650,12.47%,6.38%
2020-01-01 00:05:30,1,8,5365,207,5158,8.19%,3.86%
2020-01-01 00:05:30,1,9,12663,1147,11516,19.32%,9.06%
2020-01-01 00:05:30,1,10,4828,163,4665,7.37%,3.38%
2020-01-01 00:05:30,1,11,4936,171,4765,7.53%,3.46%
2020-01-01 00:05:30,1,12,12529,1127,11402,19.12%,9.00%
2020-01-01 00:05:30,2,1,431,0,431,0.66%,0.00%
2020-01-01 00:05:30,2,2,31351,6385,24966,47.84%,20.37%
2020-01-01 00:05:30,2,3,20898,2963,17935,31.89%,14.18%
2020-01-01 00:05:30,2,4,373,0,373,0.57%,0.00%
2020-01-01 00:05:30,2,5,11663,944,10719,17.80%,8.09%
2020-01-01 00:05:30,2,6,26,0,26,0.04%,0.00%
2020-01-01 00:05:30,2,7,10008,712,9296,15.27%,7.11%
2020-01-01 00:05:30,2,8,9203,622,8581,14.04%,6.76%
2020-01-01 00:05:30,2,9,11597,933,10664,17.70%,8.05%
2020-01-01 00:05:30,2,10,8335,513,7822,12.72%,6.15%
2020-01-01 00:05:30,2,11,8361,515,7846,12.76%,6.16%
2020-01-01 00:05:30,2,12,11436,909,10527,17.45%,7.95%
2020-01-01 00:05:30,3,1,1736,18,1718,2.65%,1.04%
2020-01-01 00:05:30,3,2,22448,3430,19018,34.25%,15.28%
2020-01-01 00:05:30,3,3,72431,28659,43772,110.52%,39.57%
2020-01-01 00:05:30,3,4,11559,1005,10554,17.64%,8.69%
2020-01-01 00:05:30,3,5,47522,13681,33841,72.51%,28.79%
2020-01-01 00:05:30,3,6,12797,1195,11602,19.53%,9.34%
2020-01-01 00:05:30,3,7,18888,2469,16419,28.82%,13.07%
2020-01-01 00:05:30,3,8,14875,1535,13340,22.70%,10.32%
2020-01-01 00:05:30,3,9,34421,7614,26807,52.52%,22.12%
2020-01-01 00:05:30,3,10,5043,184,4859,7.70%,3.65%
2020-01-01 00:05:30,3,11,1750,21,1729,2.67%,1.20%
2020-01-01 00:05:30,3,12,26841,4802,22039,40.96%,17.89%
2020-01-01 00:05:30,4,1,470,1,469,0.72%,0.21%
2020-01-01 00:05:30,4,2,301,0,301,0.46%,0.00%
2020-01-01 00:05:30,4,3,804,6,798,1.23%,0.75%
2020-01-01 00:05:30,4,4,27557,5052,22505,42.05%,18.33%
2020-01-01 00:05:30,4,5,17096,2017,15079,26.09%,11.80%
2020-01-01 00:05:30,4,6,23482,3722,19760,35.83%,15.85%
2020-01-01 00:05:30,4,7,5168,194,4974,7.89%,3.75%
2020-01-01 00:05:30,4,8,3126,78,3048,4.77%,2.50%
2020-01-01 00:05:30,4,9,15122,1573,13549,23.07%,10.40%
2020-01-01 00:05:30,4,10,2003,28,1975,3.06%,1.40%
2020-01-01 00:05:30,4,11,188,0,188,0.29%,0.00%
2020-01-01 00:05:30,4,12,12003,1006,10997,18.32%,8.38%
2020-01-01 00:05:30,5,1,3240,81,3159,4.94%,2.50%
2020-01-01 00:05:30,5,2,802,3,799,1.22%,0.37%
2020-01-01 00:05:30,5,3,447,2,445,0.68%,0.45%
2020-01-01 00:05:30,5,4,21836,3200,18636,33.32%,14.65%
2020-01-01 00:05:30,5,5,9409,654,8755,14.36%,6.95%
2020-01-01 00:05:30,5,6,14460,1495,12965,22.06%,10.34%
2020-01-01 00:05:30,5,7,4590,140,4450,7.00%,3.05%
2020-01-01 00:05:30,5,8,3150,63,3087,4.81%,2.00%
2020-01-01 00:05:30,5,9,8807,578,8229,13.44%,6.56%
2020-01-01 00:05:30,5,10,945,12,933,1.44%,1.27%
2020-01-01 00:05:30,5,11,683,4,679,1.04%,0.59%
2020-01-01 00:05:30,5,12,7581,432,7149,11.57%,5.70%
2020-01-01 00:05:30,6,1,933,8,925,1.42%,0.86%
2020-01-01 00:05:30,6,2,999,9,990,1.52%,0.90%
2020-01-01 00:05:30,6,3,1662,32,1630,2.54%,1.93%
2020-01-01 00:05:30,6,4,1641,24,1617,2.50%,1.46%
2020-01-01 00:05:30,6,5,14421,1462,12959,22.00%,10.14%
2020-01-01 00:05:30,6,6,4332,138,4194,6.61%,3.19%
2020-01-01 00:05:30,6,7,2129,39,2090,3.25%,1.83%
2020-01-01 00:05:30,6,8,1558,22,1536,2.38%,1.41%
2020-01-01 00:05:30,6,9,8182,488,7694,12.48%,5.96%
2020-01-01 00:05:30,6,10,2093,34,2059,3.19%,1.62%
2020-01-01 00:05:30,6,11,447,2,445,0.68%,0.45%
2020-01-01 00:05:30,6,12,6034,262,5772,9.21%,4.34%
2020-01-01 00:05:30,7,1,525,1,524,0.80%,0.19%
2020-01-01 00:05:30,7,2,243,0,243,0.37%,0.00%
2020-01-01 00:05:30,7,3,1384,15,1369,2.11%,1.08%
2020-01-01 00:05:30,7,4,2278,27,2251,3.48%,1.19%
2020-01-01 00:05:30,7,5,8199,509,7690,12.51%,6.21%
2020-01-01 00:05:30,7,6,13783,1372,12411,21.03%,9.95%
2020-01-01 00:05:30,7,7,3278,79,3199,5.00%,2.41%
2020-01-01 00:05:30,7,8,1430,20,1410,2.18%,1.40%
2020-01-01 00:05:30,7,9,6745,340,6405,10.29%,5.04%
2020-01-01 00:05:30,7,10,938,10,928,1.43%,1.07%
2020-01-01 00:05:30,7,11,92,0,92,0.14%,0.00%
2020-01-01 00:05:30,7,12,5835,269,5566,8.90%,4.61%
2020-01-01 00:05:30,8,1,395,1,394,0.60%,0.25%
2020-01-01 00:05:30,8,2,101,0,101,0.15%,0.00%
2020-01-01 00:05:30,8,3,2123,28,2095,3.24%,1.32%
2020-01-01 00:05:30,8,4,2847,53,2794,4.34%,1.86%
2020-01-01 00:05:30,8,5,8325,537,7788,12.70%,6.45%
2020-01-01 00:05:30,8,6,15566,1717,13849,23.75%,11.03%
2020-01-01 00:05:30,8,7,4298,149,4149,6.56%,3.47%
2020-01-01 00:05:30,8,8,1823,27,1796,2.78%,1.48%
2020-01-01 00:05:30,8,9,5938,305,5633,9.06%,5.14%
2020-01-01 00:05:30,8,10,1603,34,1569,2.45%,2.12%
2020-01-01 00:05:30,8,11,137,0,137,0.21%,0.00%
2020-01-01 00:05:30,8,12,4270,155,4115,6.52%,3.63%
2020-01-01 00:05:30,9,1,590,1,589,0.90%,0.17%
2020-01-01 00:05:30,9,2,4880,168,4712,7.45%,3.44%
2020-01-01 00:05:30,9,3,3875,108,3767,5.91%,2.79%
2020-01-01 00:05:30,9,4,11626,944,10682,17.74%,8.12%
2020-01-01 00:05:30,9,5,466,2,464,0.71%,0.43%
2020-01-01 00:05:30,9,6,12966,1183,11783,19.78%,9.12%
2020-01-01 00:05:30,9,7,32057,6709,25348,48.92%,20.93%
2020-01-01 00:05:30,9,8,8158,509,7649,12.45%,6.24%
2020-01-01 00:05:30,9,9,325,1,324,0.50%,0.31%
2020-01-01 00:05:30,9,10,2023,31,1992,3.09%,1.53%
2020-01-01 00:05:30,9,11,7146,392,6754,10.90%,5.49%
2020-01-01 00:05:30,9,12,4827,185,4642,7.37%,3.83%
2020-01-01 00:05:30,10,1,1272,214,1058,1.94%,16.82%
2020-01-01 00:05:30,10,2,4348,348,4000,6.63%,8.00%
2020-01-01 00:05:30,10,3,2895,84,2811,4.42%,2.90%
2020-01-01 00:05:30,10,4,3776,1107,2669,5.76%,29.32%
2020-01-01 00:05:30,10,5,832,43,789,1.27%,5.17%
2020-01-01 00:05:30,10,6,5933,1268,4665,9.05%,21.37%
2020-01-01 00:05:30,10,7,11889,2110,9779,18.14%,17.75%
2020-01-01 00:05:30,10,8,30439,7800,22639,46.45%,25.63%
2020-01-01 00:05:30,10,9,804,4,800,1.23%,0.50%
2020-01-01 00:05:30,10,10,2770,50,2720,4.23%,1.81%
2020-01-01 00:05:30,10,11,14404,1959,12445,21.98%,13.60%
2020-01-01 00:05:30,10,12,10733,1327,9406,16.38%,12.36%
2020-01-01 00:05:30,11,1,2721,63,2658,4.15%,2.32%
2020-01-01 00:05:30,11,2,3954,126,3828,6.03%,3.19%
2020-01-01 00:05:30,11,3,1035,10,1025,1.58%,0.97%
2020-01-01 00:05:30,11,4,3300,91,3209,5.04%,2.76%
2020-01-01 00:05:30,11,5,316,1,315,0.48%,0.32%
2020-01-01 00:05:30,11,6,4211,146,4065,6.43%,3.47%
2020-01-01 00:05:30,11,7,9938,700,9238,15.16%,7.04%
2020-01-01 00:05:30,11,8,23492,3733,19759,35.85%,15.89%
2020-01-01 00:05:30,11,9,329,1,328,0.50%,0.30%
2020-01-01 00:05:30,11,10,2848,58,2790,4.35%,2.04%
2020-01-01 00:05:30,11,11,9728,708,9020,14.84%,7.28%
2020-01-01 00:05:30,11,12,6363,323,6040,9.71%,5.08%
2020-01-01 00:05:30,12,1,60,0,60,0.09%,0.00%
2020-01-01 00:05:30,12,2,800,179,621,1.22%,22.38%
2020-01-01 00:05:30,12,3,2844,232,2612,4.34%,8.16%
2020-01-01 00:05:30,12,4,3073,73,3000,4.69%,2.38%
2020-01-01 00:05:30,12,5,9543,833,8710,14.56%,8.73%
2020-01-01 00:05:30,12,6,4993,181,4812,7.62%,3.63%
2020-01-01 00:05:30,12,7,1767,18,1749,2.70%,1.02%
2020-01-01 00:05:30,12,8,1649,299,1350,2.52%,18.13%
2020-01-01 00:05:30,12,9,21951,4281,17670,33.49%,19.50%
2020-01-01 00:05:30,12,10,4618,432,4186,7.05%,9.35%
2020-01-01 00:05:30,12,11,1823,302,1521,2.78%,16.57%
2020-01-01 00:05:30,12,12,7319,1116,6203,11.17%,15.25%
2020-01-01 00:05:30,13,1,2183,49,2134,3.33%,2.24%
2020-01-01 00:05:30,13,2,2470,57,2413,3.77%,2.31%
2020-01-01 00:05:30,13,3,986,6,980,1.50%,0.61%
2020-01-01 00:05:30,13,4,4353,474,3879,6.64%,10.89%
2020-01-01 00:05:30,13,5,7067,778,6289,10.78%,11.01%
2020-01-01 00:05:30,13,6,5164,520,4644,7.88%,10.07%
2020-01-01 00:05:30,13,7,4680,170,4510,7.14%,3.63%
2020-01-01 00:05:30,13,8,6915,349,6566,10.55%,5.05%
2020-01-01 00:05:30,13,9,7324,801,6523,11.18%,10.94%
2020-01-01 00:05:30,13,10,26368,5234,21134,40.23%,19.85%
2020-01-01 00:05:30,13,11,16407,2139,14268,25.04%,13.04%
2020-01-01 00:05:30,13,12,9055,881,8174,13.82%,9.73%
2020-01-01 00:05:30,14,1,230,0,230,0.35%,0.00%
2020-01-01 00:05:30,14,2,1185,10,1175,1.81%,0.84%
2020-01-01 00:05:30,14,3,746,6,740,1.14%,0.80%
2020-01-01 00:05:30,14,4,4784,163,4621,7.30%,3.41%
2020-01-01 00:05:30,14,5,1528,18,1510,2.33%,1.18%
2020-01-01 00:05:30,14,6,5164,187,4977,7.88%,3.62%
2020-01-01 00:05:30,14,7,12326,1103,11223,18.81%,8.95%
2020-01-01 00:05:30,14,8,13741,1343,12398,20.97%,9.77%
2020-01-01 00:05:30,14,9,1716,21,1695,2.62%,1.22%
2020-01-01 00:05:30,14,10,3945,119,3826,6.02%,3.02%
2020-01-01 00:05:30,14,11,25530,4343,21187,38.96%,17.01%
2020-01-01 00:05:30,14,12,7635,432,7203,11.65%,5.66%
2020-01-01 00:05:30,15,1,530,4,526,0.81%,0.75%
2020-01-01 00:05:30,15,2,146,0,146,0.22%,0.00%
2020-01-01 00:05:30,15,3,3735,109,3626,5.70%,2.92%
2020-01-01 00:05:30,15,4,4957,205,4752,7.56%,4.14%
2020-01-01 00:05:30,15,5,9648,715,8933,14.72%,7.41%
2020-01-01 00:05:30,15,6,5163,219,4944,7.88%,4.24%
2020-01-01 00:05:30,15,7,3236,77,3159,4.94%,2.38%
2020-01-01 00:05:30,15,8,5130,197,4933,7.83%,3.84%
2020-01-01 00:05:30,15,9,9845,743,9102,15.02%,7.55%
2020-01-01 00:05:30,15,10,4727,340,4387,7.21%,7.19%
2020-01-01 00:05:30,15,11,10010,884,9126,15.27%,8.83%
2020-01-01 00:05:30,15,12,24997,4691,20306,38.14%,18.77%
2020-01-01 00:05:30,16,1,488,3,485,0.74%,0.61%
2020-01-01 00:05:30,16,2,232,0,232,0.35%,0.00%
2020-01-01 00:05:30,16,3,1316,12,1304,2.01%,0.91%
2020-01-01 00:05:30,16,4,4751,137,4614,7.25%,2.88%
2020-01-01 00:05:30,16,5,7890,447,7443,12.04%,5.67%
2020-01-01 00:05:30,16,6,5582,198,5384,8.52%,3.55%
2020-01-01 00:05:30,16,7,3391,89,3302,5.17%,2.62%
2020-01-01 00:05:30,16,8,7732,541,7191,11.80%,7.00%
2020-01-01 00:05:30,16,9,8318,496,7822,12.69%,5.96%
2020-01-01 00:05:30,16,10,1441,42,1399,2.20%,2.91%
2020-01-01 00:05:30,16,11,9392,760,8632,14.33%,8.09%
2020-01-01 00:05:30,16,12,25507,4418,21089,38.92%,17.32%
2020-01-01 00:05:40,1,1,21255,3151,18104,32.43%,14.82%
2020-01-01 00:05:40,1,2,9018,585,8433,13.76%,6.49%
2020-01-01 00:05:40,1,3,1942,29,1913,2.96%,1.49%
2020-01-01 00:05:40,1,4,11689,1080,10609,17.84%,9.24%
2020-01-01 00:05:40,1,5,11049,989,10060,16.86%,8.95%
2020-01-01 00:05:40,1,6,11026,986,10040,16.82%,8.94%
2020-01-01 00:05:40,1,7,7062,373,6689,10.78%,5.28%
2020-01-01 00:05:40,1,8,5980,277,5703,9.12%,4.63%
2020-01-01 00:05:40,1,9,10976,976,10000,16.75%,8.89%
2020-01-01 00:05:40,1,10,5432,231,5201,8.29%,4.25%
2020-01-01 00:05:40,1,11,5521,236,5285,8.42%,4.27%
2020-01-01 00:05:40,1,12,10945,973,9972,16.70%,8.89%
2020-01-01 00:05:40,2,1,3833,119,3714,5.85%,3.10%
2020-01-01 00:05:40,2,2,32474,6917,25557,49.55%,21.30%
2020-01-01 00:05:40,2,3,19748,2748,17000,30.13%,13.92%
2020-01-01 00:05:40,2,4,3750,119,3631,5.72%,3.17%
2020-01-01 00:05:40,2,5,11817,1055,10762,18.03%,8.93%
2020-01-01 00:05:40,2,6,42,0,42,0.06%,0.00%
2020-01-01 00:05:40,2,7,8874,583,8291,13.54%,6.57%
2020-01-01 00:05:40,2,8,7830,455,7375,11.95%,5.81%
2020-01-01 00:05:40,2,9,11771,1042,10729,17.96%,8.85%
2020-01-01 00:05:40,2,10,6769,329,6440,10.33%,4.86%
2020-01-01 00:05:40,2,11,6786,331,6455,10.35%,4.88%
2020-01-01 00:05:40,2,12,11583,1012,10571,17.67%,8.74%
2020-01-01 00:05:40,3,1,2525,53,2472,3.85%,2.10%
2020-01-01 00:05:40,3,2,23777,3825,19952,36.28%,16.09%
2020-01-01 00:05:40,3,3,68652,26090,42562,104.75%,38.00%
2020-01-01 00:05:40,3,4,8744,545,8199,13.34%,6.23%
2020-01-01 00:05:40,3,5,42082,11101,30981,64.21%,26.38%
2020-01-01 00:05:40,3,6,10058,719,9339,15.35%,7.15%
2020-01-01 00:05:40,3,7,19385,2573,16812,29.58%,13.27%
2020-01-01 00:05:40,3,8,16009,1735,14274,24.43%,10.84%
2020-01-01 00:05:40,3,9,31651,6558,25093,48.30%,20.72%
2020-01-01 00:05:40,3,10,5260,184,5076,8.03%,3.50%
2020-01-01 00:05:40,3,11,1738,23,1715,2.65%,1.32%
2020-01-01 00:05:40,3,12,22362,3367,18995,34.12%,15.06%
2020-01-01 00:05:40,4,1,584,0,584,0.89%,0.00%
2020-01-01 00:05:40,4,2,373,0,373,0.57%,0.00%
2020-01-01 00:05:40,4,3,1025,10,1015,1.56%,0.98%
2020-01-01 00:05:40,4,4,29564,5767,23797,45.11%,19.51%
2020-01-01 00:05:40,4,5,18576,2376,16200,28.34%,12.79%
2020-01-01 00:05:40,4,6,25557,4367,21190,39.00%,17.09%
2020-01-01 00:05:40,4,7,5742,235,5507,8.76%,4.09%
2020-01-01 00:05:40,4,8,3349,78,3271,5.11%,2.33%
2020-01-01 00:05:40,4,9,16229,1845,14384,24.76%,11.37%
2020-01-01 00:05:40,4,10,2080,37,2043,3.17%,1.78%
2020-01-01 00:05:40,4,11,202,0,202,0.31%,0.00%
2020-01-01 00:05:40,4,12,12629,1134,11495,19.27%,8.98%
2020-01-01 00:05:40,5,1,3196,77,3119,4.88%,2.41%
2020-01-01 00:05:40,5,2,812,7,805,1.24%,0.86%
2020-01-01 00:05:40,5,3,1866,25,1841,2.85%,1.34%
2020-01-01 00:05:40,5,4,22874,3495,19379,34.90%,15.28%
2020-01-01 00:05:40,5,5,10966,869,10097,16.73%,7.92%
2020-01-01 00:05:40,5,6,16218,1826,14392,24.75%,11.26%
2020-01-01 00:05:40,5,7,4648,173,4475,7.09%,3.72%
2020-01-01 00:05:40,5,8,3758,118,3640,5.73%,3.14%
2020-01-01 00:05:40,5,9,8770,533,8237,13.38%,6.08%
2020-01-01 00:05:40,5,10,1195,10,1185,1.82%,0.84%
2020-01-01 00:05:40,5,11,567,4,563,0.87%,0.71%
2020-01-01 00:05:40,5,12,7259,374,6885,11.08%,5.15%
2020-01-01 00:05:40,6,1,1078,12,1066,1.64%,1.11%
2020-01-01 00:05:40,6,2,1143,12,1131,1.74%,1.05%
2020-01-01 00:05:40,6,3,1819,21,1798,2.78%,1.15%
2020-01-01 00:05:40,6,4,1581,15,1566,2.41%,0.95%
2020-01-01 00:05:40,6,5,14345,1418,12927,21.89%,9.88%
2020-01-01 00:05:40,6,6,5515,203,5312,8.42%,3.68%
2020-01-01 00:05:40,6,7,3250,74,3176,4.96%,2.28%
2020-01-01 00:05:40,6,8,2544,52,2492,3.88%,2.04%
2020-01-01 00:05:40,6,9,6796,329,6467,10.37%,4.84%
2020-01-01 00:05:40,6,10,2198,38,2160,3.35%,1.73%
2020-01-01 00:05:40,6,11,503,4,499,0.77%,0.80%
2020-01-01 00:05:40,6,12,4547,146,4401,6.94%,3.21%
2020-01-01 00:05:40,7,1,653,3,650,1.00%,0.46%
2020-01-01 00:05:40,7,2,207,0,207,0.32%,0.00%
2020-01-01 00:05:40,7,3,1548,24,1524,2.36%,1.55%
2020-01-01 00:05:40,7,4,2968,52,2916,4.53%,1.75%
2020-01-01 00:05:40,7,5,8304,503,7801,12.67%,6.06%
2020-01-01 00:05:40,7,6,14377,1430,12947,21.94%,9.95%
2020-01-01 00:05:40,7,7,3074,53,3021,4.69%,1.72%
2020-01-01 00:05:40,7,8,1224,11,1213,1.87%,0.90%
2020-01-01 00:05:40,7,9,6702,323,6379,10.23%,4.82%
2020-01-01 00:05:40,7,10,970,11,959,1.48%,1.13%
2020-01-01 00:05:40,7,11,90,0,90,0.14%,0.00%
2020-01-01 00:05:40,7,12,5755,253,5502,8.78%,4.40%
2020-01-01 00:05:40,8,1,477,0,477,0.73%,0.00%
2020-01-01 00:05:40,8,2,106,0,106,0.16%,0.00%
2020-01-01 00:05:40,8,3,1665,21,1644,2.54%,1.26%
2020-01-01 00:05:40,8,4,2816,64,2752,4.30%,2.27%
2020-01-01 00:05:40,8,5,7917,476,7441,12.08%,6.01%
2020-01-01 00:05:40,8,6,15297,1653,13644,23.34%,10.81%
2020-01-01 00:05:40,8,7,4437,155,4282,6.77%,3.49%
2020-01-01 00:05:40,8,8,1851,34,1817,2.82%,1.84%
2020-01-01 00:05:40,8,9,6027,281,5746,9.20%,4.66%
2020-01-01 00:05:40,8,10,1831,29,1802,2.79%,1.58%
2020-01-01 00:05:40,8,11,163,0,163,0.25%,0.00%
2020-01-01 00:05:40,8,12,4193,142,4051,6.40%,3.39%
2020-01-01 00:05:40,9,1,873,3,870,1.33%,0.34%
2020-01-01 00:05:40,9,2,3458,70,3388,5.28%,2.02%
2020-01-01 00:05:40,9,3,2210,22,2188,3.37%,1.00%
2020-01-01 00:05:40,9,4,7563,429,7134,11.54%,5.67%
2020-01-01 00:05:40,9,5,403,0,403,0.61%,0.00%
2020-01-01 00:05:40,9,6,8638,556,8082,13.18%,6.44%
2020-01-01 00:05:40,9,7,27427,5025,22402,41.85%,18.32%
2020-01-01 00:05:40,9,8,9469,653,8816,14.45%,6.90%
2020-01-01 00:05:40,9,9,143,0,143,0.22%,0.00%
2020-01-01 00:05:40,9,10,3295,121,3174,5.03%,3.67%
2020-01-01 00:05:40,9,11,8268,520,7748,12.62%,6.29%
2020-01-01 00:05:40,9,12,4655,160,4495,7.10%,3.44%
2020-01-01 00:05:40,10,1,1275,190,1085,1.95%,14.90%
2020-01-01 00:05:40,10,2,2747,231,2516,4.19%,8.41%
2020-01-01 00:05:40,10,3,1320,17,1303,2.01%,1.29%
2020-01-01 00:05:40,10,4,3954,1167,2787,6.03%,29.51%
2020-01-01 00:05:40,10,5,699,20,679,1.07%,2.86%
2020-01-01 00:05:40,10,6,6156,1304,4852,9.39%,21.18%
2020-01-01 00:05:40,10,7,10923,1969,8954,16.67%,18.03%
2020-01-01 00:05:40,10,8,29324,7497,21827,44.74%,25.57%
2020-01-01 00:05:40,10,9,826,6,820,1.26%,0.73%
2020-01-01 00:05:40,10,10,2714,59,2655,4.14%,2.17%
2020-01-01 00:05:40,10,11,14946,2047,12899,22.81%,13.70%
2020-01-01 00:05:40,10,12,11444,1411,10033,17.46%,12.33%
2020-01-01 00:05:40,11,1,2222,53,2169,3.39%,2.39%
2020-01-01 00:05:40,11,2,3356,113,3243,5.12%,3.37%
2020-01-01 00:05:40,11,3,908,11,897,1.39%,1.21%
2020-01-01 00:05:40,11,4,5320,257,5063,8.12%,4.83%
2020-01-01 00:05:40,11,5,196,0,196,0.30%,0.00%
2020-01-01 00:05:40,11,6,6419,338,6081,9.79%,5.27%
2020-01-01 00:05:40,11,7,11420,1004,10416,17.43%,8.79%
2020-01-01 00:05:40,11,8,24930,4258,20672,38.04%,17.08%
2020-01-01 00:05:40,11,9,310,0,310,0.47%,0.00%
2020-01-01 00:05:40,11,10,3073,66,3007,4.69%,2.15%
2020-01-01 00:05:40,11,11,10202,760,9442,15.57%,7.45%
2020-01-01 00:05:40,11,12,6600,345,6255,10.07%,5.23%
2020-01-01 00:05:40,12,1,71,0,71,0.11%,0.00%
2020-01-01 00:05:40,12,2,715,170,545,1.09%,23.78%
2020-01-01 00:05:40,12,3,2593,212,2381,3.96%,8.18%
2020-01-01 00:05:40,12,4,3378,74,3304,5.15%,2.19%
2020-01-01 00:05:40,12,5,9355,754,8601,14.27%,8.06%
2020-01-01 00:05:40,12,6,5517,228,5289,8.42%,4.13%
2020-01-01 00:05:40,12,7,1974,47,1927,3.01%,2.38%
2020-01-01 00:05:40,12,8,1582,343,1239,2.41%,21.68%
2020-01-01 00:05:40,12,9,22470,4298,18172,34.29%,19.13%
2020-01-01 00:05:40,12,10,4576,485,4091,6.98%,10.60%
2020-01-01 00:05:40,12,11,1774,346,1428,2.71%,19.50%
2020-01-01 00:05:40,12,12,8014,1107,6907,12.23%,13.81%
2020-01-01 00:05:40,13,1,2374,35,2339,3.62%,1.47%
2020-01-01 00:05:40,13,2,2697,45,2652,4.12%,1.67%
2020-01-01 00:05:40,13,3,988,11,977,1.51%,1.11%
2020-01-01 00:05:40,13,4,4145,358,3787,6.32%,8.64%
2020-01-01 00:05:40,13,5,6945,633,6312,10.60%,9.11%
2020-01-01 00:05:40,13,6,5130,405,4725,7.83%,7.89%
2020-01-01 00:05:40,13,7,4908,173,4735,7.49%,3.52%
2020-01-01 00:05:40,13,8,6985,384,6601,10.66%,5.50%
2020-01-01 00:05:40,13,9,7291,665,6626,11.13%,9.12%
2020-01-01 00:05:40,13,10,26142,5100,21042,39.89%,19.51%
2020-01-01 00:05:40,13,11,16228,2243,13985,24.76%,13.82%
2020-01-01 00:05:40,13,12,8834,1000,7834,13.48%,11.32%
2020-01-01 00:05:40,14,1,170,0,170,0.26%,0.00%
2020-01-01 00:05:40,14,2,1066,8,1058,1.63%,0.75%
2020-01-01 00:05:40,14,3,621,3,618,0.95%,0.48%
2020-01-01 00:05:40,14,4,6913,343,6570,10.55%,4.96%
2020-01-01 00:05:40,14,5,1537,13,1524,2.35%,0.85%
2020-01-01 00:05:40,14,6,7271,386,6885,11.09%,5.31%
2020-01-01 00:05:40,14,7,14812,1490,13322,22.60%,10.06%
2020-01-01 00:05:40,14,8,16303,1829,14474,24.88%,11.22%
2020-01-01 00:05:40,14,9,1680,16,1664,2.56%,0.95%
2020-01-01 00:05:40,14,10,4418,140,4278,6.74%,3.17%
2020-01-01 00:05:40,14,11,29418,5685,23733,44.89%,19.32%
2020-01-01 00:05:40,14,12,8408,524,7884,12.83%,6.23%
2020-01-01 00:05:40,15,1,610,2,608,0.93%,0.33%
2020-01-01 00:05:40,15,2,178,0,178,0.27%,0.00%
2020-01-01 00:05:40,15,3,3799,106,3693,5.80%,2.79%
2020-01-01 00:05:40,15,4,5758,329,5429,8.79%,5.71%
2020-01-01 00:05:40,15,5,10278,856,9422,15.68%,8.33%
2020-01-01 00:05:40,15,6,5968,346,5622,9.11%,5.80%
2020-01-01 00:05:40,15,7,3875,117,3758,5.91%,3.02%
2020-01-01 00:05:40,15,8,5845,255,5590,8.92%,4.36%
2020-01-01 00:05:40,15,9,10492,894,9598,16.01%,8.52%
2020-01-01 00:05:40,15,10,4067,200,3867,6.21%,4.92%
2020-01-01 00:05:40,15,11,10063,812,9251,15.35%,8.07%
2020-01-01 00:05:40,15,12,26633,5193,21440,40.64%,19.50%
2020-01-01 00:05:40,16,1,381,1,380,0.58%,0.26%
2020-01-01 00:05:40,16,2,299,0,299,0.46%,0.00%
2020-01-01 00:05:40,16,3,1249,13,1236,1.91%,1.04%
2020-01-01 00:05:40,16,4,4322,143,4179,6.59%,3.31%
2020-01-01 00:05:40,16,5,7585,452,7133,11.57%,5.96%
2020-01-01 00:05:40,16,6,5425,231,5194,8.28%,4.26%
2020-01-01 00:05:40,16,7,3233,51,3182,4.93%,1.58%
2020-01-01 00:05:40,16,8,7431,461,6970,11.34%,6.20%
2020-01-01 00:05:40,16,9,8019,496,7523,12.24%,6.19%
2020-01-01 00:05:40,16,10,1267,11,1256,1.93%,0.87%
2020-01-01 00:05:40,16,11,8953,631,8322,13.66%,7.05%
2020-01-01 00:05:40,16,12,24732,4156,20576,37.74%,16.80%
2020-01-01 00:05:50,1,1,19501,2648,16853,29.76%,13.58%
2020-01-01 00:05:50,1,2,8885,576,8309,13.56%,6.48%
2020-01-01 00:05:50,1,3,1906,26,1880,2.91%,1.36%
2020-01-01 00:05:50,1,4,10072,735,9337,15.37%,7.30%
2020-01-01 00:05:50,1,5,9530,652,8878,14.54%,6.84%
2020-01-01 00:05:50,1,6,9467,648,8819,14.45%,6.84%
2020-01-01 00:05:50,1,7,6952,383,6569,10.61%,5.51%
2020-01-01 00:05:50,1,8,6026,283,5743,9.19%,4.70%
2020-01-01 00:05:50,1,9,9411,639,8772,14.36%,6.79%
2020-01-01 00:05:50,1,10,5337,216,5121,8.14%,4.05%
2020-01-01 00:05:50,1,11,5450,236,5214,8.32%,4.33%
2020-01-01 00:05:50,1,12,9392,636,8756,14.33%,6.77%
2020-01-01 00:05:50,2,1,693,4,689,1.06%,0.58%
2020-01-01 00:05:50,2,2,25893,4527,21366,39.51%,17.48%
2020-01-01 00:05:50,2,3,20088,2824,17264,30.65%,14.06%
2020-01-01 00:05:50,2,4,644,2,642,0.98%,0.31%
2020-01-01 00:05:50,2,5,11421,955,10466,17.43%,8.36%
2020-01-01 00:05:50,2,6,41,0,41,0.06%,0.00%
2020-01-01 00:05:50,2,7,5099,187,4912,7.78%,3.67%
2020-01-01 00:05:50,2,8,4203,118,4085,6.41%,2.81%
2020-01-01 00:05:50,2,9,11355,944,10411,17.33%,8.31%
2020-01-01 00:05:50,2,10,3504,80,3424,5.35%,2.28%
2020-01-01 00:05:50,2,11,3527,80,3447,5.38%,2.27%
2020-01-01 00:05:50,2,12,11189,918,10271,17.07%,8.20%
2020-01-01 00:05:50,3,1,1360,12,1348,2.08%,0.88%
2020-01-01 00:05:50,3,2,25295,4251,21044,38.60%,16.81%
2020-01-01 00:05:50,3,3,71201,27742,43459,108.64%,38.96%
2020-01-01 00:05:50,3,4,8538,514,8024,13.03%,6.02%
2020-01-01 00:05:50,3,5,44345,12126,32219,67.67%,27.34%
2020-01-01 00:05:50,3,6,9706,665,9041,14.81%,6.85%
2020-01-01 00:05:50,3,7,22359,3332,19027,34.12%,14.90%
2020-01-01 00:05:50,3,8,18149,2231,15918,27.69%,12.29%
2020-01-01 00:05:50,3,9,34209,7571,26638,52.20%,22.13%
2020-01-01 00:05:50,3,10,5445,219,5226,8.31%,4.02%
2020-01-01 00:05:50,3,11,2050,36,2014,3.13%,1.76%
2020-01-01 00:05:50,3,12,24885,4155,20730,37.97%,16.70%
2020-01-01 00:05:50,4,1,581,5,576,0.89%,0.86%
2020-01-01 00:05:50,4,2,351,1,350,0.54%,0.28%
2020-01-01 00:05:50,4,3,763,13,750,1.16%,1.70%
2020-01-01 00:05:50,4,4,30024,5928,24096,45.81%,19.74%
2020-01-01 00:05:50,4,5,18059,2250,15809,27.56%,12.46%
2020-01-01 00:05:50,4,6,25419,4317,21102,38.79%,16.98%
2020-01-01 00:05:50,4,7,5982,317,5665,9.13%,5.30%
2020-01-01 00:05:50,4,8,3376,99,3277,5.15%,2.93%
2020-01-01 00:05:50,4,9,16069,1756,14313,24.52%,10.93%
2020-01-01 00:05:50,4,10,1965,25,1940,3.00%,1.27%
2020-01-01 00:05:50,4,11,180,1,179,0.27%,0.56%
2020-01-01 00:05:50,4,12,12812,1163,11649,19.55%,9.08%
2020-01-01 00:05:50,5,1,3281,88,3193,5.01%,2.68%
2020-01-01 00:05:50,5,2,725,10,715,1.11%,1.38%
2020-01-01 00:05:50,5,3,1004,7,997,1.53%,0.70%
2020-01-01 00:05:50,5,4,23559,3857,19702,35.95%,16.37%
2020-01-01 00:05:50,5,5,10234,778,9456,15.62%,7.60%
2020-01-01 00:05:50,5,6,15296,1698,13598,23.34%,11.10%
2020-01-01 00:05:50,5,7,4458,142,4316,6.80%,3.19%
2020-01-01 00:05:50,5,8,3521,87,3434,5.37%,2.47%
2020-01-01 00:05:50,5,9,8447,541,7906,12.89%,6.40%
2020-01-01 00:05:50,5,10,1271,30,1241,1.94%,2.36%
2020-01-01 00:05:50,5,11,565,5,560,0.86%,0.88%
2020-01-01 00:05:50,5,12,7003,351,6652,10.69%,5.01%
2020-01-01 00:05:50,6,1,1188,14,1174,1.81%,1.18%
2020-01-01 00:05:50,6,2,1222,14,1208,1.86%,1.15%
2020-01-01 00:05:50,6,3,1934,27,1907,2.95%,1.40%
2020-01-01 00:05:50,6,4,1048,11,1037,1.60%,1.05%
2020-01-01 00:05:50,6,5,12555,1179,11376,19.16%,9.39%
2020-01-01 00:05:50,6,6,4562,146,4416,6.96%,3.20%
2020-01-01 00:05:50,6,7,2734,48,2686,4.17%,1.76%
2020-01-01 00:05:50,6,8,2146,33,2113,3.27%,1.54%
2020-01-01 00:05:50,6,9,5750,250,5500,8.77%,4.35%
2020-01-01 00:05:50,6,10,2084,37,2047,3.18%,1.78%
2020-01-01 00:05:50,6,11,511,1,510,0.78%,0.20%
2020-01-01 00:05:50,6,12,3601,107,3494,5.49%,2.97%
2020-01-01 00:05:50,7,1,424,3,421,0.65%,0.71%
2020-01-01 00:05:50,7,2,224,0,224,0.34%,0.00%
2020-01-01 00:05:50,7,3,1012,3,1009,1.54%,0.30%
2020-01-01 00:05:50,7,4,2115,46,2069,3.23%,2.17%
2020-01-01 00:05:50,7,5,8044,435,7609,12.27%,5.41%
2020-01-01 00:05:50,7,6,13837,1334,12503,21.11%,9.64%
2020-01-01 00:05:50,7,7,3617,111,3506,5.52%,3.07%
2020-01-01 00:05:50,7,8,1522,25,1497,2.32%,1.64%
2020-01-01 00:05:50,7,9,6975,345,6630,10.64%,4.95%
2020-01-01 00:05:50,7,10,1444,11,1433,2.20%,0.76%
2020-01-01 00:05:50,7,11,128,1,127,0.20%,0.78%
2020-01-01 00:05:50,7,12,5498,198,5300,8.39%,3.60%
2020-01-01 00:05:50,8,1,358,1,357,0.55%,0.28%
2020-01-01 00:05:50,8,2,62,0,62,0.09%,0.00%
2020-01-01 00:05:50,8,3,1521,23,1498,2.32%,1.51%
2020-01-01 00:05:50,8,4,3365,85,3280,5.13%,2.53%
2020-01-01 00:05:50,8,5,7574,437,7137,11.56%,5.77%
2020-01-01 00:05:50,8,6,16421,1878,14543,25.06%,11.44%
2020-01-01 00:05:50,8,7,5367,220,5147,8.19%,4.10%
2020-01-01 00:05:50,8,8,2857,61,2796,4.36%,2.14%
2020-01-01 00:05:50,8,9,5857,274,5583,8.94%,4.68%
2020-01-01 00:05:50,8,10,1619,19,1600,2.47%,1.17%
2020-01-01 00:05:50,8,11,131,0,131,0.20%,0.00%
2020-01-01 00:05:50,8,12,4240,153,4087,6.47%,3.61%
2020-01-01 00:05:50,9,1,863,5,858,1.32%,0.58%
2020-01-01 00:05:50,9,2,5096,205,4891,7.78%,4.02%
2020-01-01 00:05:50,9,3,3695,124,3571,5.64%,3.36%
2020-01-01 00:05:50,9,4,9804,683,9121,14.96%,6.97%
2020-01-01 00:05:50,9,5,200,0,200,0.31%,0.00%
2020-01-01 00:05:50,9,6,10942,847,10095,16.70%,7.74%
2020-01-01 00:05:50,9,7,30870,6257,24613,47.10%,20.27%
2020-01-01 00:05:50,9,8,8652,546,8106,13.20%,6.31%
2020-01-01 00:05:50,9,9,113,0,113,0.17%,0.00%
2020-01-01 00:05:50,9,10,2349,40,2309,3.58%,1.70%
2020-01-01 00:05:50,9,11,7608,434,7174,11.61%,5.70%
2020-01-01 00:05:50,9,12,4975,195,4780,7.59%,3.92%
2020-01-01 00:05:50,10,1,1048,170,878,1.60%,16.22%
2020-01-01 00:05:50,10,2,2873,225,2648,4.38%,7.83%
2020-01-01 00:05:50,10,3,1605,24,1581,2.45%,1.50%
2020-01-01 00:05:50,10,4,3967,1176,2791,6.05%,29.64%
2020-01-01 00:05:50,10,5,682,40,642,1.04%,5.87%
2020-01-01 00:05:50,10,6,6011,1318,4693,9.17%,21.93%
2020-01-01 00:05:50,10,7,11302,2013,9289,17.25%,17.81%
2020-01-01 00:05:50,10,8,27861,6861,21000,42.51%,24.63%
2020-01-01 00:05:50,10,9,908,13,895,1.39%,1.43%
2020-01-01 00:05:50,10,10,2505,49,2456,3.82%,1.96%
2020-01-01 00:05:50,10,11,13443,1786,11657,20.51%,13.29%
2020-01-01 00:05:50,10,12,10085,1247,8838,15.39%,12.36%
2020-01-01 00:05:50,11,1,2510,54,2456,3.83%,2.15%
2020-01-01 00:05:50,11,2,3618,117,3501,5.52%,3.23%
2020-01-01 00:05:50,11,3,903,8,895,1.38%,0.89%
2020-01-01 00:05:50,11,4,7654,424,7230,11.68%,5.54%
2020-01-01 00:05:50,11,5,137,0,137,0.21%,0.00%
2020-01-01 00:05:50,11,6,8852,570,8282,13.51%,6.44%
2020-01-01 00:05:50,11,7,14712,1500,13212,22.45%,10.20%
2020-01-01 00:05:50,11,8,28864,5452,23412,44.04%,18.89%
2020-01-01 00:05:50,11,9,153,0,153,0.23%,0.00%
2020-01-01 00:05:50,11,10,3348,86,3262,5.11%,2.57%
2020-01-01 00:05:50,11,11,10698,835,9863,16.32%,7.81%
2020-01-01 00:05:50,11,12,6692,315,6377,10.21%,4.71%
2020-01-01 00:05:50,12,1,82,0,82,0.13%,0.00%
2020-01-01 00:05:50,12,2,646,164,482,0.99%,25.39%
2020-01-01 00:05:50,12,3,2397,208,2189,3.66%,8.68%
2020-01-01 00:05:50,12,4,3190,73,3117,4.87%,2.29%
2020-01-01 00:05:50,12,5,8637,721,7916,13.18%,8.35%
2020-01-01 00:05:50,12,6,5429,256,5173,8.28%,4.72%
2020-01-01 00:05:50,12,7,2044,41,2003,3.12%,2.01%
2020-01-01 00:05:50,12,8,1465,299,1166,2.24%,20.41%
2020-01-01 00:05:50,12,9,21819,4076,17743,33.29%,18.68%
2020-01-01 00:05:50,12,10,4368,403,3965,6.67%,9.23%
2020-01-01 00:05:50,12,11,1663,303,1360,2.54%,18.22%
2020-01-01 00:05:50,12,12,8186,1064,7122,12.49%,13.00%
2020-01-01 00:05:50,13,1,2348,33,2315,3.58%,1.41%
2020-01-01 00:05:50,13,2,2658,55,2603,4.06%,2.07%
2020-01-01 00:05:50,13,3,858,20,838,1.31%,2.33%
2020-01-01 00:05:50,13,4,4648,506,4142,7.09%,10.89%
2020-01-01 00:05:50,13,5,6914,790,6124,10.55%,11.43%
2020-01-01 00:05:50,13,6,5314,560,4754,8.11%,10.54%
2020-01-01 00:05:50,13,7,4799,166,4633,7.32%,3.46%
2020-01-01 00:05:50,13,8,6936,342,6594,10.58%,4.93%
2020-01-01 00:05:50,13,9,7250,826,6424,11.06%,11.39%
2020-01-01 00:05:50,13,10,27924,5940,21984,42.61%,21.27%
2020-01-01 00:05:50,13,11,18011,2826,15185,27.48%,15.69%
2020-01-01 00:05:50,13,12,10644,1405,9239,16.24%,13.20%
2020-01-01 00:05:50,14,1,210,0,210,0.32%,0.00%
2020-01-01 00:05:50,14,2,1146,14,1132,1.75%,1.22%
2020-01-01 00:05:50,14,3,667,8,659,1.02%,1.20%
2020-01-01 00:05:50,14,4,5309,216,5093,8.10%,4.07%
2020-01-01 00:05:50,14,5,1176,13,1163,1.79%,1.11%
2020-01-01 00:05:50,14,6,5685,250,5435,8.67%,4.40%
2020-01-01 00:05:50,14,7,13038,1231,11807,19.89%,9.44%
2020-01-01 00:05:50,14,8,14816,1548,13268,22.61%,10.45%
2020-01-01 00:05:50,14,9,1354,18,1336,2.07%,1.33%
2020-01-01 00:05:50,14,10,3458,101,3357,5.28%,2.92%
2020-01-01 00:05:50,14,11,27206,4927,22279,41.51%,18.11%
2020-01-01 00:05:50,14,12,8725,554,8171,13.31%,6.35%
2020-01-01 00:05:50,15,1,507,1,506,0.77%,0.20%
2020-01-01 00:05:50,15,2,142,0,142,0.22%,0.00%
2020-01-01 00:05:50,15,3,4193,116,4077,6.40%,2.77%
2020-01-01 00:05:50,15,4,5791,228,5563,8.84%,3.94%
2020-01-01 00:05:50,15,5,10752,816,9936,16.41%,7.59%
2020-01-01 00:05:50,15,6,6049,245,5804,9.23%,4.05%
2020-01-01 00:05:50,15,7,3856,109,3747,5.88%,2.83%
2020-01-01 00:05:50,15,8,5869,256,5613,8.96%,4.36%
2020-01-01 00:05:50,15,9,10940,841,10099,16.69%,7.69%
2020-01-01 00:05:50,15,10,4771,171,4600,7.28%,3.58%
2020-01-01 00:05:50,15,11,10789,844,9945,16.46%,7.82%
2020-01-01 00:05:50,15,12,27351,5349,22002,41.73%,19.56%
2020-01-01 00:05:50,16,1,562,6,556,0.86%,1.07%
2020-01-01 00:05:50,16,2,318,0,318,0.49%,0.00%
2020-01-01 00:05:50,16,3,1107,9,1098,1.69%,0.81%
2020-01-01 00:05:50,16,4,3942,127,3815,6.02%,3.22%
2020-01-01 00:05:50,16,5,7351,424,6927,11.22%,5.77%
2020-01-01 00:05:50,16,6,4836,186,4650,7.38%,3.85%
2020-01-01 00:05:50,16,7,3772,109,3663,5.76%,2.89%
2020-01-01 00:05:50,16,8,7472,525,6947,11.40%,7.03%
2020-01-01 00:05:50,16,9,7731,475,7256,11.80%,6.14%
2020-01-01 00:05:50,16,10,1796,21,1775,2.74%,1.17%
2020-01-01 00:05:50,16,11,9474,773,8701,14.46%,8.16%
2020-01-01 00:05:50,16,12,25057,4321,20736,38.23%,17.24%
2020-01-01 00:06:00,1,1,20487,3019,17468,31.26%,14.74%
2020-01-01 00:06:00,1,2,12249,1088,11161,18.69%,8.88%
2020-01-01 00:06:00,1,3,1492,11,1481,2.28%,0.74%
2020-01-01 00:06:00,1,4,7816,472,7344,11.93%,6.04%
2020-01-01 00:06:00,1,5,7486,437,7049,11.42%,5.84%
2020-01-01 00:06:00,1,6,7410,428,6982,11.31%,5.78%
2020-01-01 00:06:00,1,7,10733,849,9884,16.38%,7.91%
2020-01-01 00:06:00,1,8,10102,751,9351,15.41%,7.43%
2020-01-01 00:06:00,1,9,7364,423,6941,11.24%,5.74%
2020-01-01 00:06:00,1,10,9426,656,8770,14.38%,6.96%
2020-01-01 00:06:00,1,11,9558,674,8884,14.58%,7.05%
2020-01-01 00:06:00,1,12,7334,418,6916,11.19%,5.70%
2020-01-01 00:06:00,2,1,557,1,556,0.85%,0.18%
2020-01-01 00:06:00,2,2,30663,6201,24462,46.79%,20.22%
2020-01-01 00:06:00,2,3,26105,4575,21530,39.83%,17.53%
2020-01-01 00:06:00,2,4,496,1,495,0.76%,0.20%
2020-01-01 00:06:00,2,5,13582,1275,12307,20.72%,9.39%
2020-01-01 00:06:00,2,6,30,0,30,0.05%,0.00%
2020-01-01 00:06:00,2,7,3978,124,3854,6.07%,3.12%
2020-01-01 00:06:00,2,8,2935,60,2875,4.48%,2.04%
2020-01-01 00:06:00,2,9,12785,1136,11649,19.51%,8.89%
2020-01-01 00:06:00,2,10,2142,32,2110,3.27%,1.49%
2020-01-01 00:06:00,2,11,2154,33,2121,3.29%,1.53%
2020-01-01 00:06:00,2,12,12594,1099,11495,19.22%,8.73%
2020-01-01 00:06:00,3,1,1281,8,1273,1.95%,0.62%
2020-01-01 00:06:00,3,2,22061,3388,18673,33.66%,15.36%
2020-01-01 00:06:00,3,3,72938,28994,43944,111.29%,39.75%
2020-01-01 00:06:00,3,4,11592,947,10645,17.69%,8.17%
2020-01-01 00:06:00,3,5,49798,15030,34768,75.99%,30.18%
2020-01-01 00:06:00,3,6,13534,1253,12281,20.65%,9.26%
2020-01-01 00:06:00,3,7,19319,2638,16681,29.48%,13.65%
2020-01-01 00:06:00,3,8,16491,1945,14546,25.16%,11.79%
2020-01-01 00:06:00,3,9,35934,8378,27556,54.83%,23.31%
2020-01-01 00:06:00,3,10,6668,348,6320,10.17%,5.22%
2020-01-01 00:06:00,3,11,1839,28,1811,2.81%,1.52%
2020-01-01 00:06:00,3,12,26390,4712,21678,40.27%,17.86%
2020-01-01 00:06:00,4,1,483,2,481,0.74%,0.41%
2020-01-01 00:06:00,4,2,289,1,288,0.44%,0.35%
2020-01-01 00:06:00,4,3,950,3,947,1.45%,0.32%
2020-01-01 00:06:00,4,4,28555,5493,23062,43.57%,19.24%
2020-01-01 00:06:00,4,5,18477,2427,16050,28.19%,13.14%
2020-01-01 00:06:00,4,6,24582,4151,20431,37.51%,16.89%
2020-01-01 00:06:00,4,7,4802,168,4634,7.33%,3.50%
2020-01-01 00:06:00,4,8,3014,70,2944,4.60%,2.32%
2020-01-01 00:06:00,4,9,16210,1893,14317,24.73%,11.68%
2020-01-01 00:06:00,4,10,1847,23,1824,2.82%,1.25%
2020-01-01 00:06:00,4,11,144,0,144,0.22%,0.00%
2020-01-01 00:06:00,4,12,13374,1308,12066,20.41%,9.78%
2020-01-01 00:06:00,5,1,2820,52,2768,4.30%,1.84%
2020-01-01 00:06:00,5,2,868,5,863,1.32%,0.58%
2020-01-01 00:06:00,5,3,456,3,453,0.70%,0.66%
2020-01-01 00:06:00,5,4,23535,3771,19764,35.91%,16.02%
2020-01-01 00:06:00,5,5,9092,609,8483,13.87%,6.70%
2020-01-01 00:06:00,5,6,14037,1354,12683,21.42%,9.65%
2020-01-01 00:06:00,5,7,4381,135,4246,6.68%,3.08%
2020-01-01 00:06:00,5,8,3431,84,3347,5.24%,2.45%
2020-01-01 00:06:00,5,9,8422,522,7900,12.85%,6.20%
2020-01-01 00:06:00,5,10,975,7,968,1.49%,0.72%
2020-01-01 00:06:00,5,11,698,1,697,1.07%,0.14%
2020-01-01 00:06:00,5,12,7086,372,6714,10.81%,5.25%
2020-01-01 00:06:00,6,1,1075,9,1066,1.64%,0.84%
2020-01-01 00:06:00,6,2,1161,9,1152,1.77%,0.78%
2020-01-01 00:06:00,6,3,1696,22,1674,2.59%,1.30%
2020-01-01 00:06:00,6,4,1435,25,1410,2.19%,1.74%
2020-01-01 00:06:00,6,5,14765,1537,13228,22.53%,10.41%
2020-01-01 00:06:00,6,6,3790,116,3674,5.78%,3.06%
2020-01-01 00:06:00,6,7,1882,28,1854,2.87%,1.49%
2020-01-01 00:06:00,6,8,1285,14,1271,1.96%,1.09%
2020-01-01 00:06:00,6,9,9043,581,8462,13.80%,6.42%
2020-01-01 00:06:00,6,10,2255,40,2215,3.44%,1.77%
2020-01-01 00:06:00,6,11,455,2,453,0.69%,0.44%
2020-01-01 00:06:00,6,12,6649,312,6337,10.15%,4.69%
2020-01-01 00:06:00,7,1,492,5,487,0.75%,1.02%
2020-01-01 00:06:00,7,2,95,1,94,0.14%,1.05%
2020-01-01 00:06:00,7,3,1123,6,1117,1.71%,0.53%
2020-01-01 00:06:00,7,4,2441,39,2402,3.72%,1.60%
2020-01-01 00:06:00,7,5,7676,454,7222,11.71%,5.91%
2020-01-01 00:06:00,7,6,13627,1340,12287,20.79%,9.83%
2020-01-01 00:06:00,7,7,3474,91,3383,5.30%,2.62%
2020-01-01 00:06:00,7,8,1382,14,1368,2.11%,1.01%
2020-01-01 00:06:00,7,9,6510,333,6177,9.93%,5.12%
2020-01-01 00:06:00,7,10,1686,13,1673,2.57%,0.77%
2020-01-01 00:06:00,7,11,196,0,196,0.30%,0.00%
2020-01-01 00:06:00,7,12,4818,203,4615,7.35%,4.21%
2020-01-01 00:06:00,8,1,373,1,372,0.57%,0.27%
2020-01-01 00:06:00,8,2,64,0,64,0.10%,0.00%
2020-01-01 00:06:00,8,3,1456,19,1437,2.22%,1.30%
2020-01-01 00:06:00,8,4,3010,60,2950,4.59%,1.99%
2020-01-01 00:06:00,8,5,8156,503,7653,12.45%,6.17%
2020-01-01 00:06:00,8,6,17376,2136,15240,26.51%,12.29%
2020-01-01 00:06:00,8,7,6053,289,5764,9.24%,4.77%
2020-01-01 00:06:00,8,8,3045,92,2953,4.65%,3.02%
2020-01-01 00:06:00,8,9,6425,303,6122,9.80%,4.72%
2020-01-01 00:06:00,8,10,1882,33,1849,2.87%,1.75%
2020-01-01 00:06:00,8,11,249,0,249,0.38%,0.00%
2020-01-01 00:06:00,8,12,4469,150,4319,6.82%,3.36%
2020-01-01 00:06:00,9,1,402,3,399,0.61%,0.75%
2020-01-01 00:06:00,9,2,2064,40,2024,3.15%,1.94%
2020-01-01 00:06:00,9,3,1250,14,1236,1.91%,1.12%
2020-01-01 00:06:00,9,4,5640,214,5426,8.61%,3.79%
2020-01-01 00:06:00,9,5,220,0,220,0.34%,0.00%
2020-01-01 00:06:00,9,6,6461,285,6176,9.86%,4.41%
2020-01-01 00:06:00,9,7,23475,3712,19763,35.82%,15.81%
2020-01-01 00:06:00,9,8,9701,667,9034,14.80%,6.88%
2020-01-01 00:06:00,9,9,158,0,158,0.24%,0.00%
2020-01-01 00:06:00,9,10,2733,56,2677,4.17%,2.05%
2020-01-01 00:06:00,9,11,8397,501,7896,12.81%,5.97%
2020-01-01 00:06:00,9,12,5338,189,5149,8.15%,3.54%
2020-01-01 00:06:00,10,1,1200,296,904,1.83%,24.67%
2020-01-01 00:06:00,10,2,3200,349,2851,4.88%,10.91%
2020-01-01 00:06:00,10,3,1782,24,1758,2.72%,1.35%
2020-01-01 00:06:00,10,4,4268,1197,3071,6.51%,28.05%
2020-01-01 00:06:00,10,5,619,24,595,0.94%,3.88%
2020-01-01 00:06:00,10,6,6553,1363,5190,10.00%,20.80%
2020-01-01 00:06:00,10,7,11798,2221,9577,18.00%,18.83%
2020-01-01 00:06:00,10,8,27318,6673,20645,41.68%,24.43%
2020-01-01 00:06:00,10,9,741,8,733,1.13%,1.08%
2020-01-01 00:06:00,10,10,2447,46,2401,3.73%,1.88%
2020-01-01 00:06:00,10,11,12482,1433,11049,19.05%,11.48%
2020-01-01 00:06:00,10,12,9523,1020,8503,14.53%,10.71%
2020-01-01 00:06:00,11,1,2909,78,2831,4.44%,2.68%
2020-01-01 00:06:00,11,2,4815,167,4648,7.35%,3.47%
2020-01-01 00:06:00,11,3,1578,16,1562,2.41%,1.01%
2020-01-01 00:06:00,11,4,6852,346,6506,10.46%,5.05%
2020-01-01 00:06:00,11,5,157,0,157,0.24%,0.00%
2020-01-01 00:06:00,11,6,7823,456,7367,11.94%,5.83%
2020-01-01 00:06:00,11,7,15094,1592,13502,23.03%,10.55%
2020-01-01 00:06:00,11,8,29191,5585,23606,44.54%,19.13%
2020-01-01 00:06:00,11,9,252,2,250,0.38%,0.79%
2020-01-01 00:06:00,11,10,3428,107,3321,5.23%,3.12%
2020-01-01 00:06:00,11,11,10203,750,9453,15.57%,7.35%
2020-01-01 00:06:00,11,12,6318,287,6031,9.64%,4.54%
2020-01-01 00:06:00,12,1,38,0,38,0.06%,0.00%
2020-01-01 00:06:00,12,2,697,226,471,1.06%,32.42%
2020-01-01 00:06:00,12,3,2754,264,2490,4.20%,9.59%
2020-01-01 00:06:00,12,4,3603,62,3541,5.50%,1.72%
2020-01-01 00:06:00,12,5,9709,846,8863,14.81%,8.71%
2020-01-01 00:06:00,12,6,5984,242,5742,9.13%,4.04%
2020-01-01 00:06:00,12,7,2248,48,2200,3.43%,2.14%
2020-01-01 00:06:00,12,8,1398,277,1121,2.13%,19.81%
2020-01-01 00:06:00,12,9,22828,4490,18338,34.83%,19.67%
2020-01-01 00:06:00,12,10,4305,395,3910,6.57%,9.18%
2020-01-01 00:06:00,12,11,1685,281,1404,2.57%,16.68%
2020-01-01 00:06:00,12,12,8150,979,7171,12.44%,12.01%
2020-01-01 00:06:00,13,1,2327,40,2287,3.55%,1.72%
2020-01-01 00:06:00,13,2,2687,50,2637,4.10%,1.86%
2020-01-01 00:06:00,13,3,863,4,859,1.32%,0.46%
2020-01-01 00:06:00,13,4,4578,525,4053,6.99%,11.47%
2020-01-01 00:06:00,13,5,6756,797,5959,10.31%,11.80%
2020-01-01 00:06:00,13,6,5204,570,4634,7.94%,10.95%
2020-01-01 00:06:00,13,7,4678,150,4528,7.14%,3.21%
2020-01-01 00:06:00,13,8,7318,405,6913,11.17%,5.53%
2020-01-01 00:06:00,13,9,7139,834,6305,10.89%,11.68%
2020-01-01 00:06:00,13,10,27062,5615,21447,41.29%,20.75%
2020-01-01 00:06:00,13,11,17140,2487,14653,26.15%,14.51%
2020-01-01 00:06:00,13,12,9321,1072,8249,14.22%,11.50%
2020-01-01 00:06:00,14,1,519,3,516,0.79%,0.58%
2020-01-01 00:06:00,14,2,2184,35,2149,3.33%,1.60%
2020-01-01 00:06:00,14,3,1480,17,1463,2.26%,1.15%
2020-01-01 00:06:00,14,4,4057,137,3920,6.19%,3.38%
2020-01-01 00:06:00,14,5,1315,17,1298,2.01%,1.29%
2020-01-01 00:06:00,14,6,4470,165,4305,6.82%,3.69%
2020-01-01 00:06:00,14,7,12090,1113,10977,18.45%,9.21%
2020-01-01 00:06:00,14,8,14239,1572,12667,21.73%,11.04%
2020-01-01 00:06:00,14,9,1604,19,1585,2.45%,1.18%
2020-01-01 00:06:00,14,10,4042,135,3907,6.17%,3.34%
2020-01-01 00:06:00,14,11,26111,4709,21402,39.84%,18.03%
2020-01-01 00:06:00,14,12,7615,453,7162,11.62%,5.95%
2020-01-01 00:06:00,15,1,433,1,432,0.66%,0.23%
2020-01-01 00:06:00,15,2,165,1,164,0.25%,0.61%
2020-01-01 00:06:00,15,3,3703,124,3579,5.65%,3.35%
2020-01-01 00:06:00,15,4,4613,193,4420,7.04%,4.18%
2020-01-01 00:06:00,15,5,9167,686,8481,13.99%,7.48%
2020-01-01 00:06:00,15,6,4816,207,4609,7.35%,4.30%
2020-01-01 00:06:00,15,7,3330,85,3245,5.08%,2.55%
2020-01-01 00:06:00,15,8,5079,191,4888,7.75%,3.76%
2020-01-01 00:06:00,15,9,9325,703,8622,14.23%,7.54%
2020-01-01 00:06:00,15,10,4085,192,3893,6.23%,4.70%
2020-01-01 00:06:00,15,11,9317,680,8637,14.22%,7.30%
2020-01-01 00:06:00,15,12,24638,4514,20124,37.59%,18.32%
2020-01-01 00:06:00,16,1,574,0,574,0.88%,0.00%
2020-01-01 00:06:00,16,2,258,1,257,0.39%,0.39%
2020-01-01 00:06:00,16,3,1389,17,1372,2.12%,1.22%
2020-01-01 00:06:00,16,4,4748,179,4569,7.24%,3.77%
2020-01-01 00:06:00,16,5,8695,604,8091,13.27%,6.95%
2020-01-01 00:06:00,16,6,5511,228,5283,8.41%,4.14%
2020-01-01 00:06:00,16,7,3205,82,3123,4.89%,2.56%
2020-01-01 00:06:00,16,8,7535,471,7064,11.50%,6.25%
2020-01-01 00:06:00,16,9,9160,673,8487,13.98%,7.35%
2020-01-01 00:06:00,16,10,1999,32,1967,3.05%,1.60%
2020-01-01 00:06:00,16,11,9750,717,9033,14.88%,7.35%
2020-01-01 00:06:00,16,12,27373,5052,22321,41.77%,18.46%
2020-01-01 00:06:10,1,1,15632,1707,13925,23.85%,10.92%
2020-01-01 00:06:10,1,2,5169,218,4951,7.89%,4.22%
2020-01-01 00:06:10,1,3,516,3,513,0.79%,0.58%
2020-01-01 00:06:10,1,4,10069,737,9332,15.36%,7.32%
2020-01-01 00:06:10,1,5,9431,650,8781,14.39%,6.89%
2020-01-01 00:06:10,1,6,9376,639,8737,14.31%,6.82%
2020-01-01 00:06:10,1,7,4636,187,4449,7.07%,4.03%
2020-01-01 00:06:10,1,8,3505,111,3394,5.35%,3.17%
2020-01-01 00:06:10,1,9,9326,632,8694,14.23%,6.78%
2020-01-01 00:06:10,1,10,2952,74,2878,4.50%,2.51%
2020-01-01 00:06:10,1,11,3085,88,2997,4.71%,2.85%
2020-01-01 00:06:10,1,12,9298,626,8672,14.19%,6.73%
2020-01-01 00:06:10,2,1,3868,25,3843,5.90%,0.65%
2020-01-01 00:06:10,2,2,31926,6593,25333,48.72%,20.65%
2020-01-01 00:06:10,2,3,23912,3927,19985,36.49%,16.42%
2020-01-01 00:06:10,2,4,3680,24,3656,5.62%,0.65%
2020-01-01 00:06:10,2,5,12335,1084,11251,18.82%,8.79%
2020-01-01 00:06:10,2,6,16,0,16,0.02%,0.00%
2020-01-01 00:06:10,2,7,4137,131,4006,6.31%,3.17%
2020-01-01 00:06:10,2,8,3237,85,3152,4.94%,2.63%
2020-01-01 00:06:10,2,9,11884,1004,10880,18.13%,8.45%
2020-01-01 00:06:10,2,10,2341,43,2298,3.57%,1.84%
2020-01-01 00:06:10,2,11,2352,43,2309,3.59%,1.83%
2020-01-01 00:06:10,2,12,11713,973,10740,17.87%,8.31%
2020-01-01 00:06:10,3,1,1881,41,1840,2.87%,2.18%
2020-01-01 00:06:10,3,2,23281,3574,19707,35.52%,15.35%
2020-01-01 00:06:10,3,3,67453,25171,42282,102.93%,37.32%
2020-01-01 00:06:10,3,4,9237,628,8609,14.09%,6.80%
2020-01-01 00:06:10,3,5,43106,11463,31643,65.77%,26.59%
2020-01-01 00:06:10,3,6,10658,826,9832,16.26%,7.75%
2020-01-01 00:06:10,3,7,19654,2588,17066,29.99%,13.17%
2020-01-01 00:06:10,3,8,17173,2011,15162,26.20%,11.71%
2020-01-01 00:06:10,3,9,32154,6681,25473,49.06%,20.78%
2020-01-01 00:06:10,3,10,4556,141,4415,6.95%,3.09%
2020-01-01 00:06:10,3,11,1617,14,1603,2.47%,0.87%
2020-01-01 00:06:10,3,12,25519,4327,21192,38.94%,16.96%
2020-01-01 00:06:10,4,1,499,0,499,0.76%,0.00%
2020-01-01 00:06:10,4,2,298,0,298,0.45%,0.00%
2020-01-01 00:06:10,4,3,744,5,739,1.14%,0.67%
2020-01-01 00:06:10,4,4,27119,4878,22241,41.38%,17.99%
2020-01-01 00:06:10,4,5,17222,2125,15097,26.28%,12.34%
2020-01-01 00:06:10,4,6,23259,3669,19590,35.49%,15.77%
2020-01-01 00:06:10,4,7,4652,147,4505,7.10%,3.16%
2020-01-01 00:06:10,4,8,2987,49,2938,4.56%,1.64%
2020-01-01 00:06:10,4,9,15436,1737,13699,23.55%,11.25%
2020-01-01 00:06:10,4,10,1929,47,1882,2.94%,2.44%
2020-01-01 00:06:10,4,11,195,1,194,0.30%,0.51%
2020-01-01 00:06:10,4,12,12593,1146,11447,19.22%,9.10%
2020-01-01 00:06:10,5,1,2856,64,2792,4.36%,2.24%
2020-01-01 00:06:10,5,2,884,7,877,1.35%,0.79%
2020-01-01 00:06:10,5,3,4527,155,4372,6.91%,3.42%
2020-01-01 00:06:10,5,4,25096,4301,20795,38.29%,17.14%
2020-01-01 00:06:10,5,5,12797,1212,11585,19.53%,9.47%
2020-01-01 00:06:10,5,6,17702,2264,15438,27.01%,12.79%
2020-01-01 00:06:10,5,7,4472,162,4310,6.82%,3.62%
2020-01-01 00:06:10,5,8,3431,98,3333,5.24%,2.86%
2020-01-01 00:06:10,5,9,8136,500,7636,12.41%,6.15%
2020-01-01 00:06:10,5,10,901,10,891,1.37%,1.11%
2020-01-01 00:06:10,5,11,777,9,768,1.19%,1.16%
2020-01-01 00:06:10,5,12,6869,362,6507,10.48%,5.27%
2020-01-01 00:06:10,6,1,946,8,938,1.44%,0.85%
2020-01-01 00:06:10,6,2,1031,10,1021,1.57%,0.97%
2020-01-01 00:06:10,6,3,1497,24,1473,2.28%,1.60%
2020-01-01 00:06:10,6,4,1913,24,1889,2.92%,1.25%
2020-01-01 00:06:10,6,5,14587,1563,13024,22.26%,10.72%
2020-01-01 00:06:10,6,6,4231,130,4101,6.46%,3.07%
2020-01-01 00:06:10,6,7,1846,41,1805,2.82%,2.22%
2020-01-01 00:06:10,6,8,1401,27,1374,2.14%,1.93%
2020-01-01 00:06:10,6,9,8635,569,8066,13.18%,6.59%
2020-01-01 00:06:10,6,10,1874,29,1845,2.86%,1.55%
2020-01-01 00:06:10,6,11,453,0,453,0.69%,0.00%
2020-01-01 00:06:10,6,12,6622,342,6280,10.10%,5.16%
2020-01-01 00:06:10,7,1,445,2,443,0.68%,0.45%
2020-01-01 00:06:10,7,2,161,0,161,0.25%,0.00%
2020-01-01 00:06:10,7,3,1160,5,1155,1.77%,0.43%
2020-01-01 00:06:10,7,4,2177,32,2145,3.32%,1.47%
2020-01-01 00:06:10,7,5,7654,398,7256,11.68%,5.20%
2020-01-01 00:06:10,7,6,13768,1305,12463,21.01%,9.48%
2020-01-01 00:06:10,7,7,3894,110,3784,5.94%,2.82%
2020-01-01 00:06:10,7,8,1429,17,1412,2.18%,1.19%
2020-01-01 00:06:10,7,9,6304,275,6029,9.62%,4.36%
2020-01-01 00:06:10,7,10,1312,6,1306,2.00%,0.46%
2020-01-01 00:06:10,7,11,107,0,107,0.16%,0.00%
2020-01-01 00:06:10,7,12,4981,175,4806,7.60%,3.51%
2020-01-01 00:06:10,8,1,385,2,383,0.59%,0.52%
2020-01-01 00:06:10,8,2,92,0,92,0.14%,0.00%
2020-01-01 00:06:10,8,3,2151,57,2094,3.28%,2.65%
2020-01-01 00:06:10,8,4,2418,44,2374,3.69%,1.82%
2020-01-01 00:06:10,8,5,8664,533,8131,13.22%,6.15%
2020-01-01 00:06:10,8,6,15496,1643,13853,23.65%,10.60%
2020-01-01 00:06:10,8,7,4357,146,4211,6.65%,3.35%
2020-01-01 00:06:10,8,8,1622,21,1601,2.47%,1.29%
2020-01-01 00:06:10,8,9,6248,288,5960,9.53%,4.61%
2020-01-01 00:06:10,8,10,1865,23,1842,2.85%,1.23%
2020-01-01 00:06:10,8,11,248,0,248,0.38%,0.00%
2020-01-01 00:06:10,8,12,4388,144,4244,6.70%,3.28%
2020-01-01 00:06:10,9,1,322,0,322,0.49%,0.00%
2020-01-01 00:06:10,9,2,2100,34,2066,3.20%,1.62%
2020-01-01 00:06:10,9,3,1373,17,1356,2.10%,1.24%
2020-01-01 00:06:10,9,4,14838,1527,13311,22.64%,10.29%
2020-01-01 00:06:10,9,5,238,1,237,0.36%,0.42%
2020-01-01 00:06:10,9,6,15757,1719,14038,24.04%,10.91%
2020-01-01 00:06:10,9,7,34849,7778,27071,53.18%,22.32%
2020-01-01 00:06:10,9,8,11333,955,10378,17.29%,8.43%
2020-01-01 00:06:10,9,9,179,1,178,0.27%,0.56%
2020-01-01 00:06:10,9,10,4338,168,4170,6.62%,3.87%
2020-01-01 00:06:10,9,11,10155,780,9375,15.50%,7.68%
2020-01-01 00:06:10,9,12,5483,204,5279,8.37%,3.72%
2020-01-01 00:06:10,10,1,1297,302,995,1.98%,23.28%
2020-01-01 00:06:10,10,2,2971,363,2608,4.53%,12.22%
2020-01-01 00:06:10,10,3,1523,34,1489,2.32%,2.23%
2020-01-01 00:06:10,10,4,4087,1194,2893,6.24%,29.21%
2020-01-01 00:06:10,10,5,599,28,571,0.91%,4.67%
2020-01-01 00:06:10,10,6,5954,1327,4627,9.09%,22.29%
2020-01-01 00:06:10,10,7,10651,2009,8642,16.25%,18.86%
2020-01-01 00:06:10,10,8,27600,6926,20674,42.11%,25.09%
2020-01-01 00:06:10,10,9,602,7,595,0.92%,1.16%
2020-01-01 00:06:10,10,10,2371,48,2323,3.62%,2.02%
2020-01-01 00:06:10,10,11,13253,1592,11661,20.22%,12.01%
2020-01-01 00:06:10,10,12,10062,1104,8958,15.35%,10.97%
2020-01-01 00:06:10,11,1,2656,72,2584,4.05%,2.71%
2020-01-01 00:06:10,11,2,3975,131,3844,6.07%,3.30%
2020-01-01 00:06:10,11,3,1176,11,1165,1.79%,0.94%
2020-01-01 00:06:10,11,4,7865,472,7393,12.00%,6.00%
2020-01-01 00:06:10,11,5,290,1,289,0.44%,0.34%
2020-01-01 00:06:10,11,6,8775,572,8203,13.39%,6.52%
2020-01-01 00:06:10,11,7,14686,1518,13168,22.41%,10.34%
2020-01-01 00:06:10,11,8,28319,5370,22949,43.21%,18.96%
2020-01-01 00:06:10,11,9,360,0,360,0.55%,0.00%
2020-01-01 00:06:10,11,10,3123,73,3050,4.77%,2.34%
2020-01-01 00:06:10,11,11,9770,691,9079,14.91%,7.07%
2020-01-01 00:06:10,11,12,6186,288,5898,9.44%,4.66%
2020-01-01 00:06:10,12,1,25,0,25,0.04%,0.00%
2020-01-01 00:06:10,12,2,750,214,536,1.14%,28.53%
2020-01-01 00:06:10,12,3,3601,295,3306,5.49%,8.19%
2020-01-01 00:06:10,12,4,3421,62,3359,5.22%,1.81%
2020-01-01 00:06:10,12,5,10902,993,9909,16.64%,9.11%
2020-01-01 00:06:10,12,6,5764,236,5528,8.80%,4.09%
2020-01-01 00:06:10,12,7,2200,42,2158,3.36%,1.91%
2020-01-01 00:06:10,12,8,1232,306,926,1.88%,24.84%
2020-01-01 00:06:10,12,9,23047,4542,18505,35.17%,19.71%
2020-01-01 00:06:10,12,10,4111,409,3702,6.27%,9.95%
2020-01-01 00:06:10,12,11,1474,307,1167,2.25%,20.83%
2020-01-01 00:06:10,12,12,7373,1004,6369,11.25%,13.62%
2020-01-01 00:06:10,13,1,2496,42,2454,3.81%,1.68%
2020-01-01 00:06:10,13,2,2804,53,2751,4.28%,1.89%
2020-01-01 00:06:10,13,3,1068,9,1059,1.63%,0.84%
2020-01-01 00:06:10,13,4,5102,499,4603,7.79%,9.78%
2020-01-01 00:06:10,13,5,7957,899,7058,12.14%,11.30%
2020-01-01 00:06:10,13,6,6046,568,5478,9.23%,9.39%
2020-01-01 00:06:10,13,7,4877,177,4700,7.44%,3.63%
2020-01-01 00:06:10,13,8,6958,334,6624,10.62%,4.80%
2020-01-01 00:06:10,13,9,8267,926,7341,12.61%,11.20%
2020-01-01 00:06:10,13,10,26883,5390,21493,41.02%,20.05%
2020-01-01 00:06:10,13,11,15753,2010,13743,24.04%,12.76%
2020-01-01 00:06:10,13,12,8295,822,7473,12.66%,9.91%
2020-01-01 00:06:10,14,1,396,0,396,0.60%,0.00%
2020-01-01 00:06:10,14,2,1642,19,1623,2.51%,1.16%
2020-01-01 00:06:10,14,3,1073,6,1067,1.64%,0.56%
2020-01-01 00:06:10,14,4,4346,146,4200,6.63%,3.36%
2020-01-01 00:06:10,14,5,1418,13,1405,2.16%,0.92%
2020-01-01 00:06:10,14,6,4800,176,4624,7.32%,3.67%
2020-01-01 00:06:10,14,7,11666,970,10696,17.80%,8.31%
2020-01-01 00:06:10,14,8,13773,1374,12399,21.02%,9.98%
2020-01-01 00:06:10,14,9,1694,18,1676,2.58%,1.06%
2020-01-01 00:06:10,14,10,3967,114,3853,6.05%,2.87%
2020-01-01 00:06:10,14,11,25775,4519,21256,39.33%,17.53%
2020-01-01 00:06:10,14,12,7792,479,7313,11.89%,6.15%
2020-01-01 00:06:10,15,1,567,13,554,0.87%,2.29%
2020-01-01 00:06:10,15,2,171,4,167,0.26%,2.34%
2020-01-01 00:06:10,15,3,3708,108,3600,5.66%,2.91%
2020-01-01 00:06:10,15,4,5074,239,4835,7.74%,4.71%
2020-01-01 00:06:10,15,5,9654,809,8845,14.73%,8.38%
2020-01-01 00:06:10,15,6,5280,256,5024,8.06%,4.85%
2020-01-01 00:06:10,15,7,3207,68,3139,4.89%,2.12%
2020-01-01 00:06:10,15,8,5097,178,4919,7.78%,3.49%
2020-01-01 00:06:10,15,9,9835,834,9001,15.01%,8.48%
2020-01-01 00:06:10,15,10,4066,363,3703,6.20%,8.93%
2020-01-01 00:06:10,15,11,9273,828,8445,14.15%,8.93%
2020-01-01 00:06:10,15,12,24655,4593,20062,37.62%,18.63%
2020-01-01 00:06:10,16,1,576,0,576,0.88%,0.00%
2020-01-01 00:06:10,16,2,218,0,218,0.33%,0.00%
2020-01-01 00:06:10,16,3,1397,15,1382,2.13%,1.07%
2020-01-01 00:06:10,16,4,4884,181,4703,7.45%,3.71%
2020-01-01 00:06:10,16,5,8423,602,7821,12.85%,7.15%
2020-01-01 00:06:10,16,6,5800,263,5537,8.85%,4.53%
2020-01-01 00:06:10,16,7,3509,129,3380,5.35%,3.68%
2020-01-01 00:06:10,16,8,7686,506,7180,11.73%,6.58%
2020-01-01 00:06:10,16,9,8949,663,8286,13.66%,7.41%
2020-01-01 00:06:10,16,10,2359,44,2315,3.60%,1.87%
2020-01-01 00:06:10,16,11,10258,851,9407,15.65%,8.30%
2020-01-01 00:06:10,16,12,27716,5197,22519,42.29%,18.75%
2020-01-01 00:06:20,1,1,31886,6609,25277,48.65%,20.73%
2020-01-01 00:06:20,1,2,21626,3143,18483,33.00%,14.53%
2020-01-01 00:06:20,1,3,676,7,669,1.03%,1.04%
2020-01-01 00:06:20,1,4,9666,732,8934,14.75%,7.57%
2020-01-01 00:06:20,1,5,9126,660,8466,13.93%,7.23%
2020-01-01 00:06:20,1,6,9052,651,8401,13.81%,7.19%
2020-01-01 00:06:20,1,7,20924,2940,17984,31.93%,14.05%
2020-01-01 00:06:20,1,8,19900,2681,17219,30.36%,13.47%
2020-01-01 00:06:20,1,9,9010,646,8364,13.75%,7.17%
2020-01-01 00:06:20,1,10,19232,2503,16729,29.35%,13.01%
2020-01-01 00:06:20,1,11,19342,2535,16807,29.51%,13.11%
2020-01-01 00:06:20,1,12,8970,638,8332,13.69%,7.11%
2020-01-01 00:06:20,2,1,2182,31,2151,3.33%,1.42%
2020-01-01 00:06:20,2,2,27710,5137,22573,42.28%,18.54%
2020-01-01 00:06:20,2,3,19609,2745,16864,29.92%,14.00%
2020-01-01 00:06:20,2,4,2136,30,2106,3.26%,1.40%
2020-01-01 00:06:20,2,5,10298,804,9494,15.71%,7.81%
2020-01-01 00:06:20,2,6,39,0,39,0.06%,0.00%
2020-01-01 00:06:20,2,7,5912,270,5642,9.02%,4.57%
2020-01-01 00:06:20,2,8,4916,187,4729,7.50%,3.80%
2020-01-01 00:06:20,2,9,10238,790,9448,15.62%,7.72%
2020-01-01 00:06:20,2,10,4025,131,3894,6.14%,3.25%
2020-01-01 00:06:20,2,11,4036,134,3902,6.16%,3.32%
2020-01-01 00:06:20,2,12,10067,754,9313,15.36%,7.49%
2020-01-01 00:06:20,3,1,2814,60,2754,4.29%,2.13%
2020-01-01 00:06:20,3,2,25686,4450,21236,39.19%,17.32%
2020-01-01 00:06:20,3,3,72063,28217,43846,109.96%,39.16%
2020-01-01 00:06:20,3,4,8091,498,7593,12.35%,6.15%
2020-01-01 00:06:20,3,5,45396,12518,32878,69.27%,27.58%
2020-01-01 00:06:20,3,6,9096,611,8485,13.88%,6.72%
2020-01-01 00:06:20,3,7,21188,3083,18105,32.33%,14.55%
2020-01-01 00:06:20,3,8,15960,1827,14133,24.35%,11.45%
2020-01-01 00:06:20,3,9,35922,8215,27707,54.81%,22.87%
2020-01-01 00:06:20,3,10,5634,216,5418,8.60%,3.83%
2020-01-01 00:06:20,3,11,1724,27,1697,2.63%,1.57%
2020-01-01 00:06:20,3,12,27161,4967,22194,41.44%,18.29%
2020-01-01 00:06:20,4,1,528,5,523,0.81%,0.95%
2020-01-01 00:06:20,4,2,321,1,320,0.49%,0.31%
2020-01-01 00:06:20,4,3,640,2,638,0.98%,0.31%
2020-01-01 00:06:20,4,4,28119,5350,22769,42.91%,19.03%
2020-01-01 00:06:20,4,5,17575,2164,15411,26.82%,12.31%
2020-01-01 00:06:20,4,6,24206,3991,20215,36.94%,16.49%
2020-01-01 00:06:20,4,7,5401,228,5173,8.24%,4.22%
2020-01-01 00:06:20,4,8,2996,74,2922,4.57%,2.47%
2020-01-01 00:06:20,4,9,15778,1769,14009,24.08%,11.21%
2020-01-01 00:06:20,4,10,1831,26,1805,2.79%,1.42%
2020-01-01 00:06:20,4,11,194,0,194,0.30%,0.00%
2020-01-01 00:06:20,4,12,12330,1090,11240,18.81%,8.84%
2020-01-01 00:06:20,5,1,2715,67,2648,4.14%,2.47%
2020-01-01 00:06:20,5,2,688,5,683,1.05%,0.73%
2020-01-01 00:06:20,5,3,1537,16,1521,2.35%,1.04%
2020-01-01 00:06:20,5,4,21136,3137,17999,32.25%,14.84%
2020-01-01 00:06:20,5,5,10370,775,9595,15.82%,7.47%
2020-01-01 00:06:20,5,6,14955,1569,13386,22.82%,10.49%
2020-01-01 00:06:20,5,7,4121,137,3984,6.29%,3.32%
2020-01-01 00:06:20,5,8,3132,81,3051,4.78%,2.59%
2020-01-01 00:06:20,5,9,8716,556,8160,13.30%,6.38%
2020-01-01 00:06:20,5,10,970,11,959,1.48%,1.13%
2020-01-01 00:06:20,5,11,518,3,515,0.79%,0.58%
2020-01-01 00:06:20,5,12,7410,390,7020,11.31%,5.26%
2020-01-01 00:06:20,6,1,1179,15,1164,1.80%,1.27%
2020-01-01 00:06:20,6,2,1221,16,1205,1.86%,1.31%
2020-01-01 00:06:20,6,3,1954,29,1925,2.98%,1.48%
2020-01-01 00:06:20,6,4,1154,9,1145,1.76%,0.78%
2020-01-01 00:06:20,6,5,13258,1301,11957,20.23%,9.81%
2020-01-01 00:06:20,6,6,4302,171,4131,6.56%,3.97%
2020-01-01 00:06:20,6,7,2616,70,2546,3.99%,2.68%
2020-01-01 00:06:20,6,8,2171,48,2123,3.31%,2.21%
2020-01-01 00:06:20,6,9,6712,341,6371,10.24%,5.08%
2020-01-01 00:06:20,6,10,2181,43,2138,3.33%,1.97%
2020-01-01 00:06:20,6,11,458,2,456,0.70%,0.44%
2020-01-01 00:06:20,6,12,4446,142,4304,6.78%,3.19%
2020-01-01 00:06:20,7,1,511,3,508,0.78%,0.59%
2020-01-01 00:06:20,7,2,176,0,176,0.27%,0.00%
2020-01-01 00:06:20,7,3,1204,7,1197,1.84%,0.58%
2020-01-01 00:06:20,7,4,1849,18,1831,2.82%,0.97%
2020-01-01 00:06:20,7,5,8216,463,7753,12.54%,5.64%
2020-01-01 00:06:20,7,6,13713,1330,12383,20.92%,9.70%
2020-01-01 00:06:20,7,7,3606,100,3506,5.50%,2.77%
2020-01-01 00:06:20,7,8,1481,13,1468,2.26%,0.88%
2020-01-01 00:06:20,7,9,6931,321,6610,10.58%,4.63%
2020-01-01 00:06:20,7,10,1597,20,1577,2.44%,1.25%
2020-01-01 00:06:20,7,11,138,0,138,0.21%,0.00%
2020-01-01 00:06:20,7,12,5326,163,5163,8.13%,3.06%
2020-01-01 00:06:20,8,1,577,0,577,0.88%,0.00%
2020-01-01 00:06:20,8,2,96,0,96,0.15%,0.00%
2020-01-01 00:06:20,8,3,2020,19,2001,3.08%,0.94%
2020-01-01 00:06:20,8,4,2990,76,2914,4.56%,2.54%
2020-01-01 00:06:20,8,5,8307,519,7788,12.68%,6.25%
2020-01-01 00:06:20,8,6,16096,1868,14228,24.56%,11.61%
2020-01-01 00:06:20,8,7,4678,170,4508,7.14%,3.63%
2020-01-01 00:06:20,8,8,2016,38,1978,3.08%,1.88%
2020-01-01 00:06:20,8,9,6021,271,5750,9.19%,4.50%
2020-01-01 00:06:20,8,10,1654,15,1639,2.52%,0.91%
2020-01-01 00:06:20,8,11,117,0,117,0.18%,0.00%
2020-01-01 00:06:20,8,12,4357,146,4211,6.65%,3.35%
2020-01-01 00:06:20,9,1,1049,9,1040,1.60%,0.86%
2020-01-01 00:06:20,9,2,3403,74,3329,5.19%,2.17%
2020-01-01 00:06:20,9,3,2001,18,1983,3.05%,0.90%
2020-01-01 00:06:20,9,4,5368,213,5155,8.19%,3.97%
2020-01-01 00:06:20,9,5,297,3,294,0.45%,1.01%
2020-01-01 00:06:20,9,6,6283,295,5988,9.59%,4.70%
2020-01-01 00:06:20,9,7,26159,4550,21609,39.92%,17.39%
2020-01-01 00:06:20,9,8,9046,572,8474,13.80%,6.32%
2020-01-01 00:06:20,9,9,199,1,198,0.30%,0.50%
2020-01-01 00:06:20,9,10,2647,46,2601,4.04%,1.74%
2020-01-01 00:06:20,9,11,7927,438,7489,12.10%,5.53%
2020-01-01 00:06:20,9,12,5043,173,4870,7.70%,3.43%
2020-01-01 00:06:20,10,1,1251,199,1052,1.91%,15.91%
2020-01-01 00:06:20,10,2,3260,258,3002,4.97%,7.91%
2020-01-01 00:06:20,10,3,1858,21,1837,2.84%,1.13%
2020-01-01 00:06:20,10,4,3878,1099,2779,5.92%,28.34%
2020-01-01 00:06:20,10,5,740,58,682,1.13%,7.84%
2020-01-01 00:06:20,10,6,5840,1257,4583,8.91%,21.52%
2020-01-01 00:06:20,10,7,10784,1927,8857,16.46%,17.87%
2020-01-01 00:06:20,10,8,28379,7053,21326,43.30%,24.85%
2020-01-01 00:06:20,10,9,704,3,701,1.07%,0.43%
2020-01-01 00:06:20,10,10,2440,42,2398,3.72%,1.72%
2020-01-01 00:06:20,10,11,13707,1751,11956,20.92%,12.77%
2020-01-01 00:06:20,10,12,10304,1191,9113,15.72%,11.56%
2020-01-01 00:06:20,11,1,2622,55,2567,4.00%,2.10%
2020-01-01 00:06:20,11,2,3624,111,3513,5.53%,3.06%
2020-01-01 00:06:20,11,3,800,20,780,1.22%,2.50%
2020-01-01 00:06:20,11,4,3159,70,3089,4.82%,2.22%
2020-01-01 00:06:20,11,5,221,0,221,0.34%,0.00%
2020-01-01 00:06:20,11,6,4032,119,3913,6.15%,2.95%
2020-01-01 00:06:20,11,7,9515,691,8824,14.52%,7.26%
2020-01-01 00:06:20,11,8,22694,3533,19161,34.63%,15.57%
2020-01-01 00:06:20,11,9,200,1,199,0.31%,0.50%
2020-01-01 00:06:20,11,10,2898,69,2829,4.42%,2.38%
2020-01-01 00:06:20,11,11,9633,677,8956,14.70%,7.03%
2020-01-01 00:06:20,11,12,6303,313,5990,9.62%,4.97%
2020-01-01 00:06:20,12,1,54,0,54,0.08%,0.00%
2020-01-01 00:06:20,12,2,631,157,474,0.96%,24.88%
2020-01-01 00:06:20,12,3,2891,221,2670,4.41%,7.64%
2020-01-01 00:06:20,12,4,2897,58,2839,4.42%,2.00%
2020-01-01 00:06:20,12,5,9634,798,8836,14.70%,8.28%
2020-01-01 00:06:20,12,6,5256,228,5028,8.02%,4.34%
2020-01-01 00:06:20,12,7,2166,47,2119,3.31%,2.17%
2020-01-01 00:06:20,12,8,1975,316,1659,3.01%,16.00%
2020-01-01 00:06:20,12,9,24123,4747,19376,36.81%,19.68%
2020-01-01 00:06:20,12,10,4776,447,4329,7.29%,9.36%
2020-01-01 00:06:20,12,11,2102,316,1786,3.21%,15.03%
2020-01-01 00:06:20,12,12,9124,1248,7876,13.92%,13.68%
2020-01-01 00:06:20,13,1,2087,34,2053,3.18%,1.63%
2020-01-01 00:06:20,13,2,2460,54,2406,3.75%,2.20%
2020-01-01 00:06:20,13,3,792,3,789,1.21%,0.38%
2020-01-01 00:06:20,13,4,5668,580,5088,8.65%,10.23%
2020-01-01 00:06:20,13,5,8132,886,7246,12.41%,10.90%
2020-01-01 00:06:20,13,6,6585,649,5936,10.05%,9.86%
2020-01-01 00:06:20,13,7,4645,188,4457,7.09%,4.05%
2020-01-01 00:06:20,13,8,6918,364,6554,10.56%,5.26%
2020-01-01 00:06:20,13,9,8385,913,7472,12.79%,10.89%
2020-01-01 00:06:20,13,10,28183,5819,22364,43.00%,20.65%
2020-01-01 00:06:20,13,11,17167,2394,14773,26.19%,13.95%
2020-01-01 00:06:20,13,12,9740,1036,8704,14.86%,10.64%
2020-01-01 00:06:20,14,1,201,0,201,0.31%,0.00%
2020-01-01 00:06:20,14,2,1041,7,1034,1.59%,0.67%
2020-01-01 00:06:20,14,3,615,5,610,0.94%,0.81%
2020-01-01 00:06:20,14,4,3877,121,3756,5.92%,3.12%
2020-01-01 00:06:20,14,5,1593,14,1579,2.43%,0.88%
2020-01-01 00:06:20,14,6,4209,141,4068,6.42%,3.35%
2020-01-01 00:06:20,14,7,11590,967,10623,17.68%,8.34%
2020-01-01 00:06:20,14,8,13063,1224,11839,19.93%,9.37%
2020-01-01 00:06:20,14,9,1808,18,1790,2.76%,1.00%
2020-01-01 00:06:20,14,10,4156,131,4025,6.34%,3.15%
2020-01-01 00:06:20,14,11,25431,4370,21061,38.80%,17.18%
2020-01-01 00:06:20,14,12,7982,471,7511,12.18%,5.90%
2020-01-01 00:06:20,15,1,523,1,522,0.80%,0.19%
2020-01-01 00:06:20,15,2,160,0,160,0.24%,0.00%
2020-01-01 00:06:20,15,3,3971,136,3835,6.06%,3.42%
2020-01-01 00:06:20,15,4,4877,171,4706,7.44%,3.51%
2020-01-01 00:06:20,15,5,9630,720,8910,14.69%,7.48%
2020-01-01 00:06:20,15,6,5087,188,4899,7.76%,3.70%
2020-01-01 00:06:20,15,7,3111,87,3024,4.75%,2.80%
2020-01-01 00:06:20,15,8,5303,234,5069,8.09%,4.41%
2020-01-01 00:06:20,15,9,9828,740,9088,15.00%,7.53%
2020-01-01 00:06:20,15,10,4549,274,4275,6.94%,6.02%
2020-01-01 00:06:20,15,11,9954,860,9094,15.19%,8.64%
2020-01-01 00:06:20,15,12,24906,4715,20191,38.00%,18.93%
2020-01-01 00:06:20,16,1,526,1,525,0.80%,0.19%
2020-01-01 00:06:20,16,2,336,0,336,0.51%,0.00%
2020-01-01 00:06:20,16,3,1350,17,1333,2.06%,1.26%
2020-01-01 00:06:20,16,4,4772,173,4599,7.28%,3.63%
2020-01-01 00:06:20,16,5,8050,518,7532,12.28%,6.43%
2020-01-01 00:06:20,16,6,5591,234,5357,8.53%,4.19%
2020-01-01 00:06:20,16,7,4332,135,4197,6.61%,3.12%
2020-01-01 00:06:20,16,8,8260,566,7694,12.60%,6.85%
2020-01-01 00:06:20,16,9,8578,579,7999,13.09%,6.75%
2020-01-01 00:06:20,16,10,1502,24,1478,2.29%,1.60%
2020-01-01 00:06:20,16,11,10039,790,9249,15.32%,7.87%
2020-01-01 00:06:20,16,12,26067,4735,21332,39.78%,18.16%
2020-01-01 00:06:30,1,1,28412,5359,23053,43.35%,18.86%
2020-01-01 00:06:30,1,2,16594,1941,14653,25.32%,11.70%
2020-01-01 00:06:30,1,3,375,0,375,0.57%,0.00%
2020-01-01 00:06:30,1,4,11311,933,10378,17.26%,8.25%
2020-01-01 00:06:30,1,5,10980,875,10105,16.75%,7.97%
2020-01-01 00:06:30,1,6,10905,859,10046,16.64%,7.88%
2020-01-01 00:06:30,1,7,16195,1842,14353,24.71%,11.37%
2020-01-01 00:06:30,1,8,15174,1638,13536,23.15%,10.79%
2020-01-01 00:06:30,1,9,10872,855,10017,16.59%,7.86%
2020-01-01 00:06:30,1,10,14498,1489,13009,22.12%,10.27%
2020-01-01 00:06:30,1,11,14556,1498,13058,22.21%,10.29%
2020-01-01 00:06:30,1,12,10850,849,10001,16.56%,7.82%
2020-01-01 00:06:30,2,1,2575,45,2530,3.93%,1.75%
2020-01-01 00:06:30,2,2,26001,4535,21466,39.67%,17.44%
2020-01-01 00:06:30,2,3,17067,2026,15041,26.04%,11.87%
2020-01-01 00:06:30,2,4,2500,42,2458,3.81%,1.68%
2020-01-01 00:06:30,2,5,10223,739,9484,15.60%,7.23%
2020-01-01 00:06:30,2,6,28,0,28,0.04%,0.00%
2020-01-01 00:06:30,2,7,6351,316,6035,9.69%,4.98%
2020-01-01 00:06:30,2,8,5186,214,4972,7.91%,4.13%
2020-01-01 00:06:30,2,9,10110,722,9388,15.43%,7.14%
2020-01-01 00:06:30,2,10,4469,163,4306,6.82%,3.65%
2020-01-01 00:06:30,2,11,4486,165,4321,6.85%,3.68%
2020-01-01 00:06:30,2,12,9979,700,9279,15.23%,7.01%
2020-01-01 00:06:30,3,1,1700,20,1680,2.59%,1.18%
2020-01-01 00:06:30,3,2,23663,3818,19845,36.11%,16.13%
2020-01-01 00:06:30,3,3,70646,27511,43135,107.80%,38.94%
2020-01-01 00:06:30,3,4,9456,591,8865,14.43%,6.25%
2020-01-01 00:06:30,3,5,45664,12853,32811,69.68%,28.15%
2020-01-01 00:06:30,3,6,10795,786,10009,16.47%,7.28%
2020-01-01 00:06:30,3,7,20416,2877,17539,31.15%,14.09%
2020-01-01 00:06:30,3,8,16384,1897,14487,25.00%,11.58%
2020-01-01 00:06:30,3,9,34383,7861,26522,52.46%,22.86%
2020-01-01 00:06:30,3,10,4102,322,3780,6.26%,7.85%
2020-01-01 00:06:30,3,11,1992,30,1962,3.04%,1.51%
2020-01-01 00:06:30,3,12,28087,5300,22787,42.86%,18.87%
2020-01-01 00:06:30,4,1,585,1,584,0.89%,0.17%
2020-01-01 00:06:30,4,2,352,0,352,0.54%,0.00%
2020-01-01 00:06:30,4,3,817,5,812,1.25%,0.61%
2020-01-01 00:06:30,4,4,28795,5399,23396,43.94%,18.75%
2020-01-01 00:06:30,4,5,18107,2230,15877,27.63%,12.32%
2020-01-01 00:06:30,4,6,24574,3979,20595,37.50%,16.19%
2020-01-01 00:06:30,4,7,5367,193,5174,8.19%,3.60%
2020-01-01 00:06:30,4,8,3081,66,3015,4.70%,2.14%
2020-01-01 00:06:30,4,9,15471,1653,13818,23.61%,10.68%
2020-01-01 00:06:30,4,10,1906,31,1875,2.91%,1.63%
2020-01-01 00:06:30,4,11,135,0,135,0.21%,0.00%
2020-01-01 00:06:30,4,12,12340,1053,11287,18.83%,8.53%
2020-01-01 00:06:30,5,1,2645,51,2594,4.04%,1.93%
2020-01-01 00:06:30,5,2,673,7,666,1.03%,1.04%
2020-01-01 00:06:30,5,3,474,2,472,0.72%,0.42%
2020-01-01 00:06:30,5,4,21621,3276,18345,32.99%,15.15%
2020-01-01 00:06:30,5,5,9661,691,8970,14.74%,7.15%
2020-01-01 00:06:30,5,6,14359,1530,12829,21.91%,10.66%
2020-01-01 00:06:30,5,7,4158,157,4001,6.34%,3.78%
2020-01-01 00:06:30,5,8,3350,98,3252,5.11%,2.93%
2020-01-01 00:06:30,5,9,9070,612,8458,13.84%,6.75%
2020-01-01 00:06:30,5,10,1200,19,1181,1.83%,1.58%
2020-01-01 00:06:30,5,11,664,4,660,1.01%,0.60%
2020-01-01 00:06:30,5,12,7608,445,7163,11.61%,5.85%
2020-01-01 00:06:30,6,1,952,8,944,1.45%,0.84%
2020-01-01 00:06:30,6,2,1040,14,1026,1.59%,1.35%
2020-01-01 00:06:30,6,3,1576,23,1553,2.40%,1.46%
2020-01-01 00:06:30,6,4,1458,8,1450,2.22%,0.55%
2020-01-01 00:06:30,6,5,15423,1729,13694,23.53%,11.21%
2020-01-01 00:06:30,6,6,5191,203,4988,7.92%,3.91%
2020-01-01 00:06:30,6,7,3197,93,3104,4.88%,2.91%
2020-01-01 00:06:30,6,8,2579,64,2515,3.94%,2.48%
2020-01-01 00:06:30,6,9,8380,493,7887,12.79%,5.88%
2020-01-01 00:06:30,6,10,2498,64,2434,3.81%,2.56%
2020-01-01 00:06:30,6,11,428,1,427,0.65%,0.23%
2020-01-01 00:06:30,6,12,5753,212,5541,8.78%,3.69%
2020-01-01 00:06:30,7,1,421,2,419,0.64%,0.48%
2020-01-01 00:06:30,7,2,227,0,227,0.35%,0.00%
2020-01-01 00:06:30,7,3,1242,8,1234,1.90%,0.64%
2020-01-01 00:06:30,7,4,1342,12,1330,2.05%,0.89%
2020-01-01 00:06:30,7,5,8637,529,8108,13.18%,6.12%
2020-01-01 00:06:30,7,6,13495,1353,12142,20.59%,10.03%
2020-01-01 00:06:30,7,7,3487,105,3382,5.32%,3.01%
2020-01-01 00:06:30,7,8,1247,11,1236,1.90%,0.88%
2020-01-01 00:06:30,7,9,7324,396,6928,11.18%,5.41%
2020-01-01 00:06:30,7,10,2463,31,2432,3.76%,1.26%
2020-01-01 00:06:30,7,11,108,0,108,0.16%,0.00%
2020-01-01 00:06:30,7,12,4812,173,4639,7.34%,3.60%
2020-01-01 00:06:30,8,1,393,0,393,0.60%,0.00%
2020-01-01 00:06:30,8,2,107,0,107,0.16%,0.00%
2020-01-01 00:06:30,8,3,1641,19,1622,2.50%,1.16%
2020-01-01 00:06:30,8,4,2497,42,2455,3.81%,1.68%
2020-01-01 00:06:30,8,5,8302,508,7794,12.67%,6.12%
2020-01-01 00:06:30,8,6,15801,1754,14047,24.11%,11.10%
2020-01-01 00:06:30,8,7,4932,217,4715,7.53%,4.40%
2020-01-01 00:06:30,8,8,1853,31,1822,2.83%,1.67%
2020-01-01 00:06:30,8,9,6449,310,6139,9.84%,4.81%
2020-01-01 00:06:30,8,10,1705,23,1682,2.60%,1.35%
2020-01-01 00:06:30,8,11,153,0,153,0.23%,0.00%
2020-01-01 00:06:30,8,12,4643,161,4482,7.08%,3.47%
2020-01-01 00:06:30,9,1,848,17,831,1.29%,2.00%
2020-01-01 00:06:30,9,2,2672,49,2623,4.08%,1.83%
2020-01-01 00:06:30,9,3,1328,8,1320,2.03%,0.60%
2020-01-01 00:06:30,9,4,6650,309,6341,10.15%,4.65%
2020-01-01 00:06:30,9,5,258,0,258,0.39%,0.00%
2020-01-01 00:06:30,9,6,7352,389,6963,11.22%,5.29%
2020-01-01 00:06:30,9,7,27830,5127,22703,42.47%,18.42%
2020-01-01 00:06:30,9,8,11974,1058,10916,18.27%,8.84%
2020-01-01 00:06:30,9,9,143,0,143,0.22%,0.00%
2020-01-01 00:06:30,9,10,3679,108,3571,5.61%,2.94%
2020-01-01 00:06:30,9,11,10649,826,9823,16.25%,7.76%
2020-01-01 00:06:30,9,12,6643,321,6322,10.14%,4.83%
2020-01-01 00:06:30,10,1,1370,217,1153,2.09%,15.84%
2020-01-01 00:06:30,10,2,3170,264,2906,4.84%,8.33%
2020-01-01 00:06:30,10,3,1570,17,1553,2.40%,1.08%
2020-01-01 00:06:30,10,4,3780,919,2861,5.77%,24.31%
2020-01-01 00:06:30,10,5,735,39,696,1.12%,5.31%
2020-01-01 00:06:30,10,6,5772,1073,4699,8.81%,18.59%
2020-01-01 00:06:30,10,7,10534,1752,8782,16.07%,16.63%
2020-01-01 00:06:30,10,8,27374,6549,20825,41.77%,23.92%
2020-01-01 00:06:30,10,9,923,3,920,1.41%,0.33%
2020-01-01 00:06:30,10,10,2466,34,2432,3.76%,1.38%
2020-01-01 00:06:30,10,11,12968,1547,11421,19.79%,11.93%
2020-01-01 00:06:30,10,12,9641,1074,8567,14.71%,11.14%
2020-01-01 00:06:30,11,1,2444,33,2411,3.73%,1.35%
2020-01-01 00:06:30,11,2,3733,144,3589,5.70%,3.86%
2020-01-01 00:06:30,11,3,1065,51,1014,1.63%,4.79%
2020-01-01 00:06:30,11,4,5112,179,4933,7.80%,3.50%
2020-01-01 00:06:30,11,5,816,9,807,1.25%,1.10%
2020-01-01 00:06:30,11,6,6541,296,6245,9.98%,4.53%
2020-01-01 00:06:30,11,7,12259,1093,11166,18.71%,8.92%
2020-01-01 00:06:30,11,8,25746,4426,21320,39.29%,17.19%
2020-01-01 00:06:30,11,9,208,0,208,0.32%,0.00%
2020-01-01 00:06:30,11,10,3304,81,3223,5.04%,2.45%
2020-01-01 00:06:30,11,11,10145,786,9359,15.48%,7.75%
2020-01-01 00:06:30,11,12,6514,309,6205,9.94%,4.74%
2020-01-01 00:06:30,12,1,40,0,40,0.06%,0.00%
2020-01-01 00:06:30,12,2,616,186,430,0.94%,30.19%
2020-01-01 00:06:30,12,3,2999,245,2754,4.58%,8.17%
2020-01-01 00:06:30,12,4,2646,62,2584,4.04%,2.34%
2020-01-01 00:06:30,12,5,9897,913,8984,15.10%,9.23%
2020-01-01 00:06:30,12,6,6034,288,5746,9.21%,4.77%
2020-01-01 00:06:30,12,7,3247,90,3157,4.95%,2.77%
2020-01-01 00:06:30,12,8,1547,315,1232,2.36%,20.36%
2020-01-01 00:06:30,12,9,24249,4978,19271,37.00%,20.53%
2020-01-01 00:06:30,12,10,4287,424,3863,6.54%,9.89%
2020-01-01 00:06:30,12,11,1699,319,1380,2.59%,18.78%
2020-01-01 00:06:30,12,12,9573,1247,8326,14.61%,13.03%
2020-01-01 00:06:30,13,1,1988,29,1959,3.03%,1.46%
2020-01-01 00:06:30,13,2,2371,69,2302,3.62%,2.91%
2020-01-01 00:06:30,13,3,745,6,739,1.14%,0.81%
2020-01-01 00:06:30,13,4,5235,556,4679,7.99%,10.62%
2020-01-01 00:06:30,13,5,7451,859,6592,11.37%,11.53%
2020-01-01 00:06:30,13,6,6068,620,5448,9.26%,10.22%
2020-01-01 00:06:30,13,7,5357,225,5132,8.17%,4.20%
2020-01-01 00:06:30,13,8,7482,432,7050,11.42%,5.77%
2020-01-01 00:06:30,13,9,7710,880,6830,11.76%,11.41%
2020-01-01 00:06:30,13,10,28198,5932,22266,43.03%,21.04%
2020-01-01 00:06:30,13,11,17971,2609,15362,27.42%,14.52%
2020-01-01 00:06:30,13,12,9957,1149,8808,15.19%,11.54%
2020-01-01 00:06:30,14,1,379,2,377,0.58%,0.53%
2020-01-01 00:06:30,14,2,1231,17,1214,1.88%,1.38%
2020-01-01 00:06:30,14,3,604,8,596,0.92%,1.32%
2020-01-01 00:06:30,14,4,3797,105,3692,5.79%,2.77%
2020-01-01 00:06:30,14,5,1326,10,1316,2.02%,0.75%
2020-01-01 00:06:30,14,6,4069,129,3940,6.21%,3.17%
2020-01-01 00:06:30,14,7,11583,991,10592,17.67%,8.56%
2020-01-01 00:06:30,14,8,12936,1215,11721,19.74%,9.39%
2020-01-01 00:06:30,14,9,1530,18,1512,2.33%,1.18%
2020-01-01 00:06:30,14,10,4009,120,3889,6.12%,2.99%
2020-01-01 00:06:30,14,11,24936,4273,20663,38.05%,17.14%
2020-01-01 00:06:30,14,12,7779,463,7316,11.87%,5.95%
2020-01-01 00:06:30,15,1,602,1,601,0.92%,0.17%
2020-01-01 00:06:30,15,2,195,0,195,0.30%,0.00%
2020-01-01 00:06:30,15,3,4195,131,4064,6.40%,3.12%
2020-01-01 00:06:30,15,4,5224,222,5002,7.97%,4.25%
2020-01-01 00:06:30,15,5,10736,844,9892,16.38%,7.86%
2020-01-01 00:06:30,15,6,5510,249,5261,8.41%,4.52%
2020-01-01 00:06:30,15,7,3506,95,3411,5.35%,2.71%
2020-01-01 00:06:30,15,8,5516,224,5292,8.42%,4.06%
2020-01-01 00:06:30,15,9,10939,883,10056,16.69%,8.07%
2020-01-01 00:06:30,15,10,4057,115,3942,6.19%,2.83%
2020-01-01 00:06:30,15,11,9694,659,9035,14.79%,6.80%
2020-01-01 00:06:30,15,12,25903,4795,21108,39.52%,18.51%
2020-01-01 00:06:30,16,1,464,1,463,0.71%,0.22%
2020-01-01 00:06:30,16,2,278,0,278,0.42%,0.00%
2020-01-01 00:06:30,16,3,1186,9,1177,1.81%,0.76%
2020-01-01 00:06:30,16,4,3800,98,3702,5.80%,2.58%
2020-01-01 00:06:30,16,5,7099,417,6682,10.83%,5.87%
2020-01-01 00:06:30,16,6,4466,134,4332,6.81%,3.00%
2020-01-01 00:06:30,16,7,4264,155,4109,6.51%,3.64%
2020-01-01 00:06:30,16,8,7964,519,7445,12.15%,6.52%
2020-01-01 00:06:30,16,9,7508,469,7039,11.46%,6.25%
2020-01-01 00:06:30,16,10,1677,29,1648,2.56%,1.73%
2020-01-01 00:06:30,16,11,9921,755,9166,15.14%,7.61%
2020-01-01 00:06:30,16,12,25515,4480,21035,38.93%,17.56%
2020-01-01 00:06:40,1,1,21594,3222,18372,32.95%,14.92%
2020-01-01 00:06:40,1,2,10312,759,9553,15.73%,7.36%
2020-01-01 00:06:40,1,3,504,0,504,0.77%,0.00%
2020-01-01 00:06:40,1,4,10943,870,10073,16.70%,7.95%
2020-01-01 00:06:40,1,5,10664,830,9834,16.27%,7.78%
2020-01-01 00:06:40,1,6,10617,818,9799,16.20%,7.70%
2020-01-01 00:06:40,1,7,9791,686,9105,14.94%,7.01%
2020-01-01 00:06:40,1,8,7865,428,7437,12.00%,5.44%
2020-01-01 00:06:40,1,9,10558,812,9746,16.11%,7.69%
2020-01-01 00:06:40,1,10,7300,367,6933,11.14%,5.03%
2020-01-01 00:06:40,1,11,7368,380,6988,11.24%,5.16%
2020-01-01 00:06:40,1,12,10544,811,9733,16.09%,7.69%
2020-01-01 00:06:40,2,1,1397,5,1392,2.13%,0.36%
2020-01-01 00:06:40,2,2,26283,4606,21677,40.10%,17.52%
2020-01-01 00:06:40,2,3,19981,2760,17221,30.49%,13.81%
2020-01-01 00:06:40,2,4,1339,5,1334,2.04%,0.37%
2020-01-01 00:06:40,2,5,12218,1060,11158,18.64%,8.68%
2020-01-01 00:06:40,2,6,61,0,61,0.09%,0.00%
2020-01-01 00:06:40,2,7,4891,188,4703,7.46%,3.84%
2020-01-01 00:06:40,2,8,3914,114,3800,5.97%,2.91%
2020-01-01 00:06:40,2,9,12094,1036,11058,18.45%,8.57%
2020-01-01 00:06:40,2,10,3237,85,3152,4.94%,2.63%
2020-01-01 00:06:40,2,11,3276,88,3188,5.00%,2.69%
2020-01-01 00:06:40,2,12,11906,997,10909,18.17%,8.37%
2020-01-01 00:06:40,3,1,1217,7,1210,1.86%,0.58%
2020-01-01 00:06:40,3,2,24876,4215,20661,37.96%,16.94%
2020-01-01 00:06:40,3,3,71308,27857,43451,108.81%,39.07%
2020-01-01 00:06:40,3,4,5271,205,5066,8.04%,3.89%
2020-01-01 00:06:40,3,5,43028,11405,31623,65.66%,26.51%
2020-01-01 00:06:40,3,6,7292,387,6905,11.13%,5.31%
2020-01-01 00:06:40,3,7,21723,3279,18444,33.15%,15.09%
2020-01-01 00:06:40,3,8,18274,2367,15907,27.88%,12.95%
2020-01-01 00:06:40,3,9,35346,7920,27426,53.93%,22.41%
2020-01-01 00:06:40,3,10,6927,349,6578,10.57%,5.04%
2020-01-01 00:06:40,3,11,1800,25,1775,2.75%,1.39%
2020-01-01 00:06:40,3,12,25917,4421,21496,39.55%,17.06%
2020-01-01 00:06:40,4,1,484,0,484,0.74%,0.00%
2020-01-01 00:06:40,4,2,306,0,306,0.47%,0.00%
2020-01-01 00:06:40,4,3,981,13,968,1.50%,1.33%
2020-01-01 00:06:40,4,4,26673,4780,21893,40.70%,17.92%
2020-01-01 00:06:40,4,5,17242,2143,15099,26.31%,12.43%
2020-01-01 00:06:40,4,6,23089,3668,19421,35.23%,15.89%
2020-01-01 00:06:40,4,7,4709,163,4546,7.19%,3.46%
2020-01-01 00:06:40,4,8,2793,59,2734,4.26%,2.11%
2020-01-01 00:06:40,4,9,14579,1547,13032,22.25%,10.61%
2020-01-01 00:06:40,4,10,1848,29,1819,2.82%,1.57%
2020-01-01 00:06:40,4,11,148,0,148,0.23%,0.00%
2020-01-01 00:06:40,4,12,12166,1092,11074,18.56%,8.98%
2020-01-01 00:06:40,5,1,3043,68,2975,4.64%,2.23%
2020-01-01 00:06:40,5,2,820,5,815,1.25%,0.61%
2020-01-01 00:06:40,5,3,439,1,438,0.67%,0.23%
2020-01-01 00:06:40,5,4,21566,3256,18310,32.91%,15.10%
2020-01-01 00:06:40,5,5,10213,777,9436,15.58%,7.61%
2020-01-01 00:06:40,5,6,14850,1595,13255,22.66%,10.74%
2020-01-01 00:06:40,5,7,4172,147,4025,6.37%,3.52%
2020-01-01 00:06:40,5,8,3460,97,3363,5.28%,2.80%
2020-01-01 00:06:40,5,9,9633,708,8925,14.70%,7.35%
2020-01-01 00:06:40,5,10,881,6,875,1.34%,0.68%
2020-01-01 00:06:40,5,11,931,9,922,1.42%,0.97%
2020-01-01 00:06:40,5,12,8455,550,7905,12.90%,6.51%
2020-01-01 00:06:40,6,1,1045,6,1039,1.59%,0.57%
2020-01-01 00:06:40,6,2,1132,9,1123,1.73%,0.80%
2020-01-01 00:06:40,6,3,2085,28,2057,3.18%,1.34%
2020-01-01 00:06:40,6,4,1433,24,1409,2.19%,1.67%
2020-01-01 00:06:40,6,5,18180,2338,15842,27.74%,12.86%
2020-01-01 00:06:40,6,6,5152,195,4957,7.86%,3.78%
2020-01-01 00:06:40,6,7,3238,87,3151,4.94%,2.69%
2020-01-01 00:06:40,6,8,2621,55,2566,4.00%,2.10%
2020-01-01 00:06:40,6,9,10546,862,9684,16.09%,8.17%
2020-01-01 00:06:40,6,10,2623,72,2551,4.00%,2.74%
2020-01-01 00:06:40,6,11,453,3,450,0.69%,0.66%
2020-01-01 00:06:40,6,12,7861,487,7374,11.99%,6.20%
2020-01-01 00:06:40,7,1,338,3,335,0.52%,0.89%
2020-01-01 00:06:40,7,2,249,0,249,0.38%,0.00%
2020-01-01 00:06:40,7,3,1444,15,1429,2.20%,1.04%
2020-01-01 00:06:40,7,4,1376,18,1358,2.10%,1.31%
2020-01-01 00:06:40,7,5,7703,402,7301,11.75%,5.22%
2020-01-01 00:06:40,7,6,12303,1052,11251,18.77%,8.55%
2020-01-01 00:06:40,7,7,3198,67,3131,4.88%,2.10%
2020-01-01 00:06:40,7,8,1127,5,1122,1.72%,0.44%
2020-01-01 00:06:40,7,9,6194,273,5921,9.45%,4.41%
2020-01-01 00:06:40,7,10,1658,11,1647,2.53%,0.66%
2020-01-01 00:06:40,7,11,94,0,94,0.14%,0.00%
2020-01-01 00:06:40,7,12,4549,138,4411,6.94%,3.03%
2020-01-01 00:06:40,8,1,409,2,407,0.62%,0.49%
2020-01-01 00:06:40,8,2,121,1,120,0.18%,0.83%
2020-01-01 00:06:40,8,3,1713,23,1690,2.61%,1.34%
2020-01-01 00:06:40,8,4,2400,47,2353,3.66%,1.96%
2020-01-01 00:06:40,8,5,8383,530,7853,12.79%,6.32%
2020-01-01 00:06:40,8,6,16568,1970,14598,25.28%,11.89%
2020-01-01 00:06:40,8,7,5712,271,5441,8.72%,4.74%
2020-01-01 00:06:40,8,8,2679,63,2616,4.09%,2.35%
2020-01-01 00:06:40,8,9,6416,321,6095,9.79%,5.00%
2020-01-01 00:06:40,8,10,1690,16,1674,2.58%,0.95%
2020-01-01 00:06:40,8,11,148,0,148,0.23%,0.00%
2020-01-01 00:06:40,8,12,4538,170,4368,6.92%,3.75%
2020-01-01 00:06:40,9,1,347,0,347,0.53%,0.00%
2020-01-01 00:06:40,9,2,2871,76,2795,4.38%,2.65%
2020-01-01 00:06:40,9,3,1822,38,1784,2.78%,2.09%
2020-01-01 00:06:40,9,4,12107,986,11121,18.47%,8.14%
2020-01-01 00:06:40,9,5,452,1,451,0.69%,0.22%
2020-01-01 00:06:40,9,6,13010,1139,11871,19.85%,8.75%
2020-01-01 00:06:40,9,7,35062,7839,27223,53.50%,22.36%
2020-01-01 00:06:40,9,8,12862,1190,11672,19.63%,9.25%
2020-01-01 00:06:40,9,9,357,1,356,0.54%,0.28%
2020-01-01 00:06:40,9,10,5919,285,5634,9.03%,4.82%
2020-01-01 00:06:40,9,11,11428,966,10462,17.44%,8.45%
2020-01-01 00:06:40,9,12,5165,206,4959,7.88%,3.99%
2020-01-01 00:06:40,10,1,1164,277,887,1.78%,23.80%
2020-01-01 00:06:40,10,2,3628,360,3268,5.54%,9.92%
2020-01-01 00:06:40,10,3,2245,38,2207,3.43%,1.69%
2020-01-01 00:06:40,10,4,4047,995,3052,6.18%,24.59%
2020-01-01 00:06:40,10,5,577,1,576,0.88%,0.17%
2020-01-01 00:06:40,10,6,6068,1119,4949,9.26%,18.44%
2020-01-01 00:06:40,10,7,11524,1970,9554,17.58%,17.09%
2020-01-01 00:06:40,10,8,28279,7137,21142,43.15%,25.24%
2020-01-01 00:06:40,10,9,679,2,677,1.04%,0.29%
2020-01-01 00:06:40,10,10,2405,40,2365,3.67%,1.66%
2020-01-01 00:06:40,10,11,12442,1477,10965,18.98%,11.87%
2020-01-01 00:06:40,10,12,9335,1036,8299,14.24%,11.10%
2020-01-01 00:06:40,11,1,1916,28,1888,2.92%,1.46%
2020-01-01 00:06:40,11,2,3219,68,3151,4.91%,2.11%
2020-01-01 00:06:40,11,3,1136,7,1129,1.73%,0.62%
2020-01-01 00:06:40,11,4,3438,94,3344,5.25%,2.73%
2020-01-01 00:06:40,11,5,382,1,381,0.58%,0.26%
2020-01-01 00:06:40,11,6,4330,152,4178,6.61%,3.51%
2020-01-01 00:06:40,11,7,10420,791,9629,15.90%,7.59%
2020-01-01 00:06:40,11,8,23376,3757,19619,35.67%,16.07%
2020-01-01 00:06:40,11,9,221,0,221,0.34%,0.00%
2020-01-01 00:06:40,11,10,3373,104,3269,5.15%,3.08%
2020-01-01 00:06:40,11,11,9931,764,9167,15.15%,7.69%
2020-01-01 00:06:40,11,12,6338,315,6023,9.67%,4.97%
2020-01-01 00:06:40,12,1,15,0,15,0.02%,0.00%
2020-01-01 00:06:40,12,2,693,217,476,1.06%,31.31%
2020-01-01 00:06:40,12,3,2845,256,2589,4.34%,9.00%
2020-01-01 00:06:40,12,4,2487,61,2426,3.79%,2.45%
2020-01-01 00:06:40,12,5,10003,907,9096,15.26%,9.07%
2020-01-01 00:06:40,12,6,6046,262,5784,9.23%,4.33%
2020-01-01 00:06:40,12,7,3459,82,3377,5.28%,2.37%
2020-01-01 00:06:40,12,8,1268,282,986,1.93%,22.24%
2020-01-01 00:06:40,12,9,22483,4522,17961,34.31%,20.11%
2020-01-01 00:06:40,12,10,4362,401,3961,6.66%,9.19%
2020-01-01 00:06:40,12,11,1401,282,1119,2.14%,20.13%
2020-01-01 00:06:40,12,12,7397,1029,6368,11.29%,13.91%
2020-01-01 00:06:40,13,1,2256,38,2218,3.44%,1.68%
2020-01-01 00:06:40,13,2,2641,56,2585,4.03%,2.12%
2020-01-01 00:06:40,13,3,631,0,631,0.96%,0.00%
2020-01-01 00:06:40,13,4,4775,558,4217,7.29%,11.69%
2020-01-01 00:06:40,13,5,7255,866,6389,11.07%,11.94%
2020-01-01 00:06:40,13,6,5823,622,5201,8.89%,10.68%
2020-01-01 00:06:40,13,7,6292,305,5987,9.60%,4.85%
2020-01-01 00:06:40,13,8,8480,541,7939,12.94%,6.38%
2020-01-01 00:06:40,13,9,7541,900,6641,11.51%,11.93%
2020-01-01 00:06:40,13,10,28467,6013,22454,43.44%,21.12%
2020-01-01 00:06:40,13,11,18496,2738,15758,28.22%,14.80%
2020-01-01 00:06:40,13,12,9366,1040,8326,14.29%,11.10%
2020-01-01 00:06:40,14,1,420,2,418,0.64%,0.48%
2020-01-01 00:06:40,14,2,1709,21,1688,2.61%,1.23%
2020-01-01 00:06:40,14,3,1026,4,1022,1.57%,0.39%
2020-01-01 00:06:40,14,4,3748,102,3646,5.72%,2.72%
2020-01-01 00:06:40,14,5,1180,8,1172,1.80%,0.68%
2020-01-01 00:06:40,14,6,4056,118,3938,6.19%,2.91%
2020-01-01 00:06:40,14,7,11372,914,10458,17.35%,8.04%
2020-01-01 00:06:40,14,8,13305,1270,12035,20.30%,9.55%
2020-01-01 00:06:40,14,9,1482,12,1470,2.26%,0.81%
2020-01-01 00:06:40,14,10,3790,97,3693,5.78%,2.56%
2020-01-01 00:06:40,14,11,24735,4154,20581,37.74%,16.79%
2020-01-01 00:06:40,14,12,7453,391,7062,11.37%,5.25%
2020-01-01 00:06:40,15,1,398,0,398,0.61%,0.00%
2020-01-01 00:06:40,15,2,185,0,185,0.28%,0.00%
2020-01-01 00:06:40,15,3,3640,95,3545,5.55%,2.61%
2020-01-01 00:06:40,15,4,5291,212,5079,8.07%,4.01%
2020-01-01 00:06:40,15,5,10638,826,9812,16.23%,7.76%
2020-01-01 00:06:40,15,6,5570,229,5341,8.50%,4.11%
2020-01-01 00:06:40,15,7,3808,129,3679,5.81%,3.39%
2020-01-01 00:06:40,15,8,5756,269,5487,8.78%,4.67%
2020-01-01 00:06:40,15,9,10865,849,10016,16.58%,7.81%
2020-01-01 00:06:40,15,10,5065,203,4862,7.73%,4.01%
2020-01-01 00:06:40,15,11,10949,887,10062,16.71%,8.10%
2020-01-01 00:06:40,15,12,27607,5405,22202,42.12%,19.58%
2020-01-01 00:06:40,16,1,351,1,350,0.54%,0.28%
2020-01-01 00:06:40,16,2,234,0,234,0.36%,0.00%
2020-01-01 00:06:40,16,3,1015,9,1006,1.55%,0.89%
2020-01-01 00:06:40,16,4,4058,148,3910,6.19%,3.65%
2020-01-01 00:06:40,16,5,7296,527,6769,11.13%,7.22%
2020-01-01 00:06:40,16,6,4800,184,4616,7.32%,3.83%
2020-01-01 00:06:40,16,7,3674,97,3577,5.61%,2.64%
2020-01-01 00:06:40,16,8,7989,514,7475,12.19%,6.43%
2020-01-01 00:06:40,16,9,7648,570,7078,11.67%,7.45%
2020-01-01 00:06:40,16,10,1517,19,1498,2.31%,1.25%
2020-01-01 00:06:40,16,11,9771,766,9005,14.91%,7.84%
2020-01-01 00:06:40,16,12,25453,4527,20926,38.84%,17.79%
2020-01-01 00:06:50,1,1,17460,2219,15241,26.64%,12.71%
2020-01-01 00:06:50,1,2,7327,414,6913,11.18%,5.65%
2020-01-01 00:06:50,1,3,489,2,487,0.75%,0.41%
2020-01-01 00:06:50,1,4,9787,777,9010,14.93%,7.94%
2020-01-01 00:06:50,1,5,9418,716,8702,14.37%,7.60%
2020-01-01 00:06:50,1,6,9375,712,8663,14.31%,7.59%
2020-01-01 00:06:50,1,7,6827,367,6460,10.42%,5.38%
2020-01-01 00:06:50,1,8,6124,293,5831,9.34%,4.78%
2020-01-01 00:06:50,1,9,9325,698,8627,14.23%,7.49%
2020-01-01 00:06:50,1,10,5587,236,5351,8.53%,4.22%
2020-01-01 00:06:50,1,11,5670,246,5424,8.65%,4.34%
2020-01-01 00:06:50,1,12,9296,695,8601,14.18%,7.48%
2020-01-01 00:06:50,2,1,2602,52,2550,3.97%,2.00%
2020-01-01 00:06:50,2,2,25572,4345,21227,39.02%,16.99%
2020-01-01 00:06:50,2,3,19234,2520,16714,29.35%,13.10%
2020-01-01 00:06:50,2,4,2558,52,2506,3.90%,2.03%
2020-01-01 00:06:50,2,5,11714,988,10726,17.87%,8.43%
2020-01-01 00:06:50,2,6,40,0,40,0.06%,0.00%
2020-01-01 00:06:50,2,7,3719,119,3600,5.67%,3.20%
2020-01-01 00:06:50,2,8,2514,56,2458,3.84%,2.23%
2020-01-01 00:06:50,2,9,11598,968,10630,17.70%,8.35%
2020-01-01 00:06:50,2,10,1794,31,1763,2.74%,1.73%
2020-01-01 00:06:50,2,11,1830,31,1799,2.79%,1.69%
2020-01-01 00:06:50,2,12,11380,934,10446,17.36%,8.21%
2020-01-01 00:06:50,3,1,1197,9,1188,1.83%,0.75%
2020-01-01 00:06:50,3,2,24905,4242,20663,38.00%,17.03%
2020-01-01 00:06:50,3,3,70525,27417,43108,107.61%,38.88%
2020-01-01 00:06:50,3,4,6644,334,6310,10.14%,5.03%
2020-01-01 00:06:50,3,5,44368,12133,32235,67.70%,27.35%
2020-01-01 00:06:50,3,6,8152,482,7670,12.44%,5.91%
2020-01-01 00:06:50,3,7,20923,3067,17856,31.93%,14.66%
2020-01-01 00:06:50,3,8,17783,2241,15542,27.13%,12.60%
2020-01-01 00:06:50,3,9,35827,8221,27606,54.67%,22.95%
2020-01-01 00:06:50,3,10,8853,535,8318,13.51%,6.04%
2020-01-01 00:06:50,3,11,2109,36,2073,3.22%,1.71%
2020-01-01 00:06:50,3,12,24274,4014,20260,37.04%,16.54%
2020-01-01 00:06:50,4,1,455,1,454,0.69%,0.22%
2020-01-01 00:06:50,4,2,276,1,275,0.42%,0.36%
2020-01-01 00:06:50,4,3,1021,3,1018,1.56%,0.29%
2020-01-01 00:06:50,4,4,27026,4902,22124,41.24%,18.14%
2020-01-01 00:06:50,4,5,16872,1947,14925,25.74%,11.54%
2020-01-01 00:06:50,4,6,22914,3539,19375,34.96%,15.44%
2020-01-01 00:06:50,4,7,5020,190,4830,7.66%,3.78%
2020-01-01 00:06:50,4,8,2565,49,2516,3.91%,1.91%
2020-01-01 00:06:50,4,9,14931,1538,13393,22.78%,10.30%
2020-01-01 00:06:50,4,10,1762,20,1742,2.69%,1.14%
2020-01-01 00:06:50,4,11,148,0,148,0.23%,0.00%
2020-01-01 00:06:50,4,12,12553,1106,11447,19.15%,8.81%
2020-01-01 00:06:50,5,1,2967,65,2902,4.53%,2.19%
2020-01-01 00:06:50,5,2,797,6,791,1.22%,0.75%
2020-01-01 00:06:50,5,3,364,0,364,0.56%,0.00%
2020-01-01 00:06:50,5,4,22283,3459,18824,34.00%,15.52%
2020-01-01 00:06:50,5,5,10215,768,9447,15.59%,7.52%
2020-01-01 00:06:50,5,6,14926,1639,13287,22.78%,10.98%
2020-01-01 00:06:50,5,7,4260,155,4105,6.50%,3.64%
2020-01-01 00:06:50,5,8,3292,93,3199,5.02%,2.83%
2020-01-01 00:06:50,5,9,9757,704,9053,14.89%,7.22%
2020-01-01 00:06:50,5,10,963,8,955,1.47%,0.83%
2020-01-01 00:06:50,5,11,923,6,917,1.41%,0.65%
2020-01-01 00:06:50,5,12,8257,500,7757,12.60%,6.06%
2020-01-01 00:06:50,6,1,1058,18,1040,1.61%,1.70%
2020-01-01 00:06:50,6,2,1164,20,1144,1.78%,1.72%
2020-01-01 00:06:50,6,3,1905,34,1871,2.91%,1.78%
2020-01-01 00:06:50,6,4,1327,35,1292,2.02%,2.64%
2020-01-01 00:06:50,6,5,17711,2230,15481,27.02%,12.59%
2020-01-01 00:06:50,6,6,4369,181,4188,6.67%,4.14%
2020-01-01 00:06:50,6,7,2536,45,2491,3.87%,1.77%
2020-01-01 00:06:50,6,8,2038,25,2013,3.11%,1.23%
2020-01-01 00:06:50,6,9,11030,859,10171,16.83%,7.79%
2020-01-01 00:06:50,6,10,2461,35,2426,3.76%,1.42%
2020-01-01 00:06:50,6,11,365,3,362,0.56%,0.82%
2020-01-01 00:06:50,6,12,8528,514,8014,13.01%,6.03%
2020-01-01 00:06:50,7,1,373,5,368,0.57%,1.34%
2020-01-01 00:06:50,7,2,206,1,205,0.31%,0.49%
2020-01-01 00:06:50,7,3,1620,20,1600,2.47%,1.23%
2020-01-01 00:06:50,7,4,1330,19,1311,2.03%,1.43%
2020-01-01 00:06:50,7,5,7501,395,7106,11.45%,5.27%
2020-01-01 00:06:50,7,6,12201,1044,11157,18.62%,8.56%
2020-01-01 00:06:50,7,7,3333,86,3247,5.09%,2.58%
2020-01-01 00:06:50,7,8,1146,17,1129,1.75%,1.48%
2020-01-01 00:06:50,7,9,5804,221,5583,8.86%,3.81%
2020-01-01 00:06:50,7,10,1265,13,1252,1.93%,1.03%
2020-01-01 00:06:50,7,11,84,0,84,0.13%,0.00%
2020-01-01 00:06:50,7,12,4631,134,4497,7.07%,2.89%
2020-01-01 00:06:50,8,1,464,5,459,0.71%,1.08%
2020-01-01 00:06:50,8,2,108,0,108,0.16%,0.00%
2020-01-01 00:06:50,8,3,1671,24,1647,2.55%,1.44%
2020-01-01 00:06:50,8,4,2685,59,2626,4.10%,2.20%
2020-01-01 00:06:50,8,5,8237,475,7762,12.57%,5.77%
2020-01-01 00:06:50,8,6,16775,1934,14841,25.60%,11.53%
2020-01-01 00:06:50,8,7,5831,247,5584,8.90%,4.24%
2020-01-01 00:06:50,8,8,2580,50,2530,3.94%,1.94%
2020-01-01 00:06:50,8,9,6350,295,6055,9.69%,4.65%
2020-01-01 00:06:50,8,10,1866,31,1835,2.85%,1.66%
2020-01-01 00:06:50,8,11,220,0,220,0.34%,0.00%
2020-01-01 00:06:50,8,12,4296,132,4164,6.56%,3.07%
2020-01-01 00:06:50,9,1,770,2,768,1.17%,0.26%
2020-01-01 00:06:50,9,2,4157,118,4039,6.34%,2.84%
2020-01-01 00:06:50,9,3,2597,49,2548,3.96%,1.89%
2020-01-01 00:06:50,9,4,11179,929,10250,17.06%,8.31%
2020-01-01 00:06:50,9,5,483,1,482,0.74%,0.21%
2020-01-01 00:06:50,9,6,11939,1071,10868,18.22%,8.97%
2020-01-01 00:06:50,9,7,34312,7439,26873,52.36%,21.68%
2020-01-01 00:06:50,9,8,11461,890,10571,17.49%,7.77%
2020-01-01 00:06:50,9,9,371,1,370,0.57%,0.27%
2020-01-01 00:06:50,9,10,3086,70,3016,4.71%,2.27%
2020-01-01 00:06:50,9,11,9992,707,9285,15.25%,7.08%
2020-01-01 00:06:50,9,12,6475,300,6175,9.88%,4.63%
2020-01-01 00:06:50,10,1,1272,286,986,1.94%,22.48%
2020-01-01 00:06:50,10,2,2998,335,2663,4.57%,11.17%
2020-01-01 00:06:50,10,3,1552,21,1531,2.37%,1.35%
2020-01-01 00:06:50,10,4,4636,1059,3577,7.07%,22.84%
2020-01-01 00:06:50,10,5,525,3,522,0.80%,0.57%
2020-01-01 00:06:50,10,6,6599,1179,5420,10.07%,17.87%
2020-01-01 00:06:50,10,7,11353,1991,9362,17.32%,17.54%
2020-01-01 00:06:50,10,8,28110,7055,21055,42.89%,25.10%
2020-01-01 00:06:50,10,9,576,2,574,0.88%,0.35%
2020-01-01 00:06:50,10,10,2170,37,2133,3.31%,1.71%
2020-01-01 00:06:50,10,11,11516,1298,10218,17.57%,11.27%
2020-01-01 00:06:50,10,12,8764,908,7856,13.37%,10.36%
2020-01-01 00:06:50,11,1,1969,29,1940,3.00%,1.47%
2020-01-01 00:06:50,11,2,3142,77,3065,4.79%,2.45%
2020-01-01 00:06:50,11,3,1011,9,1002,1.54%,0.89%
2020-01-01 00:06:50,11,4,4805,175,4630,7.33%,3.64%
2020-01-01 00:06:50,11,5,745,2,743,1.14%,0.27%
2020-01-01 00:06:50,11,6,5975,269,5706,9.12%,4.50%
2020-01-01 00:06:50,11,7,12115,1111,11004,18.49%,9.17%
2020-01-01 00:06:50,11,8,24946,4292,20654,38.06%,17.21%
2020-01-01 00:06:50,11,9,165,0,165,0.25%,0.00%
2020-01-01 00:06:50,11,10,3159,77,3082,4.82%,2.44%
2020-01-01 00:06:50,11,11,10142,751,9391,15.48%,7.40%
2020-01-01 00:06:50,11,12,6728,357,6371,10.27%,5.31%
2020-01-01 00:06:50,12,1,90,0,90,0.14%,0.00%
2020-01-01 00:06:50,12,2,736,224,512,1.12%,30.43%
2020-01-01 00:06:50,12,3,2671,270,2401,4.08%,10.11%
2020-01-01 00:06:50,12,4,2526,49,2477,3.85%,1.94%
2020-01-01 00:06:50,12,5,10214,973,9241,15.59%,9.53%
2020-01-01 00:06:50,12,6,5827,276,5551,8.89%,4.74%
2020-01-01 00:06:50,12,7,3181,83,3098,4.85%,2.61%
2020-01-01 00:06:50,12,8,1168,239,929,1.78%,20.46%
2020-01-01 00:06:50,12,9,22498,4474,18024,34.33%,19.89%
2020-01-01 00:06:50,12,10,3796,325,3471,5.79%,8.56%
2020-01-01 00:06:50,12,11,1360,239,1121,2.08%,17.57%
2020-01-01 00:06:50,12,12,7563,1125,6438,11.54%,14.88%
2020-01-01 00:06:50,13,1,2325,33,2292,3.55%,1.42%
2020-01-01 00:06:50,13,2,2668,47,2621,4.07%,1.76%
2020-01-01 00:06:50,13,3,621,4,617,0.95%,0.64%
2020-01-01 00:06:50,13,4,4864,527,4337,7.42%,10.83%
2020-01-01 00:06:50,13,5,7267,856,6411,11.09%,11.78%
2020-01-01 00:06:50,13,6,5881,605,5276,8.97%,10.29%
2020-01-01 00:06:50,13,7,5352,209,5143,8.17%,3.91%
2020-01-01 00:06:50,13,8,7431,397,7034,11.34%,5.34%
2020-01-01 00:06:50,13,9,7692,896,6796,11.74%,11.65%
2020-01-01 00:06:50,13,10,28961,6123,22838,44.19%,21.14%
2020-01-01 00:06:50,13,11,18324,2596,15728,27.96%,14.17%
2020-01-01 00:06:50,13,12,10213,1077,9136,15.58%,10.55%
2020-01-01 00:06:50,14,1,336,0,336,0.51%,0.00%
2020-01-01 00:06:50,14,2,1417,16,1401,2.16%,1.13%
2020-01-01 00:06:50,14,3,952,5,947,1.45%,0.53%
2020-01-01 00:06:50,14,4,4542,158,4384,6.93%,3.48%
2020-01-01 00:06:50,14,5,1455,16,1439,2.22%,1.10%
2020-01-01 00:06:50,14,6,4909,183,4726,7.49%,3.73%
2020-01-01 00:06:50,14,7,11760,991,10769,17.94%,8.43%
2020-01-01 00:06:50,14,8,13715,1323,12392,20.93%,9.65%
2020-01-01 00:06:50,14,9,1787,26,1761,2.73%,1.45%
2020-01-01 00:06:50,14,10,4225,138,4087,6.45%,3.27%
2020-01-01 00:06:50,14,11,26646,4718,21928,40.66%,17.71%
2020-01-01 00:06:50,14,12,8415,515,7900,12.84%,6.12%
2020-01-01 00:06:50,15,1,499,2,497,0.76%,0.40%
2020-01-01 00:06:50,15,2,199,0,199,0.30%,0.00%
2020-01-01 00:06:50,15,3,3906,143,3763,5.96%,3.66%
2020-01-01 00:06:50,15,4,5367,241,5126,8.19%,4.49%
2020-01-01 00:06:50,15,5,11012,912,10100,16.80%,8.28%
2020-01-01 00:06:50,15,6,5603,261,5342,8.55%,4.66%
2020-01-01 00:06:50,15,7,4026,97,3929,6.14%,2.41%
2020-01-01 00:06:50,15,8,6081,284,5797,9.28%,4.67%
2020-01-01 00:06:50,15,9,11241,945,10296,17.15%,8.41%
2020-01-01 00:06:50,15,10,5564,265,5299,8.49%,4.76%
2020-01-01 00:06:50,15,11,11814,1043,10771,18.03%,8.83%
2020-01-01 00:06:50,15,12,29511,6068,23443,45.03%,20.56%
2020-01-01 00:06:50,16,1,364,2,362,0.56%,0.55%
2020-01-01 00:06:50,16,2,235,4,231,0.36%,1.70%
2020-01-01 00:06:50,16,3,1196,9,1187,1.82%,0.75%
2020-01-01 00:06:50,16,4,4304,144,4160,6.57%,3.35%
2020-01-01 00:06:50,16,5,7508,534,6974,11.46%,7.11%
2020-01-01 00:06:50,16,6,5079,230,4849,7.75%,4.53%
2020-01-01 00:06:50,16,7,3759,110,3649,5.74%,2.93%
2020-01-01 00:06:50,16,8,7311,479,6832,11.16%,6.55%
2020-01-01 00:06:50,16,9,7870,578,7292,12.01%,7.34%
2020-01-01 00:06:50,16,10,1693,45,1648,2.58%,2.66%
2020-01-01 00:06:50,16,11,9229,724,8505,14.08%,7.84%
2020-01-01 00:06:50,16,12,25310,4546,20764,38.62%,17.96%
2020-01-01 00:07:00,1,1,16983,2087,14896,25.91%,12.29%
2020-01-01 00:07:00,1,2,6509,324,6185,9.93%,4.98%
2020-01-01 00:07:00,1,3,665,5,660,1.01%,0.75%
2020-01-01 00:07:00,1,4,9939,788,9151,15.17%,7.93%
2020-01-01 00:07:00,1,5,9671,744,8927,14.76%,7.69%
2020-01-01 00:07:00,1,6,9630,742,8888,14.69%,7.71%
2020-01-01 00:07:00,1,7,5818,253,5565,8.88%,4.35%
2020-01-01 00:07:00,1,8,4600,157,4443,7.02%,3.41%
2020-01-01 00:07:00,1,9,9569,731,8838,14.60%,7.64%
2020-01-01 00:07:00,1,10,4078,123,3955,6.22%,3.02%
2020-01-01 00:07:00,1,11,4151,127,4024,6.33%,3.06%
2020-01-01 00:07:00,1,12,9541,728,8813,14.56%,7.63%
2020-01-01 00:07:00,2,1,1719,9,1710,2.62%,0.52%
2020-01-01 00:07:00,2,2,24669,4116,20553,37.64%,16.68%
2020-01-01 00:07:00,2,3,18683,2415,16268,28.51%,12.93%
2020-01-01 00:07:00,2,4,1651,7,1644,2.52%,0.42%
2020-01-01 00:07:00,2,5,12017,1022,10995,18.34%,8.50%
2020-01-01 00:07:00,2,6,45,0,45,0.07%,0.00%
2020-01-01 00:07:00,2,7,4258,158,4100,6.50%,3.71%
2020-01-01 00:07:00,2,8,3107,79,3028,4.74%,2.54%
2020-01-01 00:07:00,2,9,11938,1009,10929,18.22%,8.45%
2020-01-01 00:07:00,2,10,2355,51,2304,3.59%,2.17%
2020-01-01 00:07:00,2,11,2401,53,2348,3.66%,2.21%
2020-01-01 00:07:00,2,12,11810,989,10821,18.02%,8.37%
2020-01-01 00:07:00,3,1,1401,7,1394,2.14%,0.50%
2020-01-01 00:07:00,3,2,24147,3972,20175,36.85%,16.45%
2020-01-01 00:07:00,3,3,70963,27712,43251,108.28%,39.05%
2020-01-01 00:07:00,3,4,8437,535,7902,12.87%,6.34%
2020-01-01 00:07:00,3,5,44674,12465,32209,68.17%,27.90%
2020-01-01 00:07:00,3,6,9800,721,9079,14.95%,7.36%
2020-01-01 00:07:00,3,7,18565,2444,16121,28.33%,13.16%
2020-01-01 00:07:00,3,8,15331,1759,13572,23.39%,11.47%
2020-01-01 00:07:00,3,9,34403,7832,26571,52.49%,22.77%
2020-01-01 00:07:00,3,10,7030,372,6658,10.73%,5.29%
2020-01-01 00:07:00,3,11,1618,24,1594,2.47%,1.48%
2020-01-01 00:07:00,3,12,25226,4462,20764,38.49%,17.69%
2020-01-01 00:07:00,4,1,569,2,567,0.87%,0.35%
2020-01-01 00:07:00,4,2,346,2,344,0.53%,0.58%
2020-01-01 00:07:00,4,3,1020,8,1012,1.56%,0.78%
2020-01-01 00:07:00,4,4,28993,5559,23434,44.24%,19.17%
2020-01-01 00:07:00,4,5,18049,2341,15708,27.54%,12.97%
2020-01-01 00:07:00,4,6,24813,4171,20642,37.86%,16.81%
2020-01-01 00:07:00,4,7,5545,201,5344,8.46%,3.62%
2020-01-01 00:07:00,4,8,3122,57,3065,4.76%,1.83%
2020-01-01 00:07:00,4,9,15809,1823,13986,24.12%,11.53%
2020-01-01 00:07:00,4,10,1956,43,1913,2.98%,2.20%
2020-01-01 00:07:00,4,11,179,0,179,0.27%,0.00%
2020-01-01 00:07:00,4,12,13180,1286,11894,20.11%,9.76%
2020-01-01 00:07:00,5,1,2831,60,2771,4.32%,2.12%
2020-01-01 00:07:00,5,2,780,3,777,1.19%,0.38%
2020-01-01 00:07:00,5,3,479,1,478,0.73%,0.21%
2020-01-01 00:07:00,5,4,24436,4060,20376,37.29%,16.61%
2020-01-01 00:07:00,5,5,9987,746,9241,15.24%,7.47%
2020-01-01 00:07:00,5,6,17467,2187,15280,26.65%,12.52%
2020-01-01 00:07:00,5,7,6977,389,6588,10.65%,5.58%
2020-01-01 00:07:00,5,8,3691,147,3544,5.63%,3.98%
2020-01-01 00:07:00,5,9,9363,676,8687,14.29%,7.22%
2020-01-01 00:07:00,5,10,1457,21,1436,2.22%,1.44%
2020-01-01 00:07:00,5,11,800,11,789,1.22%,1.38%
2020-01-01 00:07:00,5,12,7657,445,7212,11.68%,5.81%
2020-01-01 00:07:00,6,1,1084,6,1078,1.65%,0.55%
2020-01-01 00:07:00,6,2,1181,8,1173,1.80%,0.68%
2020-01-01 00:07:00,6,3,1847,23,1824,2.82%,1.25%
2020-01-01 00:07:00,6,4,1331,10,1321,2.03%,0.75%
2020-01-01 00:07:00,6,5,16860,1978,14882,25.73%,11.73%
2020-01-01 00:07:00,6,6,4352,121,4231,6.64%,2.78%
2020-01-01 00:07:00,6,7,2487,49,2438,3.79%,1.97%
2020-01-01 00:07:00,6,8,2019,39,1980,3.08%,1.93%
2020-01-01 00:07:00,6,9,10296,770,9526,15.71%,7.48%
2020-01-01 00:07:00,6,10,2741,51,2690,4.18%,1.86%
2020-01-01 00:07:00,6,11,397,0,397,0.61%,0.00%
2020-01-01 00:07:00,6,12,7505,419,7086,11.45%,5.58%
2020-01-01 00:07:00,7,1,421,5,416,0.64%,1.19%
2020-01-01 00:07:00,7,2,159,1,158,0.24%,0.63%
2020-01-01 00:07:00,7,3,903,7,896,1.38%,0.78%
2020-01-01 00:07:00,7,4,2299,32,2267,3.51%,1.39%
2020-01-01 00:07:00,7,5,7839,443,7396,11.96%,5.65%
2020-01-01 00:07:00,7,6,13718,1333,12385,20.93%,9.72%
2020-01-01 00:07:00,7,7,3545,72,3473,5.41%,2.03%
2020-01-01 00:07:00,7,8,1337,17,1320,2.04%,1.27%
2020-01-01 00:07:00,7,9,6849,335,6514,10.45%,4.89%
2020-01-01 00:07:00,7,10,1637,18,1619,2.50%,1.10%
2020-01-01 00:07:00,7,11,76,0,76,0.12%,0.00%
2020-01-01 00:07:00,7,12,5237,209,5028,7.99%,3.99%
2020-01-01 00:07:00,8,1,637,10,627,0.97%,1.57%
2020-01-01 00:07:00,8,2,101,0,101,0.15%,0.00%
2020-01-01 00:07:00,8,3,1743,27,1716,2.66%,1.55%
2020-01-01 00:07:00,8,4,2716,75,2641,4.14%,2.76%
2020-01-01 00:07:00,8,5,8831,559,8272,13.48%,6.33%
2020-01-01 00:07:00,8,6,19797,2677,17120,30.21%,13.52%
2020-01-01 00:07:00,8,7,8155,468,7687,12.44%,5.74%
2020-01-01 00:07:00,8,8,4936,173,4763,7.53%,3.50%
2020-01-01 00:07:00,8,9,6839,333,6506,10.44%,4.87%
2020-01-01 00:07:00,8,10,1750,29,1721,2.67%,1.66%
2020-01-01 00:07:00,8,11,155,0,155,0.24%,0.00%
2020-01-01 00:07:00,8,12,4899,161,4738,7.48%,3.29%
2020-01-01 00:07:00,9,1,696,4,692,1.06%,0.57%
2020-01-01 00:07:00,9,2,4258,131,4127,6.50%,3.08%
2020-01-01 00:07:00,9,3,2956,63,2893,4.51%,2.13%
2020-01-01 00:07:00,9,4,7850,456,7394,11.98%,5.81%
2020-01-01 00:07:00,9,5,361,1,360,0.55%,0.28%
2020-01-01 00:07:00,9,6,8857,571,8286,13.51%,6.45%
2020-01-01 00:07:00,9,7,29629,5860,23769,45.21%,19.78%
2020-01-01 00:07:00,9,8,9835,787,9048,15.01%,8.00%
2020-01-01 00:07:00,9,9,186,0,186,0.28%,0.00%
2020-01-01 00:07:00,9,10,2579,131,2448,3.94%,5.08%
2020-01-01 00:07:00,9,11,8398,610,7788,12.81%,7.26%
2020-01-01 00:07:00,9,12,5311,209,5102,8.10%,3.94%
2020-01-01 00:07:00,10,1,1363,291,1072,2.08%,21.35%
2020-01-01 00:07:00,10,2,3025,336,2689,4.62%,11.11%
2020-01-01 00:07:00,10,3,1408,7,1401,2.15%,0.50%
2020-01-01 00:07:00,10,4,4134,1062,3072,6.31%,25.69%
2020-01-01 00:07:00,10,5,727,37,690,1.11%,5.09%
2020-01-01 00:07:00,10,6,6269,1243,5026,9.57%,19.83%
2020-01-01 00:07:00,10,7,11003,1961,9042,16.79%,17.82%
2020-01-01 00:07:00,10,8,27990,7055,20935,42.71%,25.21%
2020-01-01 00:07:00,10,9,490,0,490,0.75%,0.00%
2020-01-01 00:07:00,10,10,2028,23,2005,3.09%,1.13%
2020-01-01 00:07:00,10,11,12835,1457,11378,19.58%,11.35%
2020-01-01 00:07:00,10,12,10146,1032,9114,15.48%,10.17%
2020-01-01 00:07:00,11,1,2135,29,2106,3.26%,1.36%
2020-01-01 00:07:00,11,2,3375,100,3275,5.15%,2.96%
2020-01-01 00:07:00,11,3,1013,10,1003,1.55%,0.99%
2020-01-01 00:07:00,11,4,3604,101,3503,5.50%,2.80%
2020-01-01 00:07:00,11,5,649,3,646,0.99%,0.46%
2020-01-01 00:07:00,11,6,4882,186,4696,7.45%,3.81%
2020-01-01 00:07:00,11,7,10467,791,9676,15.97%,7.56%
2020-01-01 00:07:00,11,8,24492,4046,20446,37.37%,16.52%
2020-01-01 00:07:00,11,9,220,0,220,0.34%,0.00%
2020-01-01 00:07:00,11,10,3479,91,3388,5.31%,2.62%
2020-01-01 00:07:00,11,11,10828,853,9975,16.52%,7.88%
2020-01-01 00:07:00,11,12,7030,380,6650,10.73%,5.41%
2020-01-01 00:07:00,12,1,93,0,93,0.14%,0.00%
2020-01-01 00:07:00,12,2,648,192,456,0.99%,29.63%
2020-01-01 00:07:00,12,3,2576,235,2341,3.93%,9.12%
2020-01-01 00:07:00,12,4,2735,61,2674,4.17%,2.23%
2020-01-01 00:07:00,12,5,9344,819,8525,14.26%,8.76%
2020-01-01 00:07:00,12,6,5957,262,5695,9.09%,4.40%
2020-01-01 00:07:00,12,7,3064,73,2991,4.68%,2.38%
2020-01-01 00:07:00,12,8,1292,243,1049,1.97%,18.81%
2020-01-01 00:07:00,12,9,22021,4389,17632,33.60%,19.93%
2020-01-01 00:07:00,12,10,4019,344,3675,6.13%,8.56%
2020-01-01 00:07:00,12,11,1458,247,1211,2.22%,16.94%
2020-01-01 00:07:00,12,12,8169,1302,6867,12.46%,15.94%
2020-01-01 00:07:00,13,1,2167,37,2130,3.31%,1.71%
2020-01-01 00:07:00,13,2,2577,59,2518,3.93%,2.29%
2020-01-01 00:07:00,13,3,592,4,588,0.90%,0.68%
2020-01-01 00:07:00,13,4,4258,588,3670,6.50%,13.81%
2020-01-01 00:07:00,13,5,6879,898,5981,10.50%,13.05%
2020-01-01 00:07:00,13,6,5387,658,4729,8.22%,12.21%
2020-01-01 00:07:00,13,7,4928,179,4749,7.52%,3.63%
2020-01-01 00:07:00,13,8,7321,399,6922,11.17%,5.45%
2020-01-01 00:07:00,13,9,7242,936,6306,11.05%,12.92%
2020-01-01 00:07:00,13,10,27699,5771,21928,42.27%,20.83%
2020-01-01 00:07:00,13,11,18094,2602,15492,27.61%,14.38%
2020-01-01 00:07:00,13,12,10271,1114,9157,15.67%,10.85%
2020-01-01 00:07:00,14,1,365,2,363,0.56%,0.55%
2020-01-01 00:07:00,14,2,1564,17,1547,2.39%,1.09%
2020-01-01 00:07:00,14,3,1052,9,1043,1.61%,0.86%
2020-01-01 00:07:00,14,4,3885,101,3784,5.93%,2.60%
2020-01-01 00:07:00,14,5,1277,15,1262,1.95%,1.17%
2020-01-01 00:07:00,14,6,4243,119,4124,6.47%,2.80%
2020-01-01 00:07:00,14,7,11774,981,10793,17.97%,8.33%
2020-01-01 00:07:00,14,8,13600,1286,12314,20.75%,9.46%
2020-01-01 00:07:00,14,9,1596,24,1572,2.44%,1.50%
2020-01-01 00:07:00,14,10,4275,149,4126,6.52%,3.49%
2020-01-01 00:07:00,14,11,26552,4767,21785,40.52%,17.95%
2020-01-01 00:07:00,14,12,8348,534,7814,12.74%,6.40%
2020-01-01 00:07:00,15,1,561,2,559,0.86%,0.36%
2020-01-01 00:07:00,15,2,117,0,117,0.18%,0.00%
2020-01-01 00:07:00,15,3,4066,116,3950,6.20%,2.85%
2020-01-01 00:07:00,15,4,6009,310,5699,9.17%,5.16%
2020-01-01 00:07:00,15,5,11490,982,10508,17.53%,8.55%
2020-01-01 00:07:00,15,6,6313,351,5962,9.63%,5.56%
2020-01-01 00:07:00,15,7,3605,116,3489,5.50%,3.22%
2020-01-01 00:07:00,15,8,5694,259,5435,8.69%,4.55%
2020-01-01 00:07:00,15,9,11712,1013,10699,17.87%,8.65%
2020-01-01 00:07:00,15,10,4983,262,4721,7.60%,5.26%
2020-01-01 00:07:00,15,11,10841,905,9936,16.54%,8.35%
2020-01-01 00:07:00,15,12,29458,6083,23375,44.95%,20.65%
2020-01-01 00:07:00,16,1,375,0,375,0.57%,0.00%
2020-01-01 00:07:00,16,2,238,0,238,0.36%,0.00%
2020-01-01 00:07:00,16,3,1317,11,1306,2.01%,0.84%
2020-01-01 00:07:00,16,4,4170,116,4054,6.36%,2.78%
2020-01-01 00:07:00,16,5,7774,515,7259,11.86%,6.62%
2020-01-01 00:07:00,16,6,5000,177,4823,7.63%,3.54%
2020-01-01 00:07:00,16,7,3311,80,3231,5.05%,2.42%
2020-01-01 00:07:00,16,8,7267,455,6812,11.09%,6.26%
2020-01-01 00:07:00,16,9,8300,571,7729,12.66%,6.88%
2020-01-01 00:07:00,16,10,1615,12,1603,2.46%,0.74%
2020-01-01 00:07:00,16,11,9076,682,8394,13.85%,7.51%
2020-01-01 00:07:00,16,12,25661,4529,21132,39.16%,17.65%
2020-01-01 00:07:10,1,1,25501,4472,21029,38.91%,17.54%
2020-01-01 00:07:10,1,2,12616,1151,11465,19.25%,9.12%
2020-01-01 00:07:10,1,3,2002,35,1967,3.05%,1.75%
2020-01-01 00:07:10,1,4,12323,1153,11170,18.80%,9.36%
2020-01-01 00:07:10,1,5,11897,1059,10838,18.15%,8.90%
2020-01-01 00:07:10,1,6,11855,1065,10790,18.09%,8.98%
2020-01-01 00:07:10,1,7,10586,828,9758,16.15%,7.82%
2020-01-01 00:07:10,1,8,9788,714,9074,14.94%,7.29%
2020-01-01 00:07:10,1,9,11808,1050,10758,18.02%,8.89%
2020-01-01 00:07:10,1,10,9220,626,8594,14.07%,6.79%
2020-01-01 00:07:10,1,11,9307,637,8670,14.20%,6.84%
2020-01-01 00:07:10,1,12,11779,1043,10736,17.97%,8.85%
2020-01-01 00:07:10,2,1,821,5,816,1.25%,0.61%
2020-01-01 00:07:10,2,2,23132,3564,19568,35.30%,15.41%
2020-01-01 00:07:10,2,3,18172,2281,15891,27.73%,12.55%
2020-01-01 00:07:10,2,4,745,3,742,1.14%,0.40%
2020-01-01 00:07:10,2,5,11899,987,10912,18.16%,8.29%
2020-01-01 00:07:10,2,6,40,2,38,0.06%,5.00%
2020-01-01 00:07:10,2,7,4124,120,4004,6.29%,2.91%
2020-01-01 00:07:10,2,8,2484,45,2439,3.79%,1.81%
2020-01-01 00:07:10,2,9,11848,977,10871,18.08%,8.25%
2020-01-01 00:07:10,2,10,1615,22,1593,2.46%,1.36%
2020-01-01 00:07:10,2,11,1624,23,1601,2.48%,1.42%
2020-01-01 00:07:10,2,12,11717,957,10760,17.88%,8.17%
2020-01-01 00:07:10,3,1,1355,20,1335,2.07%,1.48%
2020-01-01 00:07:10,3,2,25376,4426,20950,38.72%,17.44%
2020-01-01 00:07:10,3,3,73328,29133,44195,111.89%,39.73%
2020-01-01 00:07:10,3,4,11902,923,10979,18.16%,7.75%
2020-01-01 00:07:10,3,5,47182,13562,33620,71.99%,28.74%
2020-01-01 00:07:10,3,6,12719,1065,11654,19.41%,8.37%
2020-01-01 00:07:10,3,7,22378,3510,18868,34.15%,15.69%
2020-01-01 00:07:10,3,8,18893,2574,16319,28.83%,13.62%
2020-01-01 00:07:10,3,9,33972,7491,26481,51.84%,22.05%
2020-01-01 00:07:10,3,10,7820,364,7456,11.93%,4.65%
2020-01-01 00:07:10,3,11,2294,50,2244,3.50%,2.18%
2020-01-01 00:07:10,3,12,23113,3642,19471,35.27%,15.76%
2020-01-01 00:07:10,4,1,625,1,624,0.95%,0.16%
2020-01-01 00:07:10,4,2,428,1,427,0.65%,0.23%
2020-01-01 00:07:10,4,3,910,4,906,1.39%,0.44%
2020-01-01 00:07:10,4,4,28427,5399,23028,43.38%,18.99%
2020-01-01 00:07:10,4,5,17493,2195,15298,26.69%,12.55%
2020-01-01 00:07:10,4,6,24208,4005,20203,36.94%,16.54%
2020-01-01 00:07:10,4,7,5395,209,5186,8.23%,3.87%
2020-01-01 00:07:10,4,8,3385,79,3306,5.17%,2.33%
2020-01-01 00:07:10,4,9,15195,1659,13536,23.19%,10.92%
2020-01-01 00:07:10,4,10,2397,58,2339,3.66%,2.42%
2020-01-01 00:07:10,4,11,211,0,211,0.32%,0.00%
2020-01-01 00:07:10,4,12,12199,1068,11131,18.61%,8.75%
2020-01-01 00:07:10,5,1,2771,62,2709,4.23%,2.24%
2020-01-01 00:07:10,5,2,704,4,700,1.07%,0.57%
2020-01-01 00:07:10,5,3,496,2,494,0.76%,0.40%
2020-01-01 00:07:10,5,4,24575,4112,20463,37.50%,16.73%
2020-01-01 00:07:10,5,5,9304,641,8663,14.20%,6.89%
2020-01-01 00:07:10,5,6,17684,2225,15459,26.98%,12.58%
2020-01-01 00:07:10,5,7,7941,500,7441,12.12%,6.30%
2020-01-01 00:07:10,5,8,3217,93,3124,4.91%,2.89%
2020-01-01 00:07:10,5,9,8620,551,8069,13.15%,6.39%
2020-01-01 00:07:10,5,10,1152,14,1138,1.76%,1.22%
2020-01-01 00:07:10,5,11,610,5,605,0.93%,0.82%
2020-01-01 00:07:10,5,12,7311,414,6897,11.16%,5.66%
2020-01-01 00:07:10,6,1,1113,8,1105,1.70%,0.72%
2020-01-01 00:07:10,6,2,1199,10,1189,1.83%,0.83%
2020-01-01 00:07:10,6,3,1708,24,1684,2.61%,1.41%
2020-01-01 00:07:10,6,4,1162,5,1157,1.77%,0.43%
2020-01-01 00:07:10,6,5,14105,1436,12669,21.52%,10.18%
2020-01-01 00:07:10,6,6,6279,272,6007,9.58%,4.33%
2020-01-01 00:07:10,6,7,4624,175,4449,7.06%,3.78%
2020-01-01 00:07:10,6,8,4226,145,4081,6.45%,3.43%
2020-01-01 00:07:10,6,9,5893,261,5632,8.99%,4.43%
2020-01-01 00:07:10,6,10,1972,30,1942,3.01%,1.52%
2020-01-01 00:07:10,6,11,510,2,508,0.78%,0.39%
2020-01-01 00:07:10,6,12,3858,126,3732,5.89%,3.27%
2020-01-01 00:07:10,7,1,356,2,354,0.54%,0.56%
2020-01-01 00:07:10,7,2,141,0,141,0.22%,0.00%
2020-01-01 00:07:10,7,3,623,4,619,0.95%,0.64%
2020-01-01 00:07:10,7,4,2304,51,2253,3.52%,2.21%
2020-01-01 00:07:10,7,5,6861,367,6494,10.47%,5.35%
2020-01-01 00:07:10,7,6,13157,1269,11888,20.08%,9.65%
2020-01-01 00:07:10,7,7,3941,121,3820,6.01%,3.07%
2020-01-01 00:07:10,7,8,1687,23,1664,2.57%,1.36%
2020-01-01 00:07:10,7,9,6177,299,5878,9.43%,4.84%
2020-01-01 00:07:10,7,10,1319,7,1312,2.01%,0.53%
2020-01-01 00:07:10,7,11,107,0,107,0.16%,0.00%
2020-01-01 00:07:10,7,12,4856,195,4661,7.41%,4.02%
2020-01-01 00:07:10,8,1,610,2,608,0.93%,0.33%
2020-01-01 00:07:10,8,2,84,0,84,0.13%,0.00%
2020-01-01 00:07:10,8,3,1899,19,1880,2.90%,1.00%
2020-01-01 00:07:10,8,4,2803,66,2737,4.28%,2.35%
2020-01-01 00:07:10,8,5,8833,556,8277,13.48%,6.29%
2020-01-01 00:07:10,8,6,16494,1888,14606,25.17%,11.45%
2020-01-01 00:07:10,8,7,4706,165,4541,7.18%,3.51%
2020-01-01 00:07:10,8,8,1958,31,1927,2.99%,1.58%
2020-01-01 00:07:10,8,9,6611,334,6277,10.09%,5.05%
2020-01-01 00:07:10,8,10,1857,27,1830,2.83%,1.45%
2020-01-01 00:07:10,8,11,137,0,137,0.21%,0.00%
2020-01-01 00:07:10,8,12,4740,178,4562,7.23%,3.76%
2020-01-01 00:07:10,9,1,567,4,563,0.87%,0.71%
2020-01-01 00:07:10,9,2,1905,34,1871,2.91%,1.78%
2020-01-01 00:07:10,9,3,1074,14,1060,1.64%,1.30%
2020-01-01 00:07:10,9,4,6180,254,5926,9.43%,4.11%
2020-01-01 00:07:10,9,5,504,0,504,0.77%,0.00%
2020-01-01 00:07:10,9,6,7460,385,7075,11.38%,5.16%
2020-01-01 00:07:10,9,7,27933,5127,22806,42.62%,18.35%
2020-01-01 00:07:10,9,8,12289,1044,11245,18.75%,8.50%
2020-01-01 00:07:10,9,9,277,0,277,0.42%,0.00%
2020-01-01 00:07:10,9,10,5614,230,5384,8.57%,4.10%
2020-01-01 00:07:10,9,11,11409,910,10499,17.41%,7.98%
2020-01-01 00:07:10,9,12,5432,212,5220,8.29%,3.90%
2020-01-01 00:07:10,10,1,1500,286,1214,2.29%,19.07%
2020-01-01 00:07:10,10,2,4456,409,4047,6.80%,9.18%
2020-01-01 00:07:10,10,3,2778,63,2715,4.24%,2.27%
2020-01-01 00:07:10,10,4,3588,957,2631,5.47%,26.67%
2020-01-01 00:07:10,10,5,1023,113,910,1.56%,11.05%
2020-01-01 00:07:10,10,6,5774,1171,4603,8.81%,20.28%
2020-01-01 00:07:10,10,7,11701,2088,9613,17.85%,17.84%
2020-01-01 00:07:10,10,8,29884,7610,22274,45.60%,25.47%
2020-01-01 00:07:10,10,9,584,1,583,0.89%,0.17%
2020-01-01 00:07:10,10,10,2181,30,2151,3.33%,1.38%
2020-01-01 00:07:10,10,11,13112,1512,11600,20.01%,11.53%
2020-01-01 00:07:10,10,12,10135,1027,9108,15.46%,10.13%
2020-01-01 00:07:10,11,1,2029,36,1993,3.10%,1.77%
2020-01-01 00:07:10,11,2,3063,82,2981,4.67%,2.68%
2020-01-01 00:07:10,11,3,820,10,810,1.25%,1.22%
2020-01-01 00:07:10,11,4,5577,241,5336,8.51%,4.32%
2020-01-01 00:07:10,11,5,203,1,202,0.31%,0.49%
2020-01-01 00:07:10,11,6,6574,346,6228,10.03%,5.26%
2020-01-01 00:07:10,11,7,12533,1279,11254,19.12%,10.21%
2020-01-01 00:07:10,11,8,26429,4913,21516,40.33%,18.59%
2020-01-01 00:07:10,11,9,204,0,204,0.31%,0.00%
2020-01-01 00:07:10,11,10,2925,72,2853,4.46%,2.46%
2020-01-01 00:07:10,11,11,10224,764,9460,15.60%,7.47%
2020-01-01 00:07:10,11,12,6739,330,6409,10.28%,4.90%
2020-01-01 00:07:10,12,1,132,0,132,0.20%,0.00%
2020-01-01 00:07:10,12,2,510,110,400,0.78%,21.57%
2020-01-01 00:07:10,12,3,3034,174,2860,4.63%,5.74%
2020-01-01 00:07:10,12,4,3113,54,3059,4.75%,1.73%
2020-01-01 00:07:10,12,5,8564,647,7917,13.07%,7.55%
2020-01-01 00:07:10,12,6,4902,134,4768,7.48%,2.73%
2020-01-01 00:07:10,12,7,1628,22,1606,2.48%,1.35%
2020-01-01 00:07:10,12,8,1330,301,1029,2.03%,22.63%
2020-01-01 00:07:10,12,9,21292,4296,16996,32.49%,20.18%
2020-01-01 00:07:10,12,10,4172,420,3752,6.37%,10.07%
2020-01-01 00:07:10,12,11,1529,305,1224,2.33%,19.95%
2020-01-01 00:07:10,12,12,8053,1457,6596,12.29%,18.09%
2020-01-01 00:07:10,13,1,1904,29,1875,2.91%,1.52%
2020-01-01 00:07:10,13,2,2251,43,2208,3.43%,1.91%
2020-01-01 00:07:10,13,3,775,7,768,1.18%,0.90%
2020-01-01 00:07:10,13,4,5568,907,4661,8.50%,16.29%
2020-01-01 00:07:10,13,5,7982,1250,6732,12.18%,15.66%
2020-01-01 00:07:10,13,6,6132,941,5191,9.36%,15.35%
2020-01-01 00:07:10,13,7,4365,133,4232,6.66%,3.05%
2020-01-01 00:07:10,13,8,6846,333,6513,10.45%,4.86%
2020-01-01 00:07:10,13,9,8443,1311,7132,12.88%,15.53%
2020-01-01 00:07:10,13,10,28439,6133,22306,43.39%,21.57%
2020-01-01 00:07:10,13,11,17428,2352,15076,26.59%,13.50%
2020-01-01 00:07:10,13,12,10146,1041,9105,15.48%,10.26%
2020-01-01 00:07:10,14,1,188,0,188,0.29%,0.00%
2020-01-01 00:07:10,14,2,1599,13,1586,2.44%,0.81%
2020-01-01 00:07:10,14,3,1053,3,1050,1.61%,0.28%
2020-01-01 00:07:10,14,4,3056,71,2985,4.66%,2.32%
2020-01-01 00:07:10,14,5,1374,18,1356,2.10%,1.31%
2020-01-01 00:07:10,14,6,3472,84,3388,5.30%,2.42%
2020-01-01 00:07:10,14,7,11205,864,10341,17.10%,7.71%
2020-01-01 00:07:10,14,8,12895,1149,11746,19.68%,8.91%
2020-01-01 00:07:10,14,9,1508,24,1484,2.30%,1.59%
2020-01-01 00:07:10,14,10,4750,193,4557,7.25%,4.06%
2020-01-01 00:07:10,14,11,26919,4784,22135,41.08%,17.77%
2020-01-01 00:07:10,14,12,8883,549,8334,13.55%,6.18%
2020-01-01 00:07:10,15,1,483,6,477,0.74%,1.24%
2020-01-01 00:07:10,15,2,115,0,115,0.18%,0.00%
2020-01-01 00:07:10,15,3,3602,110,3492,5.50%,3.05%
2020-01-01 00:07:10,15,4,4775,192,4583,7.29%,4.02%
2020-01-01 00:07:10,15,5,9313,686,8627,14.21%,7.37%
2020-01-01 00:07:10,15,6,5143,260,4883,7.85%,5.06%
2020-01-01 00:07:10,15,7,3441,97,3344,5.25%,2.82%
2020-01-01 00:07:10,15,8,5521,263,5258,8.42%,4.76%
2020-01-01 00:07:10,15,9,9472,703,8769,14.45%,7.42%
2020-01-01 00:07:10,15,10,3940,335,3605,6.01%,8.50%
2020-01-01 00:07:10,15,11,9676,916,8760,14.76%,9.47%
2020-01-01 00:07:10,15,12,25855,5054,20801,39.45%,19.55%
2020-01-01 00:07:10,16,1,303,1,302,0.46%,0.33%
2020-01-01 00:07:10,16,2,226,1,225,0.34%,0.44%
2020-01-01 00:07:10,16,3,1432,10,1422,2.19%,0.70%
2020-01-01 00:07:10,16,4,3849,138,3711,5.87%,3.59%
2020-01-01 00:07:10,16,5,7295,479,6816,11.13%,6.57%
2020-01-01 00:07:10,16,6,4697,194,4503,7.17%,4.13%
2020-01-01 00:07:10,16,7,3373,101,3272,5.15%,2.99%
2020-01-01 00:07:10,16,8,7256,467,6789,11.07%,6.44%
2020-01-01 00:07:10,16,9,7870,542,7328,12.01%,6.89%
2020-01-01 00:07:10,16,10,1557,21,1536,2.38%,1.35%
2020-01-01 00:07:10,16,11,9025,657,8368,13.77%,7.28%
2020-01-01 00:07:10,16,12,24492,4193,20299,37.37%,17.12%
2020-01-01 00:07:20,1,1,25085,4390,20695,38.28%,17.50%
2020-01-01 00:07:20,1,2,11704,1052,10652,17.86%,8.99%
2020-01-01 00:07:20,1,3,725,5,720,1.11%,0.69%
2020-01-01 00:07:20,1,4,12838,1214,11624,19.59%,9.46%
2020-01-01 00:07:20,1,5,12411,1154,11257,18.94%,9.30%
2020-01-01 00:07:20,1,6,12303,1136,11167,18.77%,9.23%
2020-01-01 00:07:20,1,7,10962,935,10027,16.73%,8.53%
2020-01-01 00:07:20,1,8,7632,497,7135,11.65%,6.51%
2020-01-01 00:07:20,1,9,12249,1124,11125,18.69%,9.18%
2020-01-01 00:07:20,1,10,7035,426,6609,10.73%,6.06%
2020-01-01 00:07:20,1,11,7151,436,6715,10.91%,6.10%
2020-01-01 00:07:20,1,12,12232,1123,11109,18.66%,9.18%
2020-01-01 00:07:20,2,1,1109,9,1100,1.69%,0.81%
2020-01-01 00:07:20,2,2,24740,4179,20561,37.75%,16.89%
2020-01-01 00:07:20,2,3,19517,2659,16858,29.78%,13.62%
2020-01-01 00:07:20,2,4,1058,8,1050,1.61%,0.76%
2020-01-01 00:07:20,2,5,10196,811,9385,15.56%,7.95%
2020-01-01 00:07:20,2,6,36,0,36,0.05%,0.00%
2020-01-01 00:07:20,2,7,4095,123,3972,6.25%,3.00%
2020-01-01 00:07:20,2,8,2668,60,2608,4.07%,2.25%
2020-01-01 00:07:20,2,9,10132,802,9330,15.46%,7.92%
2020-01-01 00:07:20,2,10,1942,29,1913,2.96%,1.49%
2020-01-01 00:07:20,2,11,1955,29,1926,2.98%,1.48%
2020-01-01 00:07:20,2,12,9950,770,9180,15.18%,7.74%
2020-01-01 00:07:20,3,1,1890,17,1873,2.88%,0.90%
2020-01-01 00:07:20,3,2,25420,4279,21141,38.79%,16.83%
2020-01-01 00:07:20,3,3,70517,27371,43146,107.60%,38.81%
2020-01-01 00:07:20,3,4,8170,514,7656,12.47%,6.29%
2020-01-01 00:07:20,3,5,44276,12086,32190,67.56%,27.30%
2020-01-01 00:07:20,3,6,9053,615,8438,13.81%,6.79%
2020-01-01 00:07:20,3,7,21752,3261,18491,33.19%,14.99%
2020-01-01 00:07:20,3,8,18514,2382,16132,28.25%,12.87%
2020-01-01 00:07:20,3,9,34602,7727,26875,52.80%,22.33%
2020-01-01 00:07:20,3,10,7858,469,7389,11.99%,5.97%
2020-01-01 00:07:20,3,11,2178,25,2153,3.32%,1.15%
2020-01-01 00:07:20,3,12,24431,4094,20337,37.28%,16.76%
2020-01-01 00:07:20,4,1,575,1,574,0.88%,0.17%
2020-01-01 00:07:20,4,2,398,1,397,0.61%,0.25%
2020-01-01 00:07:20,4,3,740,2,738,1.13%,0.27%
2020-01-01 00:07:20,4,4,27078,4969,22109,41.32%,18.35%
2020-01-01 00:07:20,4,5,16330,1927,14403,24.92%,11.80%
2020-01-01 00:07:20,4,6,23003,3646,19357,35.10%,15.85%
2020-01-01 00:07:20,4,7,5385,236,5149,8.22%,4.38%
2020-01-01 00:07:20,4,8,3151,89,3062,4.81%,2.82%
2020-01-01 00:07:20,4,9,14507,1538,12969,22.14%,10.60%
2020-01-01 00:07:20,4,10,1873,33,1840,2.86%,1.76%
2020-01-01 00:07:20,4,11,198,0,198,0.30%,0.00%
2020-01-01 00:07:20,4,12,11830,1039,10791,18.05%,8.78%
2020-01-01 00:07:20,5,1,2487,41,2446,3.79%,1.65%
2020-01-01 00:07:20,5,2,555,2,553,0.85%,0.36%
2020-01-01 00:07:20,5,3,516,0,516,0.79%,0.00%
2020-01-01 00:07:20,5,4,22344,3385,18959,34.09%,15.15%
2020-01-01 00:07:20,5,5,8510,534,7976,12.99%,6.27%
2020-01-01 00:07:20,5,6,13758,1318,12440,20.99%,9.58%
2020-01-01 00:07:20,5,7,4671,155,4516,7.13%,3.32%
2020-01-01 00:07:20,5,8,3271,71,3200,4.99%,2.17%
2020-01-01 00:07:20,5,9,7890,474,7416,12.04%,6.01%
2020-01-01 00:07:20,5,10,941,4,937,1.44%,0.43%
2020-01-01 00:07:20,5,11,491,0,491,0.75%,0.00%
2020-01-01 00:07:20,5,12,6762,362,6400,10.32%,5.35%
2020-01-01 00:07:20,6,1,1025,12,1013,1.56%,1.17%
2020-01-01 00:07:20,6,2,1076,13,1063,1.64%,1.21%
2020-01-01 00:07:20,6,3,1607,19,1588,2.45%,1.18%
2020-01-01 00:07:20,6,4,1146,10,1136,1.75%,0.87%
2020-01-01 00:07:20,6,5,12806,1215,11591,19.54%,9.49%
2020-01-01 00:07:20,6,6,4798,189,4609,7.32%,3.94%
2020-01-01 00:07:20,6,7,3241,76,3165,4.95%,2.34%
2020-01-01 00:07:20,6,8,2730,52,2678,4.17%,1.90%
2020-01-01 00:07:20,6,9,6213,290,5923,9.48%,4.67%
2020-01-01 00:07:20,6,10,1794,29,1765,2.74%,1.62%
2020-01-01 00:07:20,6,11,468,0,468,0.71%,0.00%
2020-01-01 00:07:20,6,12,4348,150,4198,6.63%,3.45%
2020-01-01 00:07:20,7,1,387,1,386,0.59%,0.26%
2020-01-01 00:07:20,7,2,237,0,237,0.36%,0.00%
2020-01-01 00:07:20,7,3,628,1,627,0.96%,0.16%
2020-01-01 00:07:20,7,4,2215,35,2180,3.38%,1.58%
2020-01-01 00:07:20,7,5,6979,372,6607,10.65%,5.33%
2020-01-01 00:07:20,7,6,13060,1247,11813,19.93%,9.55%
2020-01-01 00:07:20,7,7,3801,96,3705,5.80%,2.53%
2020-01-01 00:07:20,7,8,1523,23,1500,2.32%,1.51%
2020-01-01 00:07:20,7,9,6251,300,5951,9.54%,4.80%
2020-01-01 00:07:20,7,10,936,4,932,1.43%,0.43%
2020-01-01 00:07:20,7,11,148,1,147,0.23%,0.68%
2020-01-01 00:07:20,7,12,5323,203,5120,8.12%,3.81%
2020-01-01 00:07:20,8,1,614,3,611,0.94%,0.49%
2020-01-01 00:07:20,8,2,88,0,88,0.13%,0.00%
2020-01-01 00:07:20,8,3,2030,47,1983,3.10%,2.32%
2020-01-01 00:07:20,8,4,2826,50,2776,4.31%,1.77%
2020-01-01 00:07:20,8,5,8976,651,8325,13.70%,7.25%
2020-01-01 00:07:20,8,6,16823,2006,14817,25.67%,11.92%
2020-01-01 00:07:20,8,7,4920,185,4735,7.51%,3.76%
2020-01-01 00:07:20,8,8,2426,49,2377,3.70%,2.02%
2020-01-01 00:07:20,8,9,6444,300,6144,9.83%,4.66%
2020-01-01 00:07:20,8,10,1923,34,1889,2.93%,1.77%
2020-01-01 00:07:20,8,11,119,0,119,0.18%,0.00%
2020-01-01 00:07:20,8,12,4494,135,4359,6.86%,3.00%
2020-01-01 00:07:20,9,1,1419,10,1409,2.17%,0.70%
2020-01-01 00:07:20,9,2,3524,100,3424,5.38%,2.84%
2020-01-01 00:07:20,9,3,1781,24,1757,2.72%,1.35%
2020-01-01 00:07:20,9,4,3933,135,3798,6.00%,3.43%
2020-01-01 00:07:20,9,5,427,4,423,0.65%,0.94%
2020-01-01 00:07:20,9,6,5459,237,5222,8.33%,4.34%
2020-01-01 00:07:20,9,7,24839,4188,20651,37.90%,16.86%
2020-01-01 00:07:20,9,8,10563,869,9694,16.12%,8.23%
2020-01-01 00:07:20,9,9,287,1,286,0.44%,0.35%
2020-01-01 00:07:20,9,10,3776,106,3670,5.76%,2.81%
2020-01-01 00:07:20,9,11,9548,718,8830,14.57%,7.52%
2020-01-01 00:07:20,9,12,5448,242,5206,8.31%,4.44%
2020-01-01 00:07:20,10,1,1489,265,1224,2.27%,17.80%
2020-01-01 00:07:20,10,2,4995,437,4558,7.62%,8.75%
2020-01-01 00:07:20,10,3,3354,108,3246,5.12%,3.22%
2020-01-01 00:07:20,10,4,3803,971,2832,5.80%,25.53%
2020-01-01 00:07:20,10,5,942,101,841,1.44%,10.72%
2020-01-01 00:07:20,10,6,6018,1178,4840,9.18%,19.57%
2020-01-01 00:07:20,10,7,12584,2179,10405,19.20%,17.32%
2020-01-01 00:07:20,10,8,30926,8110,22816,47.19%,26.22%
2020-01-01 00:07:20,10,9,909,9,900,1.39%,0.99%
2020-01-01 00:07:20,10,10,2703,45,2658,4.12%,1.66%
2020-01-01 00:07:20,10,11,14679,1827,12852,22.40%,12.45%
2020-01-01 00:07:20,10,12,11163,1198,9965,17.03%,10.73%
2020-01-01 00:07:20,11,1,2464,42,2422,3.76%,1.70%
2020-01-01 00:07:20,11,2,3428,77,3351,5.23%,2.25%
2020-01-01 00:07:20,11,3,807,7,800,1.23%,0.87%
2020-01-01 00:07:20,11,4,7876,479,7397,12.02%,6.08%
2020-01-01 00:07:20,11,5,235,0,235,0.36%,0.00%
2020-01-01 00:07:20,11,6,8849,573,8276,13.50%,6.48%
2020-01-01 00:07:20,11,7,13911,1361,12550,21.23%,9.78%
2020-01-01 00:07:20,11,8,28479,5293,23186,43.46%,18.59%
2020-01-01 00:07:20,11,9,244,2,242,0.37%,0.82%
2020-01-01 00:07:20,11,10,2966,76,2890,4.53%,2.56%
2020-01-01 00:07:20,11,11,9975,715,9260,15.22%,7.17%
2020-01-01 00:07:20,11,12,6576,319,6257,10.03%,4.85%
2020-01-01 00:07:20,12,1,58,0,58,0.09%,0.00%
2020-01-01 00:07:20,12,2,593,123,470,0.90%,20.74%
2020-01-01 00:07:20,12,3,3619,232,3387,5.52%,6.41%
2020-01-01 00:07:20,12,4,3691,100,3591,5.63%,2.71%
2020-01-01 00:07:20,12,5,10003,829,9174,15.26%,8.29%
2020-01-01 00:07:20,12,6,5731,242,5489,8.74%,4.22%
2020-01-01 00:07:20,12,7,1901,20,1881,2.90%,1.05%
2020-01-01 00:07:20,12,8,1336,344,992,2.04%,25.75%
2020-01-01 00:07:20,12,9,23030,4738,18292,35.14%,20.57%
2020-01-01 00:07:20,12,10,4670,471,4199,7.13%,10.09%
2020-01-01 00:07:20,12,11,1685,351,1334,2.57%,20.83%
2020-01-01 00:07:20,12,12,7982,1267,6715,12.18%,15.87%
2020-01-01 00:07:20,13,1,2199,46,2153,3.36%,2.09%
2020-01-01 00:07:20,13,2,2486,56,2430,3.79%,2.25%
2020-01-01 00:07:20,13,3,960,9,951,1.46%,0.94%
2020-01-01 00:07:20,13,4,6758,894,5864,10.31%,13.23%
2020-01-01 00:07:20,13,5,9204,1273,7931,14.04%,13.83%
2020-01-01 00:07:20,13,6,7361,945,6416,11.23%,12.84%
2020-01-01 00:07:20,13,7,4658,174,4484,7.11%,3.74%
2020-01-01 00:07:20,13,8,6801,346,6455,10.38%,5.09%
2020-01-01 00:07:20,13,9,9571,1326,8245,14.60%,13.85%
2020-01-01 00:07:20,13,10,30945,7029,23916,47.22%,22.71%
2020-01-01 00:07:20,13,11,18079,2612,15467,27.59%,14.45%
2020-01-01 00:07:20,13,12,10943,1241,9702,16.70%,11.34%
2020-01-01 00:07:20,14,1,296,0,296,0.45%,0.00%
2020-01-01 00:07:20,14,2,1834,25,1809,2.80%,1.36%
2020-01-01 00:07:20,14,3,1217,11,1206,1.86%,0.90%
2020-01-01 00:07:20,14,4,4139,124,4015,6.32%,3.00%
2020-01-01 00:07:20,14,5,1307,11,1296,1.99%,0.84%
2020-01-01 00:07:20,14,6,4529,152,4377,6.91%,3.36%
2020-01-01 00:07:20,14,7,12387,1044,11343,18.90%,8.43%
2020-01-01 00:07:20,14,8,14391,1429,12962,21.96%,9.93%
2020-01-01 00:07:20,14,9,1641,16,1625,2.50%,0.98%
2020-01-01 00:07:20,14,10,4117,116,4001,6.28%,2.82%
2020-01-01 00:07:20,14,11,25735,4370,21365,39.27%,16.98%
2020-01-01 00:07:20,14,12,6847,327,6520,10.45%,4.78%
2020-01-01 00:07:20,15,1,511,6,505,0.78%,1.17%
2020-01-01 00:07:20,15,2,183,0,183,0.28%,0.00%
2020-01-01 00:07:20,15,3,3843,101,3742,5.86%,2.63%
2020-01-01 00:07:20,15,4,4911,215,4696,7.49%,4.38%
2020-01-01 00:07:20,15,5,9443,699,8744,14.41%,7.40%
2020-01-01 00:07:20,15,6,5196,249,4947,7.93%,4.79%
2020-01-01 00:07:20,15,7,3899,113,3786,5.95%,2.90%
2020-01-01 00:07:20,15,8,6457,304,6153,9.85%,4.71%
2020-01-01 00:07:20,15,9,9641,727,8914,14.71%,7.54%
2020-01-01 00:07:20,15,10,5571,417,5154,8.50%,7.49%
2020-01-01 00:07:20,15,11,12164,1274,10890,18.56%,10.47%
2020-01-01 00:07:20,15,12,27440,5717,21723,41.87%,20.83%
2020-01-01 00:07:20,16,1,407,6,401,0.62%,1.47%
2020-01-01 00:07:20,16,2,278,0,278,0.42%,0.00%
2020-01-01 00:07:20,16,3,1759,21,1738,2.68%,1.19%
2020-01-01 00:07:20,16,4,3410,94,3316,5.20%,2.76%
2020-01-01 00:07:20,16,5,7728,500,7228,11.79%,6.47%
2020-01-01 00:07:20,16,6,4351,148,4203,6.64%,3.40%
2020-01-01 00:07:20,16,7,3597,126,3471,5.49%,3.50%
2020-01-01 00:07:20,16,8,7902,514,7388,12.06%,6.50%
2020-01-01 00:07:20,16,9,8318,575,7743,12.69%,6.91%
2020-01-01 00:07:20,16,10,1530,16,1514,2.33%,1.05%
2020-01-01 00:07:20,16,11,9734,736,8998,14.85%,7.56%
2020-01-01 00:07:20,16,12,26104,4641,21463,39.83%,17.78%
2020-01-01 00:07:30,1,1,16505,1906,14599,25.18%,11.55%
2020-01-01 00:07:30,1,2,6014,282,5732,9.18%,4.69%
2020-01-01 00:07:30,1,3,524,4,520,0.80%,0.76%
2020-01-01 00:07:30,1,4,10078,730,9348,15.38%,7.24%
2020-01-01 00:07:30,1,5,9682,676,9006,14.77%,6.98%
2020-01-01 00:07:30,1,6,9620,661,8959,14.68%,6.87%
2020-01-01 00:07:30,1,7,5460,241,5219,8.33%,4.41%
2020-01-01 00:07:30,1,8,4524,165,4359,6.90%,3.65%
2020-01-01 00:07:30,1,9,9559,656,8903,14.59%,6.86%
2020-01-01 00:07:30,1,10,3785,110,3675,5.78%,2.91%
2020-01-01 00:07:30,1,11,3877,115,3762,5.92%,2.97%
2020-01-01 00:07:30,1,12,8856,569,8287,13.51%,6.43%
2020-01-01 00:07:30,2,1,483,3,480,0.74%,0.62%
2020-01-01 00:07:30,2,2,31168,6335,24833,47.56%,20.33%
2020-01-01 00:07:30,2,3,25660,4446,21214,39.15%,17.33%
2020-01-01 00:07:30,2,4,411,3,408,0.63%,0.73%
2020-01-01 00:07:30,2,5,14269,1452,12817,21.77%,10.18%
2020-01-01 00:07:30,2,6,44,0,44,0.07%,0.00%
2020-01-01 00:07:30,2,7,5011,153,4858,7.65%,3.05%
2020-01-01 00:07:30,2,8,4141,105,4036,6.32%,2.54%
2020-01-01 00:07:30,2,9,14215,1448,12767,21.69%,10.19%
2020-01-01 00:07:30,2,10,3217,65,3152,4.91%,2.02%
2020-01-01 00:07:30,2,11,3235,65,3170,4.94%,2.01%
2020-01-01 00:07:30,2,12,14043,1418,12625,21.43%,10.10%
2020-01-01 00:07:30,3,1,1372,7,1365,2.09%,0.51%
2020-01-01 00:07:30,3,2,25848,4489,21359,39.44%,17.37%
2020-01-01 00:07:30,3,3,71675,28144,43531,109.37%,39.27%
2020-01-01 00:07:30,3,4,9211,613,8598,14.05%,6.66%
2020-01-01 00:07:30,3,5,44784,12427,32357,68.33%,27.75%
2020-01-01 00:07:30,3,6,10506,813,9693,16.03%,7.74%
2020-01-01 00:07:30,3,7,22786,3522,19264,34.77%,15.46%
2020-01-01 00:07:30,3,8,16891,1991,14900,25.77%,11.79%
2020-01-01 00:07:30,3,9,33976,7494,26482,51.84%,22.06%
2020-01-01 00:07:30,3,10,4883,179,4704,7.45%,3.67%
2020-01-01 00:07:30,3,11,1921,24,1897,2.93%,1.25%
2020-01-01 00:07:30,3,12,25261,4375,20886,38.55%,17.32%
2020-01-01 00:07:30,4,1,568,2,566,0.87%,0.35%
2020-01-01 00:07:30,4,2,382,0,382,0.58%,0.00%
2020-01-01 00:07:30,4,3,604,2,602,0.92%,0.33%
2020-01-01 00:07:30,4,4,28305,5385,22920,43.19%,19.02%
2020-01-01 00:07:30,4,5,17507,2231,15276,26.71%,12.74%
2020-01-01 00:07:30,4,6,24387,4115,20272,37.21%,16.87%
2020-01-01 00:07:30,4,7,5615,218,5397,8.57%,3.88%
2020-01-01 00:07:30,4,8,3288,67,3221,5.02%,2.04%
2020-01-01 00:07:30,4,9,15708,1834,13874,23.97%,11.68%
2020-01-01 00:07:30,4,10,1957,42,1915,2.99%,2.15%
2020-01-01 00:07:30,4,11,140,0,140,0.21%,0.00%
2020-01-01 00:07:30,4,12,12455,1148,11307,19.00%,9.22%
2020-01-01 00:07:30,5,1,3219,82,3137,4.91%,2.55%
2020-01-01 00:07:30,5,2,843,6,837,1.29%,0.71%
2020-01-01 00:07:30,5,3,551,3,548,0.84%,0.54%
2020-01-01 00:07:30,5,4,24025,3880,20145,36.66%,16.15%
2020-01-01 00:07:30,5,5,8837,579,8258,13.48%,6.55%
2020-01-01 00:07:30,5,6,14448,1459,12989,22.05%,10.10%
2020-01-01 00:07:30,5,7,5174,217,4957,7.89%,4.19%
2020-01-01 00:07:30,5,8,3792,122,3670,5.79%,3.22%
2020-01-01 00:07:30,5,9,8103,487,7616,12.36%,6.01%
2020-01-01 00:07:30,5,10,947,7,940,1.45%,0.74%
2020-01-01 00:07:30,5,11,562,3,559,0.86%,0.53%
2020-01-01 00:07:30,5,12,6826,354,6472,10.42%,5.19%
2020-01-01 00:07:30,6,1,1000,7,993,1.53%,0.70%
2020-01-01 00:07:30,6,2,1038,7,1031,1.58%,0.67%
2020-01-01 00:07:30,6,3,1660,18,1642,2.53%,1.08%
2020-01-01 00:07:30,6,4,1400,10,1390,2.14%,0.71%
2020-01-01 00:07:30,6,5,14827,1618,13209,22.62%,10.91%
2020-01-01 00:07:30,6,6,5844,268,5576,8.92%,4.59%
2020-01-01 00:07:30,6,7,3811,94,3717,5.82%,2.47%
2020-01-01 00:07:30,6,8,3049,59,2990,4.65%,1.94%
2020-01-01 00:07:30,6,9,7028,385,6643,10.72%,5.48%
2020-01-01 00:07:30,6,10,2167,44,2123,3.31%,2.03%
2020-01-01 00:07:30,6,11,434,1,433,0.66%,0.23%
2020-01-01 00:07:30,6,12,4812,169,4643,7.34%,3.51%
2020-01-01 00:07:30,7,1,462,3,459,0.70%,0.65%
2020-01-01 00:07:30,7,2,155,1,154,0.24%,0.65%
2020-01-01 00:07:30,7,3,1419,8,1411,2.17%,0.56%
2020-01-01 00:07:30,7,4,2138,86,2052,3.26%,4.02%
2020-01-01 00:07:30,7,5,8171,516,7655,12.47%,6.32%
2020-01-01 00:07:30,7,6,14385,1522,12863,21.95%,10.58%
2020-01-01 00:07:30,7,7,4043,116,3927,6.17%,2.87%
2020-01-01 00:07:30,7,8,1784,28,1756,2.72%,1.57%
2020-01-01 00:07:30,7,9,6679,357,6322,10.19%,5.35%
2020-01-01 00:07:30,7,10,1302,10,1292,1.99%,0.77%
2020-01-01 00:07:30,7,11,103,0,103,0.16%,0.00%
2020-01-01 00:07:30,7,12,5373,249,5124,8.20%,4.63%
2020-01-01 00:07:30,8,1,440,2,438,0.67%,0.45%
2020-01-01 00:07:30,8,2,54,0,54,0.08%,0.00%
2020-01-01 00:07:30,8,3,1801,23,1778,2.75%,1.28%
2020-01-01 00:07:30,8,4,2663,52,2611,4.06%,1.95%
2020-01-01 00:07:30,8,5,8240,524,7716,12.57%,6.36%
2020-01-01 00:07:30,8,6,16672,1976,14696,25.44%,11.85%
2020-01-01 00:07:30,8,7,5634,254,5380,8.60%,4.51%
2020-01-01 00:07:30,8,8,2675,53,2622,4.08%,1.98%
2020-01-01 00:07:30,8,9,6223,299,5924,9.50%,4.80%
2020-01-01 00:07:30,8,10,1700,24,1676,2.59%,1.41%
2020-01-01 00:07:30,8,11,229,0,229,0.35%,0.00%
2020-01-01 00:07:30,8,12,4514,153,4361,6.89%,3.39%
2020-01-01 00:07:30,9,1,1061,7,1054,1.62%,0.66%
2020-01-01 00:07:30,9,2,5697,223,5474,8.69%,3.91%
2020-01-01 00:07:30,9,3,4175,123,4052,6.37%,2.95%
2020-01-01 00:07:30,9,4,5090,191,4899,7.77%,3.75%
2020-01-01 00:07:30,9,5,254,0,254,0.39%,0.00%
2020-01-01 00:07:30,9,6,6431,292,6139,9.81%,4.54%
2020-01-01 00:07:30,9,7,27050,4824,22226,41.28%,17.83%
2020-01-01 00:07:30,9,8,8159,451,7708,12.45%,5.53%
2020-01-01 00:07:30,9,9,151,0,151,0.23%,0.00%
2020-01-01 00:07:30,9,10,2220,29,2191,3.39%,1.31%
2020-01-01 00:07:30,9,11,7157,347,6810,10.92%,4.85%
2020-01-01 00:07:30,9,12,4663,156,4507,7.12%,3.35%
2020-01-01 00:07:30,10,1,1150,214,936,1.75%,18.61%
2020-01-01 00:07:30,10,2,3119,273,2846,4.76%,8.75%
2020-01-01 00:07:30,10,3,1825,27,1798,2.78%,1.48%
2020-01-01 00:07:30,10,4,4087,1035,3052,6.24%,25.32%
2020-01-01 00:07:30,10,5,659,45,614,1.01%,6.83%
2020-01-01 00:07:30,10,6,6163,1187,4976,9.40%,19.26%
2020-01-01 00:07:30,10,7,11235,1937,9298,17.14%,17.24%
2020-01-01 00:07:30,10,8,28736,7123,21613,43.85%,24.79%
2020-01-01 00:07:30,10,9,815,3,812,1.24%,0.37%
2020-01-01 00:07:30,10,10,2331,38,2293,3.56%,1.63%
2020-01-01 00:07:30,10,11,13908,1721,12187,21.22%,12.37%
2020-01-01 00:07:30,10,12,10716,1203,9513,16.35%,11.23%
2020-01-01 00:07:30,11,1,2595,55,2540,3.96%,2.12%
2020-01-01 00:07:30,11,2,3817,110,3707,5.82%,2.88%
2020-01-01 00:07:30,11,3,1041,8,1033,1.59%,0.77%
2020-01-01 00:07:30,11,4,5058,263,4795,7.72%,5.20%
2020-01-01 00:07:30,11,5,215,1,214,0.33%,0.47%
2020-01-01 00:07:30,11,6,6264,360,5904,9.56%,5.75%
2020-01-01 00:07:30,11,7,12451,1142,11309,19.00%,9.17%
2020-01-01 00:07:30,11,8,26444,4781,21663,40.35%,18.08%
2020-01-01 00:07:30,11,9,255,3,252,0.39%,1.18%
2020-01-01 00:07:30,11,10,2720,73,2647,4.15%,2.68%
2020-01-01 00:07:30,11,11,9857,763,9094,15.04%,7.74%
2020-01-01 00:07:30,11,12,6646,346,6300,10.14%,5.21%
2020-01-01 00:07:30,12,1,40,0,40,0.06%,0.00%
2020-01-01 00:07:30,12,2,632,174,458,0.96%,27.53%
2020-01-01 00:07:30,12,3,3169,246,2923,4.84%,7.76%
2020-01-01 00:07:30,12,4,3304,70,3234,5.04%,2.12%
2020-01-01 00:07:30,12,5,9430,812,8618,14.39%,8.61%
2020-01-01 00:07:30,12,6,5415,189,5226,8.26%,3.49%
2020-01-01 00:07:30,12,7,1963,26,1937,3.00%,1.32%
2020-01-01 00:07:30,12,8,1544,259,1285,2.36%,16.77%
2020-01-01 00:07:30,12,9,23170,4481,18689,35.35%,19.34%
2020-01-01 00:07:30,12,10,4436,392,4044,6.77%,8.84%
2020-01-01 00:07:30,12,11,1701,261,1440,2.60%,15.34%
2020-01-01 00:07:30,12,12,8746,1112,7634,13.35%,12.71%
2020-01-01 00:07:30,13,1,2269,41,2228,3.46%,1.81%
2020-01-01 00:07:30,13,2,2571,51,2520,3.92%,1.98%
2020-01-01 00:07:30,13,3,693,3,690,1.06%,0.43%
2020-01-01 00:07:30,13,4,6055,584,5471,9.24%,9.64%
2020-01-01 00:07:30,13,5,8177,871,7306,12.48%,10.65%
2020-01-01 00:07:30,13,6,6708,640,6068,10.24%,9.54%
2020-01-01 00:07:30,13,7,5022,203,4819,7.66%,4.04%
2020-01-01 00:07:30,13,8,7454,444,7010,11.37%,5.96%
2020-01-01 00:07:30,13,9,8545,906,7639,13.04%,10.60%
2020-01-01 00:07:30,13,10,28403,6035,22368,43.34%,21.25%
2020-01-01 00:07:30,13,11,16930,2507,14423,25.83%,14.81%
2020-01-01 00:07:30,13,12,9099,1102,7997,13.88%,12.11%
2020-01-01 00:07:30,14,1,352,0,352,0.54%,0.00%
2020-01-01 00:07:30,14,2,1489,25,1464,2.27%,1.68%
2020-01-01 00:07:30,14,3,920,8,912,1.40%,0.87%
2020-01-01 00:07:30,14,4,4443,136,4307,6.78%,3.06%
2020-01-01 00:07:30,14,5,1303,14,1289,1.99%,1.07%
2020-01-01 00:07:30,14,6,4861,164,4697,7.42%,3.37%
2020-01-01 00:07:30,14,7,12751,1123,11628,19.46%,8.81%
2020-01-01 00:07:30,14,8,14406,1439,12967,21.98%,9.99%
2020-01-01 00:07:30,14,9,1476,17,1459,2.25%,1.15%
2020-01-01 00:07:30,14,10,4065,116,3949,6.20%,2.85%
2020-01-01 00:07:30,14,11,26604,4714,21890,40.59%,17.72%
2020-01-01 00:07:30,14,12,7823,456,7367,11.94%,5.83%
2020-01-01 00:07:30,15,1,464,1,463,0.71%,0.22%
2020-01-01 00:07:30,15,2,193,1,192,0.29%,0.52%
2020-01-01 00:07:30,15,3,3877,114,3763,5.92%,2.94%
2020-01-01 00:07:30,15,4,5056,194,4862,7.71%,3.84%
2020-01-01 00:07:30,15,5,9932,753,9179,15.16%,7.58%
2020-01-01 00:07:30,15,6,5326,225,5101,8.13%,4.22%
2020-01-01 00:07:30,15,7,3766,120,3646,5.75%,3.19%
2020-01-01 00:07:30,15,8,6129,299,5830,9.35%,4.88%
2020-01-01 00:07:30,15,9,10079,779,9300,15.38%,7.73%
2020-01-01 00:07:30,15,10,4122,121,4001,6.29%,2.94%
2020-01-01 00:07:30,15,11,10355,794,9561,15.80%,7.67%
2020-01-01 00:07:30,15,12,25784,4778,21006,39.34%,18.53%
2020-01-01 00:07:30,16,1,445,0,445,0.68%,0.00%
2020-01-01 00:07:30,16,2,274,0,274,0.42%,0.00%
2020-01-01 00:07:30,16,3,3656,94,3562,5.58%,2.57%
2020-01-01 00:07:30,16,4,4134,131,4003,6.31%,3.17%
2020-01-01 00:07:30,16,5,9847,743,9104,15.03%,7.55%
2020-01-01 00:07:30,16,6,4913,174,4739,7.50%,3.54%
2020-01-01 00:07:30,16,7,3057,76,2981,4.66%,2.49%
2020-01-01 00:07:30,16,8,6737,486,6251,10.28%,7.21%
2020-01-01 00:07:30,16,9,10250,799,9451,15.64%,7.80%
2020-01-01 00:07:30,16,10,1612,24,1588,2.46%,1.49%
2020-01-01 00:07:30,16,11,8610,689,7921,13.14%,8.00%
2020-01-01 00:07:30,16,12,26179,4642,21537,39.95%,17.73%
2020-01-01 00:07:40,1,1,17060,2094,14966,26.03%,12.27%
2020-01-01 00:07:40,1,2,5029,183,4846,7.67%,3.64%
2020-01-01 00:07:40,1,3,726,6,720,1.11%,0.83%
2020-01-01 00:07:40,1,4,11614,1019,10595,17.72%,8.77%
2020-01-01 00:07:40,1,5,11274,959,10315,17.20%,8.51%
2020-01-01 00:07:40,1,6,11206,955,10251,17.10%,8.52%
2020-01-01 00:07:40,1,7,4286,134,4152,6.54%,3.13%
2020-01-01 00:07:40,1,8,3350,85,3265,5.11%,2.54%
2020-01-01 00:07:40,1,9,11145,941,10204,17.01%,8.44%
2020-01-01 00:07:40,1,10,2823,62,2761,4.31%,2.20%
2020-01-01 00:07:40,1,11,2858,64,2794,4.36%,2.24%
2020-01-01 00:07:40,1,12,10160,780,9380,15.50%,7.68%
2020-01-01 00:07:40,2,1,397,1,396,0.61%,0.25%
2020-01-01 00:07:40,2,2,26029,4582,21447,39.72%,17.60%
2020-01-01 00:07:40,2,3,19657,2711,16946,29.99%,13.79%
2020-01-01 00:07:40,2,4,373,1,372,0.57%,0.27%
2020-01-01 00:07:40,2,5,9920,702,9218,15.14%,7.08%
2020-01-01 00:07:40,2,6,53,0,53,0.08%,0.00%
2020-01-01 00:07:40,2,7,5958,286,5672,9.09%,4.80%
2020-01-01 00:07:40,2,8,4275,163,4112,6.52%,3.81%
2020-01-01 00:07:40,2,9,9866,696,9170,15.05%,7.05%
2020-01-01 00:07:40,2,10,3589,122,3467,5.48%,3.40%
2020-01-01 00:07:40,2,11,3595,122,3473,5.49%,3.39%
2020-01-01 00:07:40,2,12,9707,671,9036,14.81%,6.91%
2020-01-01 00:07:40,3,1,1693,13,1680,2.58%,0.77%
2020-01-01 00:07:40,3,2,24560,4068,20492,37.48%,16.56%
2020-01-01 00:07:40,3,3,75614,30663,44951,115.38%,40.55%
2020-01-01 00:07:40,3,4,8005,453,7552,12.21%,5.66%
2020-01-01 00:07:40,3,5,49492,14658,34834,75.52%,29.62%
2020-01-01 00:07:40,3,6,9441,643,8798,14.41%,6.81%
2020-01-01 00:07:40,3,7,20918,3017,17901,31.92%,14.42%
2020-01-01 00:07:40,3,8,16727,1921,14806,25.52%,11.48%
2020-01-01 00:07:40,3,9,39746,9864,29882,60.65%,24.82%
2020-01-01 00:07:40,3,10,4228,124,4104,6.45%,2.93%
2020-01-01 00:07:40,3,11,1957,23,1934,2.99%,1.18%
2020-01-01 00:07:40,3,12,31682,6554,25128,48.34%,20.69%
2020-01-01 00:07:40,4,1,486,3,483,0.74%,0.62%
2020-01-01 00:07:40,4,2,332,1,331,0.51%,0.30%
2020-01-01 00:07:40,4,3,681,3,678,1.04%,0.44%
2020-01-01 00:07:40,4,4,27571,5251,22320,42.07%,19.05%
2020-01-01 00:07:40,4,5,16872,2117,14755,25.74%,12.55%
2020-01-01 00:07:40,4,6,23646,3924,19722,36.08%,16.59%
2020-01-01 00:07:40,4,7,5445,231,5214,8.31%,4.24%
2020-01-01 00:07:40,4,8,3149,85,3064,4.80%,2.70%
2020-01-01 00:07:40,4,9,15015,1687,13328,22.91%,11.24%
2020-01-01 00:07:40,4,10,2157,48,2109,3.29%,2.23%
2020-01-01 00:07:40,4,11,187,1,186,0.29%,0.53%
2020-01-01 00:07:40,4,12,12168,1124,11044,18.57%,9.24%
2020-01-01 00:07:40,5,1,3522,82,3440,5.37%,2.33%
2020-01-01 00:07:40,5,2,1102,2,1100,1.68%,0.18%
2020-01-01 00:07:40,5,3,490,0,490,0.75%,0.00%
2020-01-01 00:07:40,5,4,24177,4017,20160,36.89%,16.61%
2020-01-01 00:07:40,5,5,9617,654,8963,14.67%,6.80%
2020-01-01 00:07:40,5,6,16198,1878,14320,24.72%,11.59%
2020-01-01 00:07:40,5,7,6152,352,5800,9.39%,5.72%
2020-01-01 00:07:40,5,8,4579,176,4403,6.99%,3.84%
2020-01-01 00:07:40,5,9,8964,571,8393,13.68%,6.37%
2020-01-01 00:07:40,5,10,1042,12,1030,1.59%,1.15%
2020-01-01 00:07:40,5,11,587,6,581,0.90%,1.02%
2020-01-01 00:07:40,5,12,7477,399,7078,11.41%,5.34%
2020-01-01 00:07:40,6,1,1083,6,1077,1.65%,0.55%
2020-01-01 00:07:40,6,2,1136,8,1128,1.73%,0.70%
2020-01-01 00:07:40,6,3,1558,16,1542,2.38%,1.03%
2020-01-01 00:07:40,6,4,1103,7,1096,1.68%,0.63%
2020-01-01 00:07:40,6,5,13721,1283,12438,20.94%,9.35%
2020-01-01 00:07:40,6,6,4563,154,4409,6.96%,3.37%
2020-01-01 00:07:40,6,7,3066,69,2997,4.68%,2.25%
2020-01-01 00:07:40,6,8,2314,41,2273,3.53%,1.77%
2020-01-01 00:07:40,6,9,7283,385,6898,11.11%,5.29%
2020-01-01 00:07:40,6,10,2215,38,2177,3.38%,1.72%
2020-01-01 00:07:40,6,11,466,1,465,0.71%,0.21%
2020-01-01 00:07:40,6,12,5000,178,4822,7.63%,3.56%
2020-01-01 00:07:40,7,1,490,0,490,0.75%,0.00%
2020-01-01 00:07:40,7,2,137,0,137,0.21%,0.00%
2020-01-01 00:07:40,7,3,712,5,707,1.09%,0.70%
2020-01-01 00:07:40,7,4,1957,25,1932,2.99%,1.28%
2020-01-01 00:07:40,7,5,8398,532,7866,12.81%,6.33%
2020-01-01 00:07:40,7,6,13969,1353,12616,21.32%,9.69%
2020-01-01 00:07:40,7,7,3571,101,3470,5.45%,2.83%
2020-01-01 00:07:40,7,8,1540,23,1517,2.35%,1.49%
2020-01-01 00:07:40,7,9,7532,429,7103,11.49%,5.70%
2020-01-01 00:07:40,7,10,1432,15,1417,2.19%,1.05%
2020-01-01 00:07:40,7,11,116,0,116,0.18%,0.00%
2020-01-01 00:07:40,7,12,6116,298,5818,9.33%,4.87%
2020-01-01 00:07:40,8,1,378,1,377,0.58%,0.26%
2020-01-01 00:07:40,8,2,70,4,66,0.11%,5.71%
2020-01-01 00:07:40,8,3,1750,27,1723,2.67%,1.54%
2020-01-01 00:07:40,8,4,3093,58,3035,4.72%,1.88%
2020-01-01 00:07:40,8,5,8007,479,7528,12.22%,5.98%
2020-01-01 00:07:40,8,6,16194,1861,14333,24.71%,11.49%
2020-01-01 00:07:40,8,7,5063,192,4871,7.73%,3.79%
2020-01-01 00:07:40,8,8,2232,33,2199,3.41%,1.48%
2020-01-01 00:07:40,8,9,6077,288,5789,9.27%,4.74%
2020-01-01 00:07:40,8,10,1618,20,1598,2.47%,1.24%
2020-01-01 00:07:40,8,11,291,0,291,0.44%,0.00%
2020-01-01 00:07:40,8,12,4446,149,4297,6.78%,3.35%
2020-01-01 00:07:40,9,1,1681,220,1461,2.57%,13.09%
2020-01-01 00:07:40,9,2,5637,424,5213,8.60%,7.52%
2020-01-01 00:07:40,9,3,3520,87,3433,5.37%,2.47%
2020-01-01 00:07:40,9,4,6005,316,5689,9.16%,5.26%
2020-01-01 00:07:40,9,5,183,1,182,0.28%,0.55%
2020-01-01 00:07:40,9,6,7050,416,6634,10.76%,5.90%
2020-01-01 00:07:40,9,7,29835,6082,23753,45.52%,20.39%
2020-01-01 00:07:40,9,8,9861,756,9105,15.05%,7.67%
2020-01-01 00:07:40,9,9,160,1,159,0.24%,0.62%
2020-01-01 00:07:40,9,10,3297,72,3225,5.03%,2.18%
2020-01-01 00:07:40,9,11,8940,617,8323,13.64%,6.90%
2020-01-01 00:07:40,9,12,5304,203,5101,8.09%,3.83%
2020-01-01 00:07:40,10,1,1091,178,913,1.66%,16.32%
2020-01-01 00:07:40,10,2,2598,220,2378,3.96%,8.47%
2020-01-01 00:07:40,10,3,1374,21,1353,2.10%,1.53%
2020-01-01 00:07:40,10,4,3756,855,2901,5.73%,22.76%
2020-01-01 00:07:40,10,5,989,22,967,1.51%,2.22%
2020-01-01 00:07:40,10,6,5854,994,4860,8.93%,16.98%
2020-01-01 00:07:40,10,7,10478,1611,8867,15.99%,15.38%
2020-01-01 00:07:40,10,8,27831,6598,21233,42.47%,23.71%
2020-01-01 00:07:40,10,9,766,8,758,1.17%,1.04%
2020-01-01 00:07:40,10,10,2451,39,2412,3.74%,1.59%
2020-01-01 00:07:40,10,11,13524,1629,11895,20.64%,12.05%
2020-01-01 00:07:40,10,12,10305,1120,9185,15.72%,10.87%
2020-01-01 00:07:40,11,1,2501,59,2442,3.82%,2.36%
2020-01-01 00:07:40,11,2,6685,346,6339,10.20%,5.18%
2020-01-01 00:07:40,11,3,4014,112,3902,6.12%,2.79%
2020-01-01 00:07:40,11,4,4933,221,4712,7.53%,4.48%
2020-01-01 00:07:40,11,5,197,0,197,0.30%,0.00%
2020-01-01 00:07:40,11,6,5655,274,5381,8.63%,4.85%
2020-01-01 00:07:40,11,7,14320,1567,12753,21.85%,10.94%
2020-01-01 00:07:40,11,8,27461,5136,22325,41.90%,18.70%
2020-01-01 00:07:40,11,9,204,0,204,0.31%,0.00%
2020-01-01 00:07:40,11,10,2879,65,2814,4.39%,2.26%
2020-01-01 00:07:40,11,11,9666,640,9026,14.75%,6.62%
2020-01-01 00:07:40,11,12,6528,313,6215,9.96%,4.79%
2020-01-01 00:07:40,12,1,45,1,44,0.07%,2.22%
2020-01-01 00:07:40,12,2,521,196,325,0.79%,37.62%
2020-01-01 00:07:40,12,3,3011,259,2752,4.59%,8.60%
2020-01-01 00:07:40,12,4,2602,75,2527,3.97%,2.88%
2020-01-01 00:07:40,12,5,8739,777,7962,13.33%,8.89%
2020-01-01 00:07:40,12,6,4782,222,4560,7.30%,4.64%
2020-01-01 00:07:40,12,7,2061,63,1998,3.14%,3.06%
2020-01-01 00:07:40,12,8,1349,243,1106,2.06%,18.01%
2020-01-01 00:07:40,12,9,21144,4007,17137,32.26%,18.95%
2020-01-01 00:07:40,12,10,4367,358,4009,6.66%,8.20%
2020-01-01 00:07:40,12,11,1954,257,1697,2.98%,13.15%
2020-01-01 00:07:40,12,12,7314,1075,6239,11.16%,14.70%
2020-01-01 00:07:40,13,1,2414,47,2367,3.68%,1.95%
2020-01-01 00:07:40,13,2,2730,61,2669,4.17%,2.23%
2020-01-01 00:07:40,13,3,730,2,728,1.11%,0.27%
2020-01-01 00:07:40,13,4,5078,599,4479,7.75%,11.80%
2020-01-01 00:07:40,13,5,7123,836,6287,10.87%,11.74%
2020-01-01 00:07:40,13,6,5626,639,4987,8.58%,11.36%
2020-01-01 00:07:40,13,7,5214,231,4983,7.96%,4.43%
2020-01-01 00:07:40,13,8,7801,481,7320,11.90%,6.17%
2020-01-01 00:07:40,13,9,7377,864,6513,11.26%,11.71%
2020-01-01 00:07:40,13,10,27070,5517,21553,41.31%,20.38%
2020-01-01 00:07:40,13,11,16879,2322,14557,25.76%,13.76%
2020-01-01 00:07:40,13,12,8722,895,7827,13.31%,10.26%
2020-01-01 00:07:40,14,1,368,1,367,0.56%,0.27%
2020-01-01 00:07:40,14,2,1484,18,1466,2.26%,1.21%
2020-01-01 00:07:40,14,3,945,4,941,1.44%,0.42%
2020-01-01 00:07:40,14,4,4299,148,4151,6.56%,3.44%
2020-01-01 00:07:40,14,5,1312,9,1303,2.00%,0.69%
2020-01-01 00:07:40,14,6,4615,166,4449,7.04%,3.60%
2020-01-01 00:07:40,14,7,12953,1190,11763,19.76%,9.19%
2020-01-01 00:07:40,14,8,14558,1481,13077,22.21%,10.17%
2020-01-01 00:07:40,14,9,1504,14,1490,2.29%,0.93%
2020-01-01 00:07:40,14,10,4256,139,4117,6.49%,3.27%
2020-01-01 00:07:40,14,11,27014,4821,22193,41.22%,17.85%
2020-01-01 00:07:40,14,12,7993,458,7535,12.20%,5.73%
2020-01-01 00:07:40,15,1,489,1,488,0.75%,0.20%
2020-01-01 00:07:40,15,2,157,0,157,0.24%,0.00%
2020-01-01 00:07:40,15,3,5287,212,5075,8.07%,4.01%
2020-01-01 00:07:40,15,4,6561,314,6247,10.01%,4.79%
2020-01-01 00:07:40,15,5,13357,1320,12037,20.38%,9.88%
2020-01-01 00:07:40,15,6,6883,353,6530,10.50%,5.13%
2020-01-01 00:07:40,15,7,3843,130,3713,5.86%,3.38%
2020-01-01 00:07:40,15,8,6215,326,5889,9.48%,5.25%
2020-01-01 00:07:40,15,9,13548,1358,12190,20.67%,10.02%
2020-01-01 00:07:40,15,10,3984,157,3827,6.08%,3.94%
2020-01-01 00:07:40,15,11,10328,810,9518,15.76%,7.84%
2020-01-01 00:07:40,15,12,29550,6106,23444,45.09%,20.66%
2020-01-01 00:07:40,16,1,553,5,548,0.84%,0.90%
2020-01-01 00:07:40,16,2,241,0,241,0.37%,0.00%
2020-01-01 00:07:40,16,3,1762,28,1734,2.69%,1.59%
2020-01-01 00:07:40,16,4,4912,175,4737,7.50%,3.56%
2020-01-01 00:07:40,16,5,8765,571,8194,13.37%,6.51%
2020-01-01 00:07:40,16,6,5646,214,5432,8.62%,3.79%
2020-01-01 00:07:40,16,7,3594,117,3477,5.48%,3.26%
2020-01-01 00:07:40,16,8,7495,467,7028,11.44%,6.23%
2020-01-01 00:07:40,16,9,9114,614,8500,13.91%,6.74%
2020-01-01 00:07:40,16,10,1560,24,1536,2.38%,1.54%
2020-01-01 00:07:40,16,11,9252,694,8558,14.12%,7.50%
2020-01-01 00:07:40,16,12,25663,4531,21132,39.16%,17.66%
2020-01-01 00:07:50,1,1,16129,1850,14279,24.61%,11.47%
2020-01-01 00:07:50,1,2,5120,203,4917,7.81%,3.96%
2020-01-01 00:07:50,1,3,1244,12,1232,1.90%,0.96%
2020-01-01 00:07:50,1,4,10520,793,9727,16.05%,7.54%
2020-01-01 00:07:50,1,5,10270,767,9503,15.67%,7.47%
2020-01-01 00:07:50,1,6,10242,757,9485,15.63%,7.39%
2020-01-01 00:07:50,1,7,3857,119,3738,5.89%,3.09%
2020-01-01 00:07:50,1,8,2848,77,2771,4.35%,2.70%
2020-01-01 00:07:50,1,9,10202,755,9447,15.57%,7.40%
2020-01-01 00:07:50,1,10,2166,45,2121,3.31%,2.08%
2020-01-01 00:07:50,1,11,2281,51,2230,3.48%,2.24%
2020-01-01 00:07:50,1,12,10176,749,9427,15.53%,7.36%
2020-01-01 00:07:50,2,1,611,2,609,0.93%,0.33%
2020-01-01 00:07:50,2,2,33630,7276,26354,51.32%,21.64%
2020-01-01 00:07:50,2,3,25691,4446,21245,39.20%,17.31%
2020-01-01 00:07:50,2,4,539,2,537,0.82%,0.37%
2020-01-01 00:07:50,2,5,12471,1126,11345,19.03%,9.03%
2020-01-01 00:07:50,2,6,56,0,56,0.09%,0.00%
2020-01-01 00:07:50,2,7,7309,391,6918,11.15%,5.35%
2020-01-01 00:07:50,2,8,5594,247,5347,8.54%,4.42%
2020-01-01 00:07:50,2,9,12391,1109,11282,18.91%,8.95%
2020-01-01 00:07:50,2,10,4623,179,4444,7.05%,3.87%
2020-01-01 00:07:50,2,11,4640,179,4461,7.08%,3.86%
2020-01-01 00:07:50,2,12,12235,1081,11154,18.67%,8.84%
2020-01-01 00:07:50,3,1,1455,16,1439,2.22%,1.10%
2020-01-01 00:07:50,3,2,24999,4178,20821,38.15%,16.71%
2020-01-01 00:07:50,3,3,71736,28034,43702,109.46%,39.08%
2020-01-01 00:07:50,3,4,9748,680,9068,14.87%,6.98%
2020-01-01 00:07:50,3,5,44097,11958,32139,67.29%,27.12%
2020-01-01 00:07:50,3,6,11290,911,10379,17.23%,8.07%
2020-01-01 00:07:50,3,7,22105,3330,18775,33.73%,15.06%
2020-01-01 00:07:50,3,8,17868,2224,15644,27.26%,12.45%
2020-01-01 00:07:50,3,9,32415,6820,25595,49.46%,21.04%
2020-01-01 00:07:50,3,10,3101,72,3029,4.73%,2.32%
2020-01-01 00:07:50,3,11,1991,30,1961,3.04%,1.51%
2020-01-01 00:07:50,3,12,26070,4622,21448,39.78%,17.73%
2020-01-01 00:07:50,4,1,510,4,506,0.78%,0.78%
2020-01-01 00:07:50,4,2,309,2,307,0.47%,0.65%
2020-01-01 00:07:50,4,3,788,0,788,1.20%,0.00%
2020-01-01 00:07:50,4,4,27259,4939,22320,41.59%,18.12%
2020-01-01 00:07:50,4,5,16707,1926,14781,25.49%,11.53%
2020-01-01 00:07:50,4,6,23207,3594,19613,35.41%,15.49%
2020-01-01 00:07:50,4,7,5231,208,5023,7.98%,3.98%
2020-01-01 00:07:50,4,8,2877,72,2805,4.39%,2.50%
2020-01-01 00:07:50,4,9,14786,1555,13231,22.56%,10.52%
2020-01-01 00:07:50,4,10,1761,21,1740,2.69%,1.19%
2020-01-01 00:07:50,4,11,194,0,194,0.30%,0.00%
2020-01-01 00:07:50,4,12,12432,1128,11304,18.97%,9.07%
2020-01-01 00:07:50,5,1,2962,62,2900,4.52%,2.09%
2020-01-01 00:07:50,5,2,789,7,782,1.20%,0.89%
2020-01-01 00:07:50,5,3,375,0,375,0.57%,0.00%
2020-01-01 00:07:50,5,4,20433,3067,17366,31.18%,15.01%
2020-01-01 00:07:50,5,5,9223,697,8526,14.07%,7.56%
2020-01-01 00:07:50,5,6,13208,1349,11859,20.15%,10.21%
2020-01-01 00:07:50,5,7,3530,125,3405,5.39%,3.54%
2020-01-01 00:07:50,5,8,2894,79,2815,4.42%,2.73%
2020-01-01 00:07:50,5,9,8703,626,8077,13.28%,7.19%
2020-01-01 00:07:50,5,10,1060,17,1043,1.62%,1.60%
2020-01-01 00:07:50,5,11,569,6,563,0.87%,1.05%
2020-01-01 00:07:50,5,12,7344,446,6898,11.21%,6.07%
2020-01-01 00:07:50,6,1,982,10,972,1.50%,1.02%
2020-01-01 00:07:50,6,2,1128,11,1117,1.72%,0.98%
2020-01-01 00:07:50,6,3,1491,17,1474,2.28%,1.14%
2020-01-01 00:07:50,6,4,1035,7,1028,1.58%,0.68%
2020-01-01 00:07:50,6,5,12851,1219,11632,19.61%,9.49%
2020-01-01 00:07:50,6,6,5214,217,4997,7.96%,4.16%
2020-01-01 00:07:50,6,7,3824,135,3689,5.83%,3.53%
2020-01-01 00:07:50,6,8,2864,91,2773,4.37%,3.18%
2020-01-01 00:07:50,6,9,5833,240,5593,8.90%,4.11%
2020-01-01 00:07:50,6,10,1762,29,1733,2.69%,1.65%
2020-01-01 00:07:50,6,11,434,2,432,0.66%,0.46%
2020-01-01 00:07:50,6,12,4007,108,3899,6.11%,2.70%
2020-01-01 00:07:50,7,1,406,2,404,0.62%,0.49%
2020-01-01 00:07:50,7,2,165,1,164,0.25%,0.61%
2020-01-01 00:07:50,7,3,736,3,733,1.12%,0.41%
2020-01-01 00:07:50,7,4,2333,31,2302,3.56%,1.33%
2020-01-01 00:07:50,7,5,6529,300,6229,9.96%,4.59%
2020-01-01 00:07:50,7,6,12679,1128,11551,19.35%,8.90%
2020-01-01 00:07:50,7,7,3758,106,3652,5.73%,2.82%
2020-01-01 00:07:50,7,8,1957,37,1920,2.99%,1.89%
2020-01-01 00:07:50,7,9,5491,208,5283,8.38%,3.79%
2020-01-01 00:07:50,7,10,913,2,911,1.39%,0.22%
2020-01-01 00:07:50,7,11,235,0,235,0.36%,0.00%
2020-01-01 00:07:50,7,12,4541,145,4396,6.93%,3.19%
2020-01-01 00:07:50,8,1,479,5,474,0.73%,1.04%
2020-01-01 00:07:50,8,2,73,0,73,0.11%,0.00%
2020-01-01 00:07:50,8,3,1799,31,1768,2.75%,1.72%
2020-01-01 00:07:50,8,4,3116,65,3051,4.75%,2.09%
2020-01-01 00:07:50,8,5,8724,612,8112,13.31%,7.02%
2020-01-01 00:07:50,8,6,16356,1878,14478,24.96%,11.48%
2020-01-01 00:07:50,8,7,4478,124,4354,6.83%,2.77%
2020-01-01 00:07:50,8,8,1700,18,1682,2.59%,1.06%
2020-01-01 00:07:50,8,9,6734,343,6391,10.28%,5.09%
2020-01-01 00:07:50,8,10,1832,25,1807,2.80%,1.36%
2020-01-01 00:07:50,8,11,194,0,194,0.30%,0.00%
2020-01-01 00:07:50,8,12,5000,194,4806,7.63%,3.88%
2020-01-01 00:07:50,9,1,346,3,343,0.53%,0.87%
2020-01-01 00:07:50,9,2,2986,66,2920,4.56%,2.21%
2020-01-01 00:07:50,9,3,2198,36,2162,3.35%,1.64%
2020-01-01 00:07:50,9,4,5172,159,5013,7.89%,3.07%
2020-01-01 00:07:50,9,5,346,0,346,0.53%,0.00%
2020-01-01 00:07:50,9,6,6071,222,5849,9.26%,3.66%
2020-01-01 00:07:50,9,7,29580,6065,23515,45.14%,20.50%
2020-01-01 00:07:50,9,8,13918,1596,12322,21.24%,11.47%
2020-01-01 00:07:50,9,9,142,0,142,0.22%,0.00%
2020-01-01 00:07:50,9,10,5816,497,5319,8.87%,8.55%
2020-01-01 00:07:50,9,11,12866,1387,11479,19.63%,10.78%
2020-01-01 00:07:50,9,12,6726,353,6373,10.26%,5.25%
2020-01-01 00:07:50,10,1,1249,228,1021,1.91%,18.25%
2020-01-01 00:07:50,10,2,2766,272,2494,4.22%,9.83%
2020-01-01 00:07:50,10,3,1387,18,1369,2.12%,1.30%
2020-01-01 00:07:50,10,4,4146,1114,3032,6.33%,26.87%
2020-01-01 00:07:50,10,5,1006,105,901,1.54%,10.44%
2020-01-01 00:07:50,10,6,5902,1317,4585,9.01%,22.31%
2020-01-01 00:07:50,10,7,10370,1988,8382,15.82%,19.17%
2020-01-01 00:07:50,10,8,27761,6919,20842,42.36%,24.92%
2020-01-01 00:07:50,10,9,646,2,644,0.99%,0.31%
2020-01-01 00:07:50,10,10,1941,33,1908,2.96%,1.70%
2020-01-01 00:07:50,10,11,12120,1301,10819,18.49%,10.73%
2020-01-01 00:07:50,10,12,9368,876,8492,14.29%,9.35%
2020-01-01 00:07:50,11,1,2167,34,2133,3.31%,1.57%
2020-01-01 00:07:50,11,2,3165,74,3091,4.83%,2.34%
2020-01-01 00:07:50,11,3,843,8,835,1.29%,0.95%
2020-01-01 00:07:50,11,4,3524,97,3427,5.38%,2.75%
2020-01-01 00:07:50,11,5,235,2,233,0.36%,0.85%
2020-01-01 00:07:50,11,6,4278,133,4145,6.53%,3.11%
2020-01-01 00:07:50,11,7,9246,603,8643,14.11%,6.52%
2020-01-01 00:07:50,11,8,23713,3818,19895,36.18%,16.10%
2020-01-01 00:07:50,11,9,191,2,189,0.29%,1.05%
2020-01-01 00:07:50,11,10,2970,79,2891,4.53%,2.66%
2020-01-01 00:07:50,11,11,10401,796,9605,15.87%,7.65%
2020-01-01 00:07:50,11,12,6957,349,6608,10.62%,5.02%
2020-01-01 00:07:50,12,1,59,0,59,0.09%,0.00%
2020-01-01 00:07:50,12,2,458,124,334,0.70%,27.07%
2020-01-01 00:07:50,12,3,4276,266,4010,6.52%,6.22%
2020-01-01 00:07:50,12,4,3330,89,3241,5.08%,2.67%
2020-01-01 00:07:50,12,5,9806,815,8991,14.96%,8.31%
2020-01-01 00:07:50,12,6,4893,186,4707,7.47%,3.80%
2020-01-01 00:07:50,12,7,1465,20,1445,2.24%,1.37%
2020-01-01 00:07:50,12,8,1460,248,1212,2.23%,16.99%
2020-01-01 00:07:50,12,9,22806,4417,18389,34.80%,19.37%
2020-01-01 00:07:50,12,10,4103,325,3778,6.26%,7.92%
2020-01-01 00:07:50,12,11,1733,249,1484,2.64%,14.37%
2020-01-01 00:07:50,12,12,7828,1201,6627,11.94%,15.34%
2020-01-01 00:07:50,13,1,2144,45,2099,3.27%,2.10%
2020-01-01 00:07:50,13,2,2528,63,2465,3.86%,2.49%
2020-01-01 00:07:50,13,3,586,6,580,0.89%,1.02%
2020-01-01 00:07:50,13,4,5435,932,4503,8.29%,17.15%
2020-01-01 00:07:50,13,5,7629,1272,6357,11.64%,16.67%
2020-01-01 00:07:50,13,6,5840,954,4886,8.91%,16.34%
2020-01-01 00:07:50,13,7,4744,176,4568,7.24%,3.71%
2020-01-01 00:07:50,13,8,7216,394,6822,11.01%,5.46%
2020-01-01 00:07:50,13,9,7982,1303,6679,12.18%,16.32%
2020-01-01 00:07:50,13,10,27076,5608,21468,41.31%,20.71%
2020-01-01 00:07:50,13,11,17076,2177,14899,26.06%,12.75%
2020-01-01 00:07:50,13,12,9454,822,8632,14.43%,8.69%
2020-01-01 00:07:50,14,1,432,0,432,0.66%,0.00%
2020-01-01 00:07:50,14,2,1608,24,1584,2.45%,1.49%
2020-01-01 00:07:50,14,3,925,16,909,1.41%,1.73%
2020-01-01 00:07:50,14,4,4003,128,3875,6.11%,3.20%
2020-01-01 00:07:50,14,5,1391,9,1382,2.12%,0.65%
2020-01-01 00:07:50,14,6,4377,156,4221,6.68%,3.56%
2020-01-01 00:07:50,14,7,12251,1156,11095,18.69%,9.44%
2020-01-01 00:07:50,14,8,14097,1471,12626,21.51%,10.43%
2020-01-01 00:07:50,14,9,1557,11,1546,2.38%,0.71%
2020-01-01 00:07:50,14,10,4096,120,3976,6.25%,2.93%
2020-01-01 00:07:50,14,11,28100,5379,22721,42.88%,19.14%
2020-01-01 00:07:50,14,12,9543,694,8849,14.56%,7.27%
2020-01-01 00:07:50,15,1,534,3,531,0.81%,0.56%
2020-01-01 00:07:50,15,2,122,0,122,0.19%,0.00%
2020-01-01 00:07:50,15,3,10806,867,9939,16.49%,8.02%
2020-01-01 00:07:50,15,4,4813,196,4617,7.34%,4.07%
2020-01-01 00:07:50,15,5,16555,1976,14579,25.26%,11.94%
2020-01-01 00:07:50,15,6,5110,255,4855,7.80%,4.99%
2020-01-01 00:07:50,15,7,3060,87,2973,4.67%,2.84%
2020-01-01 00:07:50,15,8,4995,190,4805,7.62%,3.80%
2020-01-01 00:07:50,15,9,16741,2018,14723,25.54%,12.05%
2020-01-01 00:07:50,15,10,4512,453,4059,6.88%,10.04%
2020-01-01 00:07:50,15,11,9673,959,8714,14.76%,9.91%
2020-01-01 00:07:50,15,12,32290,7216,25074,49.27%,22.35%
2020-01-01 00:07:50,16,1,427,3,424,0.65%,0.70%
2020-01-01 00:07:50,16,2,241,0,241,0.37%,0.00%
2020-01-01 00:07:50,16,3,1834,22,1812,2.80%,1.20%
2020-01-01 00:07:50,16,4,5059,195,4864,7.72%,3.85%
2020-01-01 00:07:50,16,5,9189,659,8530,14.02%,7.17%
2020-01-01 00:07:50,16,6,5877,253,5624,8.97%,4.30%
2020-01-01 00:07:50,16,7,3297,78,3219,5.03%,2.37%
2020-01-01 00:07:50,16,8,7655,480,7175,11.68%,6.27%
2020-01-01 00:07:50,16,9,9713,715,8998,14.82%,7.36%
2020-01-01 00:07:50,16,10,1603,24,1579,2.45%,1.50%
2020-01-01 00:07:50,16,11,9482,721,8761,14.47%,7.60%
2020-01-01 00:07:50,16,12,27424,5154,22270,41.85%,18.79%
2020-01-01 00:08:00,1,1,15701,1830,13871,23.96%,11.66%
2020-01-01 00:08:00,1,2,5053,222,4831,7.71%,4.39%
2020-01-01 00:08:00,1,3,395,0,395,0.60%,0.00%
2020-01-01 00:08:00,1,4,10406,839,9567,15.88%,8.06%
2020-01-01 00:08:00,1,5,10080,793,9287,15.38%,7.87%
2020-01-01 00:08:00,1,6,10085,794,9291,15.39%,7.87%
2020-01-01 00:08:00,1,7,4627,190,4437,7.06%,4.11%
2020-01-01 00:08:00,1,8,3899,124,3775,5.95%,3.18%
2020-01-01 00:08:00,1,9,10043,790,9253,15.32%,7.87%
2020-01-01 00:08:00,1,10,3247,86,3161,4.95%,2.65%
2020-01-01 00:08:00,1,11,3365,92,3273,5.13%,2.73%
2020-01-01 00:08:00,1,12,10025,788,9237,15.30%,7.86%
2020-01-01 00:08:00,2,1,540,1,539,0.82%,0.19%
2020-01-01 00:08:00,2,2,41630,10803,30827,63.52%,25.95%
2020-01-01 00:08:00,2,3,28597,5440,23157,43.64%,19.02%
2020-01-01 00:08:00,2,4,439,1,438,0.67%,0.23%
2020-01-01 00:08:00,2,5,17347,2062,15285,26.47%,11.89%
2020-01-01 00:08:00,2,6,53,0,53,0.08%,0.00%
2020-01-01 00:08:00,2,7,12477,1114,11363,19.04%,8.93%
2020-01-01 00:08:00,2,8,10727,834,9893,16.37%,7.77%
2020-01-01 00:08:00,2,9,16918,1961,14957,25.81%,11.59%
2020-01-01 00:08:00,2,10,10031,729,9302,15.31%,7.27%
2020-01-01 00:08:00,2,11,10036,731,9305,15.31%,7.28%
2020-01-01 00:08:00,2,12,16775,1931,14844,25.60%,11.51%
2020-01-01 00:08:00,3,1,1469,20,1449,2.24%,1.36%
2020-01-01 00:08:00,3,2,26433,4650,21783,40.33%,17.59%
2020-01-01 00:08:00,3,3,65640,24146,41494,100.16%,36.79%
2020-01-01 00:08:00,3,4,6890,364,6526,10.51%,5.28%
2020-01-01 00:08:00,3,5,38221,9199,29022,58.32%,24.07%
2020-01-01 00:08:00,3,6,8751,572,8179,13.35%,6.54%
2020-01-01 00:08:00,3,7,22663,3415,19248,34.58%,15.07%
2020-01-01 00:08:00,3,8,17668,2155,15513,26.96%,12.20%
2020-01-01 00:08:00,3,9,28655,5425,23230,43.72%,18.93%
2020-01-01 00:08:00,3,10,6226,258,5968,9.50%,4.14%
2020-01-01 00:08:00,3,11,2085,31,2054,3.18%,1.49%
2020-01-01 00:08:00,3,12,20523,2893,17630,31.32%,14.10%
2020-01-01 00:08:00,4,1,497,2,495,0.76%,0.40%
2020-01-01 00:08:00,4,2,291,1,290,0.44%,0.34%
2020-01-01 00:08:00,4,3,931,4,927,1.42%,0.43%
2020-01-01 00:08:00,4,4,26236,4639,21597,40.03%,17.68%
2020-01-01 00:08:00,4,5,17411,2146,15265,26.57%,12.33%
2020-01-01 00:08:00,4,6,22661,3540,19121,34.58%,15.62%
2020-01-01 00:08:00,4,7,4026,121,3905,6.14%,3.01%
2020-01-01 00:08:00,4,8,2717,65,2652,4.15%,2.39%
2020-01-01 00:08:00,4,9,15367,1665,13702,23.45%,10.83%
2020-01-01 00:08:00,4,10,1759,21,1738,2.68%,1.19%
2020-01-01 00:08:00,4,11,87,0,87,0.13%,0.00%
2020-01-01 00:08:00,4,12,12768,1188,11580,19.48%,9.30%
2020-01-01 00:08:00,5,1,2712,56,2656,4.14%,2.06%
2020-01-01 00:08:00,5,2,819,5,814,1.25%,0.61%
2020-01-01 00:08:00,5,3,1225,6,1219,1.87%,0.49%
2020-01-01 00:08:00,5,4,23415,3697,19718,35.73%,15.79%
2020-01-01 00:08:00,5,5,10237,765,9472,15.62%,7.47%
2020-01-01 00:08:00,5,6,15931,1797,14134,24.31%,11.28%
2020-01-01 00:08:00,5,7,5225,227,4998,7.97%,4.34%
2020-01-01 00:08:00,5,8,4367,161,4206,6.66%,3.69%
2020-01-01 00:08:00,5,9,8878,562,8316,13.55%,6.33%
2020-01-01 00:08:00,5,10,1187,15,1172,1.81%,1.26%
2020-01-01 00:08:00,5,11,894,9,885,1.36%,1.01%
2020-01-01 00:08:00,5,12,7384,393,6991,11.27%,5.32%
2020-01-01 00:08:00,6,1,1152,16,1136,1.76%,1.39%
2020-01-01 00:08:00,6,2,1244,19,1225,1.90%,1.53%
2020-01-01 00:08:00,6,3,1446,23,1423,2.21%,1.59%
2020-01-01 00:08:00,6,4,1389,7,1382,2.12%,0.50%
2020-01-01 00:08:00,6,5,15484,1642,13842,23.63%,10.60%
2020-01-01 00:08:00,6,6,4255,123,4132,6.49%,2.89%
2020-01-01 00:08:00,6,7,2349,37,2312,3.58%,1.58%
2020-01-01 00:08:00,6,8,1763,27,1736,2.69%,1.53%
2020-01-01 00:08:00,6,9,9434,630,8804,14.40%,6.68%
2020-01-01 00:08:00,6,10,2125,40,2085,3.24%,1.88%
2020-01-01 00:08:00,6,11,479,2,477,0.73%,0.42%
2020-01-01 00:08:00,6,12,7185,350,6835,10.96%,4.87%
2020-01-01 00:08:00,7,1,535,1,534,0.82%,0.19%
2020-01-01 00:08:00,7,2,145,1,144,0.22%,0.69%
2020-01-01 00:08:00,7,3,915,2,913,1.40%,0.22%
2020-01-01 00:08:00,7,4,1899,31,1868,2.90%,1.63%
2020-01-01 00:08:00,7,5,6628,285,6343,10.11%,4.30%
2020-01-01 00:08:00,7,6,12220,1020,11200,18.65%,8.35%
2020-01-01 00:08:00,7,7,3656,133,3523,5.58%,3.64%
2020-01-01 00:08:00,7,8,1501,8,1493,2.29%,0.53%
2020-01-01 00:08:00,7,9,5673,215,5458,8.66%,3.79%
2020-01-01 00:08:00,7,10,935,7,928,1.43%,0.75%
2020-01-01 00:08:00,7,11,208,0,208,0.32%,0.00%
2020-01-01 00:08:00,7,12,4703,150,4553,7.18%,3.19%
2020-01-01 00:08:00,8,1,376,2,374,0.57%,0.53%
2020-01-01 00:08:00,8,2,60,0,60,0.09%,0.00%
2020-01-01 00:08:00,8,3,1627,18,1609,2.48%,1.11%
2020-01-01 00:08:00,8,4,2517,56,2461,3.84%,2.22%
2020-01-01 00:08:00,8,5,7575,405,7170,11.56%,5.35%
2020-01-01 00:08:00,8,6,14716,1529,13187,22.45%,10.39%
2020-01-01 00:08:00,8,7,4557,137,4420,6.95%,3.01%
2020-01-01 00:08:00,8,8,1668,20,1648,2.55%,1.20%
2020-01-01 00:08:00,8,9,5797,242,5555,8.85%,4.17%
2020-01-01 00:08:00,8,10,1731,25,1706,2.64%,1.44%
2020-01-01 00:08:00,8,11,323,0,323,0.49%,0.00%
2020-01-01 00:08:00,8,12,4008,118,3890,6.12%,2.94%
2020-01-01 00:08:00,9,1,266,1,265,0.41%,0.38%
2020-01-01 00:08:00,9,2,3233,80,3153,4.93%,2.47%
2020-01-01 00:08:00,9,3,2605,52,2553,3.97%,2.00%
2020-01-01 00:08:00,9,4,11757,981,10776,17.94%,8.34%
2020-01-01 00:08:00,9,5,217,0,217,0.33%,0.00%
2020-01-01 00:08:00,9,6,12183,1049,11134,18.59%,8.61%
2020-01-01 00:08:00,9,7,32023,6758,25265,48.86%,21.10%
2020-01-01 00:08:00,9,8,10887,895,9992,16.61%,8.22%
2020-01-01 00:08:00,9,9,176,0,176,0.27%,0.00%
2020-01-01 00:08:00,9,10,4181,127,4054,6.38%,3.04%
2020-01-01 00:08:00,9,11,9687,715,8972,14.78%,7.38%
2020-01-01 00:08:00,9,12,5203,211,4992,7.94%,4.06%
2020-01-01 00:08:00,10,1,932,311,621,1.42%,33.37%
2020-01-01 00:08:00,10,2,4032,407,3625,6.15%,10.09%
2020-01-01 00:08:00,10,3,2903,58,2845,4.43%,2.00%
2020-01-01 00:08:00,10,4,4041,1067,2974,6.17%,26.40%
2020-01-01 00:08:00,10,5,643,14,629,0.98%,2.18%
2020-01-01 00:08:00,10,6,5831,1190,4641,8.90%,20.41%
2020-01-01 00:08:00,10,7,11763,2100,9663,17.95%,17.85%
2020-01-01 00:08:00,10,8,27237,6637,20600,41.56%,24.37%
2020-01-01 00:08:00,10,9,690,3,687,1.05%,0.43%
2020-01-01 00:08:00,10,10,2646,57,2589,4.04%,2.15%
2020-01-01 00:08:00,10,11,12049,1352,10697,18.39%,11.22%
2020-01-01 00:08:00,10,12,8889,866,8023,13.56%,9.74%
2020-01-01 00:08:00,11,1,2494,55,2439,3.81%,2.21%
2020-01-01 00:08:00,11,2,3927,134,3793,5.99%,3.41%
2020-01-01 00:08:00,11,3,1290,13,1277,1.97%,1.01%
2020-01-01 00:08:00,11,4,7142,373,6769,10.90%,5.22%
2020-01-01 00:08:00,11,5,209,2,207,0.32%,0.96%
2020-01-01 00:08:00,11,6,7969,467,7502,12.16%,5.86%
2020-01-01 00:08:00,11,7,14040,1419,12621,21.42%,10.11%
2020-01-01 00:08:00,11,8,28511,5443,23068,43.50%,19.09%
2020-01-01 00:08:00,11,9,330,0,330,0.50%,0.00%
2020-01-01 00:08:00,11,10,3532,89,3443,5.39%,2.52%
2020-01-01 00:08:00,11,11,10171,726,9445,15.52%,7.14%
2020-01-01 00:08:00,11,12,6309,295,6014,9.63%,4.68%
2020-01-01 00:08:00,12,1,17,0,17,0.03%,0.00%
2020-01-01 00:08:00,12,2,654,251,403,1.00%,38.38%
2020-01-01 00:08:00,12,3,3172,301,2871,4.84%,9.49%
2020-01-01 00:08:00,12,4,3655,96,3559,5.58%,2.63%
2020-01-01 00:08:00,12,5,10252,931,9321,15.64%,9.08%
2020-01-01 00:08:00,12,6,6165,256,5909,9.41%,4.15%
2020-01-01 00:08:00,12,7,2402,29,2373,3.67%,1.21%
2020-01-01 00:08:00,12,8,1283,201,1082,1.96%,15.67%
2020-01-01 00:08:00,12,9,24340,4743,19597,37.14%,19.49%
2020-01-01 00:08:00,12,10,3706,281,3425,5.65%,7.58%
2020-01-01 00:08:00,12,11,1539,205,1334,2.35%,13.32%
2020-01-01 00:08:00,12,12,9651,1179,8472,14.73%,12.22%
2020-01-01 00:08:00,13,1,2386,45,2341,3.64%,1.89%
2020-01-01 00:08:00,13,2,2686,57,2629,4.10%,2.12%
2020-01-01 00:08:00,13,3,1000,7,993,1.53%,0.70%
2020-01-01 00:08:00,13,4,5339,489,4850,8.15%,9.16%
2020-01-01 00:08:00,13,5,7590,792,6798,11.58%,10.43%
2020-01-01 00:08:00,13,6,5939,536,5403,9.06%,9.03%
2020-01-01 00:08:00,13,7,4730,176,4554,7.22%,3.72%
2020-01-01 00:08:00,13,8,6845,384,6461,10.44%,5.61%
2020-01-01 00:08:00,13,9,7883,825,7058,12.03%,10.47%
2020-01-01 00:08:00,13,10,26950,5384,21566,41.12%,19.98%
2020-01-01 00:08:00,13,11,16574,2180,14394,25.29%,13.15%
2020-01-01 00:08:00,13,12,9407,893,8514,14.35%,9.49%
2020-01-01 00:08:00,14,1,414,0,414,0.63%,0.00%
2020-01-01 00:08:00,14,2,2054,55,1999,3.13%,2.68%
2020-01-01 00:08:00,14,3,1419,31,1388,2.17%,2.18%
2020-01-01 00:08:00,14,4,4306,136,4170,6.57%,3.16%
2020-01-01 00:08:00,14,5,1451,25,1426,2.21%,1.72%
2020-01-01 00:08:00,14,6,4581,153,4428,6.99%,3.34%
2020-01-01 00:08:00,14,7,11321,942,10379,17.27%,8.32%
2020-01-01 00:08:00,14,8,13230,1256,11974,20.19%,9.49%
2020-01-01 00:08:00,14,9,1665,30,1635,2.54%,1.80%
2020-01-01 00:08:00,14,10,3952,141,3811,6.03%,3.57%
2020-01-01 00:08:00,14,11,23766,3897,19869,36.26%,16.40%
2020-01-01 00:08:00,14,12,6332,307,6025,9.66%,4.85%
2020-01-01 00:08:00,15,1,463,2,461,0.71%,0.43%
2020-01-01 00:08:00,15,2,245,1,244,0.37%,0.41%
2020-01-01 00:08:00,15,3,3544,113,3431,5.41%,3.19%
2020-01-01 00:08:00,15,4,4865,182,4683,7.42%,3.74%
2020-01-01 00:08:00,15,5,9283,754,8529,14.16%,8.12%
2020-01-01 00:08:00,15,6,5081,196,4885,7.75%,3.86%
2020-01-01 00:08:00,15,7,3383,108,3275,5.16%,3.19%
2020-01-01 00:08:00,15,8,5217,220,4997,7.96%,4.22%
2020-01-01 00:08:00,15,9,9422,770,8652,14.38%,8.17%
2020-01-01 00:08:00,15,10,5008,334,4674,7.64%,6.67%
2020-01-01 00:08:00,15,11,10326,932,9394,15.76%,9.03%
2020-01-01 00:08:00,15,12,25559,4842,20717,39.00%,18.94%
2020-01-01 00:08:00,16,1,499,0,499,0.76%,0.00%
2020-01-01 00:08:00,16,2,213,1,212,0.33%,0.47%
2020-01-01 00:08:00,16,3,1453,14,1439,2.22%,0.96%
2020-01-01 00:08:00,16,4,4513,143,4370,6.89%,3.17%
2020-01-01 00:08:00,16,5,8142,628,7514,12.42%,7.71%
2020-01-01 00:08:00,16,6,5363,235,5128,8.18%,4.38%
2020-01-01 00:08:00,16,7,2914,60,2854,4.45%,2.06%
2020-01-01 00:08:00,16,8,6633,350,6283,10.12%,5.28%
2020-01-01 00:08:00,16,9,8584,669,7915,13.10%,7.79%
2020-01-01 00:08:00,16,10,2281,42,2239,3.48%,1.84%
2020-01-01 00:08:00,16,11,9097,631,8466,13.88%,6.94%
2020-01-01 00:08:00,16,12,26537,4924,21613,40.49%,18.56%
2020-01-01 00:08:10,1,1,20319,2806,17513,31.00%,13.81%
2020-01-01 00:08:10,1,2,7472,417,7055,11.40%,5.58%
2020-01-01 00:08:10,1,3,586,3,583,0.89%,0.51%
2020-01-01 00:08:10,1,4,12314,1101,11213,18.79%,8.94%
2020-01-01 00:08:10,1,5,12060,1060,11000,18.40%,8.79%
2020-01-01 00:08:10,1,6,12016,1052,10964,18.33%,8.75%
2020-01-01 00:08:10,1,7,6874,347,6527,10.49%,5.05%
2020-01-01 00:08:10,1,8,4169,121,4048,6.36%,2.90%
2020-01-01 00:08:10,1,9,11927,1037,10890,18.20%,8.69%
2020-01-01 00:08:10,1,10,3228,69,3159,4.93%,2.14%
2020-01-01 00:08:10,1,11,3335,82,3253,5.09%,2.46%
2020-01-01 00:08:10,1,12,11901,1034,10867,18.16%,8.69%
2020-01-01 00:08:10,2,1,448,3,445,0.68%,0.67%
2020-01-01 00:08:10,2,2,27050,4960,22090,41.28%,18.34%
2020-01-01 00:08:10,2,3,22467,3483,18984,34.28%,15.50%
2020-01-01 00:08:10,2,4,378,2,376,0.58%,0.53%
2020-01-01 00:08:10,2,5,12543,1155,11388,19.14%,9.21%
2020-01-01 00:08:10,2,6,33,0,33,0.05%,0.00%
2020-01-01 00:08:10,2,7,4123,142,3981,6.29%,3.44%
2020-01-01 00:08:10,2,8,3185,77,3108,4.86%,2.42%
2020-01-01 00:08:10,2,9,12479,1138,11341,19.04%,9.12%
2020-01-01 00:08:10,2,10,2152,33,2119,3.28%,1.53%
2020-01-01 00:08:10,2,11,2158,34,2124,3.29%,1.58%
2020-01-01 00:08:10,2,12,12313,1110,11203,18.79%,9.01%
2020-01-01 00:08:10,3,1,1852,31,1821,2.83%,1.67%
2020-01-01 00:08:10,3,2,22456,3467,18989,34.27%,15.44%
2020-01-01 00:08:10,3,3,66479,24802,41677,101.44%,37.31%
2020-01-01 00:08:10,3,4,11948,986,10962,18.23%,8.25%
2020-01-01 00:08:10,3,5,42789,11308,31481,65.29%,26.43%
2020-01-01 00:08:10,3,6,13226,1201,12025,20.18%,9.08%
2020-01-01 00:08:10,3,7,18973,2473,16500,28.95%,13.03%
2020-01-01 00:08:10,3,8,15136,1605,13531,23.10%,10.60%
2020-01-01 00:08:10,3,9,29077,5577,23500,44.37%,19.18%
2020-01-01 00:08:10,3,10,6099,262,5837,9.31%,4.30%
2020-01-01 00:08:10,3,11,1979,29,1950,3.02%,1.47%
2020-01-01 00:08:10,3,12,21204,3079,18125,32.35%,14.52%
2020-01-01 00:08:10,4,1,576,6,570,0.88%,1.04%
2020-01-01 00:08:10,4,2,331,2,329,0.51%,0.60%
2020-01-01 00:08:10,4,3,987,4,983,1.51%,0.41%
2020-01-01 00:08:10,4,4,30348,6110,24238,46.31%,20.13%
2020-01-01 00:08:10,4,5,18230,2332,15898,27.82%,12.79%
2020-01-01 00:08:10,4,6,25125,4288,20837,38.34%,17.07%
2020-01-01 00:08:10,4,7,5248,208,5040,8.01%,3.96%
2020-01-01 00:08:10,4,8,2951,76,2875,4.50%,2.58%
2020-01-01 00:08:10,4,9,16044,1834,14210,24.48%,11.43%
2020-01-01 00:08:10,4,10,2255,39,2216,3.44%,1.73%
2020-01-01 00:08:10,4,11,234,1,233,0.36%,0.43%
2020-01-01 00:08:10,4,12,12936,1181,11755,19.74%,9.13%
2020-01-01 00:08:10,5,1,3139,72,3067,4.79%,2.29%
2020-01-01 00:08:10,5,2,849,3,846,1.30%,0.35%
2020-01-01 00:08:10,5,3,489,2,487,0.75%,0.41%
2020-01-01 00:08:10,5,4,21442,3177,18265,32.72%,14.82%
2020-01-01 00:08:10,5,5,8309,511,7798,12.68%,6.15%
2020-01-01 00:08:10,5,6,13466,1245,12221,20.55%,9.25%
2020-01-01 00:08:10,5,7,4532,148,4384,6.92%,3.27%
2020-01-01 00:08:10,5,8,3454,72,3382,5.27%,2.08%
2020-01-01 00:08:10,5,9,7694,442,7252,11.74%,5.74%
2020-01-01 00:08:10,5,10,1000,10,990,1.53%,1.00%
2020-01-01 00:08:10,5,11,413,2,411,0.63%,0.48%
2020-01-01 00:08:10,5,12,6440,324,6116,9.83%,5.03%
2020-01-01 00:08:10,6,1,1209,7,1202,1.84%,0.58%
2020-01-01 00:08:10,6,2,1278,8,1270,1.95%,0.63%
2020-01-01 00:08:10,6,3,1663,14,1649,2.54%,0.84%
2020-01-01 00:08:10,6,4,1434,12,1422,2.19%,0.84%
2020-01-01 00:08:10,6,5,13139,1230,11909,20.05%,9.36%
2020-01-01 00:08:10,6,6,4218,127,4091,6.44%,3.01%
2020-01-01 00:08:10,6,7,2405,44,2361,3.67%,1.83%
2020-01-01 00:08:10,6,8,1709,21,1688,2.61%,1.23%
2020-01-01 00:08:10,6,9,6947,358,6589,10.60%,5.15%
2020-01-01 00:08:10,6,10,2193,41,2152,3.35%,1.87%
2020-01-01 00:08:10,6,11,501,2,499,0.76%,0.40%
2020-01-01 00:08:10,6,12,4685,152,4533,7.15%,3.24%
2020-01-01 00:08:10,7,1,617,4,613,0.94%,0.65%
2020-01-01 00:08:10,7,2,600,1,599,0.92%,0.17%
2020-01-01 00:08:10,7,3,708,3,705,1.08%,0.42%
2020-01-01 00:08:10,7,4,2631,52,2579,4.01%,1.98%
2020-01-01 00:08:10,7,5,7154,372,6782,10.92%,5.20%
2020-01-01 00:08:10,7,6,13444,1273,12171,20.51%,9.47%
2020-01-01 00:08:10,7,7,3631,82,3549,5.54%,2.26%
2020-01-01 00:08:10,7,8,1243,13,1230,1.90%,1.05%
2020-01-01 00:08:10,7,9,6400,323,6077,9.77%,5.05%
2020-01-01 00:08:10,7,10,1071,3,1068,1.63%,0.28%
2020-01-01 00:08:10,7,11,73,0,73,0.11%,0.00%
2020-01-01 00:08:10,7,12,5318,234,5084,8.11%,4.40%
2020-01-01 00:08:10,8,1,516,4,512,0.79%,0.78%
2020-01-01 00:08:10,8,2,71,4,67,0.11%,5.63%
2020-01-01 00:08:10,8,3,2083,29,2054,3.18%,1.39%
2020-01-01 00:08:10,8,4,2968,71,2897,4.53%,2.39%
2020-01-01 00:08:10,8,5,8800,565,8235,13.43%,6.42%
2020-01-01 00:08:10,8,6,17628,2221,15407,26.90%,12.60%
2020-01-01 00:08:10,8,7,5792,278,5514,8.84%,4.80%
2020-01-01 00:08:10,8,8,1838,32,1806,2.80%,1.74%
2020-01-01 00:08:10,8,9,6460,297,6163,9.86%,4.60%
2020-01-01 00:08:10,8,10,1905,26,1879,2.91%,1.36%
2020-01-01 00:08:10,8,11,79,0,79,0.12%,0.00%
2020-01-01 00:08:10,8,12,4614,157,4457,7.04%,3.40%
2020-01-01 00:08:10,9,1,497,2,495,0.76%,0.40%
2020-01-01 00:08:10,9,2,2186,44,2142,3.34%,2.01%
2020-01-01 00:08:10,9,3,1381,30,1351,2.11%,2.17%
2020-01-01 00:08:10,9,4,3692,117,3575,5.63%,3.17%
2020-01-01 00:08:10,9,5,799,2,797,1.22%,0.25%
2020-01-01 00:08:10,9,6,5150,220,4930,7.86%,4.27%
2020-01-01 00:08:10,9,7,25856,4555,21301,39.45%,17.62%
2020-01-01 00:08:10,9,8,12303,1073,11230,18.77%,8.72%
2020-01-01 00:08:10,9,9,752,2,750,1.15%,0.27%
2020-01-01 00:08:10,9,10,3568,90,3478,5.44%,2.52%
2020-01-01 00:08:10,9,11,9816,671,9145,14.98%,6.84%
2020-01-01 00:08:10,9,12,5905,264,5641,9.01%,4.47%
2020-01-01 00:08:10,10,1,1692,289,1403,2.58%,17.08%
2020-01-01 00:08:10,10,2,3419,346,3073,5.22%,10.12%
2020-01-01 00:08:10,10,3,1596,27,1569,2.44%,1.69%
2020-01-01 00:08:10,10,4,4228,1186,3042,6.45%,28.05%
2020-01-01 00:08:10,10,5,1035,112,923,1.58%,10.82%
2020-01-01 00:08:10,10,6,6523,1444,5079,9.95%,22.14%
2020-01-01 00:08:10,10,7,11490,2253,9237,17.53%,19.61%
2020-01-01 00:08:10,10,8,33233,9321,23912,50.71%,28.05%
2020-01-01 00:08:10,10,9,532,3,529,0.81%,0.56%
2020-01-01 00:08:10,10,10,3362,71,3291,5.13%,2.11%
2020-01-01 00:08:10,10,11,16349,2425,13924,24.95%,14.83%
2020-01-01 00:08:10,10,12,12123,1618,10505,18.50%,13.35%
2020-01-01 00:08:10,11,1,3055,71,2984,4.66%,2.32%
2020-01-01 00:08:10,11,2,3950,119,3831,6.03%,3.01%
2020-01-01 00:08:10,11,3,697,3,694,1.06%,0.43%
2020-01-01 00:08:10,11,4,5582,252,5330,8.52%,4.51%
2020-01-01 00:08:10,11,5,197,0,197,0.30%,0.00%
2020-01-01 00:08:10,11,6,6471,326,6145,9.87%,5.04%
2020-01-01 00:08:10,11,7,12255,1070,11185,18.70%,8.73%
2020-01-01 00:08:10,11,8,26825,4775,22050,40.93%,17.80%
2020-01-01 00:08:10,11,9,217,2,215,0.33%,0.92%
2020-01-01 00:08:10,11,10,2872,61,2811,4.38%,2.12%
2020-01-01 00:08:10,11,11,10838,877,9961,16.54%,8.09%
2020-01-01 00:08:10,11,12,7393,453,6940,11.28%,6.13%
2020-01-01 00:08:10,12,1,45,0,45,0.07%,0.00%
2020-01-01 00:08:10,12,2,562,175,387,0.86%,31.14%
2020-01-01 00:08:10,12,3,2633,216,2417,4.02%,8.20%
2020-01-01 00:08:10,12,4,3225,151,3074,4.92%,4.68%
2020-01-01 00:08:10,12,5,8595,756,7839,13.11%,8.80%
2020-01-01 00:08:10,12,6,5208,277,4931,7.95%,5.32%
2020-01-01 00:08:10,12,7,1812,26,1786,2.76%,1.43%
2020-01-01 00:08:10,12,8,1849,359,1490,2.82%,19.42%
2020-01-01 00:08:10,12,9,22793,4714,18079,34.78%,20.68%
2020-01-01 00:08:10,12,10,5584,552,5032,8.52%,9.89%
2020-01-01 00:08:10,12,11,2220,365,1855,3.39%,16.44%
2020-01-01 00:08:10,12,12,7712,1320,6392,11.77%,17.12%
2020-01-01 00:08:10,13,1,2040,37,2003,3.11%,1.81%
2020-01-01 00:08:10,13,2,2333,52,2281,3.56%,2.23%
2020-01-01 00:08:10,13,3,1053,3,1050,1.61%,0.28%
2020-01-01 00:08:10,13,4,5049,513,4536,7.70%,10.16%
2020-01-01 00:08:10,13,5,7447,812,6635,11.36%,10.90%
2020-01-01 00:08:10,13,6,5556,553,5003,8.48%,9.95%
2020-01-01 00:08:10,13,7,4471,163,4308,6.82%,3.65%
2020-01-01 00:08:10,13,8,8376,516,7860,12.78%,6.16%
2020-01-01 00:08:10,13,9,7740,848,6892,11.81%,10.96%
2020-01-01 00:08:10,13,10,28315,5857,22458,43.21%,20.69%
2020-01-01 00:08:10,13,11,17315,2399,14916,26.42%,13.86%
2020-01-01 00:08:10,13,12,8641,944,7697,13.19%,10.92%
2020-01-01 00:08:10,14,1,295,0,295,0.45%,0.00%
2020-01-01 00:08:10,14,2,1679,18,1661,2.56%,1.07%
2020-01-01 00:08:10,14,3,1191,11,1180,1.82%,0.92%
2020-01-01 00:08:10,14,4,4386,164,4222,6.69%,3.74%
2020-01-01 00:08:10,14,5,1495,26,1469,2.28%,1.74%
2020-01-01 00:08:10,14,6,4682,189,4493,7.14%,4.04%
2020-01-01 00:08:10,14,7,12911,1187,11724,19.70%,9.19%
2020-01-01 00:08:10,14,8,14458,1452,13006,22.06%,10.04%
2020-01-01 00:08:10,14,9,1729,30,1699,2.64%,1.74%
2020-01-01 00:08:10,14,10,4174,134,4040,6.37%,3.21%
2020-01-01 00:08:10,14,11,29469,5627,23842,44.97%,19.09%
2020-01-01 00:08:10,14,12,10416,748,9668,15.89%,7.18%
2020-01-01 00:08:10,15,1,562,2,560,0.86%,0.36%
2020-01-01 00:08:10,15,2,102,0,102,0.16%,0.00%
2020-01-01 00:08:10,15,3,3981,134,3847,6.07%,3.37%
2020-01-01 00:08:10,15,4,4728,212,4516,7.21%,4.48%
2020-01-01 00:08:10,15,5,9427,695,8732,14.38%,7.37%
2020-01-01 00:08:10,15,6,4919,222,4697,7.51%,4.51%
2020-01-01 00:08:10,15,7,4039,121,3918,6.16%,3.00%
2020-01-01 00:08:10,15,8,6113,294,5819,9.33%,4.81%
2020-01-01 00:08:10,15,9,9626,717,8909,14.69%,7.45%
2020-01-01 00:08:10,15,10,5268,415,4853,8.04%,7.88%
2020-01-01 00:08:10,15,11,11532,1161,10371,17.60%,10.07%
2020-01-01 00:08:10,15,12,26778,5360,21418,40.86%,20.02%
2020-01-01 00:08:10,16,1,563,0,563,0.86%,0.00%
2020-01-01 00:08:10,16,2,221,0,221,0.34%,0.00%
2020-01-01 00:08:10,16,3,1255,13,1242,1.91%,1.04%
2020-01-01 00:08:10,16,4,4159,109,4050,6.35%,2.62%
2020-01-01 00:08:10,16,5,7733,474,7259,11.80%,6.13%
2020-01-01 00:08:10,16,6,5507,220,5287,8.40%,3.99%
2020-01-01 00:08:10,16,7,3557,93,3464,5.43%,2.61%
2020-01-01 00:08:10,16,8,7151,470,6681,10.91%,6.57%
2020-01-01 00:08:10,16,9,8295,537,7758,12.66%,6.47%
2020-01-01 00:08:10,16,10,2490,48,2442,3.80%,1.93%
2020-01-01 00:08:10,16,11,9965,801,9164,15.21%,8.04%
2020-01-01 00:08:10,16,12,26749,4747,22002,40.82%,17.75%
2020-01-01 00:08:20,1,1,15601,1764,13837,23.81%,11.31%
2020-01-01 00:08:20,1,2,5925,278,5647,9.04%,4.69%
2020-01-01 00:08:20,1,3,494,1,493,0.75%,0.20%
2020-01-01 00:08:20,1,4,9398,659,8739,14.34%,7.01%
2020-01-01 00:08:20,1,5,9313,650,8663,14.21%,6.98%
2020-01-01 00:08:20,1,6,9187,635,8552,14.02%,6.91%
2020-01-01 00:08:20,1,7,5406,238,5168,8.25%,4.40%
2020-01-01 00:08:20,1,8,4446,155,4291,6.78%,3.49%
2020-01-01 00:08:20,1,9,9147,627,8520,13.96%,6.85%
2020-01-01 00:08:20,1,10,3800,94,3706,5.80%,2.47%
2020-01-01 00:08:20,1,11,4014,122,3892,6.12%,3.04%
2020-01-01 00:08:20,1,12,9111,618,8493,13.90%,6.78%
2020-01-01 00:08:20,2,1,555,2,553,0.85%,0.36%
2020-01-01 00:08:20,2,2,26232,4605,21627,40.03%,17.55%
2020-01-01 00:08:20,2,3,20183,2785,17398,30.80%,13.80%
2020-01-01 00:08:20,2,4,444,1,443,0.68%,0.23%
2020-01-01 00:08:20,2,5,9900,734,9166,15.11%,7.41%
2020-01-01 00:08:20,2,6,79,0,79,0.12%,0.00%
2020-01-01 00:08:20,2,7,5472,210,5262,8.35%,3.84%
2020-01-01 00:08:20,2,8,4014,112,3902,6.12%,2.79%
2020-01-01 00:08:20,2,9,9797,720,9077,14.95%,7.35%
2020-01-01 00:08:20,2,10,3141,70,3071,4.79%,2.23%
2020-01-01 00:08:20,2,11,3155,70,3085,4.81%,2.22%
2020-01-01 00:08:20,2,12,9593,697,8896,14.64%,7.27%
2020-01-01 00:08:20,3,1,1429,16,1413,2.18%,1.12%
2020-01-01 00:08:20,3,2,23426,3655,19771,35.75%,15.60%
2020-01-01 00:08:20,3,3,69229,26467,42762,105.64%,38.23%
2020-01-01 00:08:20,3,4,11178,927,10251,17.06%,8.29%
2020-01-01 00:08:20,3,5,44646,12313,32333,68.12%,27.58%
2020-01-01 00:08:20,3,6,12758,1175,11583,19.47%,9.21%
2020-01-01 00:08:20,3,7,19779,2655,17124,30.18%,13.42%
2020-01-01 00:08:20,3,8,16035,1756,14279,24.47%,10.95%
2020-01-01 00:08:20,3,9,31499,6596,24903,48.06%,20.94%
2020-01-01 00:08:20,3,10,4965,183,4782,7.58%,3.69%
2020-01-01 00:08:20,3,11,1727,22,1705,2.64%,1.27%
2020-01-01 00:08:20,3,12,23901,3973,19928,36.47%,16.62%
2020-01-01 00:08:20,4,1,580,0,580,0.89%,0.00%
2020-01-01 00:08:20,4,2,320,0,320,0.49%,0.00%
2020-01-01 00:08:20,4,3,629,3,626,0.96%,0.48%
2020-01-01 00:08:20,4,4,28513,5462,23051,43.51%,19.16%
2020-01-01 00:08:20,4,5,17738,2192,15546,27.07%,12.36%
2020-01-01 00:08:20,4,6,24146,4007,20139,36.84%,16.59%
2020-01-01 00:08:20,4,7,5094,220,4874,7.77%,4.32%
2020-01-01 00:08:20,4,8,3081,77,3004,4.70%,2.50%
2020-01-01 00:08:20,4,9,16060,1807,14253,24.51%,11.25%
2020-01-01 00:08:20,4,10,2143,41,2102,3.27%,1.91%
2020-01-01 00:08:20,4,11,136,0,136,0.21%,0.00%
2020-01-01 00:08:20,4,12,12943,1206,11737,19.75%,9.32%
2020-01-01 00:08:20,5,1,2742,58,2684,4.18%,2.12%
2020-01-01 00:08:20,5,2,1347,17,1330,2.06%,1.26%
2020-01-01 00:08:20,5,3,704,7,697,1.07%,0.99%
2020-01-01 00:08:20,5,4,21944,3267,18677,33.48%,14.89%
2020-01-01 00:08:20,5,5,10248,788,9460,15.64%,7.69%
2020-01-01 00:08:20,5,6,15426,1683,13743,23.54%,10.91%
2020-01-01 00:08:20,5,7,4844,192,4652,7.39%,3.96%
2020-01-01 00:08:20,5,8,3781,120,3661,5.77%,3.17%
2020-01-01 00:08:20,5,9,9386,656,8730,14.32%,6.99%
2020-01-01 00:08:20,5,10,1062,15,1047,1.62%,1.41%
2020-01-01 00:08:20,5,11,809,5,804,1.23%,0.62%
2020-01-01 00:08:20,5,12,8117,487,7630,12.39%,6.00%
2020-01-01 00:08:20,6,1,1005,5,1000,1.53%,0.50%
2020-01-01 00:08:20,6,2,1066,7,1059,1.63%,0.66%
2020-01-01 00:08:20,6,3,1706,16,1690,2.60%,0.94%
2020-01-01 00:08:20,6,4,1773,23,1750,2.71%,1.30%
2020-01-01 00:08:20,6,5,15081,1678,13403,23.01%,11.13%
2020-01-01 00:08:20,6,6,4479,186,4293,6.83%,4.15%
2020-01-01 00:08:20,6,7,2292,77,2215,3.50%,3.36%
2020-01-01 00:08:20,6,8,1888,61,1827,2.88%,3.23%
2020-01-01 00:08:20,6,9,8448,508,7940,12.89%,6.01%
2020-01-01 00:08:20,6,10,2686,52,2634,4.10%,1.94%
2020-01-01 00:08:20,6,11,440,0,440,0.67%,0.00%
2020-01-01 00:08:20,6,12,5717,226,5491,8.72%,3.95%
2020-01-01 00:08:20,7,1,435,3,432,0.66%,0.69%
2020-01-01 00:08:20,7,2,139,0,139,0.21%,0.00%
2020-01-01 00:08:20,7,3,1194,17,1177,1.82%,1.42%
2020-01-01 00:08:20,7,4,1868,24,1844,2.85%,1.28%
2020-01-01 00:08:20,7,5,7854,455,7399,11.98%,5.79%
2020-01-01 00:08:20,7,6,12691,1161,11530,19.36%,9.15%
2020-01-01 00:08:20,7,7,2930,61,2869,4.47%,2.08%
2020-01-01 00:08:20,7,8,1214,7,1207,1.85%,0.58%
2020-01-01 00:08:20,7,9,6453,328,6125,9.85%,5.08%
2020-01-01 00:08:20,7,10,1212,12,1200,1.85%,0.99%
2020-01-01 00:08:20,7,11,85,0,85,0.13%,0.00%
2020-01-01 00:08:20,7,12,5212,218,4994,7.95%,4.18%
2020-01-01 00:08:20,8,1,486,1,485,0.74%,0.21%
2020-01-01 00:08:20,8,2,106,0,106,0.16%,0.00%
2020-01-01 00:08:20,8,3,1557,10,1547,2.38%,0.64%
2020-01-01 00:08:20,8,4,2903,68,2835,4.43%,2.34%
2020-01-01 00:08:20,8,5,8937,596,8341,13.64%,6.67%
2020-01-01 00:08:20,8,6,17186,2083,15103,26.22%,12.12%
2020-01-01 00:08:20,8,7,5313,222,5091,8.11%,4.18%
2020-01-01 00:08:20,8,8,2133,35,2098,3.25%,1.64%
2020-01-01 00:08:20,8,9,6987,378,6609,10.66%,5.41%
2020-01-01 00:08:20,8,10,2681,48,2633,4.09%,1.79%
2020-01-01 00:08:20,8,11,211,0,211,0.32%,0.00%
2020-01-01 00:08:20,8,12,4282,148,4134,6.53%,3.46%
2020-01-01 00:08:20,9,1,485,2,483,0.74%,0.41%
2020-01-01 00:08:20,9,2,1857,18,1839,2.83%,0.97%
2020-01-01 00:08:20,9,3,982,6,976,1.50%,0.61%
2020-01-01 00:08:20,9,4,7155,372,6783,10.92%,5.20%
2020-01-01 00:08:20,9,5,197,1,196,0.30%,0.51%
2020-01-01 00:08:20,9,6,7826,442,7384,11.94%,5.65%
2020-01-01 00:08:20,9,7,29323,5595,23728,44.74%,19.08%
2020-01-01 00:08:20,9,8,10644,800,9844,16.24%,7.52%
2020-01-01 00:08:20,9,9,144,1,143,0.22%,0.69%
2020-01-01 00:08:20,9,10,3492,57,3435,5.33%,1.63%
2020-01-01 00:08:20,9,11,9157,599,8558,13.97%,6.54%
2020-01-01 00:08:20,9,12,5326,222,5104,8.13%,4.17%
2020-01-01 00:08:20,10,1,1186,174,1012,1.81%,14.67%
2020-01-01 00:08:20,10,2,2826,206,2620,4.31%,7.29%
2020-01-01 00:08:20,10,3,1469,12,1457,2.24%,0.82%
2020-01-01 00:08:20,10,4,3724,713,3011,5.68%,19.15%
2020-01-01 00:08:20,10,5,760,5,755,1.16%,0.66%
2020-01-01 00:08:20,10,6,5730,834,4896,8.74%,14.55%
2020-01-01 00:08:20,10,7,10102,1445,8657,15.41%,14.30%
2020-01-01 00:08:20,10,8,30400,7540,22860,46.39%,24.80%
2020-01-01 00:08:20,10,9,930,4,926,1.42%,0.43%
2020-01-01 00:08:20,10,10,2850,65,2785,4.35%,2.28%
2020-01-01 00:08:20,10,11,15741,2190,13551,24.02%,13.91%
2020-01-01 00:08:20,10,12,12315,1592,10723,18.79%,12.93%
2020-01-01 00:08:20,11,1,2214,48,2166,3.38%,2.17%
2020-01-01 00:08:20,11,2,3182,73,3109,4.86%,2.29%
2020-01-01 00:08:20,11,3,825,3,822,1.26%,0.36%
2020-01-01 00:08:20,11,4,6155,319,5836,9.39%,5.18%
2020-01-01 00:08:20,11,5,156,0,156,0.24%,0.00%
2020-01-01 00:08:20,11,6,6909,393,6516,10.54%,5.69%
2020-01-01 00:08:20,11,7,12616,1170,11446,19.25%,9.27%
2020-01-01 00:08:20,11,8,26982,4919,22063,41.17%,18.23%
2020-01-01 00:08:20,11,9,182,0,182,0.28%,0.00%
2020-01-01 00:08:20,11,10,2824,68,2756,4.31%,2.41%
2020-01-01 00:08:20,11,11,9985,733,9252,15.24%,7.34%
2020-01-01 00:08:20,11,12,6662,328,6334,10.17%,4.92%
2020-01-01 00:08:20,12,1,87,0,87,0.13%,0.00%
2020-01-01 00:08:20,12,2,574,224,350,0.88%,39.02%
2020-01-01 00:08:20,12,3,3408,319,3089,5.20%,9.36%
2020-01-01 00:08:20,12,4,3131,107,3024,4.78%,3.42%
2020-01-01 00:08:20,12,5,10399,1000,9399,15.87%,9.62%
2020-01-01 00:08:20,12,6,6104,306,5798,9.31%,5.01%
2020-01-01 00:08:20,12,7,2770,60,2710,4.23%,2.17%
2020-01-01 00:08:20,12,8,1453,278,1175,2.22%,19.13%
2020-01-01 00:08:20,12,9,23471,4889,18582,35.81%,20.83%
2020-01-01 00:08:20,12,10,3877,372,3505,5.92%,9.60%
2020-01-01 00:08:20,12,11,1831,288,1543,2.79%,15.73%
2020-01-01 00:08:20,12,12,8312,1298,7014,12.68%,15.62%
2020-01-01 00:08:20,13,1,2873,73,2800,4.38%,2.54%
2020-01-01 00:08:20,13,2,3203,93,3110,4.89%,2.90%
2020-01-01 00:08:20,13,3,662,3,659,1.01%,0.45%
2020-01-01 00:08:20,13,4,5515,453,5062,8.42%,8.21%
2020-01-01 00:08:20,13,5,7495,710,6785,11.44%,9.47%
2020-01-01 00:08:20,13,6,6123,498,5625,9.34%,8.13%
2020-01-01 00:08:20,13,7,5931,264,5667,9.05%,4.45%
2020-01-01 00:08:20,13,8,7718,454,7264,11.78%,5.88%
2020-01-01 00:08:20,13,9,7845,745,7100,11.97%,9.50%
2020-01-01 00:08:20,13,10,28516,6038,22478,43.51%,21.17%
2020-01-01 00:08:20,13,11,17569,2658,14911,26.81%,15.13%
2020-01-01 00:08:20,13,12,9453,1146,8307,14.42%,12.12%
2020-01-01 00:08:20,14,1,339,2,337,0.52%,0.59%
2020-01-01 00:08:20,14,2,1443,38,1405,2.20%,2.63%
2020-01-01 00:08:20,14,3,905,24,881,1.38%,2.65%
2020-01-01 00:08:20,14,4,8290,540,7750,12.65%,6.51%
2020-01-01 00:08:20,14,5,1389,12,1377,2.12%,0.86%
2020-01-01 00:08:20,14,6,8499,561,7938,12.97%,6.60%
2020-01-01 00:08:20,14,7,16073,1859,14214,24.53%,11.57%
2020-01-01 00:08:20,14,8,17978,2300,15678,27.43%,12.79%
2020-01-01 00:08:20,14,9,1658,19,1639,2.53%,1.15%
2020-01-01 00:08:20,14,10,3906,102,3804,5.96%,2.61%
2020-01-01 00:08:20,14,11,29998,5976,24022,45.77%,19.92%
2020-01-01 00:08:20,14,12,7896,465,7431,12.05%,5.89%
2020-01-01 00:08:20,15,1,657,4,653,1.00%,0.61%
2020-01-01 00:08:20,15,2,192,0,192,0.29%,0.00%
2020-01-01 00:08:20,15,3,5340,227,5113,8.15%,4.25%
2020-01-01 00:08:20,15,4,4859,214,4645,7.41%,4.40%
2020-01-01 00:08:20,15,5,12038,1098,10940,18.37%,9.12%
2020-01-01 00:08:20,15,6,5090,232,4858,7.77%,4.56%
2020-01-01 00:08:20,15,7,3944,127,3817,6.02%,3.22%
2020-01-01 00:08:20,15,8,6706,347,6359,10.23%,5.17%
2020-01-01 00:08:20,15,9,12240,1125,11115,18.68%,9.19%
2020-01-01 00:08:20,15,10,3942,114,3828,6.02%,2.89%
2020-01-01 00:08:20,15,11,10807,863,9944,16.49%,7.99%
2020-01-01 00:08:20,15,12,28577,5666,22911,43.61%,19.83%
2020-01-01 00:08:20,16,1,351,1,350,0.54%,0.28%
2020-01-01 00:08:20,16,2,227,0,227,0.35%,0.00%
2020-01-01 00:08:20,16,3,1409,54,1355,2.15%,3.83%
2020-01-01 00:08:20,16,4,4520,167,4353,6.90%,3.69%
2020-01-01 00:08:20,16,5,8053,569,7484,12.29%,7.07%
2020-01-01 00:08:20,16,6,5184,220,4964,7.91%,4.24%
2020-01-01 00:08:20,16,7,3728,104,3624,5.69%,2.79%
2020-01-01 00:08:20,16,8,8267,592,7675,12.61%,7.16%
2020-01-01 00:08:20,16,9,8476,615,7861,12.93%,7.26%
2020-01-01 00:08:20,16,10,1549,19,1530,2.36%,1.23%
2020-01-01 00:08:20,16,11,10040,791,9249,15.32%,7.88%
2020-01-01 00:08:20,16,12,26209,4774,21435,39.99%,18.22%
2020-01-01 00:08:30,1,1,19131,2616,16515,29.19%,13.67%
2020-01-01 00:08:30,1,2,9161,613,8548,13.98%,6.69%
2020-01-01 00:08:30,1,3,850,5,845,1.30%,0.59%
2020-01-01 00:08:30,1,4,9768,785,8983,14.90%,8.04%
2020-01-01 00:08:30,1,5,9288,722,8566,14.17%,7.77%
2020-01-01 00:08:30,1,6,9241,714,8527,14.10%,7.73%
2020-01-01 00:08:30,1,7,8292,500,7792,12.65%,6.03%
2020-01-01 00:08:30,1,8,6778,331,6447,10.34%,4.88%
2020-01-01 00:08:30,1,9,9197,708,8489,14.03%,7.70%
2020-01-01 00:08:30,1,10,6205,281,5924,9.47%,4.53%
2020-01-01 00:08:30,1,11,6317,291,6026,9.64%,4.61%
2020-01-01 00:08:30,1,12,9137,704,8433,13.94%,7.70%
2020-01-01 00:08:30,2,1,920,3,917,1.40%,0.33%
2020-01-01 00:08:30,2,2,24617,4145,20472,37.56%,16.84%
2020-01-01 00:08:30,2,3,18386,2390,15996,28.05%,13.00%
2020-01-01 00:08:30,2,4,873,3,870,1.33%,0.34%
2020-01-01 00:08:30,2,5,10972,887,10085,16.74%,8.08%
2020-01-01 00:08:30,2,6,55,0,55,0.08%,0.00%
2020-01-01 00:08:30,2,7,5292,200,5092,8.07%,3.78%
2020-01-01 00:08:30,2,8,4150,127,4023,6.33%,3.06%
2020-01-01 00:08:30,2,9,10923,874,10049,16.67%,8.00%
2020-01-01 00:08:30,2,10,3490,87,3403,5.33%,2.49%
2020-01-01 00:08:30,2,11,3505,88,3417,5.35%,2.51%
2020-01-01 00:08:30,2,12,10780,848,9932,16.45%,7.87%
2020-01-01 00:08:30,3,1,1394,16,1378,2.13%,1.15%
2020-01-01 00:08:30,3,2,23568,3797,19771,35.96%,16.11%
2020-01-01 00:08:30,3,3,73329,29137,44192,111.89%,39.73%
2020-01-01 00:08:30,3,4,8062,451,7611,12.30%,5.59%
2020-01-01 00:08:30,3,5,47147,13440,33707,71.94%,28.51%
2020-01-01 00:08:30,3,6,9222,601,8621,14.07%,6.52%
2020-01-01 00:08:30,3,7,20467,2906,17561,31.23%,14.20%
2020-01-01 00:08:30,3,8,15644,1722,13922,23.87%,11.01%
2020-01-01 00:08:30,3,9,37649,8989,28660,57.45%,23.88%
2020-01-01 00:08:30,3,10,5013,163,4850,7.65%,3.25%
2020-01-01 00:08:30,3,11,1184,12,1172,1.81%,1.01%
2020-01-01 00:08:30,3,12,29676,5816,23860,45.28%,19.60%
2020-01-01 00:08:30,4,1,584,4,580,0.89%,0.68%
2020-01-01 00:08:30,4,2,357,2,355,0.54%,0.56%
2020-01-01 00:08:30,4,3,812,6,806,1.24%,0.74%
2020-01-01 00:08:30,4,4,28202,5293,22909,43.03%,18.77%
2020-01-01 00:08:30,4,5,17010,2107,14903,25.96%,12.39%
2020-01-01 00:08:30,4,6,23642,3844,19798,36.07%,16.26%
2020-01-01 00:08:30,4,7,5153,220,4933,7.86%,4.27%
2020-01-01 00:08:30,4,8,2745,67,2678,4.19%,2.44%
2020-01-01 00:08:30,4,9,14859,1637,13222,22.67%,11.02%
2020-01-01 00:08:30,4,10,1858,23,1835,2.84%,1.24%
2020-01-01 00:08:30,4,11,195,0,195,0.30%,0.00%
2020-01-01 00:08:30,4,12,12425,1145,11280,18.96%,9.22%
2020-01-01 00:08:30,5,1,2881,63,2818,4.40%,2.19%
2020-01-01 00:08:30,5,2,1624,22,1602,2.48%,1.35%
2020-01-01 00:08:30,5,3,1939,36,1903,2.96%,1.86%
2020-01-01 00:08:30,5,4,24570,4009,20561,37.49%,16.32%
2020-01-01 00:08:30,5,5,11810,1008,10802,18.02%,8.54%
2020-01-01 00:08:30,5,6,16486,1946,14540,25.16%,11.80%
2020-01-01 00:08:30,5,7,4311,188,4123,6.58%,4.36%
2020-01-01 00:08:30,5,8,3132,92,3040,4.78%,2.94%
2020-01-01 00:08:30,5,9,9752,677,9075,14.88%,6.94%
2020-01-01 00:08:30,5,10,2257,37,2220,3.44%,1.64%
2020-01-01 00:08:30,5,11,594,3,591,0.91%,0.51%
2020-01-01 00:08:30,5,12,7268,368,6900,11.09%,5.06%
2020-01-01 00:08:30,6,1,1098,5,1093,1.68%,0.46%
2020-01-01 00:08:30,6,2,1211,5,1206,1.85%,0.41%
2020-01-01 00:08:30,6,3,1518,11,1507,2.32%,0.72%
2020-01-01 00:08:30,6,4,1209,14,1195,1.84%,1.16%
2020-01-01 00:08:30,6,5,15213,1609,13604,23.21%,10.58%
2020-01-01 00:08:30,6,6,5221,180,5041,7.97%,3.45%
2020-01-01 00:08:30,6,7,3565,88,3477,5.44%,2.47%
2020-01-01 00:08:30,6,8,3014,70,2944,4.60%,2.32%
2020-01-01 00:08:30,6,9,8155,470,7685,12.44%,5.76%
2020-01-01 00:08:30,6,10,2260,35,2225,3.45%,1.55%
2020-01-01 00:08:30,6,11,443,0,443,0.68%,0.00%
2020-01-01 00:08:30,6,12,5840,237,5603,8.91%,4.06%
2020-01-01 00:08:30,7,1,421,1,420,0.64%,0.24%
2020-01-01 00:08:30,7,2,197,0,197,0.30%,0.00%
2020-01-01 00:08:30,7,3,584,3,581,0.89%,0.51%
2020-01-01 00:08:30,7,4,2577,46,2531,3.93%,1.79%
2020-01-01 00:08:30,7,5,6210,309,5901,9.48%,4.98%
2020-01-01 00:08:30,7,6,12389,1157,11232,18.90%,9.34%
2020-01-01 00:08:30,7,7,3580,118,3462,5.46%,3.30%
2020-01-01 00:08:30,7,8,1773,28,1745,2.71%,1.58%
2020-01-01 00:08:30,7,9,5486,246,5240,8.37%,4.48%
2020-01-01 00:08:30,7,10,1002,8,994,1.53%,0.80%
2020-01-01 00:08:30,7,11,74,0,74,0.11%,0.00%
2020-01-01 00:08:30,7,12,4447,169,4278,6.79%,3.80%
2020-01-01 00:08:30,8,1,412,4,408,0.63%,0.97%
2020-01-01 00:08:30,8,2,76,0,76,0.12%,0.00%
2020-01-01 00:08:30,8,3,1784,10,1774,2.72%,0.56%
2020-01-01 00:08:30,8,4,2979,72,2907,4.55%,2.42%
2020-01-01 00:08:30,8,5,8621,521,8100,13.15%,6.04%
2020-01-01 00:08:30,8,6,16639,1908,14731,25.39%,11.47%
2020-01-01 00:08:30,8,7,4984,186,4798,7.60%,3.73%
2020-01-01 00:08:30,8,8,2212,46,2166,3.38%,2.08%
2020-01-01 00:08:30,8,9,6488,292,6196,9.90%,4.50%
2020-01-01 00:08:30,8,10,1737,23,1714,2.65%,1.32%
2020-01-01 00:08:30,8,11,190,1,189,0.29%,0.53%
2020-01-01 00:08:30,8,12,4582,159,4423,6.99%,3.47%
2020-01-01 00:08:30,9,1,384,1,383,0.59%,0.26%
2020-01-01 00:08:30,9,2,1885,27,1858,2.88%,1.43%
2020-01-01 00:08:30,9,3,1107,15,1092,1.69%,1.36%
2020-01-01 00:08:30,9,4,4100,110,3990,6.26%,2.68%
2020-01-01 00:08:30,9,5,919,1,918,1.40%,0.11%
2020-01-01 00:08:30,9,6,6165,264,5901,9.41%,4.28%
2020-01-01 00:08:30,9,7,22012,3282,18730,33.59%,14.91%
2020-01-01 00:08:30,9,8,8513,515,7998,12.99%,6.05%
2020-01-01 00:08:30,9,9,403,0,403,0.61%,0.00%
2020-01-01 00:08:30,9,10,1868,28,1840,2.85%,1.50%
2020-01-01 00:08:30,9,11,7231,381,6850,11.03%,5.27%
2020-01-01 00:08:30,9,12,5038,186,4852,7.69%,3.69%
2020-01-01 00:08:30,10,1,1270,230,1040,1.94%,18.11%
2020-01-01 00:08:30,10,2,3100,309,2791,4.73%,9.97%
2020-01-01 00:08:30,10,3,1670,37,1633,2.55%,2.22%
2020-01-01 00:08:30,10,4,3849,962,2887,5.87%,24.99%
2020-01-01 00:08:30,10,5,1014,61,953,1.55%,6.02%
2020-01-01 00:08:30,10,6,5565,1106,4459,8.49%,19.87%
2020-01-01 00:08:30,10,7,10551,1795,8756,16.10%,17.01%
2020-01-01 00:08:30,10,8,30163,7975,22188,46.03%,26.44%
2020-01-01 00:08:30,10,9,665,2,663,1.01%,0.30%
2020-01-01 00:08:30,10,10,3456,104,3352,5.27%,3.01%
2020-01-01 00:08:30,10,11,14590,1964,12626,22.26%,13.46%
2020-01-01 00:08:30,10,12,10511,1245,9266,16.04%,11.84%
2020-01-01 00:08:30,11,1,2004,31,1973,3.06%,1.55%
2020-01-01 00:08:30,11,2,2788,60,2728,4.25%,2.15%
2020-01-01 00:08:30,11,3,652,4,648,0.99%,0.61%
2020-01-01 00:08:30,11,4,6147,265,5882,9.38%,4.31%
2020-01-01 00:08:30,11,5,289,8,281,0.44%,2.77%
2020-01-01 00:08:30,11,6,6948,344,6604,10.60%,4.95%
2020-01-01 00:08:30,11,7,11542,934,10608,17.61%,8.09%
2020-01-01 00:08:30,11,8,26954,4880,22074,41.13%,18.10%
2020-01-01 00:08:30,11,9,108,0,108,0.16%,0.00%
2020-01-01 00:08:30,11,10,2748,69,2679,4.19%,2.51%
2020-01-01 00:08:30,11,11,10248,772,9476,15.64%,7.53%
2020-01-01 00:08:30,11,12,7051,372,6679,10.76%,5.28%
2020-01-01 00:08:30,12,1,47,1,46,0.07%,2.13%
2020-01-01 00:08:30,12,2,498,159,339,0.76%,31.93%
2020-01-01 00:08:30,12,3,2104,195,1909,3.21%,9.27%
2020-01-01 00:08:30,12,4,3303,73,3230,5.04%,2.21%
2020-01-01 00:08:30,12,5,7587,562,7025,11.58%,7.41%
2020-01-01 00:08:30,12,6,4806,166,4640,7.33%,3.45%
2020-01-01 00:08:30,12,7,1377,14,1363,2.10%,1.02%
2020-01-01 00:08:30,12,8,1643,217,1426,2.51%,13.21%
2020-01-01 00:08:30,12,9,21135,3650,17485,32.25%,17.27%
2020-01-01 00:08:30,12,10,3975,314,3661,6.07%,7.90%
2020-01-01 00:08:30,12,11,1937,228,1709,2.96%,11.77%
2020-01-01 00:08:30,12,12,7587,908,6679,11.58%,11.97%
2020-01-01 00:08:30,13,1,2159,61,2098,3.29%,2.83%
2020-01-01 00:08:30,13,2,2502,74,2428,3.82%,2.96%
2020-01-01 00:08:30,13,3,543,1,542,0.83%,0.18%
2020-01-01 00:08:30,13,4,4947,497,4450,7.55%,10.05%
2020-01-01 00:08:30,13,5,7565,873,6692,11.54%,11.54%
2020-01-01 00:08:30,13,6,5547,544,5003,8.46%,9.81%
2020-01-01 00:08:30,13,7,4772,205,4567,7.28%,4.30%
2020-01-01 00:08:30,13,8,7711,488,7223,11.77%,6.33%
2020-01-01 00:08:30,13,9,7890,911,6979,12.04%,11.55%
2020-01-01 00:08:30,13,10,28272,5852,22420,43.14%,20.70%
2020-01-01 00:08:30,13,11,17954,2467,15487,27.40%,13.74%
2020-01-01 00:08:30,13,12,9763,866,8897,14.90%,8.87%
2020-01-01 00:08:30,14,1,481,3,478,0.73%,0.62%
2020-01-01 00:08:30,14,2,1267,13,1254,1.93%,1.03%
2020-01-01 00:08:30,14,3,600,3,597,0.92%,0.50%
2020-01-01 00:08:30,14,4,4723,162,4561,7.21%,3.43%
2020-01-01 00:08:30,14,5,1657,25,1632,2.53%,1.51%
2020-01-01 00:08:30,14,6,5056,186,4870,7.71%,3.68%
2020-01-01 00:08:30,14,7,11772,1038,10734,17.96%,8.82%
2020-01-01 00:08:30,14,8,13486,1307,12179,20.58%,9.69%
2020-01-01 00:08:30,14,9,1864,32,1832,2.84%,1.72%
2020-01-01 00:08:30,14,10,4004,128,3876,6.11%,3.20%
2020-01-01 00:08:30,14,11,26212,4543,21669,40.00%,17.33%
2020-01-01 00:08:30,14,12,8293,542,7751,12.65%,6.54%
2020-01-01 00:08:30,15,1,650,3,647,0.99%,0.46%
2020-01-01 00:08:30,15,2,125,0,125,0.19%,0.00%
2020-01-01 00:08:30,15,3,6982,307,6675,10.65%,4.40%
2020-01-01 00:08:30,15,4,4376,195,4181,6.68%,4.46%
2020-01-01 00:08:30,15,5,12887,1229,11658,19.66%,9.54%
2020-01-01 00:08:30,15,6,4647,237,4410,7.09%,5.10%
2020-01-01 00:08:30,15,7,3191,88,3103,4.87%,2.76%
2020-01-01 00:08:30,15,8,5523,225,5298,8.43%,4.07%
2020-01-01 00:08:30,15,9,13088,1266,11822,19.97%,9.67%
2020-01-01 00:08:30,15,10,12462,1207,11255,19.02%,9.69%
2020-01-01 00:08:30,15,11,18183,2399,15784,27.75%,13.19%
2020-01-01 00:08:30,15,12,37058,9173,27885,56.55%,24.75%
2020-01-01 00:08:30,16,1,328,0,328,0.50%,0.00%
2020-01-01 00:08:30,16,2,281,2,279,0.43%,0.71%
2020-01-01 00:08:30,16,3,1121,17,1104,1.71%,1.52%
2020-01-01 00:08:30,16,4,4246,95,4151,6.48%,2.24%
2020-01-01 00:08:30,16,5,8165,600,7565,12.46%,7.35%
2020-01-01 00:08:30,16,6,5118,150,4968,7.81%,2.93%
2020-01-01 00:08:30,16,7,2950,65,2885,4.50%,2.20%
2020-01-01 00:08:30,16,8,6246,372,5874,9.53%,5.96%
2020-01-01 00:08:30,16,9,8635,651,7984,13.18%,7.54%
2020-01-01 00:08:30,16,10,1588,27,1561,2.42%,1.70%
2020-01-01 00:08:30,16,11,8024,551,7473,12.24%,6.87%
2020-01-01 00:08:30,16,12,24056,4043,20013,36.71%,16.81%
2020-01-01 00:08:40,1,1,18543,2472,16071,28.29%,13.33%
2020-01-01 00:08:40,1,2,5416,229,5187,8.26%,4.23%
2020-01-01 00:08:40,1,3,435,2,433,0.66%,0.46%
2020-01-01 00:08:40,1,4,12790,1246,11544,19.52%,9.74%
2020-01-01 00:08:40,1,5,12525,1189,11336,19.11%,9.49%
2020-01-01 00:08:40,1,6,12483,1188,11295,19.05%,9.52%
2020-01-01 00:08:40,1,7,4972,196,4776,7.59%,3.94%
2020-01-01 00:08:40,1,8,4050,118,3932,6.18%,2.91%
2020-01-01 00:08:40,1,9,12452,1180,11272,19.00%,9.48%
2020-01-01 00:08:40,1,10,3418,79,3339,5.22%,2.31%
2020-01-01 00:08:40,1,11,3515,88,3427,5.36%,2.50%
2020-01-01 00:08:40,1,12,12380,1172,11208,18.89%,9.47%
2020-01-01 00:08:40,2,1,532,4,528,0.81%,0.75%
2020-01-01 00:08:40,2,2,22875,3570,19305,34.90%,15.61%
2020-01-01 00:08:40,2,3,18236,2366,15870,27.83%,12.97%
2020-01-01 00:08:40,2,4,453,3,450,0.69%,0.66%
2020-01-01 00:08:40,2,5,12119,1046,11073,18.49%,8.63%
2020-01-01 00:08:40,2,6,39,0,39,0.06%,0.00%
2020-01-01 00:08:40,2,7,4101,122,3979,6.26%,2.97%
2020-01-01 00:08:40,2,8,2884,58,2826,4.40%,2.01%
2020-01-01 00:08:40,2,9,11949,1022,10927,18.23%,8.55%
2020-01-01 00:08:40,2,10,2190,34,2156,3.34%,1.55%
2020-01-01 00:08:40,2,11,2242,35,2207,3.42%,1.56%
2020-01-01 00:08:40,2,12,11794,989,10805,18.00%,8.39%
2020-01-01 00:08:40,3,1,1643,19,1624,2.51%,1.16%
2020-01-01 00:08:40,3,2,23956,3853,20103,36.55%,16.08%
2020-01-01 00:08:40,3,3,73120,28970,44150,111.57%,39.62%
2020-01-01 00:08:40,3,4,7827,433,7394,11.94%,5.53%
2020-01-01 00:08:40,3,5,47659,13718,33941,72.72%,28.78%
2020-01-01 00:08:40,3,6,9752,661,9091,14.88%,6.78%
2020-01-01 00:08:40,3,7,20906,3013,17893,31.90%,14.41%
2020-01-01 00:08:40,3,8,17500,2101,15399,26.70%,12.01%
2020-01-01 00:08:40,3,9,37594,8950,28644,57.36%,23.81%
2020-01-01 00:08:40,3,10,5945,280,5665,9.07%,4.71%
2020-01-01 00:08:40,3,11,1845,17,1828,2.82%,0.92%
2020-01-01 00:08:40,3,12,29196,5540,23656,44.55%,18.98%
2020-01-01 00:08:40,4,1,476,1,475,0.73%,0.21%
2020-01-01 00:08:40,4,2,287,0,287,0.44%,0.00%
2020-01-01 00:08:40,4,3,1390,13,1377,2.12%,0.94%
2020-01-01 00:08:40,4,4,28737,5422,23315,43.85%,18.87%
2020-01-01 00:08:40,4,5,18871,2473,16398,28.79%,13.10%
2020-01-01 00:08:40,4,6,25153,4242,20911,38.38%,16.86%
2020-01-01 00:08:40,4,7,5089,229,4860,7.77%,4.50%
2020-01-01 00:08:40,4,8,2977,87,2890,4.54%,2.92%
2020-01-01 00:08:40,4,9,15499,1711,13788,23.65%,11.04%
2020-01-01 00:08:40,4,10,2046,47,1999,3.12%,2.30%
2020-01-01 00:08:40,4,11,189,0,189,0.29%,0.00%
2020-01-01 00:08:40,4,12,12673,1144,11529,19.34%,9.03%
2020-01-01 00:08:40,5,1,2736,48,2688,4.17%,1.75%
2020-01-01 00:08:40,5,2,794,4,790,1.21%,0.50%
2020-01-01 00:08:40,5,3,608,4,604,0.93%,0.66%
2020-01-01 00:08:40,5,4,21631,3239,18392,33.01%,14.97%
2020-01-01 00:08:40,5,5,9896,745,9151,15.10%,7.53%
2020-01-01 00:08:40,5,6,15506,1759,13747,23.66%,11.34%
2020-01-01 00:08:40,5,7,4936,191,4745,7.53%,3.87%
2020-01-01 00:08:40,5,8,3949,116,3833,6.03%,2.94%
2020-01-01 00:08:40,5,9,9146,631,8515,13.96%,6.90%
2020-01-01 00:08:40,5,10,1215,12,1203,1.85%,0.99%
2020-01-01 00:08:40,5,11,882,8,874,1.35%,0.91%
2020-01-01 00:08:40,5,12,7629,439,7190,11.64%,5.75%
2020-01-01 00:08:40,6,1,970,10,960,1.48%,1.03%
2020-01-01 00:08:40,6,2,1080,10,1070,1.65%,0.93%
2020-01-01 00:08:40,6,3,1676,18,1658,2.56%,1.07%
2020-01-01 00:08:40,6,4,1368,16,1352,2.09%,1.17%
2020-01-01 00:08:40,6,5,16774,1989,14785,25.60%,11.86%
2020-01-01 00:08:40,6,6,4174,142,4032,6.37%,3.40%
2020-01-01 00:08:40,6,7,2379,34,2345,3.63%,1.43%
2020-01-01 00:08:40,6,8,1868,22,1846,2.85%,1.18%
2020-01-01 00:08:40,6,9,10539,816,9723,16.08%,7.74%
2020-01-01 00:08:40,6,10,2152,40,2112,3.28%,1.86%
2020-01-01 00:08:40,6,11,422,2,420,0.64%,0.47%
2020-01-01 00:08:40,6,12,8271,520,7751,12.62%,6.29%
2020-01-01 00:08:40,7,1,422,5,417,0.64%,1.18%
2020-01-01 00:08:40,7,2,191,0,191,0.29%,0.00%
2020-01-01 00:08:40,7,3,2491,35,2456,3.80%,1.41%
2020-01-01 00:08:40,7,4,1483,18,1465,2.26%,1.21%
2020-01-01 00:08:40,7,5,8270,497,7773,12.62%,6.01%
2020-01-01 00:08:40,7,6,13402,1278,12124,20.45%,9.54%
2020-01-01 00:08:40,7,7,3615,87,3528,5.52%,2.41%
2020-01-01 00:08:40,7,8,1286,7,1279,1.96%,0.54%
2020-01-01 00:08:40,7,9,5671,255,5416,8.65%,4.50%
2020-01-01 00:08:40,7,10,897,17,880,1.37%,1.90%
2020-01-01 00:08:40,7,11,102,0,102,0.16%,0.00%
2020-01-01 00:08:40,7,12,4807,182,4625,7.33%,3.79%
2020-01-01 00:08:40,8,1,478,2,476,0.73%,0.42%
2020-01-01 00:08:40,8,2,99,1,98,0.15%,1.01%
2020-01-01 00:08:40,8,3,1693,20,1673,2.58%,1.18%
2020-01-01 00:08:40,8,4,2776,49,2727,4.24%,1.77%
2020-01-01 00:08:40,8,5,8756,538,8218,13.36%,6.14%
2020-01-01 00:08:40,8,6,16589,1980,14609,25.31%,11.94%
2020-01-01 00:08:40,8,7,5001,209,4792,7.63%,4.18%
2020-01-01 00:08:40,8,8,1906,37,1869,2.91%,1.94%
2020-01-01 00:08:40,8,9,6911,361,6550,10.55%,5.22%
2020-01-01 00:08:40,8,10,1883,29,1854,2.87%,1.54%
2020-01-01 00:08:40,8,11,171,0,171,0.26%,0.00%
2020-01-01 00:08:40,8,12,4989,189,4800,7.61%,3.79%
2020-01-01 00:08:40,9,1,270,0,270,0.41%,0.00%
2020-01-01 00:08:40,9,2,5559,213,5346,8.48%,3.83%
2020-01-01 00:08:40,9,3,4839,168,4671,7.38%,3.47%
2020-01-01 00:08:40,9,4,10130,778,9352,15.46%,7.68%
2020-01-01 00:08:40,9,5,330,0,330,0.50%,0.00%
2020-01-01 00:08:40,9,6,10987,910,10077,16.76%,8.28%
2020-01-01 00:08:40,9,7,32069,6661,25408,48.93%,20.77%
2020-01-01 00:08:40,9,8,10106,732,9374,15.42%,7.24%
2020-01-01 00:08:40,9,9,174,0,174,0.27%,0.00%
2020-01-01 00:08:40,9,10,2685,41,2644,4.10%,1.53%
2020-01-01 00:08:40,9,11,8886,571,8315,13.56%,6.43%
2020-01-01 00:08:40,9,12,5900,255,5645,9.00%,4.32%
2020-01-01 00:08:40,10,1,1209,287,922,1.84%,23.74%
2020-01-01 00:08:40,10,2,2740,327,2413,4.18%,11.93%
2020-01-01 00:08:40,10,3,1273,11,1262,1.94%,0.86%
2020-01-01 00:08:40,10,4,4160,998,3162,6.35%,23.99%
2020-01-01 00:08:40,10,5,603,4,599,0.92%,0.66%
2020-01-01 00:08:40,10,6,5981,1113,4868,9.13%,18.61%
2020-01-01 00:08:40,10,7,11206,1949,9257,17.10%,17.39%
2020-01-01 00:08:40,10,8,26946,6691,20255,41.12%,24.83%
2020-01-01 00:08:40,10,9,561,3,558,0.86%,0.53%
2020-01-01 00:08:40,10,10,2197,45,2152,3.35%,2.05%
2020-01-01 00:08:40,10,11,11695,1436,10259,17.85%,12.28%
2020-01-01 00:08:40,10,12,8999,1065,7934,13.73%,11.83%
2020-01-01 00:08:40,11,1,2043,36,2007,3.12%,1.76%
2020-01-01 00:08:40,11,2,3279,91,3188,5.00%,2.78%
2020-01-01 00:08:40,11,3,1134,9,1125,1.73%,0.79%
2020-01-01 00:08:40,11,4,4273,141,4132,6.52%,3.30%
2020-01-01 00:08:40,11,5,720,2,718,1.10%,0.28%
2020-01-01 00:08:40,11,6,5586,219,5367,8.52%,3.92%
2020-01-01 00:08:40,11,7,10609,851,9758,16.19%,8.02%
2020-01-01 00:08:40,11,8,23918,4000,19918,36.50%,16.72%
2020-01-01 00:08:40,11,9,252,0,252,0.38%,0.00%
2020-01-01 00:08:40,11,10,3089,73,3016,4.71%,2.36%
2020-01-01 00:08:40,11,11,10264,770,9494,15.66%,7.50%
2020-01-01 00:08:40,11,12,6872,363,6509,10.49%,5.28%
2020-01-01 00:08:40,12,1,53,0,53,0.08%,0.00%
2020-01-01 00:08:40,12,2,689,226,463,1.05%,32.80%
2020-01-01 00:08:40,12,3,3160,303,2857,4.82%,9.59%
2020-01-01 00:08:40,12,4,2625,64,2561,4.01%,2.44%
2020-01-01 00:08:40,12,5,9824,906,8918,14.99%,9.22%
2020-01-01 00:08:40,12,6,5846,276,5570,8.92%,4.72%
2020-01-01 00:08:40,12,7,3115,61,3054,4.75%,1.96%
2020-01-01 00:08:40,12,8,1427,330,1097,2.18%,23.13%
2020-01-01 00:08:40,12,9,22459,4477,17982,34.27%,19.93%
2020-01-01 00:08:40,12,10,4369,458,3911,6.67%,10.48%
2020-01-01 00:08:40,12,11,1636,334,1302,2.50%,20.42%
2020-01-01 00:08:40,12,12,7190,1050,6140,10.97%,14.60%
2020-01-01 00:08:40,13,1,2346,50,2296,3.58%,2.13%
2020-01-01 00:08:40,13,2,2805,70,2735,4.28%,2.50%
2020-01-01 00:08:40,13,3,578,5,573,0.88%,0.87%
2020-01-01 00:08:40,13,4,4548,435,4113,6.94%,9.56%
2020-01-01 00:08:40,13,5,7542,771,6771,11.51%,10.22%
2020-01-01 00:08:40,13,6,6094,548,5546,9.30%,8.99%
2020-01-01 00:08:40,13,7,5574,246,5328,8.51%,4.41%
2020-01-01 00:08:40,13,8,7269,405,6864,11.09%,5.57%
2020-01-01 00:08:40,13,9,7718,786,6932,11.78%,10.18%
2020-01-01 00:08:40,13,10,29308,6117,23191,44.72%,20.87%
2020-01-01 00:08:40,13,11,18855,2740,16115,28.77%,14.53%
2020-01-01 00:08:40,13,12,10997,1223,9774,16.78%,11.12%
2020-01-01 00:08:40,14,1,498,1,497,0.76%,0.20%
2020-01-01 00:08:40,14,2,2086,26,2060,3.18%,1.25%
2020-01-01 00:08:40,14,3,1342,14,1328,2.05%,1.04%
2020-01-01 00:08:40,14,4,4457,155,4302,6.80%,3.48%
2020-01-01 00:08:40,14,5,1244,11,1233,1.90%,0.88%
2020-01-01 00:08:40,14,6,4859,185,4674,7.41%,3.81%
2020-01-01 00:08:40,14,7,12192,1052,11140,18.60%,8.63%
2020-01-01 00:08:40,14,8,13881,1385,12496,21.18%,9.98%
2020-01-01 00:08:40,14,9,1709,23,1686,2.61%,1.35%
2020-01-01 00:08:40,14,10,4120,133,3987,6.29%,3.23%
2020-01-01 00:08:40,14,11,25734,4519,21215,39.27%,17.56%
2020-01-01 00:08:40,14,12,7413,417,6996,11.31%,5.63%
2020-01-01 00:08:40,15,1,483,2,481,0.74%,0.41%
2020-01-01 00:08:40,15,2,165,0,165,0.25%,0.00%
2020-01-01 00:08:40,15,3,4004,127,3877,6.11%,3.17%
2020-01-01 00:08:40,15,4,5321,188,5133,8.12%,3.53%
2020-01-01 00:08:40,15,5,11267,878,10389,17.19%,7.79%
2020-01-01 00:08:40,15,6,5620,205,5415,8.58%,3.65%
2020-01-01 00:08:40,15,7,4048,197,3851,6.18%,4.87%
2020-01-01 00:08:40,15,8,5865,342,5523,8.95%,5.83%
2020-01-01 00:08:40,15,9,11443,912,10531,17.46%,7.97%
2020-01-01 00:08:40,15,10,7215,408,6807,11.01%,5.65%
2020-01-01 00:08:40,15,11,13180,1354,11826,20.11%,10.27%
2020-01-01 00:08:40,15,12,29944,6095,23849,45.69%,20.35%
2020-01-01 00:08:40,16,1,490,6,484,0.75%,1.22%
2020-01-01 00:08:40,16,2,271,0,271,0.41%,0.00%
2020-01-01 00:08:40,16,3,1272,16,1256,1.94%,1.26%
2020-01-01 00:08:40,16,4,4105,121,3984,6.26%,2.95%
2020-01-01 00:08:40,16,5,7441,502,6939,11.35%,6.75%
2020-01-01 00:08:40,16,6,4984,177,4807,7.60%,3.55%
2020-01-01 00:08:40,16,7,3114,79,3035,4.75%,2.54%
2020-01-01 00:08:40,16,8,8281,506,7775,12.64%,6.11%
2020-01-01 00:08:40,16,9,7889,559,7330,12.04%,7.09%
2020-01-01 00:08:40,16,10,2228,29,2199,3.40%,1.30%
2020-01-01 00:08:40,16,11,10856,968,9888,16.56%,8.92%
2020-01-01 00:08:40,16,12,27856,5342,22514,42.50%,19.18%
2020-01-01 00:08:50,1,1,18653,2401,16252,28.46%,12.87%
2020-01-01 00:08:50,1,2,7463,399,7064,11.39%,5.35%
2020-01-01 00:08:50,1,3,568,1,567,0.87%,0.18%
2020-01-01 00:08:50,1,4,10855,917,9938,16.56%,8.45%
2020-01-01 00:08:50,1,5,10259,822,9437,15.65%,8.01%
2020-01-01 00:08:50,1,6,10275,826,9449,15.68%,8.04%
2020-01-01 00:08:50,1,7,6865,343,6522,10.48%,5.00%
2020-01-01 00:08:50,1,8,5192,171,5021,7.92%,3.29%
2020-01-01 00:08:50,1,9,10117,799,9318,15.44%,7.90%
2020-01-01 00:08:50,1,10,4242,107,4135,6.47%,2.52%
2020-01-01 00:08:50,1,11,4337,112,4225,6.62%,2.58%
2020-01-01 00:08:50,1,12,10094,795,9299,15.40%,7.88%
2020-01-01 00:08:50,2,1,800,2,798,1.22%,0.25%
2020-01-01 00:08:50,2,2,30545,6098,24447,46.61%,19.96%
2020-01-01 00:08:50,2,3,25341,4299,21042,38.67%,16.96%
2020-01-01 00:08:50,2,4,711,2,709,1.08%,0.28%
2020-01-01 00:08:50,2,5,16520,1863,14657,25.21%,11.28%
2020-01-01 00:08:50,2,6,21,0,21,0.03%,0.00%
2020-01-01 00:08:50,2,7,4382,139,4243,6.69%,3.17%
2020-01-01 00:08:50,2,8,3314,76,3238,5.06%,2.29%
2020-01-01 00:08:50,2,9,16455,1843,14612,25.11%,11.20%
2020-01-01 00:08:50,2,10,2522,42,2480,3.85%,1.67%
2020-01-01 00:08:50,2,11,2555,42,2513,3.90%,1.64%
2020-01-01 00:08:50,2,12,16254,1794,14460,24.80%,11.04%
2020-01-01 00:08:50,3,1,1835,20,1815,2.80%,1.09%
2020-01-01 00:08:50,3,2,22146,3335,18811,33.79%,15.06%
2020-01-01 00:08:50,3,3,70209,27164,43045,107.13%,38.69%
2020-01-01 00:08:50,3,4,9817,705,9112,14.98%,7.18%
2020-01-01 00:08:50,3,5,45392,12713,32679,69.26%,28.01%
2020-01-01 00:08:50,3,6,11236,928,10308,17.14%,8.26%
2020-01-01 00:08:50,3,7,18210,2340,15870,27.79%,12.85%
2020-01-01 00:08:50,3,8,15254,1691,13563,23.28%,11.09%
2020-01-01 00:08:50,3,9,33725,7478,26247,51.46%,22.17%
2020-01-01 00:08:50,3,10,4773,148,4625,7.28%,3.10%
2020-01-01 00:08:50,3,11,1712,31,1681,2.61%,1.81%
2020-01-01 00:08:50,3,12,27044,4936,22108,41.27%,18.25%
2020-01-01 00:08:50,4,1,485,1,484,0.74%,0.21%
2020-01-01 00:08:50,4,2,348,1,347,0.53%,0.29%
2020-01-01 00:08:50,4,3,991,6,985,1.51%,0.61%
2020-01-01 00:08:50,4,4,29421,5770,23651,44.89%,19.61%
2020-01-01 00:08:50,4,5,19771,2726,17045,30.17%,13.79%
2020-01-01 00:08:50,4,6,25962,4549,21413,39.61%,17.52%
2020-01-01 00:08:50,4,7,4783,169,4614,7.30%,3.53%
2020-01-01 00:08:50,4,8,3187,76,3111,4.86%,2.38%
2020-01-01 00:08:50,4,9,17548,2217,15331,26.78%,12.63%
2020-01-01 00:08:50,4,10,1942,20,1922,2.96%,1.03%
2020-01-01 00:08:50,4,11,164,0,164,0.25%,0.00%
2020-01-01 00:08:50,4,12,14873,1656,13217,22.69%,11.13%
2020-01-01 00:08:50,5,1,2297,35,2262,3.50%,1.52%
2020-01-01 00:08:50,5,2,643,2,641,0.98%,0.31%
2020-01-01 00:08:50,5,3,1575,18,1557,2.40%,1.14%
2020-01-01 00:08:50,5,4,25704,4474,21230,39.22%,17.41%
2020-01-01 00:08:50,5,5,9921,749,9172,15.14%,7.55%
2020-01-01 00:08:50,5,6,20223,2881,17342,30.86%,14.25%
2020-01-01 00:08:50,5,7,9635,721,8914,14.70%,7.48%
2020-01-01 00:08:50,5,8,3464,98,3366,5.29%,2.83%
2020-01-01 00:08:50,5,9,8163,515,7648,12.46%,6.31%
2020-01-01 00:08:50,5,10,1436,15,1421,2.19%,1.04%
2020-01-01 00:08:50,5,11,1047,9,1038,1.60%,0.86%
2020-01-01 00:08:50,5,12,6417,311,6106,9.79%,4.85%
2020-01-01 00:08:50,6,1,797,7,790,1.22%,0.88%
2020-01-01 00:08:50,6,2,935,11,924,1.43%,1.18%
2020-01-01 00:08:50,6,3,1678,22,1656,2.56%,1.31%
2020-01-01 00:08:50,6,4,1517,15,1502,2.31%,0.99%
2020-01-01 00:08:50,6,5,15898,1776,14122,24.26%,11.17%
2020-01-01 00:08:50,6,6,4268,151,4117,6.51%,3.54%
2020-01-01 00:08:50,6,7,2403,47,2356,3.67%,1.96%
2020-01-01 00:08:50,6,8,1842,24,1818,2.81%,1.30%
2020-01-01 00:08:50,6,9,9676,657,9019,14.76%,6.79%
2020-01-01 00:08:50,6,10,2045,29,2016,3.12%,1.42%
2020-01-01 00:08:50,6,11,428,1,427,0.65%,0.23%
2020-01-01 00:08:50,6,12,7584,418,7166,11.57%,5.51%
2020-01-01 00:08:50,7,1,395,2,393,0.60%,0.51%
2020-01-01 00:08:50,7,2,215,0,215,0.33%,0.00%
2020-01-01 00:08:50,7,3,1238,6,1232,1.89%,0.48%
2020-01-01 00:08:50,7,4,1410,23,1387,2.15%,1.63%
2020-01-01 00:08:50,7,5,7155,382,6773,10.92%,5.34%
2020-01-01 00:08:50,7,6,12344,1129,11215,18.84%,9.15%
2020-01-01 00:08:50,7,7,3754,132,3622,5.73%,3.52%
2020-01-01 00:08:50,7,8,1271,15,1256,1.94%,1.18%
2020-01-01 00:08:50,7,9,5845,266,5579,8.92%,4.55%
2020-01-01 00:08:50,7,10,1306,15,1291,1.99%,1.15%
2020-01-01 00:08:50,7,11,73,0,73,0.11%,0.00%
2020-01-01 00:08:50,7,12,4539,158,4381,6.93%,3.48%
2020-01-01 00:08:50,8,1,450,1,449,0.69%,0.22%
2020-01-01 00:08:50,8,2,186,0,186,0.28%,0.00%
2020-01-01 00:08:50,8,3,1540,12,1528,2.35%,0.78%
2020-01-01 00:08:50,8,4,2580,45,2535,3.94%,1.74%
2020-01-01 00:08:50,8,5,7671,430,7241,11.71%,5.61%
2020-01-01 00:08:50,8,6,15508,1731,13777,23.66%,11.16%
2020-01-01 00:08:50,8,7,5186,223,4963,7.91%,4.30%
2020-01-01 00:08:50,8,8,2147,43,2104,3.28%,2.00%
2020-01-01 00:08:50,8,9,5960,256,5704,9.09%,4.30%
2020-01-01 00:08:50,8,10,1892,14,1878,2.89%,0.74%
2020-01-01 00:08:50,8,11,207,0,207,0.32%,0.00%
2020-01-01 00:08:50,8,12,3906,125,3781,5.96%,3.20%
2020-01-01 00:08:50,9,1,1050,6,1044,1.60%,0.57%
2020-01-01 00:08:50,9,2,2948,67,2881,4.50%,2.27%
2020-01-01 00:08:50,9,3,1320,18,1302,2.01%,1.36%
2020-01-01 00:08:50,9,4,8137,470,7667,12.42%,5.78%
2020-01-01 00:08:50,9,5,170,2,168,0.26%,1.18%
2020-01-01 00:08:50,9,6,8892,572,8320,13.57%,6.43%
2020-01-01 00:08:50,9,7,29440,5628,23812,44.92%,19.12%
2020-01-01 00:08:50,9,8,11676,965,10711,17.82%,8.26%
2020-01-01 00:08:50,9,9,134,1,133,0.20%,0.75%
2020-01-01 00:08:50,9,10,4969,194,4775,7.58%,3.90%
2020-01-01 00:08:50,9,11,10516,779,9737,16.05%,7.41%
2020-01-01 00:08:50,9,12,5210,197,5013,7.95%,3.78%
2020-01-01 00:08:50,10,1,1113,276,837,1.70%,24.80%
2020-01-01 00:08:50,10,2,3143,350,2793,4.80%,11.14%
2020-01-01 00:08:50,10,3,1803,46,1757,2.75%,2.55%
2020-01-01 00:08:50,10,4,4724,1057,3667,7.21%,22.38%
2020-01-01 00:08:50,10,5,607,3,604,0.93%,0.49%
2020-01-01 00:08:50,10,6,6661,1203,5458,10.16%,18.06%
2020-01-01 00:08:50,10,7,11632,2049,9583,17.75%,17.62%
2020-01-01 00:08:50,10,8,28265,7176,21089,43.13%,25.39%
2020-01-01 00:08:50,10,9,758,4,754,1.16%,0.53%
2020-01-01 00:08:50,10,10,2287,41,2246,3.49%,1.79%
2020-01-01 00:08:50,10,11,12378,1491,10887,18.89%,12.05%
2020-01-01 00:08:50,10,12,9554,1086,8468,14.58%,11.37%
2020-01-01 00:08:50,11,1,2328,35,2293,3.55%,1.50%
2020-01-01 00:08:50,11,2,3905,111,3794,5.96%,2.84%
2020-01-01 00:08:50,11,3,1423,11,1412,2.17%,0.77%
2020-01-01 00:08:50,11,4,3154,67,3087,4.81%,2.12%
2020-01-01 00:08:50,11,5,328,4,324,0.50%,1.22%
2020-01-01 00:08:50,11,6,4050,123,3927,6.18%,3.04%
2020-01-01 00:08:50,11,7,9553,709,8844,14.58%,7.42%
2020-01-01 00:08:50,11,8,27018,4978,22040,41.23%,18.42%
2020-01-01 00:08:50,11,9,213,0,213,0.33%,0.00%
2020-01-01 00:08:50,11,10,3019,65,2954,4.61%,2.15%
2020-01-01 00:08:50,11,11,13925,1368,12557,21.25%,9.82%
2020-01-01 00:08:50,11,12,10655,782,9873,16.26%,7.34%
2020-01-01 00:08:50,12,1,45,0,45,0.07%,0.00%
2020-01-01 00:08:50,12,2,751,267,484,1.15%,35.55%
2020-01-01 00:08:50,12,3,2699,313,2386,4.12%,11.60%
2020-01-01 00:08:50,12,4,2147,44,2103,3.28%,2.05%
2020-01-01 00:08:50,12,5,8185,704,7481,12.49%,8.60%
2020-01-01 00:08:50,12,6,4635,167,4468,7.07%,3.60%
2020-01-01 00:08:50,12,7,2398,42,2356,3.66%,1.75%
2020-01-01 00:08:50,12,8,1066,254,812,1.63%,23.83%
2020-01-01 00:08:50,12,9,20327,3953,16374,31.02%,19.45%
2020-01-01 00:08:50,12,10,3773,364,3409,5.76%,9.65%
2020-01-01 00:08:50,12,11,1251,256,995,1.91%,20.46%
2020-01-01 00:08:50,12,12,6939,1062,5877,10.59%,15.30%
2020-01-01 00:08:50,13,1,2461,54,2407,3.76%,2.19%
2020-01-01 00:08:50,13,2,2832,69,2763,4.32%,2.44%
2020-01-01 00:08:50,13,3,912,7,905,1.39%,0.77%
2020-01-01 00:08:50,13,4,4864,460,4404,7.42%,9.46%
2020-01-01 00:08:50,13,5,7137,744,6393,10.89%,10.42%
2020-01-01 00:08:50,13,6,5560,505,5055,8.48%,9.08%
2020-01-01 00:08:50,13,7,5395,214,5181,8.23%,3.97%
2020-01-01 00:08:50,13,8,8187,520,7667,12.49%,6.35%
2020-01-01 00:08:50,13,9,7526,776,6750,11.48%,10.31%
2020-01-01 00:08:50,13,10,28827,6034,22793,43.99%,20.93%
2020-01-01 00:08:50,13,11,18832,2711,16121,28.74%,14.40%
2020-01-01 00:08:50,13,12,10096,1015,9081,15.41%,10.05%
2020-01-01 00:08:50,14,1,490,2,488,0.75%,0.41%
2020-01-01 00:08:50,14,2,1724,30,1694,2.63%,1.74%
2020-01-01 00:08:50,14,3,948,6,942,1.45%,0.63%
2020-01-01 00:08:50,14,4,4171,116,4055,6.36%,2.78%
2020-01-01 00:08:50,14,5,1496,18,1478,2.28%,1.20%
2020-01-01 00:08:50,14,6,4721,148,4573,7.20%,3.13%
2020-01-01 00:08:50,14,7,11732,989,10743,17.90%,8.43%
2020-01-01 00:08:50,14,8,13305,1268,12037,20.30%,9.53%
2020-01-01 00:08:50,14,9,1822,25,1797,2.78%,1.37%
2020-01-01 00:08:50,14,10,4320,142,4178,6.59%,3.29%
2020-01-01 00:08:50,14,11,25071,4288,20783,38.26%,17.10%
2020-01-01 00:08:50,14,12,7160,373,6787,10.93%,5.21%
2020-01-01 00:08:50,15,1,512,1,511,0.78%,0.20%
2020-01-01 00:08:50,15,2,127,0,127,0.19%,0.00%
2020-01-01 00:08:50,15,3,3824,118,3706,5.83%,3.09%
2020-01-01 00:08:50,15,4,5051,305,4746,7.71%,6.04%
2020-01-01 00:08:50,15,5,10809,929,9880,16.49%,8.59%
2020-01-01 00:08:50,15,6,5297,315,4982,8.08%,5.95%
2020-01-01 00:08:50,15,7,3444,115,3329,5.26%,3.34%
2020-01-01 00:08:50,15,8,5434,252,5182,8.29%,4.64%
2020-01-01 00:08:50,15,9,10961,949,10012,16.73%,8.66%
2020-01-01 00:08:50,15,10,4370,122,4248,6.67%,2.79%
2020-01-01 00:08:50,15,11,9913,718,9195,15.13%,7.24%
2020-01-01 00:08:50,15,12,26738,5223,21515,40.80%,19.53%
2020-01-01 00:08:50,16,1,480,0,480,0.73%,0.00%
2020-01-01 00:08:50,16,2,224,0,224,0.34%,0.00%
2020-01-01 00:08:50,16,3,1348,13,1335,2.06%,0.96%
2020-01-01 00:08:50,16,4,3754,82,3672,5.73%,2.18%
2020-01-01 00:08:50,16,5,7554,496,7058,11.53%,6.57%
2020-01-01 00:08:50,16,6,4538,134,4404,6.92%,2.95%
2020-01-01 00:08:50,16,7,3618,103,3515,5.52%,2.85%
2020-01-01 00:08:50,16,8,7817,472,7345,11.93%,6.04%
2020-01-01 00:08:50,16,9,8050,562,7488,12.28%,6.98%
2020-01-01 00:08:50,16,10,1840,31,1809,2.81%,1.68%
2020-01-01 00:08:50,16,11,9855,701,9154,15.04%,7.11%
2020-01-01 00:08:50,16,12,25971,4588,21383,39.63%,17.67%
2020-01-01 00:09:00,1,1,17379,2224,15155,26.52%,12.80%
2020-01-01 00:09:00,1,2,6430,325,6105,9.81%,5.05%
2020-01-01 00:09:00,1,3,569,16,553,0.87%,2.81%
2020-01-01 00:09:00,1,4,10339,870,9469,15.78%,8.41%
2020-01-01 00:09:00,1,5,10028,819,9209,15.30%,8.17%
2020-01-01 00:09:00,1,6,9956,808,9148,15.19%,8.12%
2020-01-01 00:09:00,1,7,5839,261,5578,8.91%,4.47%
2020-01-01 00:09:00,1,8,4131,127,4004,6.30%,3.07%
2020-01-01 00:09:00,1,9,9888,800,9088,15.09%,8.09%
2020-01-01 00:09:00,1,10,3642,100,3542,5.56%,2.75%
2020-01-01 00:09:00,1,11,3726,104,3622,5.69%,2.79%
2020-01-01 00:09:00,1,12,9854,794,9060,15.04%,8.06%
2020-01-01 00:09:00,2,1,487,3,484,0.74%,0.62%
2020-01-01 00:09:00,2,2,26741,4740,22001,40.80%,17.73%
2020-01-01 00:09:00,2,3,22413,3423,18990,34.20%,15.27%
2020-01-01 00:09:00,2,4,353,2,351,0.54%,0.57%
2020-01-01 00:09:00,2,5,15520,1726,13794,23.68%,11.12%
2020-01-01 00:09:00,2,6,33,0,33,0.05%,0.00%
2020-01-01 00:09:00,2,7,3819,103,3716,5.83%,2.70%
2020-01-01 00:09:00,2,8,2709,51,2658,4.13%,1.88%
2020-01-01 00:09:00,2,9,15457,1713,13744,23.59%,11.08%
2020-01-01 00:09:00,2,10,1971,32,1939,3.01%,1.62%
2020-01-01 00:09:00,2,11,1987,32,1955,3.03%,1.61%
2020-01-01 00:09:00,2,12,15244,1669,13575,23.26%,10.95%
2020-01-01 00:09:00,3,1,1520,23,1497,2.32%,1.51%
2020-01-01 00:09:00,3,2,23832,3859,19973,36.36%,16.19%
2020-01-01 00:09:00,3,3,73074,29198,43876,111.50%,39.96%
2020-01-01 00:09:00,3,4,12720,1194,11526,19.41%,9.39%
2020-01-01 00:09:00,3,5,48024,14114,33910,73.28%,29.39%
2020-01-01 00:09:00,3,6,14180,1464,12716,21.64%,10.32%
2020-01-01 00:09:00,3,7,20097,2803,17294,30.67%,13.95%
2020-01-01 00:09:00,3,8,16781,1995,14786,25.61%,11.89%
2020-01-01 00:09:00,3,9,33433,7239,26194,51.01%,21.65%
2020-01-01 00:09:00,3,10,8079,473,7606,12.33%,5.85%
2020-01-01 00:09:00,3,11,2050,43,2007,3.13%,2.10%
2020-01-01 00:09:00,3,12,22491,3437,19054,34.32%,15.28%
2020-01-01 00:09:00,4,1,576,1,575,0.88%,0.17%
2020-01-01 00:09:00,4,2,361,1,360,0.55%,0.28%
2020-01-01 00:09:00,4,3,583,4,579,0.89%,0.69%
2020-01-01 00:09:00,4,4,29942,5854,24088,45.69%,19.55%
2020-01-01 00:09:00,4,5,19369,2614,16755,29.55%,13.50%
2020-01-01 00:09:00,4,6,25714,4409,21305,39.24%,17.15%
2020-01-01 00:09:00,4,7,5082,167,4915,7.75%,3.29%
2020-01-01 00:09:00,4,8,2869,61,2808,4.38%,2.13%
2020-01-01 00:09:00,4,9,17525,2153,15372,26.74%,12.29%
2020-01-01 00:09:00,4,10,2284,34,2250,3.49%,1.49%
2020-01-01 00:09:00,4,11,235,0,235,0.36%,0.00%
2020-01-01 00:09:00,4,12,14430,1526,12904,22.02%,10.58%
2020-01-01 00:09:00,5,1,2608,66,2542,3.98%,2.53%
2020-01-01 00:09:00,5,2,729,7,722,1.11%,0.96%
2020-01-01 00:09:00,5,3,476,0,476,0.73%,0.00%
2020-01-01 00:09:00,5,4,25465,4460,21005,38.86%,17.51%
2020-01-01 00:09:00,5,5,8963,611,8352,13.68%,6.82%
2020-01-01 00:09:00,5,6,19047,2610,16437,29.06%,13.70%
2020-01-01 00:09:00,5,7,9465,717,8748,14.44%,7.58%
2020-01-01 00:09:00,5,8,3535,98,3437,5.39%,2.77%
2020-01-01 00:09:00,5,9,8337,519,7818,12.72%,6.23%
2020-01-01 00:09:00,5,10,949,16,933,1.45%,1.69%
2020-01-01 00:09:00,5,11,590,3,587,0.90%,0.51%
2020-01-01 00:09:00,5,12,6921,363,6558,10.56%,5.24%
2020-01-01 00:09:00,6,1,1245,11,1234,1.90%,0.88%
2020-01-01 00:09:00,6,2,1367,14,1353,2.09%,1.02%
2020-01-01 00:09:00,6,3,1854,23,1831,2.83%,1.24%
2020-01-01 00:09:00,6,4,997,12,985,1.52%,1.20%
2020-01-01 00:09:00,6,5,15267,1675,13592,23.30%,10.97%
2020-01-01 00:09:00,6,6,5487,252,5235,8.37%,4.59%
2020-01-01 00:09:00,6,7,4190,160,4030,6.39%,3.82%
2020-01-01 00:09:00,6,8,3102,103,2999,4.73%,3.32%
2020-01-01 00:09:00,6,9,7626,444,7182,11.64%,5.82%
2020-01-01 00:09:00,6,10,2710,55,2655,4.14%,2.03%
2020-01-01 00:09:00,6,11,537,2,535,0.82%,0.37%
2020-01-01 00:09:00,6,12,4858,172,4686,7.41%,3.54%
2020-01-01 00:09:00,7,1,665,10,655,1.01%,1.50%
2020-01-01 00:09:00,7,2,137,0,137,0.21%,0.00%
2020-01-01 00:09:00,7,3,831,3,828,1.27%,0.36%
2020-01-01 00:09:00,7,4,2636,51,2585,4.02%,1.93%
2020-01-01 00:09:00,7,5,7364,383,6981,11.24%,5.20%
2020-01-01 00:09:00,7,6,14395,1534,12861,21.97%,10.66%
2020-01-01 00:09:00,7,7,4369,145,4224,6.67%,3.32%
2020-01-01 00:09:00,7,8,1729,15,1714,2.64%,0.87%
2020-01-01 00:09:00,7,9,6443,291,6152,9.83%,4.52%
2020-01-01 00:09:00,7,10,1120,8,1112,1.71%,0.71%
2020-01-01 00:09:00,7,11,112,1,111,0.17%,0.89%
2020-01-01 00:09:00,7,12,5301,211,5090,8.09%,3.98%
2020-01-01 00:09:00,8,1,468,1,467,0.71%,0.21%
2020-01-01 00:09:00,8,2,88,0,88,0.13%,0.00%
2020-01-01 00:09:00,8,3,1973,21,1952,3.01%,1.06%
2020-01-01 00:09:00,8,4,2523,41,2482,3.85%,1.63%
2020-01-01 00:09:00,8,5,8305,468,7837,12.67%,5.64%
2020-01-01 00:09:00,8,6,15658,1693,13965,23.89%,10.81%
2020-01-01 00:09:00,8,7,4791,191,4600,7.31%,3.99%
2020-01-01 00:09:00,8,8,1924,47,1877,2.94%,2.44%
2020-01-01 00:09:00,8,9,6112,289,5823,9.33%,4.73%
2020-01-01 00:09:00,8,10,1857,21,1836,2.83%,1.13%
2020-01-01 00:09:00,8,11,112,0,112,0.17%,0.00%
2020-01-01 00:09:00,8,12,4321,160,4161,6.59%,3.70%
2020-01-01 00:09:00,9,1,474,0,474,0.72%,0.00%
2020-01-01 00:09:00,9,2,2460,40,2420,3.75%,1.63%
2020-01-01 00:09:00,9,3,1456,10,1446,2.22%,0.69%
2020-01-01 00:09:00,9,4,3237,79,3158,4.94%,2.44%
2020-01-01 00:09:00,9,5,351,2,349,0.54%,0.57%
2020-01-01 00:09:00,9,6,4102,130,3972,6.26%,3.17%
2020-01-01 00:09:00,9,7,27608,4990,22618,42.13%,18.07%
2020-01-01 00:09:00,9,8,13829,1389,12440,21.10%,10.04%
2020-01-01 00:09:00,9,9,209,0,209,0.32%,0.00%
2020-01-01 00:09:00,9,10,4432,99,4333,6.76%,2.23%
2020-01-01 00:09:00,9,11,11860,990,10870,18.10%,8.35%
2020-01-01 00:09:00,9,12,7054,381,6673,10.76%,5.40%
2020-01-01 00:09:00,10,1,1940,300,1640,2.96%,15.46%
2020-01-01 00:09:00,10,2,3766,355,3411,5.75%,9.43%
2020-01-01 00:09:00,10,3,1680,17,1663,2.56%,1.01%
2020-01-01 00:09:00,10,4,3685,1156,2529,5.62%,31.37%
2020-01-01 00:09:00,10,5,840,52,788,1.28%,6.19%
2020-01-01 00:09:00,10,6,6153,1337,4816,9.39%,21.73%
2020-01-01 00:09:00,10,7,11477,2175,9302,17.51%,18.95%
2020-01-01 00:09:00,10,8,29443,7728,21715,44.93%,26.25%
2020-01-01 00:09:00,10,9,620,1,619,0.95%,0.16%
2020-01-01 00:09:00,10,10,2444,36,2408,3.73%,1.47%
2020-01-01 00:09:00,10,11,14217,1905,12312,21.69%,13.40%
2020-01-01 00:09:00,10,12,10996,1334,9662,16.78%,12.13%
2020-01-01 00:09:00,11,1,3158,85,3073,4.82%,2.69%
2020-01-01 00:09:00,11,2,4142,145,3997,6.32%,3.50%
2020-01-01 00:09:00,11,3,691,8,683,1.05%,1.16%
2020-01-01 00:09:00,11,4,5367,226,5141,8.19%,4.21%
2020-01-01 00:09:00,11,5,218,1,217,0.33%,0.46%
2020-01-01 00:09:00,11,6,6309,309,6000,9.63%,4.90%
2020-01-01 00:09:00,11,7,12222,1078,11144,18.65%,8.82%
2020-01-01 00:09:00,11,8,28429,5397,23032,43.38%,18.98%
2020-01-01 00:09:00,11,9,236,1,235,0.36%,0.42%
2020-01-01 00:09:00,11,10,3252,187,3065,4.96%,5.75%
2020-01-01 00:09:00,11,11,12042,1113,10929,18.37%,9.24%
2020-01-01 00:09:00,11,12,8317,478,7839,12.69%,5.75%
2020-01-01 00:09:00,12,1,47,0,47,0.07%,0.00%
2020-01-01 00:09:00,12,2,613,176,437,0.94%,28.71%
2020-01-01 00:09:00,12,3,3080,234,2846,4.70%,7.60%
2020-01-01 00:09:00,12,4,2845,70,2775,4.34%,2.46%
2020-01-01 00:09:00,12,5,8465,666,7799,12.92%,7.87%
2020-01-01 00:09:00,12,6,4706,171,4535,7.18%,3.63%
2020-01-01 00:09:00,12,7,1678,25,1653,2.56%,1.49%
2020-01-01 00:09:00,12,8,1374,292,1082,2.10%,21.25%
2020-01-01 00:09:00,12,9,21746,4289,17457,33.18%,19.72%
2020-01-01 00:09:00,12,10,5160,468,4692,7.87%,9.07%
2020-01-01 00:09:00,12,11,2148,308,1840,3.28%,14.34%
2020-01-01 00:09:00,12,12,7527,1255,6272,11.49%,16.67%
2020-01-01 00:09:00,13,1,2300,55,2245,3.51%,2.39%
2020-01-01 00:09:00,13,2,2560,71,2489,3.91%,2.77%
2020-01-01 00:09:00,13,3,959,17,942,1.46%,1.77%
2020-01-01 00:09:00,13,4,4688,452,4236,7.15%,9.64%
2020-01-01 00:09:00,13,5,7304,759,6545,11.15%,10.39%
2020-01-01 00:09:00,13,6,5439,492,4947,8.30%,9.05%
2020-01-01 00:09:00,13,7,4578,164,4414,6.99%,3.58%
2020-01-01 00:09:00,13,8,6892,319,6573,10.52%,4.63%
2020-01-01 00:09:00,13,9,7590,789,6801,11.58%,10.40%
2020-01-01 00:09:00,13,10,26572,5228,21344,40.55%,19.67%
2020-01-01 00:09:00,13,11,15418,2033,13385,23.53%,13.19%
2020-01-01 00:09:00,13,12,8049,881,7168,12.28%,10.95%
2020-01-01 00:09:00,14,1,177,0,177,0.27%,0.00%
2020-01-01 00:09:00,14,2,1408,13,1395,2.15%,0.92%
2020-01-01 00:09:00,14,3,1073,7,1066,1.64%,0.65%
2020-01-01 00:09:00,14,4,3948,120,3828,6.02%,3.04%
2020-01-01 00:09:00,14,5,1530,19,1511,2.33%,1.24%
2020-01-01 00:09:00,14,6,4218,139,4079,6.44%,3.30%
2020-01-01 00:09:00,14,7,11951,1028,10923,18.24%,8.60%
2020-01-01 00:09:00,14,8,13566,1320,12246,20.70%,9.73%
2020-01-01 00:09:00,14,9,1837,31,1806,2.80%,1.69%
2020-01-01 00:09:00,14,10,4270,136,4134,6.52%,3.19%
2020-01-01 00:09:00,14,11,25969,4600,21369,39.63%,17.71%
2020-01-01 00:09:00,14,12,7850,490,7360,11.98%,6.24%
2020-01-01 00:09:00,15,1,521,1,520,0.79%,0.19%
2020-01-01 00:09:00,15,2,148,0,148,0.23%,0.00%
2020-01-01 00:09:00,15,3,3820,99,3721,5.83%,2.59%
2020-01-01 00:09:00,15,4,4780,192,4588,7.29%,4.02%
2020-01-01 00:09:00,15,5,9661,673,8988,14.74%,6.97%
2020-01-01 00:09:00,15,6,5039,206,4833,7.69%,4.09%
2020-01-01 00:09:00,15,7,3684,144,3540,5.62%,3.91%
2020-01-01 00:09:00,15,8,5418,263,5155,8.27%,4.85%
2020-01-01 00:09:00,15,9,9871,700,9171,15.06%,7.09%
2020-01-01 00:09:00,15,10,4178,444,3734,6.38%,10.63%
2020-01-01 00:09:00,15,11,9801,1038,8763,14.96%,10.59%
2020-01-01 00:09:00,15,12,25384,4954,20430,38.73%,19.52%
2020-01-01 00:09:00,16,1,565,0,565,0.86%,0.00%
2020-01-01 00:09:00,16,2,204,0,204,0.31%,0.00%
2020-01-01 00:09:00,16,3,1550,20,1530,2.37%,1.29%
2020-01-01 00:09:00,16,4,4337,203,4134,6.62%,4.68%
2020-01-01 00:09:00,16,5,7792,611,7181,11.89%,7.84%
2020-01-01 00:09:00,16,6,5278,268,5010,8.05%,5.08%
2020-01-01 00:09:00,16,7,3307,86,3221,5.05%,2.60%
2020-01-01 00:09:00,16,8,7352,416,6936,11.22%,5.66%
2020-01-01 00:09:00,16,9,8347,669,7678,12.74%,8.01%
2020-01-01 00:09:00,16,10,2131,34,2097,3.25%,1.60%
2020-01-01 00:09:00,16,11,9780,725,9055,14.92%,7.41%
2020-01-01 00:09:00,16,12,26779,4966,21813,40.86%,18.54%
2020-01-01 00:09:10,1,1,15271,1678,13593,23.30%,10.99%
2020-01-01 00:09:10,1,2,7351,375,6976,11.22%,5.10%
2020-01-01 00:09:10,1,3,559,3,556,0.85%,0.54%
2020-01-01 00:09:10,1,4,7405,443,6962,11.30%,5.98%
2020-01-01 00:09:10,1,5,7177,420,6757,10.95%,5.85%
2020-01-01 00:09:10,1,6,7081,414,6667,10.80%,5.85%
2020-01-01 00:09:10,1,7,6780,327,6453,10.35%,4.82%
2020-01-01 00:09:10,1,8,4463,137,4326,6.81%,3.07%
2020-01-01 00:09:10,1,9,7057,411,6646,10.77%,5.82%
2020-01-01 00:09:10,1,10,3663,91,3572,5.59%,2.48%
2020-01-01 00:09:10,1,11,3784,98,3686,5.77%,2.59%
2020-01-01 00:09:10,1,12,7002,405,6597,10.68%,5.78%
2020-01-01 00:09:10,2,1,529,0,529,0.81%,0.00%
2020-01-01 00:09:10,2,2,28779,5458,23321,43.91%,18.97%
2020-01-01 00:09:10,2,3,24399,3999,20400,37.23%,16.39%
2020-01-01 00:09:10,2,4,459,0,459,0.70%,0.00%
2020-01-01 00:09:10,2,5,14746,1516,13230,22.50%,10.28%
2020-01-01 00:09:10,2,6,53,0,53,0.08%,0.00%
2020-01-01 00:09:10,2,7,3829,92,3737,5.84%,2.40%
2020-01-01 00:09:10,2,8,2514,44,2470,3.84%,1.75%
2020-01-01 00:09:10,2,9,14572,1475,13097,22.24%,10.12%
2020-01-01 00:09:10,2,10,1601,21,1580,2.44%,1.31%
2020-01-01 00:09:10,2,11,1630,21,1609,2.49%,1.29%
2020-01-01 00:09:10,2,12,14433,1453,12980,22.02%,10.07%
2020-01-01 00:09:10,3,1,1444,31,1413,2.20%,2.15%
2020-01-01 00:09:10,3,2,22586,3488,19098,34.46%,15.44%
2020-01-01 00:09:10,3,3,76483,31343,45140,116.70%,40.98%
2020-01-01 00:09:10,3,4,14285,1471,12814,21.80%,10.30%
2020-01-01 00:09:10,3,5,53254,16783,36471,81.26%,31.52%
2020-01-01 00:09:10,3,6,15501,1737,13764,23.65%,11.21%
2020-01-01 00:09:10,3,7,19208,2567,16641,29.31%,13.36%
2020-01-01 00:09:10,3,8,16633,1931,14702,25.38%,11.61%
2020-01-01 00:09:10,3,9,37154,8723,28431,56.69%,23.48%
2020-01-01 00:09:10,3,10,7440,396,7044,11.35%,5.32%
2020-01-01 00:09:10,3,11,1768,27,1741,2.70%,1.53%
2020-01-01 00:09:10,3,12,27241,4918,22323,41.57%,18.05%
2020-01-01 00:09:10,4,1,657,3,654,1.00%,0.46%
2020-01-01 00:09:10,4,2,432,2,430,0.66%,0.46%
2020-01-01 00:09:10,4,3,757,4,753,1.16%,0.53%
2020-01-01 00:09:10,4,4,27355,4957,22398,41.74%,18.12%
2020-01-01 00:09:10,4,5,17087,2061,15026,26.07%,12.06%
2020-01-01 00:09:10,4,6,23003,3627,19376,35.10%,15.77%
2020-01-01 00:09:10,4,7,4704,146,4558,7.18%,3.10%
2020-01-01 00:09:10,4,8,2609,43,2566,3.98%,1.65%
2020-01-01 00:09:10,4,9,15197,1627,13570,23.19%,10.71%
2020-01-01 00:09:10,4,10,2016,36,1980,3.08%,1.79%
2020-01-01 00:09:10,4,11,191,1,190,0.29%,0.52%
2020-01-01 00:09:10,4,12,12531,1155,11376,19.12%,9.22%
2020-01-01 00:09:10,5,1,3262,80,3182,4.98%,2.45%
2020-01-01 00:09:10,5,2,775,4,771,1.18%,0.52%
2020-01-01 00:09:10,5,3,485,0,485,0.74%,0.00%
2020-01-01 00:09:10,5,4,21326,3081,18245,32.54%,14.45%
2020-01-01 00:09:10,5,5,9555,640,8915,14.58%,6.70%
2020-01-01 00:09:10,5,6,14522,1457,13065,22.16%,10.03%
2020-01-01 00:09:10,5,7,4536,155,4381,6.92%,3.42%
2020-01-01 00:09:10,5,8,3535,99,3436,5.39%,2.80%
2020-01-01 00:09:10,5,9,8950,572,8378,13.66%,6.39%
2020-01-01 00:09:10,5,10,892,6,886,1.36%,0.67%
2020-01-01 00:09:10,5,11,558,4,554,0.85%,0.72%
2020-01-01 00:09:10,5,12,7860,446,7414,11.99%,5.67%
2020-01-01 00:09:10,6,1,1175,25,1150,1.79%,2.13%
2020-01-01 00:09:10,6,2,1271,29,1242,1.94%,2.28%
2020-01-01 00:09:10,6,3,1911,46,1865,2.92%,2.41%
2020-01-01 00:09:10,6,4,1002,5,997,1.53%,0.50%
2020-01-01 00:09:10,6,5,12103,1026,11077,18.47%,8.48%
2020-01-01 00:09:10,6,6,3728,96,3632,5.69%,2.58%
2020-01-01 00:09:10,6,7,2316,37,2279,3.53%,1.60%
2020-01-01 00:09:10,6,8,1818,26,1792,2.77%,1.43%
2020-01-01 00:09:10,6,9,6158,272,5886,9.40%,4.42%
2020-01-01 00:09:10,6,10,1793,27,1766,2.74%,1.51%
2020-01-01 00:09:10,6,11,469,4,465,0.72%,0.85%
2020-01-01 00:09:10,6,12,4293,120,4173,6.55%,2.80%
2020-01-01 00:09:10,7,1,478,2,476,0.73%,0.42%
2020-01-01 00:09:10,7,2,353,1,352,0.54%,0.28%
2020-01-01 00:09:10,7,3,483,2,481,0.74%,0.41%
2020-01-01 00:09:10,7,4,2289,23,2266,3.49%,1.00%
2020-01-01 00:09:10,7,5,7407,399,7008,11.30%,5.39%
2020-01-01 00:09:10,7,6,13926,1382,12544,21.25%,9.92%
2020-01-01 00:09:10,7,7,4187,152,4035,6.39%,3.63%
2020-01-01 00:09:10,7,8,2214,48,2166,3.38%,2.17%
2020-01-01 00:09:10,7,9,6527,309,6218,9.96%,4.73%
2020-01-01 00:09:10,7,10,1502,12,1490,2.29%,0.80%
2020-01-01 00:09:10,7,11,85,1,84,0.13%,1.18%
2020-01-01 00:09:10,7,12,5023,190,4833,7.66%,3.78%
2020-01-01 00:09:10,8,1,483,1,482,0.74%,0.21%
2020-01-01 00:09:10,8,2,106,3,103,0.16%,2.83%
2020-01-01 00:09:10,8,3,1853,29,1824,2.83%,1.57%
2020-01-01 00:09:10,8,4,3221,76,3145,4.91%,2.36%
2020-01-01 00:09:10,8,5,8810,586,8224,13.44%,6.65%
2020-01-01 00:09:10,8,6,16284,1927,14357,24.85%,11.83%
2020-01-01 00:09:10,8,7,4208,130,4078,6.42%,3.09%
2020-01-01 00:09:10,8,8,1424,26,1398,2.17%,1.83%
2020-01-01 00:09:10,8,9,6761,328,6433,10.32%,4.85%
2020-01-01 00:09:10,8,10,1999,22,1977,3.05%,1.10%
2020-01-01 00:09:10,8,11,133,0,133,0.20%,0.00%
2020-01-01 00:09:10,8,12,4800,171,4629,7.32%,3.56%
2020-01-01 00:09:10,9,1,255,0,255,0.39%,0.00%
2020-01-01 00:09:10,9,2,2325,36,2289,3.55%,1.55%
2020-01-01 00:09:10,9,3,1642,21,1621,2.51%,1.28%
2020-01-01 00:09:10,9,4,5405,246,5159,8.25%,4.55%
2020-01-01 00:09:10,9,5,677,4,673,1.03%,0.59%
2020-01-01 00:09:10,9,6,6588,358,6230,10.05%,5.43%
2020-01-01 00:09:10,9,7,27271,4967,22304,41.61%,18.21%
2020-01-01 00:09:10,9,8,11735,933,10802,17.91%,7.95%
2020-01-01 00:09:10,9,9,269,1,268,0.41%,0.37%
2020-01-01 00:09:10,9,10,3820,66,3754,5.83%,1.73%
2020-01-01 00:09:10,9,11,10746,790,9956,16.40%,7.35%
2020-01-01 00:09:10,9,12,6612,325,6287,10.09%,4.92%
2020-01-01 00:09:10,10,1,1504,234,1270,2.29%,15.56%
2020-01-01 00:09:10,10,2,3466,306,3160,5.29%,8.83%
2020-01-01 00:09:10,10,3,1825,23,1802,2.78%,1.26%
2020-01-01 00:09:10,10,4,3852,1137,2715,5.88%,29.52%
2020-01-01 00:09:10,10,5,1062,116,946,1.62%,10.92%
2020-01-01 00:09:10,10,6,6124,1371,4753,9.34%,22.39%
2020-01-01 00:09:10,10,7,10990,2125,8865,16.77%,19.34%
2020-01-01 00:09:10,10,8,29232,7488,21744,44.60%,25.62%
2020-01-01 00:09:10,10,9,559,4,555,0.85%,0.72%
2020-01-01 00:09:10,10,10,1799,32,1767,2.75%,1.78%
2020-01-01 00:09:10,10,11,13090,1495,11595,19.97%,11.42%
2020-01-01 00:09:10,10,12,10195,1044,9151,15.56%,10.24%
2020-01-01 00:09:10,11,1,2327,44,2283,3.55%,1.89%
2020-01-01 00:09:10,11,2,3832,111,3721,5.85%,2.90%
2020-01-01 00:09:10,11,3,1242,15,1227,1.90%,1.21%
2020-01-01 00:09:10,11,4,3561,92,3469,5.43%,2.58%
2020-01-01 00:09:10,11,5,217,2,215,0.33%,0.92%
2020-01-01 00:09:10,11,6,4335,140,4195,6.61%,3.23%
2020-01-01 00:09:10,11,7,9723,710,9013,14.84%,7.30%
2020-01-01 00:09:10,11,8,24570,4083,20487,37.49%,16.62%
2020-01-01 00:09:10,11,9,186,0,186,0.28%,0.00%
2020-01-01 00:09:10,11,10,3123,80,3043,4.77%,2.56%
2020-01-01 00:09:10,11,11,10553,822,9731,16.10%,7.79%
2020-01-01 00:09:10,11,12,6876,375,6501,10.49%,5.45%
2020-01-01 00:09:10,12,1,37,0,37,0.06%,0.00%
2020-01-01 00:09:10,12,2,473,118,355,0.72%,24.95%
2020-01-01 00:09:10,12,3,2907,177,2730,4.44%,6.09%
2020-01-01 00:09:10,12,4,2962,60,2902,4.52%,2.03%
2020-01-01 00:09:10,12,5,9572,788,8784,14.61%,8.23%
2020-01-01 00:09:10,12,6,5427,268,5159,8.28%,4.94%
2020-01-01 00:09:10,12,7,2330,73,2257,3.56%,3.13%
2020-01-01 00:09:10,12,8,2025,278,1747,3.09%,13.73%
2020-01-01 00:09:10,12,9,22434,4478,17956,34.23%,19.96%
2020-01-01 00:09:10,12,10,4775,380,4395,7.29%,7.96%
2020-01-01 00:09:10,12,11,2485,292,2193,3.79%,11.75%
2020-01-01 00:09:10,12,12,7423,1263,6160,11.33%,17.01%
2020-01-01 00:09:10,13,1,1673,23,1650,2.55%,1.37%
2020-01-01 00:09:10,13,2,2124,31,2093,3.24%,1.46%
2020-01-01 00:09:10,13,3,922,27,895,1.41%,2.93%
2020-01-01 00:09:10,13,4,4689,859,3830,7.15%,18.32%
2020-01-01 00:09:10,13,5,7187,1200,5987,10.97%,16.70%
2020-01-01 00:09:10,13,6,5197,898,4299,7.93%,17.28%
2020-01-01 00:09:10,13,7,4104,122,3982,6.26%,2.97%
2020-01-01 00:09:10,13,8,6264,289,5975,9.56%,4.61%
2020-01-01 00:09:10,13,9,7461,1228,6233,11.38%,16.46%
2020-01-01 00:09:10,13,10,27021,5582,21439,41.23%,20.66%
2020-01-01 00:09:10,13,11,16655,2039,14616,25.41%,12.24%
2020-01-01 00:09:10,13,12,10020,858,9162,15.29%,8.56%
2020-01-01 00:09:10,14,1,278,1,277,0.42%,0.36%
2020-01-01 00:09:10,14,2,1615,21,1594,2.46%,1.30%
2020-01-01 00:09:10,14,3,1044,8,1036,1.59%,0.77%
2020-01-01 00:09:10,14,4,3501,82,3419,5.34%,2.34%
2020-01-01 00:09:10,14,5,1158,8,1150,1.77%,0.69%
2020-01-01 00:09:10,14,6,4034,105,3929,6.16%,2.60%
2020-01-01 00:09:10,14,7,12135,995,11140,18.52%,8.20%
2020-01-01 00:09:10,14,8,13604,1258,12346,20.76%,9.25%
2020-01-01 00:09:10,14,9,1496,12,1484,2.28%,0.80%
2020-01-01 00:09:10,14,10,4449,146,4303,6.79%,3.28%
2020-01-01 00:09:10,14,11,29208,5554,23654,44.57%,19.02%
2020-01-01 00:09:10,14,12,10759,844,9915,16.42%,7.84%
2020-01-01 00:09:10,15,1,497,2,495,0.76%,0.40%
2020-01-01 00:09:10,15,2,128,0,128,0.20%,0.00%
2020-01-01 00:09:10,15,3,8653,554,8099,13.20%,6.40%
2020-01-01 00:09:10,15,4,5321,231,5090,8.12%,4.34%
2020-01-01 00:09:10,15,5,14955,1699,13256,22.82%,11.36%
2020-01-01 00:09:10,15,6,5592,275,5317,8.53%,4.92%
2020-01-01 00:09:10,15,7,3352,93,3259,5.11%,2.77%
2020-01-01 00:09:10,15,8,5180,229,4951,7.90%,4.42%
2020-01-01 00:09:10,15,9,15147,1740,13407,23.11%,11.49%
2020-01-01 00:09:10,15,10,5575,455,5120,8.51%,8.16%
2020-01-01 00:09:10,15,11,10997,1103,9894,16.78%,10.03%
2020-01-01 00:09:10,15,12,31474,6952,24522,48.03%,22.09%
2020-01-01 00:09:10,16,1,597,2,595,0.91%,0.34%
2020-01-01 00:09:10,16,2,294,0,294,0.45%,0.00%
2020-01-01 00:09:10,16,3,1559,22,1537,2.38%,1.41%
2020-01-01 00:09:10,16,4,4282,129,4153,6.53%,3.01%
2020-01-01 00:09:10,16,5,8737,626,8111,13.33%,7.16%
2020-01-01 00:09:10,16,6,5308,201,5107,8.10%,3.79%
2020-01-01 00:09:10,16,7,3411,99,3312,5.20%,2.90%
2020-01-01 00:09:10,16,8,7617,434,7183,11.62%,5.70%
2020-01-01 00:09:10,16,9,9180,683,8497,14.01%,7.44%
2020-01-01 00:09:10,16,10,1630,25,1605,2.49%,1.53%
2020-01-01 00:09:10,16,11,9464,669,8795,14.44%,7.07%
2020-01-01 00:09:10,16,12,27165,4959,22206,41.45%,18.26%
2020-01-01 00:09:20,1,1,13984,1407,12577,21.34%,10.06%
2020-01-01 00:09:20,1,2,4510,136,4374,6.88%,3.02%
2020-01-01 00:09:20,1,3,454,1,453,0.69%,0.22%
2020-01-01 00:09:20,1,4,9078,634,8444,13.85%,6.98%
2020-01-01 00:09:20,1,5,8609,586,8023,13.14%,6.81%
2020-01-01 00:09:20,1,6,8482,576,7906,12.94%,6.79%
2020-01-01 00:09:20,1,7,4035,109,3926,6.16%,2.70%
2020-01-01 00:09:20,1,8,3338,66,3272,5.09%,1.98%
2020-01-01 00:09:20,1,9,8461,573,7888,12.91%,6.77%
2020-01-01 00:09:20,1,10,2657,47,2610,4.05%,1.77%
2020-01-01 00:09:20,1,11,2703,47,2656,4.12%,1.74%
2020-01-01 00:09:20,1,12,8235,546,7689,12.57%,6.63%
2020-01-01 00:09:20,2,1,781,0,781,1.19%,0.00%
2020-01-01 00:09:20,2,2,28910,5450,23460,44.11%,18.85%
2020-01-01 00:09:20,2,3,24228,3861,20367,36.97%,15.94%
2020-01-01 00:09:20,2,4,710,0,710,1.08%,0.00%
2020-01-01 00:09:20,2,5,16123,1742,14381,24.60%,10.80%
2020-01-01 00:09:20,2,6,21,0,21,0.03%,0.00%
2020-01-01 00:09:20,2,7,3883,102,3781,5.92%,2.63%
2020-01-01 00:09:20,2,8,3037,60,2977,4.63%,1.98%
2020-01-01 00:09:20,2,9,16039,1719,14320,24.47%,10.72%
2020-01-01 00:09:20,2,10,2224,37,2187,3.39%,1.66%
2020-01-01 00:09:20,2,11,2230,37,2193,3.40%,1.66%
2020-01-01 00:09:20,2,12,15823,1669,14154,24.14%,10.55%
2020-01-01 00:09:20,3,1,1752,34,1718,2.67%,1.94%
2020-01-01 00:09:20,3,2,23587,3896,19691,35.99%,16.52%
2020-01-01 00:09:20,3,3,62690,22463,40227,95.66%,35.83%
2020-01-01 00:09:20,3,4,5399,217,5182,8.24%,4.02%
2020-01-01 00:09:20,3,5,37746,9147,28599,57.60%,24.23%
2020-01-01 00:09:20,3,6,7016,356,6660,10.71%,5.07%
2020-01-01 00:09:20,3,7,19872,2834,17038,30.32%,14.26%
2020-01-01 00:09:20,3,8,16135,1853,14282,24.62%,11.48%
2020-01-01 00:09:20,3,9,30162,6094,24068,46.02%,20.20%
2020-01-01 00:09:20,3,10,4150,127,4023,6.33%,3.06%
2020-01-01 00:09:20,3,11,1947,32,1915,2.97%,1.64%
2020-01-01 00:09:20,3,12,22676,3600,19076,34.60%,15.88%
2020-01-01 00:09:20,4,1,433,1,432,0.66%,0.23%
2020-01-01 00:09:20,4,2,254,1,253,0.39%,0.39%
2020-01-01 00:09:20,4,3,815,4,811,1.24%,0.49%
2020-01-01 00:09:20,4,4,27567,5121,22446,42.06%,18.58%
2020-01-01 00:09:20,4,5,17063,2031,15032,26.04%,11.90%
2020-01-01 00:09:20,4,6,23921,3923,19998,36.50%,16.40%
2020-01-01 00:09:20,4,7,5461,276,5185,8.33%,5.05%
2020-01-01 00:09:20,4,8,3070,74,2996,4.68%,2.41%
2020-01-01 00:09:20,4,9,14998,1637,13361,22.89%,10.91%
2020-01-01 00:09:20,4,10,2050,44,2006,3.13%,2.15%
2020-01-01 00:09:20,4,11,148,0,148,0.23%,0.00%
2020-01-01 00:09:20,4,12,12308,1110,11198,18.78%,9.02%
2020-01-01 00:09:20,5,1,3180,77,3103,4.85%,2.42%
2020-01-01 00:09:20,5,2,705,1,704,1.08%,0.14%
2020-01-01 00:09:20,5,3,576,0,576,0.88%,0.00%
2020-01-01 00:09:20,5,4,27384,5013,22371,41.78%,18.31%
2020-01-01 00:09:20,5,5,9753,713,9040,14.88%,7.31%
2020-01-01 00:09:20,5,6,16242,1908,14334,24.78%,11.75%
2020-01-01 00:09:20,5,7,5915,281,5634,9.03%,4.75%
2020-01-01 00:09:20,5,8,4564,172,4392,6.96%,3.77%
2020-01-01 00:09:20,5,9,9017,622,8395,13.76%,6.90%
2020-01-01 00:09:20,5,10,854,6,848,1.30%,0.70%
2020-01-01 00:09:20,5,11,614,2,612,0.94%,0.33%
2020-01-01 00:09:20,5,12,7860,491,7369,11.99%,6.25%
2020-01-01 00:09:20,6,1,1135,13,1122,1.73%,1.15%
2020-01-01 00:09:20,6,2,1266,14,1252,1.93%,1.11%
2020-01-01 00:09:20,6,3,1767,26,1741,2.70%,1.47%
2020-01-01 00:09:20,6,4,1297,8,1289,1.98%,0.62%
2020-01-01 00:09:20,6,5,18275,2366,15909,27.89%,12.95%
2020-01-01 00:09:20,6,6,6126,297,5829,9.35%,4.85%
2020-01-01 00:09:20,6,7,4392,146,4246,6.70%,3.32%
2020-01-01 00:09:20,6,8,3834,108,3726,5.85%,2.82%
2020-01-01 00:09:20,6,9,10056,768,9288,15.34%,7.64%
2020-01-01 00:09:20,6,10,2876,63,2813,4.39%,2.19%
2020-01-01 00:09:20,6,11,387,0,387,0.59%,0.00%
2020-01-01 00:09:20,6,12,7091,400,6691,10.82%,5.64%
2020-01-01 00:09:20,7,1,503,1,502,0.77%,0.20%
2020-01-01 00:09:20,7,2,140,0,140,0.21%,0.00%
2020-01-01 00:09:20,7,3,661,4,657,1.01%,0.61%
2020-01-01 00:09:20,7,4,2068,38,2030,3.16%,1.84%
2020-01-01 00:09:20,7,5,7543,430,7113,11.51%,5.70%
2020-01-01 00:09:20,7,6,12734,1182,11552,19.43%,9.28%
2020-01-01 00:09:20,7,7,3099,114,2985,4.73%,3.68%
2020-01-01 00:09:20,7,8,1325,24,1301,2.02%,1.81%
2020-01-01 00:09:20,7,9,6736,329,6407,10.28%,4.88%
2020-01-01 00:09:20,7,10,1631,12,1619,2.49%,0.74%
2020-01-01 00:09:20,7,11,90,0,90,0.14%,0.00%
2020-01-01 00:09:20,7,12,5149,211,4938,7.86%,4.10%
2020-01-01 00:09:20,8,1,508,5,503,0.78%,0.98%
2020-01-01 00:09:20,8,2,124,3,121,0.19%,2.42%
2020-01-01 00:09:20,8,3,1676,15,1661,2.56%,0.89%
2020-01-01 00:09:20,8,4,2756,63,2693,4.21%,2.29%
2020-01-01 00:09:20,8,5,7993,484,7509,12.20%,6.06%
2020-01-01 00:09:20,8,6,16797,1965,14832,25.63%,11.70%
2020-01-01 00:09:20,8,7,5993,261,5732,9.14%,4.36%
2020-01-01 00:09:20,8,8,2572,61,2511,3.92%,2.37%
2020-01-01 00:09:20,8,9,6065,274,5791,9.25%,4.52%
2020-01-01 00:09:20,8,10,1821,24,1797,2.78%,1.32%
2020-01-01 00:09:20,8,11,227,0,227,0.35%,0.00%
2020-01-01 00:09:20,8,12,4207,133,4074,6.42%,3.16%
2020-01-01 00:09:20,9,1,1115,3,1112,1.70%,0.27%
2020-01-01 00:09:20,9,2,3366,84,3282,5.14%,2.50%
2020-01-01 00:09:20,9,3,1847,23,1824,2.82%,1.25%
2020-01-01 00:09:20,9,4,4143,153,3990,6.32%,3.69%
2020-01-01 00:09:20,9,5,378,1,377,0.58%,0.26%
2020-01-01 00:09:20,9,6,5410,237,5173,8.26%,4.38%
2020-01-01 00:09:20,9,7,24959,4287,20672,38.08%,17.18%
2020-01-01 00:09:20,9,8,9567,741,8826,14.60%,7.75%
2020-01-01 00:09:20,9,9,237,1,236,0.36%,0.42%
2020-01-01 00:09:20,9,10,2619,126,2493,4.00%,4.81%
2020-01-01 00:09:20,9,11,8286,571,7715,12.64%,6.89%
2020-01-01 00:09:20,9,12,5303,209,5094,8.09%,3.94%
2020-01-01 00:09:20,10,1,1187,276,911,1.81%,23.25%
2020-01-01 00:09:20,10,2,4243,392,3851,6.47%,9.24%
2020-01-01 00:09:20,10,3,2874,64,2810,4.39%,2.23%
2020-01-01 00:09:20,10,4,4427,1102,3325,6.76%,24.89%
2020-01-01 00:09:20,10,5,646,24,622,0.99%,3.72%
2020-01-01 00:09:20,10,6,6861,1289,5572,10.47%,18.79%
2020-01-01 00:09:20,10,7,12627,2225,10402,19.27%,17.62%
2020-01-01 00:09:20,10,8,29936,7631,22305,45.68%,25.49%
2020-01-01 00:09:20,10,9,727,7,720,1.11%,0.96%
2020-01-01 00:09:20,10,10,2610,61,2549,3.98%,2.34%
2020-01-01 00:09:20,10,11,12895,1617,11278,19.68%,12.54%
2020-01-01 00:09:20,10,12,9492,1089,8403,14.48%,11.47%
2020-01-01 00:09:20,11,1,2955,70,2885,4.51%,2.37%
2020-01-01 00:09:20,11,2,4555,179,4376,6.95%,3.93%
2020-01-01 00:09:20,11,3,1448,23,1425,2.21%,1.59%
2020-01-01 00:09:20,11,4,5466,220,5246,8.34%,4.02%
2020-01-01 00:09:20,11,5,247,1,246,0.38%,0.40%
2020-01-01 00:09:20,11,6,6434,297,6137,9.82%,4.62%
2020-01-01 00:09:20,11,7,12710,1155,11555,19.39%,9.09%
2020-01-01 00:09:20,11,8,27391,4957,22434,41.80%,18.10%
2020-01-01 00:09:20,11,9,302,0,302,0.46%,0.00%
2020-01-01 00:09:20,11,10,3433,104,3329,5.24%,3.03%
2020-01-01 00:09:20,11,11,10242,773,9469,15.63%,7.55%
2020-01-01 00:09:20,11,12,6448,319,6129,9.84%,4.95%
2020-01-01 00:09:20,12,1,27,0,27,0.04%,0.00%
2020-01-01 00:09:20,12,2,676,201,475,1.03%,29.73%
2020-01-01 00:09:20,12,3,2691,243,2448,4.11%,9.03%
2020-01-01 00:09:20,12,4,2810,56,2754,4.29%,1.99%
2020-01-01 00:09:20,12,5,8600,705,7895,13.12%,8.20%
2020-01-01 00:09:20,12,6,4920,188,4732,7.51%,3.82%
2020-01-01 00:09:20,12,7,1989,52,1937,3.03%,2.61%
2020-01-01 00:09:20,12,8,1120,182,938,1.71%,16.25%
2020-01-01 00:09:20,12,9,26949,5679,21270,41.12%,21.07%
2020-01-01 00:09:20,12,10,4270,289,3981,6.52%,6.77%
2020-01-01 00:09:20,12,11,1344,186,1158,2.05%,13.84%
2020-01-01 00:09:20,12,12,12583,1808,10775,19.20%,14.37%
2020-01-01 00:09:20,13,1,2381,39,2342,3.63%,1.64%
2020-01-01 00:09:20,13,2,2745,52,2693,4.19%,1.89%
2020-01-01 00:09:20,13,3,611,7,604,0.93%,1.15%
2020-01-01 00:09:20,13,4,5988,707,5281,9.14%,11.81%
2020-01-01 00:09:20,13,5,8050,1056,6994,12.28%,13.12%
2020-01-01 00:09:20,13,6,6586,767,5819,10.05%,11.65%
2020-01-01 00:09:20,13,7,5484,235,5249,8.37%,4.29%
2020-01-01 00:09:20,13,8,7641,432,7209,11.66%,5.65%
2020-01-01 00:09:20,13,9,8341,1084,7257,12.73%,13.00%
2020-01-01 00:09:20,13,10,29177,6262,22915,44.52%,21.46%
2020-01-01 00:09:20,13,11,18309,2649,15660,27.94%,14.47%
2020-01-01 00:09:20,13,12,10219,1109,9110,15.59%,10.85%
2020-01-01 00:09:20,14,1,399,0,399,0.61%,0.00%
2020-01-01 00:09:20,14,2,1817,28,1789,2.77%,1.54%
2020-01-01 00:09:20,14,3,1043,13,1030,1.59%,1.25%
2020-01-01 00:09:20,14,4,4502,134,4368,6.87%,2.98%
2020-01-01 00:09:20,14,5,1797,24,1773,2.74%,1.34%
2020-01-01 00:09:20,14,6,4829,156,4673,7.37%,3.23%
2020-01-01 00:09:20,14,7,12732,1106,11626,19.43%,8.69%
2020-01-01 00:09:20,14,8,14568,1467,13101,22.23%,10.07%
2020-01-01 00:09:20,14,9,2135,34,2101,3.26%,1.59%
2020-01-01 00:09:20,14,10,4813,194,4619,7.34%,4.03%
2020-01-01 00:09:20,14,11,26992,4868,22124,41.19%,18.03%
2020-01-01 00:09:20,14,12,7363,393,6970,11.24%,5.34%
2020-01-01 00:09:20,15,1,550,1,549,0.84%,0.18%
2020-01-01 00:09:20,15,2,166,2,164,0.25%,1.20%
2020-01-01 00:09:20,15,3,5441,213,5228,8.30%,3.91%
2020-01-01 00:09:20,15,4,7226,392,6834,11.03%,5.42%
2020-01-01 00:09:20,15,5,13380,1348,12032,20.42%,10.07%
2020-01-01 00:09:20,15,6,7440,419,7021,11.35%,5.63%
2020-01-01 00:09:20,15,7,3934,117,3817,6.00%,2.97%
2020-01-01 00:09:20,15,8,5356,221,5135,8.17%,4.13%
2020-01-01 00:09:20,15,9,13637,1392,12245,20.81%,10.21%
2020-01-01 00:09:20,15,10,4217,173,4044,6.43%,4.10%
2020-01-01 00:09:20,15,11,9735,715,9020,14.85%,7.34%
2020-01-01 00:09:20,15,12,29105,5901,23204,44.41%,20.27%
2020-01-01 00:09:20,16,1,529,3,526,0.81%,0.57%
2020-01-01 00:09:20,16,2,269,1,268,0.41%,0.37%
2020-01-01 00:09:20,16,3,1068,18,1050,1.63%,1.69%
2020-01-01 00:09:20,16,4,4672,184,4488,7.13%,3.94%
2020-01-01 00:09:20,16,5,7786,496,7290,11.88%,6.37%
2020-01-01 00:09:20,16,6,5615,248,5367,8.57%,4.42%
2020-01-01 00:09:20,16,7,3458,99,3359,5.28%,2.86%
2020-01-01 00:09:20,16,8,8096,503,7593,12.35%,6.21%
2020-01-01 00:09:20,16,9,8187,541,7646,12.49%,6.61%
2020-01-01 00:09:20,16,10,1495,22,1473,2.28%,1.47%
2020-01-01 00:09:20,16,11,9738,709,9029,14.86%,7.28%
2020-01-01 00:09:20,16,12,27039,4939,22100,41.26%,18.27%
2020-01-01 00:09:30,1,1,19950,2798,17152,30.44%,14.03%
2020-01-01 00:09:30,1,2,8575,516,8059,13.08%,6.02%
2020-01-01 00:09:30,1,3,333,0,333,0.51%,0.00%
2020-01-01 00:09:30,1,4,10994,963,10031,16.78%,8.76%
2020-01-01 00:09:30,1,5,10820,919,9901,16.51%,8.49%
2020-01-01 00:09:30,1,6,10763,913,9850,16.42%,8.48%
2020-01-01 00:09:30,1,7,8237,479,7758,12.57%,5.82%
2020-01-01 00:09:30,1,8,7321,372,6949,11.17%,5.08%
2020-01-01 00:09:30,1,9,10720,907,9813,16.36%,8.46%
2020-01-01 00:09:30,1,10,6880,330,6550,10.50%,4.80%
2020-01-01 00:09:30,1,11,6946,337,6609,10.60%,4.85%
2020-01-01 00:09:30,1,12,10688,901,9787,16.31%,8.43%
2020-01-01 00:09:30,2,1,393,2,391,0.60%,0.51%
2020-01-01 00:09:30,2,2,25687,4466,21221,39.20%,17.39%
2020-01-01 00:09:30,2,3,21231,3132,18099,32.40%,14.75%
2020-01-01 00:09:30,2,4,292,1,291,0.45%,0.34%
2020-01-01 00:09:30,2,5,12817,1165,11652,19.56%,9.09%
2020-01-01 00:09:30,2,6,55,0,55,0.08%,0.00%
2020-01-01 00:09:30,2,7,4056,131,3925,6.19%,3.23%
2020-01-01 00:09:30,2,8,3084,74,3010,4.71%,2.40%
2020-01-01 00:09:30,2,9,12765,1157,11608,19.48%,9.06%
2020-01-01 00:09:30,2,10,2455,47,2408,3.75%,1.91%
2020-01-01 00:09:30,2,11,2469,47,2422,3.77%,1.90%
2020-01-01 00:09:30,2,12,12602,1127,11475,19.23%,8.94%
2020-01-01 00:09:30,3,1,1928,41,1887,2.94%,2.13%
2020-01-01 00:09:30,3,2,23811,3923,19888,36.33%,16.48%
2020-01-01 00:09:30,3,3,75402,30681,44721,115.05%,40.69%
2020-01-01 00:09:30,3,4,7690,390,7300,11.73%,5.07%
2020-01-01 00:09:30,3,5,50124,14985,35139,76.48%,29.90%
2020-01-01 00:09:30,3,6,8976,547,8429,13.70%,6.09%
2020-01-01 00:09:30,3,7,19743,2766,16977,30.13%,14.01%
2020-01-01 00:09:30,3,8,15280,1718,13562,23.32%,11.24%
2020-01-01 00:09:30,3,9,40734,10277,30457,62.16%,25.23%
2020-01-01 00:09:30,3,10,9682,687,8995,14.77%,7.10%
2020-01-01 00:09:30,3,11,1951,29,1922,2.98%,1.49%
2020-01-01 00:09:30,3,12,27180,4821,22359,41.47%,17.74%
2020-01-01 00:09:30,4,1,430,5,425,0.66%,1.16%
2020-01-01 00:09:30,4,2,245,1,244,0.37%,0.41%
2020-01-01 00:09:30,4,3,799,7,792,1.22%,0.88%
2020-01-01 00:09:30,4,4,29338,5663,23675,44.77%,19.30%
2020-01-01 00:09:30,4,5,17249,2064,15185,26.32%,11.97%
2020-01-01 00:09:30,4,6,24173,3938,20235,36.89%,16.29%
2020-01-01 00:09:30,4,7,5625,225,5400,8.58%,4.00%
2020-01-01 00:09:30,4,8,2951,53,2898,4.50%,1.80%
2020-01-01 00:09:30,4,9,15212,1626,13586,23.21%,10.69%
2020-01-01 00:09:30,4,10,2227,33,2194,3.40%,1.48%
2020-01-01 00:09:30,4,11,147,0,147,0.22%,0.00%
2020-01-01 00:09:30,4,12,12275,1085,11190,18.73%,8.84%
2020-01-01 00:09:30,5,1,2823,60,2763,4.31%,2.13%
2020-01-01 00:09:30,5,2,732,6,726,1.12%,0.82%
2020-01-01 00:09:30,5,3,1212,4,1208,1.85%,0.33%
2020-01-01 00:09:30,5,4,23452,3830,19622,35.78%,16.33%
2020-01-01 00:09:30,5,5,10660,802,9858,16.27%,7.52%
2020-01-01 00:09:30,5,6,15782,1800,13982,24.08%,11.41%
2020-01-01 00:09:30,5,7,4661,177,4484,7.11%,3.80%
2020-01-01 00:09:30,5,8,3721,107,3614,5.68%,2.88%
2020-01-01 00:09:30,5,9,8983,569,8414,13.71%,6.33%
2020-01-01 00:09:30,5,10,1174,10,1164,1.79%,0.85%
2020-01-01 00:09:30,5,11,828,8,820,1.26%,0.97%
2020-01-01 00:09:30,5,12,7537,389,7148,11.50%,5.16%
2020-01-01 00:09:30,6,1,1064,9,1055,1.62%,0.85%
2020-01-01 00:09:30,6,2,1175,13,1162,1.79%,1.11%
2020-01-01 00:09:30,6,3,1601,24,1577,2.44%,1.50%
2020-01-01 00:09:30,6,4,1630,18,1612,2.49%,1.10%
2020-01-01 00:09:30,6,5,13776,1407,12369,21.02%,10.21%
2020-01-01 00:09:30,6,6,4507,187,4320,6.88%,4.15%
2020-01-01 00:09:30,6,7,2395,44,2351,3.65%,1.84%
2020-01-01 00:09:30,6,8,1879,31,1848,2.87%,1.65%
2020-01-01 00:09:30,6,9,7254,391,6863,11.07%,5.39%
2020-01-01 00:09:30,6,10,2048,31,2017,3.12%,1.51%
2020-01-01 00:09:30,6,11,408,2,406,0.62%,0.49%
2020-01-01 00:09:30,6,12,5141,214,4927,7.84%,4.16%
2020-01-01 00:09:30,7,1,561,6,555,0.86%,1.07%
2020-01-01 00:09:30,7,2,81,0,81,0.12%,0.00%
2020-01-01 00:09:30,7,3,1419,6,1413,2.17%,0.42%
2020-01-01 00:09:30,7,4,1901,29,1872,2.90%,1.53%
2020-01-01 00:09:30,7,5,8346,520,7826,12.73%,6.23%
2020-01-01 00:09:30,7,6,13105,1248,11857,20.00%,9.52%
2020-01-01 00:09:30,7,7,2838,69,2769,4.33%,2.43%
2020-01-01 00:09:30,7,8,1049,8,1041,1.60%,0.76%
2020-01-01 00:09:30,7,9,6763,364,6399,10.32%,5.38%
2020-01-01 00:09:30,7,10,1267,16,1251,1.93%,1.26%
2020-01-01 00:09:30,7,11,90,0,90,0.14%,0.00%
2020-01-01 00:09:30,7,12,5497,240,5257,8.39%,4.37%
2020-01-01 00:09:30,8,1,403,3,400,0.61%,0.74%
2020-01-01 00:09:30,8,2,96,0,96,0.15%,0.00%
2020-01-01 00:09:30,8,3,1296,11,1285,1.98%,0.85%
2020-01-01 00:09:30,8,4,2672,55,2617,4.08%,2.06%
2020-01-01 00:09:30,8,5,7272,395,6877,11.10%,5.43%
2020-01-01 00:09:30,8,6,15919,1766,14153,24.29%,11.09%
2020-01-01 00:09:30,8,7,5919,242,5677,9.03%,4.09%
2020-01-01 00:09:30,8,8,2602,56,2546,3.97%,2.15%
2020-01-01 00:09:30,8,9,5693,239,5454,8.69%,4.20%
2020-01-01 00:09:30,8,10,1570,17,1553,2.40%,1.08%
2020-01-01 00:09:30,8,11,220,0,220,0.34%,0.00%
2020-01-01 00:09:30,8,12,4085,127,3958,6.23%,3.11%
2020-01-01 00:09:30,9,1,1457,15,1442,2.22%,1.03%
2020-01-01 00:09:30,9,2,4614,148,4466,7.04%,3.21%
2020-01-01 00:09:30,9,3,2747,61,2686,4.19%,2.22%
2020-01-01 00:09:30,9,4,5123,173,4950,7.82%,3.38%
2020-01-01 00:09:30,9,5,488,3,485,0.74%,0.61%
2020-01-01 00:09:30,9,6,6096,249,5847,9.30%,4.08%
2020-01-01 00:09:30,9,7,28957,5520,23437,44.18%,19.06%
2020-01-01 00:09:30,9,8,9692,650,9042,14.79%,6.71%
2020-01-01 00:09:30,9,9,359,0,359,0.55%,0.00%
2020-01-01 00:09:30,9,10,3242,63,3179,4.95%,1.94%
2020-01-01 00:09:30,9,11,8507,504,8003,12.98%,5.92%
2020-01-01 00:09:30,9,12,4856,172,4684,7.41%,3.54%
2020-01-01 00:09:30,10,1,1096,197,899,1.67%,17.97%
2020-01-01 00:09:30,10,2,3685,286,3399,5.62%,7.76%
2020-01-01 00:09:30,10,3,2402,46,2356,3.67%,1.92%
2020-01-01 00:09:30,10,4,3823,890,2933,5.83%,23.28%
2020-01-01 00:09:30,10,5,710,4,706,1.08%,0.56%
2020-01-01 00:09:30,10,6,5886,1026,4860,8.98%,17.43%
2020-01-01 00:09:30,10,7,11236,1784,9452,17.14%,15.88%
2020-01-01 00:09:30,10,8,29051,7211,21840,44.33%,24.82%
2020-01-01 00:09:30,10,9,804,5,799,1.23%,0.62%
2020-01-01 00:09:30,10,10,2434,42,2392,3.71%,1.73%
2020-01-01 00:09:30,10,11,13644,1915,11729,20.82%,14.04%
2020-01-01 00:09:30,10,12,10635,1416,9219,16.23%,13.31%
2020-01-01 00:09:30,11,1,2620,77,2543,4.00%,2.94%
2020-01-01 00:09:30,11,2,4304,165,4139,6.57%,3.83%
2020-01-01 00:09:30,11,3,1543,18,1525,2.35%,1.17%
2020-01-01 00:09:30,11,4,5650,239,5411,8.62%,4.23%
2020-01-01 00:09:30,11,5,418,0,418,0.64%,0.00%
2020-01-01 00:09:30,11,6,6668,332,6336,10.17%,4.98%
2020-01-01 00:09:30,11,7,12754,1187,11567,19.46%,9.31%
2020-01-01 00:09:30,11,8,26515,4840,21675,40.46%,18.25%
2020-01-01 00:09:30,11,9,215,0,215,0.33%,0.00%
2020-01-01 00:09:30,11,10,3101,94,3007,4.73%,3.03%
2020-01-01 00:09:30,11,11,9851,767,9084,15.03%,7.79%
2020-01-01 00:09:30,11,12,6451,335,6116,9.84%,5.19%
2020-01-01 00:09:30,12,1,82,0,82,0.13%,0.00%
2020-01-01 00:09:30,12,2,699,215,484,1.07%,30.76%
2020-01-01 00:09:30,12,3,2525,251,2274,3.85%,9.94%
2020-01-01 00:09:30,12,4,2624,51,2573,4.00%,1.94%
2020-01-01 00:09:30,12,5,8439,709,7730,12.88%,8.40%
2020-01-01 00:09:30,12,6,5160,206,4954,7.87%,3.99%
2020-01-01 00:09:30,12,7,2384,63,2321,3.64%,2.64%
2020-01-01 00:09:30,12,8,1477,349,1128,2.25%,23.63%
2020-01-01 00:09:30,12,9,23240,4745,18495,35.46%,20.42%
2020-01-01 00:09:30,12,10,4272,496,3776,6.52%,11.61%
2020-01-01 00:09:30,12,11,1670,351,1319,2.55%,21.02%
2020-01-01 00:09:30,12,12,9675,1331,8344,14.76%,13.76%
2020-01-01 00:09:30,13,1,2291,40,2251,3.50%,1.75%
2020-01-01 00:09:30,13,2,2623,54,2569,4.00%,2.06%
2020-01-01 00:09:30,13,3,542,0,542,0.83%,0.00%
2020-01-01 00:09:30,13,4,5196,518,4678,7.93%,9.97%
2020-01-01 00:09:30,13,5,7108,821,6287,10.85%,11.55%
2020-01-01 00:09:30,13,6,5830,575,5255,8.90%,9.86%
2020-01-01 00:09:30,13,7,5248,203,5045,8.01%,3.87%
2020-01-01 00:09:30,13,8,7416,402,7014,11.32%,5.42%
2020-01-01 00:09:30,13,9,7382,846,6536,11.26%,11.46%
2020-01-01 00:09:30,13,10,27213,5693,21520,41.52%,20.92%
2020-01-01 00:09:30,13,11,17203,2511,14692,26.25%,14.60%
2020-01-01 00:09:30,13,12,9343,1144,8199,14.26%,12.24%
2020-01-01 00:09:30,14,1,360,0,360,0.55%,0.00%
2020-01-01 00:09:30,14,2,1568,18,1550,2.39%,1.15%
2020-01-01 00:09:30,14,3,894,1,893,1.36%,0.11%
2020-01-01 00:09:30,14,4,4375,137,4238,6.68%,3.13%
2020-01-01 00:09:30,14,5,1108,13,1095,1.69%,1.17%
2020-01-01 00:09:30,14,6,4595,150,4445,7.01%,3.26%
2020-01-01 00:09:30,14,7,11811,1014,10797,18.02%,8.59%
2020-01-01 00:09:30,14,8,13279,1250,12029,20.26%,9.41%
2020-01-01 00:09:30,14,9,1446,19,1427,2.21%,1.31%
2020-01-01 00:09:30,14,10,4008,115,3893,6.12%,2.87%
2020-01-01 00:09:30,14,11,26615,4664,21951,40.61%,17.52%
2020-01-01 00:09:30,14,12,9169,627,8542,13.99%,6.84%
2020-01-01 00:09:30,15,1,530,3,527,0.81%,0.57%
2020-01-01 00:09:30,15,2,185,0,185,0.28%,0.00%
2020-01-01 00:09:30,15,3,3723,133,3590,5.68%,3.57%
2020-01-01 00:09:30,15,4,4778,213,4565,7.29%,4.46%
2020-01-01 00:09:30,15,5,9639,725,8914,14.71%,7.52%
2020-01-01 00:09:30,15,6,5022,232,4790,7.66%,4.62%
2020-01-01 00:09:30,15,7,4121,162,3959,6.29%,3.93%
2020-01-01 00:09:30,15,8,6492,322,6170,9.91%,4.96%
2020-01-01 00:09:30,15,9,9835,746,9089,15.01%,7.59%
2020-01-01 00:09:30,15,10,3556,180,3376,5.43%,5.06%
2020-01-01 00:09:30,15,11,10192,865,9327,15.55%,8.49%
2020-01-01 00:09:30,15,12,26086,5064,21022,39.80%,19.41%
2020-01-01 00:09:30,16,1,467,3,464,0.71%,0.64%
2020-01-01 00:09:30,16,2,162,0,162,0.25%,0.00%
2020-01-01 00:09:30,16,3,1637,23,1614,2.50%,1.41%
2020-01-01 00:09:30,16,4,4536,170,4366,6.92%,3.75%
2020-01-01 00:09:30,16,5,7924,492,7432,12.09%,6.21%
2020-01-01 00:09:30,16,6,5247,219,5028,8.01%,4.17%
2020-01-01 00:09:30,16,7,3572,104,3468,5.45%,2.91%
2020-01-01 00:09:30,16,8,7699,511,7188,11.75%,6.64%
2020-01-01 00:09:30,16,9,8308,534,7774,12.68%,6.43%
2020-01-01 00:09:30,16,10,1662,14,1648,2.54%,0.84%
2020-01-01 00:09:30,16,11,9505,741,8764,14.50%,7.80%
2020-01-01 00:09:30,16,12,25651,4438,21213,39.14%,17.30%
2020-01-01 00:09:40,1,1,19978,2823,17155,30.48%,14.13%
2020-01-01 00:09:40,1,2,10066,728,9338,15.36%,7.23%
2020-01-01 00:09:40,1,3,436,2,434,0.67%,0.46%
2020-01-01 00:09:40,1,4,9450,708,8742,14.42%,7.49%
2020-01-01 00:09:40,1,5,8853,628,8225,13.51%,7.09%
2020-01-01 00:09:40,1,6,8788,620,8168,13.41%,7.06%
2020-01-01 00:09:40,1,7,9618,660,8958,14.68%,6.86%
2020-01-01 00:09:40,1,8,3739,110,3629,5.71%,2.94%
2020-01-01 00:09:40,1,9,8754,613,8141,13.36%,7.00%
2020-01-01 00:09:40,1,10,3252,85,3167,4.96%,2.61%
2020-01-01 00:09:40,1,11,3300,87,3213,5.04%,2.64%
2020-01-01 00:09:40,1,12,8725,610,8115,13.31%,6.99%
2020-01-01 00:09:40,2,1,2044,50,1994,3.12%,2.45%
2020-01-01 00:09:40,2,2,32209,6790,25419,49.15%,21.08%
2020-01-01 00:09:40,2,3,25137,4246,20891,38.36%,16.89%
2020-01-01 00:09:40,2,4,1970,45,1925,3.01%,2.28%
2020-01-01 00:09:40,2,5,15042,1610,13432,22.95%,10.70%
2020-01-01 00:09:40,2,6,27,0,27,0.04%,0.00%
2020-01-01 00:09:40,2,7,5013,190,4823,7.65%,3.79%
2020-01-01 00:09:40,2,8,3554,105,3449,5.42%,2.95%
2020-01-01 00:09:40,2,9,14999,1605,13394,22.89%,10.70%
2020-01-01 00:09:40,2,10,2881,66,2815,4.40%,2.29%
2020-01-01 00:09:40,2,11,2894,66,2828,4.42%,2.28%
2020-01-01 00:09:40,2,12,14843,1575,13268,22.65%,10.61%
2020-01-01 00:09:40,3,1,2325,43,2282,3.55%,1.85%
2020-01-01 00:09:40,3,2,22411,3435,18976,34.20%,15.33%
2020-01-01 00:09:40,3,3,70876,27440,43436,108.15%,38.72%
2020-01-01 00:09:40,3,4,13026,1235,11791,19.88%,9.48%
2020-01-01 00:09:40,3,5,47381,13592,33789,72.30%,28.69%
2020-01-01 00:09:40,3,6,14443,1488,12955,22.04%,10.30%
2020-01-01 00:09:40,3,7,18283,2308,15975,27.90%,12.62%
2020-01-01 00:09:40,3,8,15785,1740,14045,24.09%,11.02%
2020-01-01 00:09:40,3,9,32167,6765,25402,49.08%,21.03%
2020-01-01 00:09:40,3,10,5896,244,5652,9.00%,4.14%
2020-01-01 00:09:40,3,11,2262,58,2204,3.45%,2.56%
2020-01-01 00:09:40,3,12,23977,3883,20094,36.59%,16.19%
2020-01-01 00:09:40,4,1,589,6,583,0.90%,1.02%
2020-01-01 00:09:40,4,2,383,4,379,0.58%,1.04%
2020-01-01 00:09:40,4,3,847,6,841,1.29%,0.71%
2020-01-01 00:09:40,4,4,27504,4966,22538,41.97%,18.06%
2020-01-01 00:09:40,4,5,16455,1870,14585,25.11%,11.36%
2020-01-01 00:09:40,4,6,23069,3549,19520,35.20%,15.38%
2020-01-01 00:09:40,4,7,5377,224,5153,8.20%,4.17%
2020-01-01 00:09:40,4,8,2936,67,2869,4.48%,2.28%
2020-01-01 00:09:40,4,9,14405,1420,12985,21.98%,9.86%
2020-01-01 00:09:40,4,10,1996,25,1971,3.05%,1.25%
2020-01-01 00:09:40,4,11,164,1,163,0.25%,0.61%
2020-01-01 00:09:40,4,12,11702,933,10769,17.86%,7.97%
2020-01-01 00:09:40,5,1,2154,42,2112,3.29%,1.95%
2020-01-01 00:09:40,5,2,624,6,618,0.95%,0.96%
2020-01-01 00:09:40,5,3,514,5,509,0.78%,0.97%
2020-01-01 00:09:40,5,4,21966,3429,18537,33.52%,15.61%
2020-01-01 00:09:40,5,5,9136,634,8502,13.94%,6.94%
2020-01-01 00:09:40,5,6,13505,1360,12145,20.61%,10.07%
2020-01-01 00:09:40,5,7,3907,142,3765,5.96%,3.63%
2020-01-01 00:09:40,5,8,2878,64,2814,4.39%,2.22%
2020-01-01 00:09:40,5,9,8137,511,7626,12.42%,6.28%
2020-01-01 00:09:40,5,10,1091,13,1078,1.66%,1.19%
2020-01-01 00:09:40,5,11,449,2,447,0.69%,0.45%
2020-01-01 00:09:40,5,12,6753,337,6416,10.30%,4.99%
2020-01-01 00:09:40,6,1,956,7,949,1.46%,0.73%
2020-01-01 00:09:40,6,2,1057,7,1050,1.61%,0.66%
2020-01-01 00:09:40,6,3,1660,18,1642,2.53%,1.08%
2020-01-01 00:09:40,6,4,1030,7,1023,1.57%,0.68%
2020-01-01 00:09:40,6,5,11909,1071,10838,18.17%,8.99%
2020-01-01 00:09:40,6,6,3971,131,3840,6.06%,3.30%
2020-01-01 00:09:40,6,7,2549,63,2486,3.89%,2.47%
2020-01-01 00:09:40,6,8,2113,42,2071,3.22%,1.99%
2020-01-01 00:09:40,6,9,5942,286,5656,9.07%,4.81%
2020-01-01 00:09:40,6,10,1740,24,1716,2.66%,1.38%
2020-01-01 00:09:40,6,11,427,2,425,0.65%,0.47%
2020-01-01 00:09:40,6,12,4157,148,4009,6.34%,3.56%
2020-01-01 00:09:40,7,1,537,0,537,0.82%,0.00%
2020-01-01 00:09:40,7,2,161,0,161,0.25%,0.00%
2020-01-01 00:09:40,7,3,703,2,701,1.07%,0.28%
2020-01-01 00:09:40,7,4,2522,47,2475,3.85%,1.86%
2020-01-01 00:09:40,7,5,7552,416,7136,11.52%,5.51%
2020-01-01 00:09:40,7,6,13675,1325,12350,20.87%,9.69%
2020-01-01 00:09:40,7,7,3529,92,3437,5.38%,2.61%
2020-01-01 00:09:40,7,8,1340,18,1322,2.04%,1.34%
2020-01-01 00:09:40,7,9,6439,305,6134,9.83%,4.74%
2020-01-01 00:09:40,7,10,1075,7,1068,1.64%,0.65%
2020-01-01 00:09:40,7,11,82,0,82,0.13%,0.00%
2020-01-01 00:09:40,7,12,5387,213,5174,8.22%,3.95%
2020-01-01 00:09:40,8,1,539,3,536,0.82%,0.56%
2020-01-01 00:09:40,8,2,73,0,73,0.11%,0.00%
2020-01-01 00:09:40,8,3,1556,36,1520,2.37%,2.31%
2020-01-01 00:09:40,8,4,2561,54,2507,3.91%,2.11%
2020-01-01 00:09:40,8,5,7798,448,7350,11.90%,5.75%
2020-01-01 00:09:40,8,6,16498,1922,14576,25.17%,11.65%
2020-01-01 00:09:40,8,7,6111,306,5805,9.32%,5.01%
2020-01-01 00:09:40,8,8,2086,44,2042,3.18%,2.11%
2020-01-01 00:09:40,8,9,5784,246,5538,8.83%,4.25%
2020-01-01 00:09:40,8,10,1752,28,1724,2.67%,1.60%
2020-01-01 00:09:40,8,11,146,0,146,0.22%,0.00%
2020-01-01 00:09:40,8,12,4062,122,3940,6.20%,3.00%
2020-01-01 00:09:40,9,1,825,2,823,1.26%,0.24%
2020-01-01 00:09:40,9,2,2114,33,2081,3.23%,1.56%
2020-01-01 00:09:40,9,3,985,7,978,1.50%,0.71%
2020-01-01 00:09:40,9,4,2730,71,2659,4.17%,2.60%
2020-01-01 00:09:40,9,5,600,1,599,0.92%,0.17%
2020-01-01 00:09:40,9,6,3853,119,3734,5.88%,3.09%
2020-01-01 00:09:40,9,7,23602,3810,19792,36.01%,16.14%
2020-01-01 00:09:40,9,8,9999,690,9309,15.26%,6.90%
2020-01-01 00:09:40,9,9,371,0,371,0.57%,0.00%
2020-01-01 00:09:40,9,10,3383,81,3302,5.16%,2.39%
2020-01-01 00:09:40,9,11,9024,566,8458,13.77%,6.27%
2020-01-01 00:09:40,9,12,5339,212,5127,8.15%,3.97%
2020-01-01 00:09:40,10,1,1462,243,1219,2.23%,16.62%
2020-01-01 00:09:40,10,2,3045,297,2748,4.65%,9.75%
2020-01-01 00:09:40,10,3,1453,17,1436,2.22%,1.17%
2020-01-01 00:09:40,10,4,3604,842,2762,5.50%,23.36%
2020-01-01 00:09:40,10,5,873,80,793,1.33%,9.16%
2020-01-01 00:09:40,10,6,5652,1033,4619,8.62%,18.28%
2020-01-01 00:09:40,10,7,10436,1752,8684,15.92%,16.79%
2020-01-01 00:09:40,10,8,29192,7272,21920,44.54%,24.91%
2020-01-01 00:09:40,10,9,567,3,564,0.87%,0.53%
2020-01-01 00:09:40,10,10,2257,34,2223,3.44%,1.51%
2020-01-01 00:09:40,10,11,13069,1532,11537,19.94%,11.72%
2020-01-01 00:09:40,10,12,9968,1049,8919,15.21%,10.52%
2020-01-01 00:09:40,11,1,2358,36,2322,3.60%,1.53%
2020-01-01 00:09:40,11,2,3564,97,3467,5.44%,2.72%
2020-01-01 00:09:40,11,3,1094,6,1088,1.67%,0.55%
2020-01-01 00:09:40,11,4,2963,73,2890,4.52%,2.46%
2020-01-01 00:09:40,11,5,211,0,211,0.32%,0.00%
2020-01-01 00:09:40,11,6,3688,102,3586,5.63%,2.77%
2020-01-01 00:09:40,11,7,8853,583,8270,13.51%,6.59%
2020-01-01 00:09:40,11,8,23135,3697,19438,35.30%,15.98%
2020-01-01 00:09:40,11,9,124,3,121,0.19%,2.42%
2020-01-01 00:09:40,11,10,3395,82,3313,5.18%,2.42%
2020-01-01 00:09:40,11,11,10345,768,9577,15.79%,7.42%
2020-01-01 00:09:40,11,12,6583,319,6264,10.04%,4.85%
2020-01-01 00:09:40,12,1,55,0,55,0.08%,0.00%
2020-01-01 00:09:40,12,2,557,132,425,0.85%,23.70%
2020-01-01 00:09:40,12,3,2521,169,2352,3.85%,6.70%
2020-01-01 00:09:40,12,4,3377,112,3265,5.15%,3.32%
2020-01-01 00:09:40,12,5,8363,638,7725,12.76%,7.63%
2020-01-01 00:09:40,12,6,5237,233,5004,7.99%,4.45%
2020-01-01 00:09:40,12,7,1739,26,1713,2.65%,1.50%
2020-01-01 00:09:40,12,8,1471,324,1147,2.24%,22.03%
2020-01-01 00:09:40,12,9,21320,4181,17139,32.53%,19.61%
2020-01-01 00:09:40,12,10,4810,495,4315,7.34%,10.29%
2020-01-01 00:09:40,12,11,1921,332,1589,2.93%,17.28%
2020-01-01 00:09:40,12,12,7711,1245,6466,11.77%,16.15%
2020-01-01 00:09:40,13,1,2036,38,1998,3.11%,1.87%
2020-01-01 00:09:40,13,2,2422,50,2372,3.70%,2.06%
2020-01-01 00:09:40,13,3,805,3,802,1.23%,0.37%
2020-01-01 00:09:40,13,4,4349,660,3689,6.64%,15.18%
2020-01-01 00:09:40,13,5,6525,991,5534,9.96%,15.19%
2020-01-01 00:09:40,13,6,4860,695,4165,7.42%,14.30%
2020-01-01 00:09:40,13,7,4437,172,4265,6.77%,3.88%
2020-01-01 00:09:40,13,8,17619,2188,15431,26.88%,12.42%
2020-01-01 00:09:40,13,9,6978,1029,5949,10.65%,14.75%
2020-01-01 00:09:40,13,10,37992,9819,28173,57.97%,25.84%
2020-01-01 00:09:40,13,11,28059,5518,22541,42.81%,19.67%
2020-01-01 00:09:40,13,12,10038,1116,8922,15.32%,11.12%
2020-01-01 00:09:40,14,1,170,0,170,0.26%,0.00%
2020-01-01 00:09:40,14,2,1526,16,1510,2.33%,1.05%
2020-01-01 00:09:40,14,3,1131,5,1126,1.73%,0.44%
2020-01-01 00:09:40,14,4,3729,112,3617,5.69%,3.00%
2020-01-01 00:09:40,14,5,957,11,946,1.46%,1.15%
2020-01-01 00:09:40,14,6,3887,119,3768,5.93%,3.06%
2020-01-01 00:09:40,14,7,11161,865,10296,17.03%,7.75%
2020-01-01 00:09:40,14,8,13499,1255,12244,20.60%,9.30%
2020-01-01 00:09:40,14,9,1141,13,1128,1.74%,1.14%
2020-01-01 00:09:40,14,10,3815,120,3695,5.82%,3.15%
2020-01-01 00:09:40,14,11,26975,4869,22106,41.16%,18.05%
2020-01-01 00:09:40,14,12,9265,630,8635,14.14%,6.80%
2020-01-01 00:09:40,15,1,475,4,471,0.72%,0.84%
2020-01-01 00:09:40,15,2,153,0,153,0.23%,0.00%
2020-01-01 00:09:40,15,3,3557,116,3441,5.43%,3.26%
2020-01-01 00:09:40,15,4,3843,162,3681,5.86%,4.22%
2020-01-01 00:09:40,15,5,9132,710,8422,13.93%,7.77%
2020-01-01 00:09:40,15,6,4088,196,3892,6.24%,4.79%
2020-01-01 00:09:40,15,7,3734,95,3639,5.70%,2.54%
2020-01-01 00:09:40,15,8,6012,275,5737,9.17%,4.57%
2020-01-01 00:09:40,15,9,9344,742,8602,14.26%,7.94%
2020-01-01 00:09:40,15,10,4339,382,3957,6.62%,8.80%
2020-01-01 00:09:40,15,11,10460,1021,9439,15.96%,9.76%
2020-01-01 00:09:40,15,12,25399,5006,20393,38.76%,19.71%
2020-01-01 00:09:40,16,1,398,0,398,0.61%,0.00%
2020-01-01 00:09:40,16,2,259,1,258,0.40%,0.39%
2020-01-01 00:09:40,16,3,1426,15,1411,2.18%,1.05%
2020-01-01 00:09:40,16,4,4661,165,4496,7.11%,3.54%
2020-01-01 00:09:40,16,5,8475,575,7900,12.93%,6.78%
2020-01-01 00:09:40,16,6,5466,223,5243,8.34%,4.08%
2020-01-01 00:09:40,16,7,3457,106,3351,5.27%,3.07%
2020-01-01 00:09:40,16,8,7398,547,6851,11.29%,7.39%
2020-01-01 00:09:40,16,9,8984,636,8348,13.71%,7.08%
2020-01-01 00:09:40,16,10,3731,147,3584,5.69%,3.94%
2020-01-01 00:09:40,16,11,11356,1077,10279,17.33%,9.48%
2020-01-01 00:09:40,16,12,27653,5394,22259,42.20%,19.51%
2020-01-01 00:09:50,1,1,17501,2179,15322,26.70%,12.45%
2020-01-01 00:09:50,1,2,8558,556,8002,13.06%,6.50%
2020-01-01 00:09:50,1,3,581,2,579,0.89%,0.34%
2020-01-01 00:09:50,1,4,8540,618,7922,13.03%,7.24%
2020-01-01 00:09:50,1,5,8265,584,7681,12.61%,7.07%
2020-01-01 00:09:50,1,6,8187,576,7611,12.49%,7.04%
2020-01-01 00:09:50,1,7,7968,480,7488,12.16%,6.02%
2020-01-01 00:09:50,1,8,4994,176,4818,7.62%,3.52%
2020-01-01 00:09:50,1,9,8164,575,7589,12.46%,7.04%
2020-01-01 00:09:50,1,10,4472,141,4331,6.82%,3.15%
2020-01-01 00:09:50,1,11,4526,142,4384,6.91%,3.14%
2020-01-01 00:09:50,1,12,8148,573,7575,12.43%,7.03%
2020-01-01 00:09:50,2,1,2561,49,2512,3.91%,1.91%
2020-01-01 00:09:50,2,2,52043,16276,35767,79.41%,31.27%
2020-01-01 00:09:50,2,3,34710,7835,26875,52.96%,22.57%
2020-01-01 00:09:50,2,4,2473,47,2426,3.77%,1.90%
2020-01-01 00:09:50,2,5,25461,4427,21034,38.85%,17.39%
2020-01-01 00:09:50,2,6,46,0,46,0.07%,0.00%
2020-01-01 00:09:50,2,7,14749,1600,13149,22.51%,10.85%
2020-01-01 00:09:50,2,8,4563,158,4405,6.96%,3.46%
2020-01-01 00:09:50,2,9,25419,4410,21009,38.79%,17.35%
2020-01-01 00:09:50,2,10,3787,106,3681,5.78%,2.80%
2020-01-01 00:09:50,2,11,3806,107,3699,5.81%,2.81%
2020-01-01 00:09:50,2,12,25267,4370,20897,38.55%,17.30%
2020-01-01 00:09:50,3,1,1647,23,1624,2.51%,1.40%
2020-01-01 00:09:50,3,2,20924,2995,17929,31.93%,14.31%
2020-01-01 00:09:50,3,3,67889,25564,42325,103.59%,37.66%
2020-01-01 00:09:50,3,4,12596,1157,11439,19.22%,9.19%
2020-01-01 00:09:50,3,5,45575,12757,32818,69.54%,27.99%
2020-01-01 00:09:50,3,6,14781,1547,13234,22.55%,10.47%
2020-01-01 00:09:50,3,7,17209,2070,15139,26.26%,12.03%
2020-01-01 00:09:50,3,8,13299,1279,12020,20.29%,9.62%
2020-01-01 00:09:50,3,9,30242,6066,24176,46.15%,20.06%
2020-01-01 00:09:50,3,10,3935,111,3824,6.00%,2.82%
2020-01-01 00:09:50,3,11,1570,12,1558,2.40%,0.76%
2020-01-01 00:09:50,3,12,23908,3911,19997,36.48%,16.36%
2020-01-01 00:09:50,4,1,501,1,500,0.76%,0.20%
2020-01-01 00:09:50,4,2,306,0,306,0.47%,0.00%
2020-01-01 00:09:50,4,3,743,21,722,1.13%,2.83%
2020-01-01 00:09:50,4,4,25707,4442,21265,39.23%,17.28%
2020-01-01 00:09:50,4,5,16022,1782,14240,24.45%,11.12%
2020-01-01 00:09:50,4,6,22084,3310,18774,33.70%,14.99%
2020-01-01 00:09:50,4,7,4905,176,4729,7.48%,3.59%
2020-01-01 00:09:50,4,8,2625,45,2580,4.01%,1.71%
2020-01-01 00:09:50,4,9,14141,1385,12756,21.58%,9.79%
2020-01-01 00:09:50,4,10,1729,32,1697,2.64%,1.85%
2020-01-01 00:09:50,4,11,205,1,204,0.31%,0.49%
2020-01-01 00:09:50,4,12,11078,827,10251,16.90%,7.47%
2020-01-01 00:09:50,5,1,2660,44,2616,4.06%,1.65%
2020-01-01 00:09:50,5,2,576,1,575,0.88%,0.17%
2020-01-01 00:09:50,5,3,463,3,460,0.71%,0.65%
2020-01-01 00:09:50,5,4,19122,2512,16610,29.18%,13.14%
2020-01-01 00:09:50,5,5,8228,516,7712,12.55%,6.27%
2020-01-01 00:09:50,5,6,12616,1167,11449,19.25%,9.25%
2020-01-01 00:09:50,5,7,3899,118,3781,5.95%,3.03%
2020-01-01 00:09:50,5,8,3148,81,3067,4.80%,2.57%
2020-01-01 00:09:50,5,9,7589,445,7144,11.58%,5.86%
2020-01-01 00:09:50,5,10,1644,14,1630,2.51%,0.85%
2020-01-01 00:09:50,5,11,438,1,437,0.67%,0.23%
2020-01-01 00:09:50,5,12,5695,262,5433,8.69%,4.60%
2020-01-01 00:09:50,6,1,917,7,910,1.40%,0.76%
2020-01-01 00:09:50,6,2,980,9,971,1.50%,0.92%
2020-01-01 00:09:50,6,3,1617,23,1594,2.47%,1.42%
2020-01-01 00:09:50,6,4,1505,144,1361,2.30%,9.57%
2020-01-01 00:09:50,6,5,11597,1076,10521,17.70%,9.28%
2020-01-01 00:09:50,6,6,4638,298,4340,7.08%,6.43%
2020-01-01 00:09:50,6,7,2675,57,2618,4.08%,2.13%
2020-01-01 00:09:50,6,8,1936,39,1897,2.95%,2.01%
2020-01-01 00:09:50,6,9,5149,183,4966,7.86%,3.55%
2020-01-01 00:09:50,6,10,1544,18,1526,2.36%,1.17%
2020-01-01 00:09:50,6,11,450,2,448,0.69%,0.44%
2020-01-01 00:09:50,6,12,3555,92,3463,5.42%,2.59%
2020-01-01 00:09:50,7,1,460,6,454,0.70%,1.30%
2020-01-01 00:09:50,7,2,246,2,244,0.38%,0.81%
2020-01-01 00:09:50,7,3,1487,12,1475,2.27%,0.81%
2020-01-01 00:09:50,7,4,1549,28,1521,2.36%,1.81%
2020-01-01 00:09:50,7,5,7715,407,7308,11.77%,5.28%
2020-01-01 00:09:50,7,6,12542,1118,11424,19.14%,8.91%
2020-01-01 00:09:50,7,7,3241,87,3154,4.95%,2.68%
2020-01-01 00:09:50,7,8,1403,17,1386,2.14%,1.21%
2020-01-01 00:09:50,7,9,6055,252,5803,9.24%,4.16%
2020-01-01 00:09:50,7,10,1032,8,1024,1.57%,0.78%
2020-01-01 00:09:50,7,11,85,0,85,0.13%,0.00%
2020-01-01 00:09:50,7,12,4977,171,4806,7.59%,3.44%
2020-01-01 00:09:50,8,1,513,0,513,0.78%,0.00%
2020-01-01 00:09:50,8,2,86,0,86,0.13%,0.00%
2020-01-01 00:09:50,8,3,1561,12,1549,2.38%,0.77%
2020-01-01 00:09:50,8,4,2558,42,2516,3.90%,1.64%
2020-01-01 00:09:50,8,5,7530,432,7098,11.49%,5.74%
2020-01-01 00:09:50,8,6,15207,1625,13582,23.20%,10.69%
2020-01-01 00:09:50,8,7,5071,204,4867,7.74%,4.02%
2020-01-01 00:09:50,8,8,1696,27,1669,2.59%,1.59%
2020-01-01 00:09:50,8,9,5634,242,5392,8.60%,4.30%
2020-01-01 00:09:50,8,10,1589,23,1566,2.42%,1.45%
2020-01-01 00:09:50,8,11,77,0,77,0.12%,0.00%
2020-01-01 00:09:50,8,12,4060,123,3937,6.20%,3.03%
2020-01-01 00:09:50,9,1,993,8,985,1.52%,0.81%
2020-01-01 00:09:50,9,2,3665,104,3561,5.59%,2.84%
2020-01-01 00:09:50,9,3,2346,43,2303,3.58%,1.83%
2020-01-01 00:09:50,9,4,18858,2512,16346,28.78%,13.32%
2020-01-01 00:09:50,9,5,395,1,394,0.60%,0.25%
2020-01-01 00:09:50,9,6,19931,2802,17129,30.41%,14.06%
2020-01-01 00:09:50,9,7,38968,9502,29466,59.46%,24.38%
2020-01-01 00:09:50,9,8,9655,632,9023,14.73%,6.55%
2020-01-01 00:09:50,9,9,203,0,203,0.31%,0.00%
2020-01-01 00:09:50,9,10,3057,59,2998,4.66%,1.93%
2020-01-01 00:09:50,9,11,8770,508,8262,13.38%,5.79%
2020-01-01 00:09:50,9,12,5450,196,5254,8.32%,3.60%
2020-01-01 00:09:50,10,1,1379,193,1186,2.10%,14.00%
2020-01-01 00:09:50,10,2,3034,251,2783,4.63%,8.27%
2020-01-01 00:09:50,10,3,1533,17,1516,2.34%,1.11%
2020-01-01 00:09:50,10,4,3542,700,2842,5.40%,19.76%
2020-01-01 00:09:50,10,5,843,40,803,1.29%,4.74%
2020-01-01 00:09:50,10,6,5198,820,4378,7.93%,15.78%
2020-01-01 00:09:50,10,7,10135,1500,8635,15.46%,14.80%
2020-01-01 00:09:50,10,8,26313,6068,20245,40.15%,23.06%
2020-01-01 00:09:50,10,9,670,2,668,1.02%,0.30%
2020-01-01 00:09:50,10,10,1851,14,1837,2.82%,0.76%
2020-01-01 00:09:50,10,11,12233,1419,10814,18.67%,11.60%
2020-01-01 00:09:50,10,12,9420,1008,8412,14.37%,10.70%
2020-01-01 00:09:50,11,1,2312,51,2261,3.53%,2.21%
2020-01-01 00:09:50,11,2,3335,114,3221,5.09%,3.42%
2020-01-01 00:09:50,11,3,850,8,842,1.30%,0.94%
2020-01-01 00:09:50,11,4,2792,35,2757,4.26%,1.25%
2020-01-01 00:09:50,11,5,206,4,202,0.31%,1.94%
2020-01-01 00:09:50,11,6,3553,66,3487,5.42%,1.86%
2020-01-01 00:09:50,11,7,8530,623,7907,13.02%,7.30%
2020-01-01 00:09:50,11,8,20989,3149,17840,32.03%,15.00%
2020-01-01 00:09:50,11,9,110,0,110,0.17%,0.00%
2020-01-01 00:09:50,11,10,2471,45,2426,3.77%,1.82%
2020-01-01 00:09:50,11,11,8766,557,8209,13.38%,6.35%
2020-01-01 00:09:50,11,12,6020,277,5743,9.19%,4.60%
2020-01-01 00:09:50,12,1,43,0,43,0.07%,0.00%
2020-01-01 00:09:50,12,2,456,130,326,0.70%,28.51%
2020-01-01 00:09:50,12,3,2637,166,2471,4.02%,6.30%
2020-01-01 00:09:50,12,4,2694,50,2644,4.11%,1.86%
2020-01-01 00:09:50,12,5,8336,606,7730,12.72%,7.27%
2020-01-01 00:09:50,12,6,4935,151,4784,7.53%,3.06%
2020-01-01 00:09:50,12,7,2077,32,2045,3.17%,1.54%
2020-01-01 00:09:50,12,8,1187,241,946,1.81%,20.30%
2020-01-01 00:09:50,12,9,19848,3547,16301,30.29%,17.87%
2020-01-01 00:09:50,12,10,3554,322,3232,5.42%,9.06%
2020-01-01 00:09:50,12,11,1386,244,1142,2.11%,17.60%
2020-01-01 00:09:50,12,12,7608,1016,6592,11.61%,13.35%
2020-01-01 00:09:50,13,1,1864,32,1832,2.84%,1.72%
2020-01-01 00:09:50,13,2,2163,45,2118,3.30%,2.08%
2020-01-01 00:09:50,13,3,657,4,653,1.00%,0.61%
2020-01-01 00:09:50,13,4,4660,562,4098,7.11%,12.06%
2020-01-01 00:09:50,13,5,6437,771,5666,9.82%,11.98%
2020-01-01 00:09:50,13,6,5220,595,4625,7.97%,11.40%
2020-01-01 00:09:50,13,7,3826,112,3714,5.84%,2.93%
2020-01-01 00:09:50,13,8,10330,812,9518,15.76%,7.86%
2020-01-01 00:09:50,13,9,6768,803,5965,10.33%,11.86%
2020-01-01 00:09:50,13,10,28839,6124,22715,44.00%,21.24%
2020-01-01 00:09:50,13,11,19454,2935,16519,29.68%,15.09%
2020-01-01 00:09:50,13,12,8743,803,7940,13.34%,9.18%
2020-01-01 00:09:50,14,1,338,0,338,0.52%,0.00%
2020-01-01 00:09:50,14,2,1292,16,1276,1.97%,1.24%
2020-01-01 00:09:50,14,3,704,5,699,1.07%,0.71%
2020-01-01 00:09:50,14,4,4458,140,4318,6.80%,3.14%
2020-01-01 00:09:50,14,5,1397,23,1374,2.13%,1.65%
2020-01-01 00:09:50,14,6,4725,156,4569,7.21%,3.30%
2020-01-01 00:09:50,14,7,11802,940,10862,18.01%,7.96%
2020-01-01 00:09:50,14,8,13257,1202,12055,20.23%,9.07%
2020-01-01 00:09:50,14,9,1493,25,1468,2.28%,1.67%
2020-01-01 00:09:50,14,10,3767,112,3655,5.75%,2.97%
2020-01-01 00:09:50,14,11,23800,3806,19994,36.32%,15.99%
2020-01-01 00:09:50,14,12,6503,327,6176,9.92%,5.03%
2020-01-01 00:09:50,15,1,564,3,561,0.86%,0.53%
2020-01-01 00:09:50,15,2,110,1,109,0.17%,0.91%
2020-01-01 00:09:50,15,3,3517,97,3420,5.37%,2.76%
2020-01-01 00:09:50,15,4,4042,137,3905,6.17%,3.39%
2020-01-01 00:09:50,15,5,8266,508,7758,12.61%,6.15%
2020-01-01 00:09:50,15,6,4273,151,4122,6.52%,3.53%
2020-01-01 00:09:50,15,7,3368,79,3289,5.14%,2.35%
2020-01-01 00:09:50,15,8,5269,204,5065,8.04%,3.87%
2020-01-01 00:09:50,15,9,8450,534,7916,12.89%,6.32%
2020-01-01 00:09:50,15,10,5696,321,5375,8.69%,5.64%
2020-01-01 00:09:50,15,11,11100,933,10167,16.94%,8.41%
2020-01-01 00:09:50,15,12,24779,4549,20230,37.81%,18.36%
2020-01-01 00:09:50,16,1,369,2,367,0.56%,0.54%
2020-01-01 00:09:50,16,2,236,0,236,0.36%,0.00%
2020-01-01 00:09:50,16,3,1433,12,1421,2.19%,0.84%
2020-01-01 00:09:50,16,4,4165,144,4021,6.36%,3.46%
2020-01-01 00:09:50,16,5,7892,483,7409,12.04%,6.12%
2020-01-01 00:09:50,16,6,4932,191,4741,7.53%,3.87%
2020-01-01 00:09:50,16,7,3804,124,3680,5.80%,3.26%
2020-01-01 00:09:50,16,8,7310,503,6807,11.15%,6.88%
2020-01-01 00:09:50,16,9,8324,524,7800,12.70%,6.30%
2020-01-01 00:09:50,16,10,1842,23,1819,2.81%,1.25%
2020-01-01 00:09:50,16,11,9378,736,8642,14.31%,7.85%
2020-01-01 00:09:50,16,12,24777,4201,20576,37.81%,16.96%
2020-01-01 00:10:00,1,1,17518,2190,15328,26.73%,12.50%
2020-01-01 00:10:00,1,2,7616,456,7160,11.62%,5.99%
2020-01-01 00:10:00,1,3,243,0,243,0.37%,0.00%
2020-01-01 00:10:00,1,4,9630,720,8910,14.69%,7.48%
2020-01-01 00:10:00,1,5,9410,684,8726,14.36%,7.27%
2020-01-01 00:10:00,1,6,9342,677,8665,14.25%,7.25%
2020-01-01 00:10:00,1,7,7363,430,6933,11.24%,5.84%
2020-01-01 00:10:00,1,8,5830,254,5576,8.90%,4.36%
2020-01-01 00:10:00,1,9,9307,672,8635,14.20%,7.22%
2020-01-01 00:10:00,1,10,5111,184,4927,7.80%,3.60%
2020-01-01 00:10:00,1,11,5177,191,4986,7.90%,3.69%
2020-01-01 00:10:00,1,12,9285,671,8614,14.17%,7.23%
2020-01-01 00:10:00,2,1,1381,14,1367,2.11%,1.01%
2020-01-01 00:10:00,2,2,36896,8702,28194,56.30%,23.59%
2020-01-01 00:10:00,2,3,24173,3884,20289,36.89%,16.07%
2020-01-01 00:10:00,2,4,1188,12,1176,1.81%,1.01%
2020-01-01 00:10:00,2,5,15718,1736,13982,23.98%,11.04%
2020-01-01 00:10:00,2,6,36,0,36,0.05%,0.00%
2020-01-01 00:10:00,2,7,11328,926,10402,17.29%,8.17%
2020-01-01 00:10:00,2,8,4323,124,4199,6.60%,2.87%
2020-01-01 00:10:00,2,9,15628,1718,13910,23.85%,10.99%
2020-01-01 00:10:00,2,10,3380,76,3304,5.16%,2.25%
2020-01-01 00:10:00,2,11,3390,77,3313,5.17%,2.27%
2020-01-01 00:10:00,2,12,15474,1681,13793,23.61%,10.86%
2020-01-01 00:10:00,3,1,1534,12,1522,2.34%,0.78%
2020-01-01 00:10:00,3,2,26371,4684,21687,40.24%,17.76%
2020-01-01 00:10:00,3,3,65657,24259,41398,100.18%,36.95%
2020-01-01 00:10:00,3,4,5548,246,5302,8.47%,4.43%
2020-01-01 00:10:00,3,5,38252,9240,29012,58.37%,24.16%
2020-01-01 00:10:00,3,6,6479,327,6152,9.89%,5.05%
2020-01-01 00:10:00,3,7,22405,3457,18948,34.19%,15.43%
2020-01-01 00:10:00,3,8,17090,2063,15027,26.08%,12.07%
2020-01-01 00:10:00,3,9,31453,6367,25086,47.99%,20.24%
2020-01-01 00:10:00,3,10,4718,153,4565,7.20%,3.24%
2020-01-01 00:10:00,3,11,2287,51,2236,3.49%,2.23%
2020-01-01 00:10:00,3,12,23721,3770,19951,36.20%,15.89%
2020-01-01 00:10:00,4,1,500,3,497,0.76%,0.60%
2020-01-01 00:10:00,4,2,284,1,283,0.43%,0.35%
2020-01-01 00:10:00,4,3,783,7,776,1.19%,0.89%
2020-01-01 00:10:00,4,4,29443,5751,23692,44.93%,19.53%
2020-01-01 00:10:00,4,5,18381,2354,16027,28.05%,12.81%
2020-01-01 00:10:00,4,6,25778,4480,21298,39.33%,17.38%
2020-01-01 00:10:00,4,7,6081,275,5806,9.28%,4.52%
2020-01-01 00:10:00,4,8,2852,55,2797,4.35%,1.93%
2020-01-01 00:10:00,4,9,16345,1897,14448,24.94%,11.61%
2020-01-01 00:10:00,4,10,1956,24,1932,2.98%,1.23%
2020-01-01 00:10:00,4,11,153,0,153,0.23%,0.00%
2020-01-01 00:10:00,4,12,12945,1212,11733,19.75%,9.36%
2020-01-01 00:10:00,5,1,3142,86,3056,4.79%,2.74%
2020-01-01 00:10:00,5,2,674,2,672,1.03%,0.30%
2020-01-01 00:10:00,5,3,432,0,432,0.66%,0.00%
2020-01-01 00:10:00,5,4,27952,5236,22716,42.65%,18.73%
2020-01-01 00:10:00,5,5,9411,648,8763,14.36%,6.89%
2020-01-01 00:10:00,5,6,15154,1650,13504,23.12%,10.89%
2020-01-01 00:10:00,5,7,5229,281,4948,7.98%,5.37%
2020-01-01 00:10:00,5,8,3691,117,3574,5.63%,3.17%
2020-01-01 00:10:00,5,9,8853,592,8261,13.51%,6.69%
2020-01-01 00:10:00,5,10,1097,12,1085,1.67%,1.09%
2020-01-01 00:10:00,5,11,540,2,538,0.82%,0.37%
2020-01-01 00:10:00,5,12,7418,432,6986,11.32%,5.82%
2020-01-01 00:10:00,6,1,1227,13,1214,1.87%,1.06%
2020-01-01 00:10:00,6,2,1289,13,1276,1.97%,1.01%
2020-01-01 00:10:00,6,3,1878,38,1840,2.87%,2.02%
2020-01-01 00:10:00,6,4,1559,29,1530,2.38%,1.86%
2020-01-01 00:10:00,6,5,13556,1333,12223,20.68%,9.83%
2020-01-01 00:10:00,6,6,4714,174,4540,7.19%,3.69%
2020-01-01 00:10:00,6,7,2638,47,2591,4.03%,1.78%
2020-01-01 00:10:00,6,8,2068,30,2038,3.16%,1.45%
2020-01-01 00:10:00,6,9,6572,321,6251,10.03%,4.88%
2020-01-01 00:10:00,6,10,1776,21,1755,2.71%,1.18%
2020-01-01 00:10:00,6,11,429,1,428,0.65%,0.23%
2020-01-01 00:10:00,6,12,4732,160,4572,7.22%,3.38%
2020-01-01 00:10:00,7,1,396,3,393,0.60%,0.76%
2020-01-01 00:10:00,7,2,270,0,270,0.41%,0.00%
2020-01-01 00:10:00,7,3,1379,26,1353,2.10%,1.89%
2020-01-01 00:10:00,7,4,1192,15,1177,1.82%,1.26%
2020-01-01 00:10:00,7,5,7814,504,7310,11.92%,6.45%
2020-01-01 00:10:00,7,6,12010,1118,10892,18.33%,9.31%
2020-01-01 00:10:00,7,7,2965,74,2891,4.52%,2.50%
2020-01-01 00:10:00,7,8,1067,7,1060,1.63%,0.66%
2020-01-01 00:10:00,7,9,6377,338,6039,9.73%,5.30%
2020-01-01 00:10:00,7,10,1108,11,1097,1.69%,0.99%
2020-01-01 00:10:00,7,11,91,0,91,0.14%,0.00%
2020-01-01 00:10:00,7,12,5290,235,5055,8.07%,4.44%
2020-01-01 00:10:00,8,1,412,0,412,0.63%,0.00%
2020-01-01 00:10:00,8,2,133,0,133,0.20%,0.00%
2020-01-01 00:10:00,8,3,1432,10,1422,2.19%,0.70%
2020-01-01 00:10:00,8,4,2531,59,2472,3.86%,2.33%
2020-01-01 00:10:00,8,5,7983,476,7507,12.18%,5.96%
2020-01-01 00:10:00,8,6,15801,1825,13976,24.11%,11.55%
2020-01-01 00:10:00,8,7,5244,228,5016,8.00%,4.35%
2020-01-01 00:10:00,8,8,1912,24,1888,2.92%,1.26%
2020-01-01 00:10:00,8,9,6312,303,6009,9.63%,4.80%
2020-01-01 00:10:00,8,10,1970,24,1946,3.01%,1.22%
2020-01-01 00:10:00,8,11,231,0,231,0.35%,0.00%
2020-01-01 00:10:00,8,12,4291,154,4137,6.55%,3.59%
2020-01-01 00:10:00,9,1,589,1,588,0.90%,0.17%
2020-01-01 00:10:00,9,2,3113,61,3052,4.75%,1.96%
2020-01-01 00:10:00,9,3,2111,27,2084,3.22%,1.28%
2020-01-01 00:10:00,9,4,10203,741,9462,15.57%,7.26%
2020-01-01 00:10:00,9,5,251,0,251,0.38%,0.00%
2020-01-01 00:10:00,9,6,11040,866,10174,16.85%,7.84%
2020-01-01 00:10:00,9,7,31238,6274,24964,47.67%,20.08%
2020-01-01 00:10:00,9,8,10529,842,9687,16.07%,8.00%
2020-01-01 00:10:00,9,9,196,0,196,0.30%,0.00%
2020-01-01 00:10:00,9,10,2171,45,2126,3.31%,2.07%
2020-01-01 00:10:00,9,11,9446,671,8775,14.41%,7.10%
2020-01-01 00:10:00,9,12,6887,368,6519,10.51%,5.34%
2020-01-01 00:10:00,10,1,1237,207,1030,1.89%,16.73%
2020-01-01 00:10:00,10,2,2908,246,2662,4.44%,8.46%
2020-01-01 00:10:00,10,3,1378,12,1366,2.10%,0.87%
2020-01-01 00:10:00,10,4,4065,681,3384,6.20%,16.75%
2020-01-01 00:10:00,10,5,783,3,780,1.19%,0.38%
2020-01-01 00:10:00,10,6,5932,789,5143,9.05%,13.30%
2020-01-01 00:10:00,10,7,10885,1472,9413,16.61%,13.52%
2020-01-01 00:10:00,10,8,27209,6271,20938,41.52%,23.05%
2020-01-01 00:10:00,10,9,657,4,653,1.00%,0.61%
2020-01-01 00:10:00,10,10,2365,44,2321,3.61%,1.86%
2020-01-01 00:10:00,10,11,12540,1606,10934,19.13%,12.81%
2020-01-01 00:10:00,10,12,9487,1137,8350,14.48%,11.98%
2020-01-01 00:10:00,11,1,2163,24,2139,3.30%,1.11%
2020-01-01 00:10:00,11,2,3293,63,3230,5.02%,1.91%
2020-01-01 00:10:00,11,3,967,6,961,1.48%,0.62%
2020-01-01 00:10:00,11,4,3749,102,3647,5.72%,2.72%
2020-01-01 00:10:00,11,5,153,1,152,0.23%,0.65%
2020-01-01 00:10:00,11,6,4661,156,4505,7.11%,3.35%
2020-01-01 00:10:00,11,7,9990,679,9311,15.24%,6.80%
2020-01-01 00:10:00,11,8,23660,3711,19949,36.10%,15.68%
2020-01-01 00:10:00,11,9,263,1,262,0.40%,0.38%
2020-01-01 00:10:00,11,10,3032,72,2960,4.63%,2.37%
2020-01-01 00:10:00,11,11,10185,745,9440,15.54%,7.31%
2020-01-01 00:10:00,11,12,6887,346,6541,10.51%,5.02%
2020-01-01 00:10:00,12,1,99,0,99,0.15%,0.00%
2020-01-01 00:10:00,12,2,627,202,425,0.96%,32.22%
2020-01-01 00:10:00,12,3,3620,295,3325,5.52%,8.15%
2020-01-01 00:10:00,12,4,2455,40,2415,3.75%,1.63%
2020-01-01 00:10:00,12,5,9423,863,8560,14.38%,9.16%
2020-01-01 00:10:00,12,6,5024,204,4820,7.67%,4.06%
2020-01-01 00:10:00,12,7,2442,46,2396,3.73%,1.88%
2020-01-01 00:10:00,12,8,1372,350,1022,2.09%,25.51%
2020-01-01 00:10:00,12,9,21882,4415,17467,33.39%,20.18%
2020-01-01 00:10:00,12,10,3784,437,3347,5.77%,11.55%
2020-01-01 00:10:00,12,11,1550,357,1193,2.37%,23.03%
2020-01-01 00:10:00,12,12,8169,1195,6974,12.46%,14.63%
2020-01-01 00:10:00,13,1,2195,34,2161,3.35%,1.55%
2020-01-01 00:10:00,13,2,2565,48,2517,3.91%,1.87%
2020-01-01 00:10:00,13,3,525,2,523,0.80%,0.38%
2020-01-01 00:10:00,13,4,5494,560,4934,8.38%,10.19%
2020-01-01 00:10:00,13,5,7644,832,6812,11.66%,10.88%
2020-01-01 00:10:00,13,6,6273,622,5651,9.57%,9.92%
2020-01-01 00:10:00,13,7,4891,167,4724,7.46%,3.41%
2020-01-01 00:10:00,13,8,6792,341,6451,10.36%,5.02%
2020-01-01 00:10:00,13,9,7930,863,7067,12.10%,10.88%
2020-01-01 00:10:00,13,10,26858,5366,21492,40.98%,19.98%
2020-01-01 00:10:00,13,11,15755,2054,13701,24.04%,13.04%
2020-01-01 00:10:00,13,12,8311,846,7465,12.68%,10.18%
2020-01-01 00:10:00,14,1,359,2,357,0.55%,0.56%
2020-01-01 00:10:00,14,2,1733,18,1715,2.64%,1.04%
2020-01-01 00:10:00,14,3,1104,10,1094,1.68%,0.91%
2020-01-01 00:10:00,14,4,4095,124,3971,6.25%,3.03%
2020-01-01 00:10:00,14,5,1678,29,1649,2.56%,1.73%
2020-01-01 00:10:00,14,6,4313,136,4177,6.58%,3.15%
2020-01-01 00:10:00,14,7,12451,1053,11398,19.00%,8.46%
2020-01-01 00:10:00,14,8,14216,1396,12820,21.69%,9.82%
2020-01-01 00:10:00,14,9,1819,34,1785,2.78%,1.87%
2020-01-01 00:10:00,14,10,4375,164,4211,6.68%,3.75%
2020-01-01 00:10:00,14,11,27704,5127,22577,42.27%,18.51%
2020-01-01 00:10:00,14,12,8876,586,8290,13.54%,6.60%
2020-01-01 00:10:00,15,1,551,3,548,0.84%,0.54%
2020-01-01 00:10:00,15,2,180,0,180,0.27%,0.00%
2020-01-01 00:10:00,15,3,3982,105,3877,6.08%,2.64%
2020-01-01 00:10:00,15,4,4922,307,4615,7.51%,6.24%
2020-01-01 00:10:00,15,5,9703,751,8952,14.81%,7.74%
2020-01-01 00:10:00,15,6,5219,327,4892,7.96%,6.27%
2020-01-01 00:10:00,15,7,3752,112,3640,5.73%,2.99%
2020-01-01 00:10:00,15,8,5569,242,5327,8.50%,4.35%
2020-01-01 00:10:00,15,9,9967,789,9178,15.21%,7.92%
2020-01-01 00:10:00,15,10,4154,176,3978,6.34%,4.24%
2020-01-01 00:10:00,15,11,9870,722,9148,15.06%,7.32%
2020-01-01 00:10:00,15,12,25442,4707,20735,38.82%,18.50%
2020-01-01 00:10:00,16,1,555,1,554,0.85%,0.18%
2020-01-01 00:10:00,16,2,290,1,289,0.44%,0.34%
2020-01-01 00:10:00,16,3,1599,21,1578,2.44%,1.31%
2020-01-01 00:10:00,16,4,4408,143,4265,6.73%,3.24%
2020-01-01 00:10:00,16,5,8051,550,7501,12.28%,6.83%
2020-01-01 00:10:00,16,6,5204,206,4998,7.94%,3.96%
2020-01-01 00:10:00,16,7,3693,86,3607,5.64%,2.33%
2020-01-01 00:10:00,16,8,7441,450,6991,11.35%,6.05%
2020-01-01 00:10:00,16,9,9432,721,8711,14.39%,7.64%
2020-01-01 00:10:00,16,10,2076,34,2042,3.17%,1.64%
2020-01-01 00:10:00,16,11,9780,759,9021,14.92%,7.76%
2020-01-01 00:10:00,16,12,27066,5109,21957,41.30%,18.88%
2020-01-01 00:10:10,1,1,17788,2297,15491,27.14%,12.91%
2020-01-01 00:10:10,1,2,6246,298,5948,9.53%,4.77%
2020-01-01 00:10:10,1,3,404,2,402,0.62%,0.50%
2020-01-01 00:10:10,1,4,11155,943,10212,17.02%,8.45%
2020-01-01 00:10:10,1,5,10998,896,10102,16.78%,8.15%
2020-01-01 00:10:10,1,6,10859,885,9974,16.57%,8.15%
2020-01-01 00:10:10,1,7,5830,262,5568,8.90%,4.49%
2020-01-01 00:10:10,1,8,4870,179,4691,7.43%,3.68%
2020-01-01 00:10:10,1,9,10833,879,9954,16.53%,8.11%
2020-01-01 00:10:10,1,10,4031,128,3903,6.15%,3.18%
2020-01-01 00:10:10,1,11,4120,136,3984,6.29%,3.30%
2020-01-01 00:10:10,1,12,10808,875,9933,16.49%,8.10%
2020-01-01 00:10:10,2,1,318,5,313,0.49%,1.57%
2020-01-01 00:10:10,2,2,27399,4942,22457,41.81%,18.04%
2020-01-01 00:10:10,2,3,22741,3468,19273,34.70%,15.25%
2020-01-01 00:10:10,2,4,254,4,250,0.39%,1.57%
2020-01-01 00:10:10,2,5,14331,1444,12887,21.87%,10.08%
2020-01-01 00:10:10,2,6,50,0,50,0.08%,0.00%
2020-01-01 00:10:10,2,7,4322,128,4194,6.59%,2.96%
2020-01-01 00:10:10,2,8,3119,61,3058,4.76%,1.96%
2020-01-01 00:10:10,2,9,14208,1411,12797,21.68%,9.93%
2020-01-01 00:10:10,2,10,2303,37,2266,3.51%,1.61%
2020-01-01 00:10:10,2,11,2318,37,2281,3.54%,1.60%
2020-01-01 00:10:10,2,12,14005,1371,12634,21.37%,9.79%
2020-01-01 00:10:10,3,1,1489,17,1472,2.27%,1.14%
2020-01-01 00:10:10,3,2,28409,5329,23080,43.35%,18.76%
2020-01-01 00:10:10,3,3,77909,32297,45612,118.88%,41.45%
2020-01-01 00:10:10,3,4,7710,450,7260,11.76%,5.84%
2020-01-01 00:10:10,3,5,48446,14239,34207,73.92%,29.39%
2020-01-01 00:10:10,3,6,8915,611,8304,13.60%,6.85%
2020-01-01 00:10:10,3,7,25144,4247,20897,38.37%,16.89%
2020-01-01 00:10:10,3,8,20110,2779,17331,30.69%,13.82%
2020-01-01 00:10:10,3,9,39224,9727,29497,59.85%,24.80%
2020-01-01 00:10:10,3,10,6694,316,6378,10.21%,4.72%
2020-01-01 00:10:10,3,11,2072,30,2042,3.16%,1.45%
2020-01-01 00:10:10,3,12,29868,5879,23989,45.57%,19.68%
2020-01-01 00:10:10,4,1,462,0,462,0.70%,0.00%
2020-01-01 00:10:10,4,2,250,0,250,0.38%,0.00%
2020-01-01 00:10:10,4,3,896,7,889,1.37%,0.78%
2020-01-01 00:10:10,4,4,30419,6171,24248,46.42%,20.29%
2020-01-01 00:10:10,4,5,18517,2414,16103,28.25%,13.04%
2020-01-01 00:10:10,4,6,26235,4715,21520,40.03%,17.97%
2020-01-01 00:10:10,4,7,6250,312,5938,9.54%,4.99%
2020-01-01 00:10:10,4,8,2934,64,2870,4.48%,2.18%
2020-01-01 00:10:10,4,9,16057,1829,14228,24.50%,11.39%
2020-01-01 00:10:10,4,10,2076,32,2044,3.17%,1.54%
2020-01-01 00:10:10,4,11,178,0,178,0.27%,0.00%
2020-01-01 00:10:10,4,12,12935,1207,11728,19.74%,9.33%
2020-01-01 00:10:10,5,1,2688,54,2634,4.10%,2.01%
2020-01-01 00:10:10,5,2,677,2,675,1.03%,0.30%
2020-01-01 00:10:10,5,3,422,1,421,0.64%,0.24%
2020-01-01 00:10:10,5,4,24069,3933,20136,36.73%,16.34%
2020-01-01 00:10:10,5,5,9889,693,9196,15.09%,7.01%
2020-01-01 00:10:10,5,6,15628,1725,13903,23.85%,11.04%
2020-01-01 00:10:10,5,7,5320,218,5102,8.12%,4.10%
2020-01-01 00:10:10,5,8,3671,104,3567,5.60%,2.83%
2020-01-01 00:10:10,5,9,9327,618,8709,14.23%,6.63%
2020-01-01 00:10:10,5,10,1176,11,1165,1.79%,0.94%
2020-01-01 00:10:10,5,11,755,6,749,1.15%,0.79%
2020-01-01 00:10:10,5,12,7885,440,7445,12.03%,5.58%
2020-01-01 00:10:10,6,1,1094,11,1083,1.67%,1.01%
2020-01-01 00:10:10,6,2,1165,12,1153,1.78%,1.03%
2020-01-01 00:10:10,6,3,1793,29,1764,2.74%,1.62%
2020-01-01 00:10:10,6,4,1463,14,1449,2.23%,0.96%
2020-01-01 00:10:10,6,5,15488,1632,13856,23.63%,10.54%
2020-01-01 00:10:10,6,6,5131,180,4951,7.83%,3.51%
2020-01-01 00:10:10,6,7,3203,82,3121,4.89%,2.56%
2020-01-01 00:10:10,6,8,2657,64,2593,4.05%,2.41%
2020-01-01 00:10:10,6,9,8222,506,7716,12.55%,6.15%
2020-01-01 00:10:10,6,10,1971,34,1937,3.01%,1.73%
2020-01-01 00:10:10,6,11,356,0,356,0.54%,0.00%
2020-01-01 00:10:10,6,12,6154,284,5870,9.39%,4.61%
2020-01-01 00:10:10,7,1,481,1,480,0.73%,0.21%
2020-01-01 00:10:10,7,2,187,1,186,0.29%,0.53%
2020-01-01 00:10:10,7,3,1043,9,1034,1.59%,0.86%
2020-01-01 00:10:10,7,4,1286,19,1267,1.96%,1.48%
2020-01-01 00:10:10,7,5,8668,578,8090,13.23%,6.67%
2020-01-01 00:10:10,7,6,13213,1254,11959,20.16%,9.49%
2020-01-01 00:10:10,7,7,3237,81,3156,4.94%,2.50%
2020-01-01 00:10:10,7,8,1139,16,1123,1.74%,1.40%
2020-01-01 00:10:10,7,9,6460,326,6134,9.86%,5.05%
2020-01-01 00:10:10,7,10,1136,7,1129,1.73%,0.62%
2020-01-01 00:10:10,7,11,127,1,126,0.19%,0.79%
2020-01-01 00:10:10,7,12,5322,223,5099,8.12%,4.19%
2020-01-01 00:10:10,8,1,340,2,338,0.52%,0.59%
2020-01-01 00:10:10,8,2,79,0,79,0.12%,0.00%
2020-01-01 00:10:10,8,3,1516,11,1505,2.31%,0.73%
2020-01-01 00:10:10,8,4,2463,47,2416,3.76%,1.91%
2020-01-01 00:10:10,8,5,8687,565,8122,13.26%,6.50%
2020-01-01 00:10:10,8,6,16215,1863,14352,24.74%,11.49%
2020-01-01 00:10:10,8,7,5016,206,4810,7.65%,4.11%
2020-01-01 00:10:10,8,8,2021,34,1987,3.08%,1.68%
2020-01-01 00:10:10,8,9,6865,369,6496,10.48%,5.38%
2020-01-01 00:10:10,8,10,1831,23,1808,2.79%,1.26%
2020-01-01 00:10:10,8,11,246,0,246,0.38%,0.00%
2020-01-01 00:10:10,8,12,4992,199,4793,7.62%,3.99%
2020-01-01 00:10:10,9,1,414,1,413,0.63%,0.24%
2020-01-01 00:10:10,9,2,2058,57,2001,3.14%,2.77%
2020-01-01 00:10:10,9,3,1191,37,1154,1.82%,3.11%
2020-01-01 00:10:10,9,4,7205,385,6820,10.99%,5.34%
2020-01-01 00:10:10,9,5,245,0,245,0.37%,0.00%
2020-01-01 00:10:10,9,6,7777,435,7342,11.87%,5.59%
2020-01-01 00:10:10,9,7,26906,4821,22085,41.06%,17.92%
2020-01-01 00:10:10,9,8,11103,902,10201,16.94%,8.12%
2020-01-01 00:10:10,9,9,177,0,177,0.27%,0.00%
2020-01-01 00:10:10,9,10,4238,123,4115,6.47%,2.90%
2020-01-01 00:10:10,9,11,9750,690,9060,14.88%,7.08%
2020-01-01 00:10:10,9,12,5219,185,5034,7.96%,3.54%
2020-01-01 00:10:10,10,1,1154,266,888,1.76%,23.05%
2020-01-01 00:10:10,10,2,2796,320,2476,4.27%,11.44%
2020-01-01 00:10:10,10,3,1409,22,1387,2.15%,1.56%
2020-01-01 00:10:10,10,4,5573,973,4600,8.50%,17.46%
2020-01-01 00:10:10,10,5,685,7,678,1.05%,1.02%
2020-01-01 00:10:10,10,6,7333,1108,6225,11.19%,15.11%
2020-01-01 00:10:10,10,7,12065,1903,10162,18.41%,15.77%
2020-01-01 00:10:10,10,8,29040,7290,21750,44.31%,25.10%
2020-01-01 00:10:10,10,9,543,2,541,0.83%,0.37%
2020-01-01 00:10:10,10,10,2242,46,2196,3.42%,2.05%
2020-01-01 00:10:10,10,11,12492,1651,10841,19.06%,13.22%
2020-01-01 00:10:10,10,12,9681,1209,8472,14.77%,12.49%
2020-01-01 00:10:10,11,1,2238,42,2196,3.41%,1.88%
2020-01-01 00:10:10,11,2,3485,89,3396,5.32%,2.55%
2020-01-01 00:10:10,11,3,1099,7,1092,1.68%,0.64%
2020-01-01 00:10:10,11,4,3007,69,2938,4.59%,2.29%
2020-01-01 00:10:10,11,5,535,2,533,0.82%,0.37%
2020-01-01 00:10:10,11,6,4210,122,4088,6.42%,2.90%
2020-01-01 00:10:10,11,7,9516,668,8848,14.52%,7.02%
2020-01-01 00:10:10,11,8,23125,3669,19456,35.29%,15.87%
2020-01-01 00:10:10,11,9,245,1,244,0.37%,0.41%
2020-01-01 00:10:10,11,10,2953,65,2888,4.51%,2.20%
2020-01-01 00:10:10,11,11,10249,744,9505,15.64%,7.26%
2020-01-01 00:10:10,11,12,7026,371,6655,10.72%,5.28%
2020-01-01 00:10:10,12,1,74,0,74,0.11%,0.00%
2020-01-01 00:10:10,12,2,657,224,433,1.00%,34.09%
2020-01-01 00:10:10,12,3,2563,263,2300,3.91%,10.26%
2020-01-01 00:10:10,12,4,2635,61,2574,4.02%,2.31%
2020-01-01 00:10:10,12,5,8433,706,7727,12.87%,8.37%
2020-01-01 00:10:10,12,6,5051,175,4876,7.71%,3.46%
2020-01-01 00:10:10,12,7,2296,28,2268,3.50%,1.22%
2020-01-01 00:10:10,12,8,1261,303,958,1.92%,24.03%
2020-01-01 00:10:10,12,9,21395,4252,17143,32.65%,19.87%
2020-01-01 00:10:10,12,10,3735,387,3348,5.70%,10.36%
2020-01-01 00:10:10,12,11,1454,305,1149,2.22%,20.98%
2020-01-01 00:10:10,12,12,7713,1178,6535,11.77%,15.27%
2020-01-01 00:10:10,13,1,2316,44,2272,3.53%,1.90%
2020-01-01 00:10:10,13,2,2695,59,2636,4.11%,2.19%
2020-01-01 00:10:10,13,3,604,2,602,0.92%,0.33%
2020-01-01 00:10:10,13,4,4865,447,4418,7.42%,9.19%
2020-01-01 00:10:10,13,5,7389,738,6651,11.27%,9.99%
2020-01-01 00:10:10,13,6,5829,510,5319,8.89%,8.75%
2020-01-01 00:10:10,13,7,5080,190,4890,7.75%,3.74%
2020-01-01 00:10:10,13,8,6844,348,6496,10.44%,5.08%
2020-01-01 00:10:10,13,9,7708,773,6935,11.76%,10.03%
2020-01-01 00:10:10,13,10,28679,6010,22669,43.76%,20.96%
2020-01-01 00:10:10,13,11,17928,2619,15309,27.36%,14.61%
2020-01-01 00:10:10,13,12,10357,1172,9185,15.80%,11.32%
2020-01-01 00:10:10,14,1,493,6,487,0.75%,1.22%
2020-01-01 00:10:10,14,2,1948,24,1924,2.97%,1.23%
2020-01-01 00:10:10,14,3,1241,4,1237,1.89%,0.32%
2020-01-01 00:10:10,14,4,4095,125,3970,6.25%,3.05%
2020-01-01 00:10:10,14,5,1455,21,1434,2.22%,1.44%
2020-01-01 00:10:10,14,6,4377,143,4234,6.68%,3.27%
2020-01-01 00:10:10,14,7,12130,1037,11093,18.51%,8.55%
2020-01-01 00:10:10,14,8,13689,1343,12346,20.89%,9.81%
2020-01-01 00:10:10,14,9,1747,30,1717,2.67%,1.72%
2020-01-01 00:10:10,14,10,4101,129,3972,6.26%,3.15%
2020-01-01 00:10:10,14,11,25932,4529,21403,39.57%,17.46%
2020-01-01 00:10:10,14,12,7730,435,7295,11.80%,5.63%
2020-01-01 00:10:10,15,1,493,0,493,0.75%,0.00%
2020-01-01 00:10:10,15,2,190,0,190,0.29%,0.00%
2020-01-01 00:10:10,15,3,3734,130,3604,5.70%,3.48%
2020-01-01 00:10:10,15,4,5584,256,5328,8.52%,4.58%
2020-01-01 00:10:10,15,5,10763,860,9903,16.42%,7.99%
2020-01-01 00:10:10,15,6,5899,284,5615,9.00%,4.81%
2020-01-01 00:10:10,15,7,3723,119,3604,5.68%,3.20%
2020-01-01 00:10:10,15,8,5521,243,5278,8.42%,4.40%
2020-01-01 00:10:10,15,9,10961,878,10083,16.73%,8.01%
2020-01-01 00:10:10,15,10,4491,266,4225,6.85%,5.92%
2020-01-01 00:10:10,15,11,10140,857,9283,15.47%,8.45%
2020-01-01 00:10:10,15,12,26508,5167,21341,40.45%,19.49%
2020-01-01 00:10:10,16,1,448,0,448,0.68%,0.00%
2020-01-01 00:10:10,16,2,280,0,280,0.43%,0.00%
2020-01-01 00:10:10,16,3,1008,12,996,1.54%,1.19%
2020-01-01 00:10:10,16,4,4475,147,4328,6.83%,3.28%
2020-01-01 00:10:10,16,5,7335,455,6880,11.19%,6.20%
2020-01-01 00:10:10,16,6,5243,195,5048,8.00%,3.72%
2020-01-01 00:10:10,16,7,3537,111,3426,5.40%,3.14%
2020-01-01 00:10:10,16,8,7778,441,7337,11.87%,5.67%
2020-01-01 00:10:10,16,9,7723,495,7228,11.78%,6.41%
2020-01-01 00:10:10,16,10,1605,22,1583,2.45%,1.37%
2020-01-01 00:10:10,16,11,9625,673,8952,14.69%,6.99%
2020-01-01 00:10:10,16,12,25803,4605,21198,39.37%,17.85%
2020-01-01 00:10:20,1,1,15675,1848,13827,23.92%,11.79%
2020-01-01 00:10:20,1,2,5631,262,5369,8.59%,4.65%
2020-01-01 00:10:20,1,3,557,2,555,0.85%,0.36%
2020-01-01 00:10:20,1,4,9798,770,9028,14.95%,7.86%
2020-01-01 00:10:20,1,5,9566,745,8821,14.60%,7.79%
2020-01-01 00:10:20,1,6,9490,726,8764,14.48%,7.65%
2020-01-01 00:10:20,1,7,5047,198,4849,7.70%,3.92%
2020-01-01 00:10:20,1,8,4201,135,4066,6.41%,3.21%
2020-01-01 00:10:20,1,9,9450,722,8728,14.42%,7.64%
2020-01-01 00:10:20,1,10,3440,91,3349,5.25%,2.65%
2020-01-01 00:10:20,1,11,3566,99,3467,5.44%,2.78%
2020-01-01 00:10:20,1,12,9290,704,8586,14.18%,7.58%
2020-01-01 00:10:20,2,1,1221,15,1206,1.86%,1.23%
2020-01-01 00:10:20,2,2,26899,4835,22064,41.04%,17.97%
2020-01-01 00:10:20,2,3,20121,2818,17303,30.70%,14.01%
2020-01-01 00:10:20,2,4,1188,15,1173,1.81%,1.26%
2020-01-01 00:10:20,2,5,11797,1002,10795,18.00%,8.49%
2020-01-01 00:10:20,2,6,58,0,58,0.09%,0.00%
2020-01-01 00:10:20,2,7,5538,218,5320,8.45%,3.94%
2020-01-01 00:10:20,2,8,4637,154,4483,7.08%,3.32%
2020-01-01 00:10:20,2,9,11693,992,10701,17.84%,8.48%
2020-01-01 00:10:20,2,10,3809,106,3703,5.81%,2.78%
2020-01-01 00:10:20,2,11,3820,106,3714,5.83%,2.77%
2020-01-01 00:10:20,2,12,11495,956,10539,17.54%,8.32%
2020-01-01 00:10:20,3,1,1542,10,1532,2.35%,0.65%
2020-01-01 00:10:20,3,2,23301,3684,19617,35.55%,15.81%
2020-01-01 00:10:20,3,3,73259,29083,44176,111.78%,39.70%
2020-01-01 00:10:20,3,4,7318,461,6857,11.17%,6.30%
2020-01-01 00:10:20,3,5,48280,14204,34076,73.67%,29.42%
2020-01-01 00:10:20,3,6,8532,595,7937,13.02%,6.97%
2020-01-01 00:10:20,3,7,19926,2747,17179,30.40%,13.79%
2020-01-01 00:10:20,3,8,17175,2006,15169,26.21%,11.68%
2020-01-01 00:10:20,3,9,39369,9853,29516,60.07%,25.03%
2020-01-01 00:10:20,3,10,7097,378,6719,10.83%,5.33%
2020-01-01 00:10:20,3,11,1841,32,1809,2.81%,1.74%
2020-01-01 00:10:20,3,12,28761,5528,23233,43.89%,19.22%
2020-01-01 00:10:20,4,1,710,4,706,1.08%,0.56%
2020-01-01 00:10:20,4,2,373,1,372,0.57%,0.27%
2020-01-01 00:10:20,4,3,752,26,726,1.15%,3.46%
2020-01-01 00:10:20,4,4,28649,5320,23329,43.71%,18.57%
2020-01-01 00:10:20,4,5,17263,2050,15213,26.34%,11.88%
2020-01-01 00:10:20,4,6,24250,3911,20339,37.00%,16.13%
2020-01-01 00:10:20,4,7,5467,217,5250,8.34%,3.97%
2020-01-01 00:10:20,4,8,2959,67,2892,4.52%,2.26%
2020-01-01 00:10:20,4,9,15280,1638,13642,23.32%,10.72%
2020-01-01 00:10:20,4,10,1983,32,1951,3.03%,1.61%
2020-01-01 00:10:20,4,11,164,0,164,0.25%,0.00%
2020-01-01 00:10:20,4,12,12540,1146,11394,19.13%,9.14%
2020-01-01 00:10:20,5,1,2915,68,2847,4.45%,2.33%
2020-01-01 00:10:20,5,2,1159,7,1152,1.77%,0.60%
2020-01-01 00:10:20,5,3,2295,42,2253,3.50%,1.83%
2020-01-01 00:10:20,5,4,23241,3732,19509,35.46%,16.06%
2020-01-01 00:10:20,5,5,11081,865,10216,16.91%,7.81%
2020-01-01 00:10:20,5,6,16358,1871,14487,24.96%,11.44%
2020-01-01 00:10:20,5,7,4898,161,4737,7.47%,3.29%
2020-01-01 00:10:20,5,8,3784,105,3679,5.77%,2.77%
2020-01-01 00:10:20,5,9,8475,507,7968,12.93%,5.98%
2020-01-01 00:10:20,5,10,1297,13,1284,1.98%,1.00%
2020-01-01 00:10:20,5,11,578,3,575,0.88%,0.52%
2020-01-01 00:10:20,5,12,6855,343,6512,10.46%,5.00%
2020-01-01 00:10:20,6,1,1079,10,1069,1.65%,0.93%
2020-01-01 00:10:20,6,2,1205,10,1195,1.84%,0.83%
2020-01-01 00:10:20,6,3,1685,15,1670,2.57%,0.89%
2020-01-01 00:10:20,6,4,1569,15,1554,2.39%,0.96%
2020-01-01 00:10:20,6,5,15561,1722,13839,23.74%,11.07%
2020-01-01 00:10:20,6,6,5246,171,5075,8.00%,3.26%
2020-01-01 00:10:20,6,7,3223,75,3148,4.92%,2.33%
2020-01-01 00:10:20,6,8,2738,54,2684,4.18%,1.97%
2020-01-01 00:10:20,6,9,8413,543,7870,12.84%,6.45%
2020-01-01 00:10:20,6,10,2067,29,2038,3.15%,1.40%
2020-01-01 00:10:20,6,11,345,1,344,0.53%,0.29%
2020-01-01 00:10:20,6,12,6276,305,5971,9.58%,4.86%
2020-01-01 00:10:20,7,1,446,2,444,0.68%,0.45%
2020-01-01 00:10:20,7,2,181,0,181,0.28%,0.00%
2020-01-01 00:10:20,7,3,1196,7,1189,1.82%,0.59%
2020-01-01 00:10:20,7,4,2108,26,2082,3.22%,1.23%
2020-01-01 00:10:20,7,5,8303,521,7782,12.67%,6.27%
2020-01-01 00:10:20,7,6,14003,1378,12625,21.37%,9.84%
2020-01-01 00:10:20,7,7,3543,93,3450,5.41%,2.62%
2020-01-01 00:10:20,7,8,1488,12,1476,2.27%,0.81%
2020-01-01 00:10:20,7,9,6167,297,5870,9.41%,4.82%
2020-01-01 00:10:20,7,10,1030,7,1023,1.57%,0.68%
2020-01-01 00:10:20,7,11,86,0,86,0.13%,0.00%
2020-01-01 00:10:20,7,12,5124,227,4897,7.82%,4.43%
2020-01-01 00:10:20,8,1,490,2,488,0.75%,0.41%
2020-01-01 00:10:20,8,2,90,0,90,0.14%,0.00%
2020-01-01 00:10:20,8,3,1918,34,1884,2.93%,1.77%
2020-01-01 00:10:20,8,4,2928,72,2856,4.47%,2.46%
2020-01-01 00:10:20,8,5,9057,616,8441,13.82%,6.80%
2020-01-01 00:10:20,8,6,17463,2150,15313,26.65%,12.31%
2020-01-01 00:10:20,8,7,5411,214,5197,8.26%,3.95%
2020-01-01 00:10:20,8,8,2457,55,2402,3.75%,2.24%
2020-01-01 00:10:20,8,9,6882,355,6527,10.50%,5.16%
2020-01-01 00:10:20,8,10,1795,28,1767,2.74%,1.56%
2020-01-01 00:10:20,8,11,218,0,218,0.33%,0.00%
2020-01-01 00:10:20,8,12,5038,190,4848,7.69%,3.77%
2020-01-01 00:10:20,9,1,596,0,596,0.91%,0.00%
2020-01-01 00:10:20,9,2,2224,42,2182,3.39%,1.89%
2020-01-01 00:10:20,9,3,1105,10,1095,1.69%,0.90%
2020-01-01 00:10:20,9,4,8325,485,7840,12.70%,5.83%
2020-01-01 00:10:20,9,5,430,4,426,0.66%,0.93%
2020-01-01 00:10:20,9,6,9532,646,8886,14.54%,6.78%
2020-01-01 00:10:20,9,7,30169,6185,23984,46.03%,20.50%
2020-01-01 00:10:20,9,8,9462,709,8753,14.44%,7.49%
2020-01-01 00:10:20,9,9,227,1,226,0.35%,0.44%
2020-01-01 00:10:20,9,10,3229,88,3141,4.93%,2.73%
2020-01-01 00:10:20,9,11,8302,521,7781,12.67%,6.28%
2020-01-01 00:10:20,9,12,4809,161,4648,7.34%,3.35%
2020-01-01 00:10:20,10,1,1252,334,918,1.91%,26.68%
2020-01-01 00:10:20,10,2,3212,391,2821,4.90%,12.17%
2020-01-01 00:10:20,10,3,1784,34,1750,2.72%,1.91%
2020-01-01 00:10:20,10,4,4634,1061,3573,7.07%,22.90%
2020-01-01 00:10:20,10,5,851,39,812,1.30%,4.58%
2020-01-01 00:10:20,10,6,6770,1231,5539,10.33%,18.18%
2020-01-01 00:10:20,10,7,12005,2133,9872,18.32%,17.77%
2020-01-01 00:10:20,10,8,28785,7405,21380,43.92%,25.73%
2020-01-01 00:10:20,10,9,556,2,554,0.85%,0.36%
2020-01-01 00:10:20,10,10,2659,47,2612,4.06%,1.77%
2020-01-01 00:10:20,10,11,12582,1642,10940,19.20%,13.05%
2020-01-01 00:10:20,10,12,9356,1172,8184,14.28%,12.53%
2020-01-01 00:10:20,11,1,2246,39,2207,3.43%,1.74%
2020-01-01 00:10:20,11,2,3220,90,3130,4.91%,2.80%
2020-01-01 00:10:20,11,3,827,10,817,1.26%,1.21%
2020-01-01 00:10:20,11,4,3118,62,3056,4.76%,1.99%
2020-01-01 00:10:20,11,5,243,0,243,0.37%,0.00%
2020-01-01 00:10:20,11,6,3941,117,3824,6.01%,2.97%
2020-01-01 00:10:20,11,7,8945,620,8325,13.65%,6.93%
2020-01-01 00:10:20,11,8,23471,3800,19671,35.81%,16.19%
2020-01-01 00:10:20,11,9,191,0,191,0.29%,0.00%
2020-01-01 00:10:20,11,10,3264,80,3184,4.98%,2.45%
2020-01-01 00:10:20,11,11,10514,786,9728,16.04%,7.48%
2020-01-01 00:10:20,11,12,6779,334,6445,10.34%,4.93%
2020-01-01 00:10:20,12,1,47,0,47,0.07%,0.00%
2020-01-01 00:10:20,12,2,536,186,350,0.82%,34.70%
2020-01-01 00:10:20,12,3,2501,225,2276,3.82%,9.00%
2020-01-01 00:10:20,12,4,2506,50,2456,3.82%,2.00%
2020-01-01 00:10:20,12,5,7741,614,7127,11.81%,7.93%
2020-01-01 00:10:20,12,6,4484,164,4320,6.84%,3.66%
2020-01-01 00:10:20,12,7,1807,31,1776,2.76%,1.72%
2020-01-01 00:10:20,12,8,978,198,780,1.49%,20.25%
2020-01-01 00:10:20,12,9,20749,3673,17076,31.66%,17.70%
2020-01-01 00:10:20,12,10,3612,274,3338,5.51%,7.59%
2020-01-01 00:10:20,12,11,1385,207,1178,2.11%,14.95%
2020-01-01 00:10:20,12,12,8418,1056,7362,12.84%,12.54%
2020-01-01 00:10:20,13,1,1898,28,1870,2.90%,1.48%
2020-01-01 00:10:20,13,2,2265,43,2222,3.46%,1.90%
2020-01-01 00:10:20,13,3,616,3,613,0.94%,0.49%
2020-01-01 00:10:20,13,4,4753,589,4164,7.25%,12.39%
2020-01-01 00:10:20,13,5,7016,843,6173,10.71%,12.02%
2020-01-01 00:10:20,13,6,5476,637,4839,8.36%,11.63%
2020-01-01 00:10:20,13,7,4715,170,4545,7.19%,3.61%
2020-01-01 00:10:20,13,8,6855,366,6489,10.46%,5.34%
2020-01-01 00:10:20,13,9,7275,875,6400,11.10%,12.03%
2020-01-01 00:10:20,13,10,27454,5712,21742,41.89%,20.81%
2020-01-01 00:10:20,13,11,17073,2432,14641,26.05%,14.24%
2020-01-01 00:10:20,13,12,9670,1092,8578,14.76%,11.29%
2020-01-01 00:10:20,14,1,449,1,448,0.69%,0.22%
2020-01-01 00:10:20,14,2,2630,64,2566,4.01%,2.43%
2020-01-01 00:10:20,14,3,1958,29,1929,2.99%,1.48%
2020-01-01 00:10:20,14,4,4037,114,3923,6.16%,2.82%
2020-01-01 00:10:20,14,5,1349,16,1333,2.06%,1.19%
2020-01-01 00:10:20,14,6,4285,129,4156,6.54%,3.01%
2020-01-01 00:10:20,14,7,12462,1112,11350,19.02%,8.92%
2020-01-01 00:10:20,14,8,14063,1398,12665,21.46%,9.94%
2020-01-01 00:10:20,14,9,1690,26,1664,2.58%,1.54%
2020-01-01 00:10:20,14,10,3885,118,3767,5.93%,3.04%
2020-01-01 00:10:20,14,11,28416,5367,23049,43.36%,18.89%
2020-01-01 00:10:20,14,12,10004,726,9278,15.26%,7.26%
2020-01-01 00:10:20,15,1,503,1,502,0.77%,0.20%
2020-01-01 00:10:20,15,2,199,0,199,0.30%,0.00%
2020-01-01 00:10:20,15,3,9086,620,8466,13.86%,6.82%
2020-01-01 00:10:20,15,4,4769,181,4588,7.28%,3.80%
2020-01-01 00:10:20,15,5,15413,1748,13665,23.52%,11.34%
2020-01-01 00:10:20,15,6,5047,231,4816,7.70%,4.58%
2020-01-01 00:10:20,15,7,3123,71,3052,4.77%,2.27%
2020-01-01 00:10:20,15,8,4935,179,4756,7.53%,3.63%
2020-01-01 00:10:20,15,9,15566,1779,13787,23.75%,11.43%
2020-01-01 00:10:20,15,10,5405,319,5086,8.25%,5.90%
2020-01-01 00:10:20,15,11,10465,913,9552,15.97%,8.72%
2020-01-01 00:10:20,15,12,31851,7069,24782,48.60%,22.19%
2020-01-01 00:10:20,16,1,425,0,425,0.65%,0.00%
2020-01-01 00:10:20,16,2,275,2,273,0.42%,0.73%
2020-01-01 00:10:20,16,3,1135,8,1127,1.73%,0.70%
2020-01-01 00:10:20,16,4,3566,95,3471,5.44%,2.66%
2020-01-01 00:10:20,16,5,6868,330,6538,10.48%,4.80%
2020-01-01 00:10:20,16,6,4341,120,4221,6.62%,2.76%
2020-01-01 00:10:20,16,7,3430,86,3344,5.23%,2.51%
2020-01-01 00:10:20,16,8,7232,476,6756,11.04%,6.58%
2020-01-01 00:10:20,16,9,7278,377,6901,11.11%,5.18%
2020-01-01 00:10:20,16,10,1789,20,1769,2.73%,1.12%
2020-01-01 00:10:20,16,11,9235,707,8528,14.09%,7.66%
2020-01-01 00:10:20,16,12,24298,4000,20298,37.08%,16.46%
2020-01-01 00:10:30,1,1,19979,2827,17152,30.49%,14.15%
2020-01-01 00:10:30,1,2,6367,301,6066,9.72%,4.73%
2020-01-01 00:10:30,1,3,494,2,492,0.75%,0.40%
2020-01-01 00:10:30,1,4,13318,1301,12017,20.32%,9.77%
2020-01-01 00:10:30,1,5,13055,1254,11801,19.92%,9.61%
2020-01-01 00:10:30,1,6,13000,1243,11757,19.84%,9.56%
2020-01-01 00:10:30,1,7,5853,249,5604,8.93%,4.25%
2020-01-01 00:10:30,1,8,4902,166,4736,7.48%,3.39%
2020-01-01 00:10:30,1,9,12964,1236,11728,19.78%,9.53%
2020-01-01 00:10:30,1,10,4338,132,4206,6.62%,3.04%
2020-01-01 00:10:30,1,11,4441,135,4306,6.78%,3.04%
2020-01-01 00:10:30,1,12,12865,1220,11645,19.63%,9.48%
2020-01-01 00:10:30,2,1,2221,44,2177,3.39%,1.98%
2020-01-01 00:10:30,2,2,28260,5390,22870,43.12%,19.07%
2020-01-01 00:10:30,2,3,21153,3148,18005,32.28%,14.88%
2020-01-01 00:10:30,2,4,2118,40,2078,3.23%,1.89%
2020-01-01 00:10:30,2,5,13563,1320,12243,20.70%,9.73%
2020-01-01 00:10:30,2,6,35,0,35,0.05%,0.00%
2020-01-01 00:10:30,2,7,4863,164,4699,7.42%,3.37%
2020-01-01 00:10:30,2,8,3522,83,3439,5.37%,2.36%
2020-01-01 00:10:30,2,9,13443,1304,12139,20.51%,9.70%
2020-01-01 00:10:30,2,10,2779,45,2734,4.24%,1.62%
2020-01-01 00:10:30,2,11,2795,47,2748,4.26%,1.68%
2020-01-01 00:10:30,2,12,13288,1267,12021,20.28%,9.53%
2020-01-01 00:10:30,3,1,1480,14,1466,2.26%,0.95%
2020-01-01 00:10:30,3,2,22598,3457,19141,34.48%,15.30%
2020-01-01 00:10:30,3,3,67350,25126,42224,102.77%,37.31%
2020-01-01 00:10:30,3,4,7886,458,7428,12.03%,5.81%
2020-01-01 00:10:30,3,5,43330,11564,31766,66.12%,26.69%
2020-01-01 00:10:30,3,6,9096,592,8504,13.88%,6.51%
2020-01-01 00:10:30,3,7,19424,2558,16866,29.64%,13.17%
2020-01-01 00:10:30,3,8,15400,1627,13773,23.50%,10.56%
2020-01-01 00:10:30,3,9,33903,7386,26517,51.73%,21.79%
2020-01-01 00:10:30,3,10,5245,195,5050,8.00%,3.72%
2020-01-01 00:10:30,3,11,1629,32,1597,2.49%,1.96%
2020-01-01 00:10:30,3,12,24489,4062,20427,37.37%,16.59%
2020-01-01 00:10:30,4,1,487,0,487,0.74%,0.00%
2020-01-01 00:10:30,4,2,293,0,293,0.45%,0.00%
2020-01-01 00:10:30,4,3,684,4,680,1.04%,0.58%
2020-01-01 00:10:30,4,4,27826,5160,22666,42.46%,18.54%
2020-01-01 00:10:30,4,5,17011,2057,14954,25.96%,12.09%
2020-01-01 00:10:30,4,6,23536,3761,19775,35.91%,15.98%
2020-01-01 00:10:30,4,7,5151,189,4962,7.86%,3.67%
2020-01-01 00:10:30,4,8,2766,68,2698,4.22%,2.46%
2020-01-01 00:10:30,4,9,15236,1707,13529,23.25%,11.20%
2020-01-01 00:10:30,4,10,1978,49,1929,3.02%,2.48%
2020-01-01 00:10:30,4,11,170,1,169,0.26%,0.59%
2020-01-01 00:10:30,4,12,12398,1100,11298,18.92%,8.87%
2020-01-01 00:10:30,5,1,2858,69,2789,4.36%,2.41%
2020-01-01 00:10:30,5,2,967,13,954,1.48%,1.34%
2020-01-01 00:10:30,5,3,584,1,583,0.89%,0.17%
2020-01-01 00:10:30,5,4,24154,3917,20237,36.86%,16.22%
2020-01-01 00:10:30,5,5,9679,671,9008,14.77%,6.93%
2020-01-01 00:10:30,5,6,14714,1535,13179,22.45%,10.43%
2020-01-01 00:10:30,5,7,4632,163,4469,7.07%,3.52%
2020-01-01 00:10:30,5,8,3713,103,3610,5.67%,2.77%
2020-01-01 00:10:30,5,9,8961,575,8386,13.67%,6.42%
2020-01-01 00:10:30,5,10,1306,18,1288,1.99%,1.38%
2020-01-01 00:10:30,5,11,711,3,708,1.08%,0.42%
2020-01-01 00:10:30,5,12,7290,382,6908,11.12%,5.24%
2020-01-01 00:10:30,6,1,1013,7,1006,1.55%,0.69%
2020-01-01 00:10:30,6,2,1140,11,1129,1.74%,0.96%
2020-01-01 00:10:30,6,3,1691,27,1664,2.58%,1.60%
2020-01-01 00:10:30,6,4,1022,17,1005,1.56%,1.66%
2020-01-01 00:10:30,6,5,14006,1441,12565,21.37%,10.29%
2020-01-01 00:10:30,6,6,4848,201,4647,7.40%,4.15%
2020-01-01 00:10:30,6,7,3430,106,3324,5.23%,3.09%
2020-01-01 00:10:30,6,8,2939,88,2851,4.48%,2.99%
2020-01-01 00:10:30,6,9,7105,368,6737,10.84%,5.18%
2020-01-01 00:10:30,6,10,2161,32,2129,3.30%,1.48%
2020-01-01 00:10:30,6,11,407,0,407,0.62%,0.00%
2020-01-01 00:10:30,6,12,4879,190,4689,7.44%,3.89%
2020-01-01 00:10:30,7,1,394,2,392,0.60%,0.51%
2020-01-01 00:10:30,7,2,190,1,189,0.29%,0.53%
2020-01-01 00:10:30,7,3,853,6,847,1.30%,0.70%
2020-01-01 00:10:30,7,4,2093,32,2061,3.19%,1.53%
2020-01-01 00:10:30,7,5,7516,413,7103,11.47%,5.49%
2020-01-01 00:10:30,7,6,13241,1236,12005,20.20%,9.33%
2020-01-01 00:10:30,7,7,3576,89,3487,5.46%,2.49%
2020-01-01 00:10:30,7,8,1464,21,1443,2.23%,1.43%
2020-01-01 00:10:30,7,9,6462,310,6152,9.86%,4.80%
2020-01-01 00:10:30,7,10,1172,12,1160,1.79%,1.02%
2020-01-01 00:10:30,7,11,72,0,72,0.11%,0.00%
2020-01-01 00:10:30,7,12,5331,197,5134,8.13%,3.70%
2020-01-01 00:10:30,8,1,415,0,415,0.63%,0.00%
2020-01-01 00:10:30,8,2,78,3,75,0.12%,3.85%
2020-01-01 00:10:30,8,3,1728,17,1711,2.64%,0.98%
2020-01-01 00:10:30,8,4,2783,69,2714,4.25%,2.48%
2020-01-01 00:10:30,8,5,8640,492,8148,13.18%,5.69%
2020-01-01 00:10:30,8,6,17027,2018,15009,25.98%,11.85%
2020-01-01 00:10:30,8,7,5565,234,5331,8.49%,4.20%
2020-01-01 00:10:30,8,8,2718,60,2658,4.15%,2.21%
2020-01-01 00:10:30,8,9,6464,281,6183,9.86%,4.35%
2020-01-01 00:10:30,8,10,1970,27,1943,3.01%,1.37%
2020-01-01 00:10:30,8,11,168,0,168,0.26%,0.00%
2020-01-01 00:10:30,8,12,4403,124,4279,6.72%,2.82%
2020-01-01 00:10:30,9,1,890,4,886,1.36%,0.45%
2020-01-01 00:10:30,9,2,2084,37,2047,3.18%,1.78%
2020-01-01 00:10:30,9,3,852,7,845,1.30%,0.82%
2020-01-01 00:10:30,9,4,12199,1072,11127,18.61%,8.79%
2020-01-01 00:10:30,9,5,487,4,483,0.74%,0.82%
2020-01-01 00:10:30,9,6,13571,1325,12246,20.71%,9.76%
2020-01-01 00:10:30,9,7,39007,9656,29351,59.52%,24.75%
2020-01-01 00:10:30,9,8,14561,1480,13081,22.22%,10.16%
2020-01-01 00:10:30,9,9,323,1,322,0.49%,0.31%
2020-01-01 00:10:30,9,10,7942,429,7513,12.12%,5.40%
2020-01-01 00:10:30,9,11,13403,1234,12169,20.45%,9.21%
2020-01-01 00:10:30,9,12,5129,185,4944,7.83%,3.61%
2020-01-01 00:10:30,10,1,1160,276,884,1.77%,23.79%
2020-01-01 00:10:30,10,2,3308,343,2965,5.05%,10.37%
2020-01-01 00:10:30,10,3,1617,26,1591,2.47%,1.61%
2020-01-01 00:10:30,10,4,4139,807,3332,6.32%,19.50%
2020-01-01 00:10:30,10,5,751,31,720,1.15%,4.13%
2020-01-01 00:10:30,10,6,6051,958,5093,9.23%,15.83%
2020-01-01 00:10:30,10,7,11663,1804,9859,17.80%,15.47%
2020-01-01 00:10:30,10,8,28577,7059,21518,43.61%,24.70%
2020-01-01 00:10:30,10,9,465,2,463,0.71%,0.43%
2020-01-01 00:10:30,10,10,2526,40,2486,3.85%,1.58%
2020-01-01 00:10:30,10,11,12695,1578,11117,19.37%,12.43%
2020-01-01 00:10:30,10,12,9664,1126,8538,14.75%,11.65%
2020-01-01 00:10:30,11,1,2037,32,2005,3.11%,1.57%
2020-01-01 00:10:30,11,2,4056,136,3920,6.19%,3.35%
2020-01-01 00:10:30,11,3,1895,33,1862,2.89%,1.74%
2020-01-01 00:10:30,11,4,4682,194,4488,7.14%,4.14%
2020-01-01 00:10:30,11,5,243,4,239,0.37%,1.65%
2020-01-01 00:10:30,11,6,5682,285,5397,8.67%,5.02%
2020-01-01 00:10:30,11,7,11667,1006,10661,17.80%,8.62%
2020-01-01 00:10:30,11,8,26630,4858,21772,40.63%,18.24%
2020-01-01 00:10:30,11,9,419,2,417,0.64%,0.48%
2020-01-01 00:10:30,11,10,3911,132,3779,5.97%,3.38%
2020-01-01 00:10:30,11,11,10729,894,9835,16.37%,8.33%
2020-01-01 00:10:30,11,12,6428,314,6114,9.81%,4.88%
2020-01-01 00:10:30,12,1,39,0,39,0.06%,0.00%
2020-01-01 00:10:30,12,2,508,183,325,0.78%,36.02%
2020-01-01 00:10:30,12,3,2433,215,2218,3.71%,8.84%
2020-01-01 00:10:30,12,4,2741,57,2684,4.18%,2.08%
2020-01-01 00:10:30,12,5,8470,710,7760,12.92%,8.38%
2020-01-01 00:10:30,12,6,5245,216,5029,8.00%,4.12%
2020-01-01 00:10:30,12,7,2303,31,2272,3.51%,1.35%
2020-01-01 00:10:30,12,8,1507,238,1269,2.30%,15.79%
2020-01-01 00:10:30,12,9,21327,4079,17248,32.54%,19.13%
2020-01-01 00:10:30,12,10,4072,333,3739,6.21%,8.18%
2020-01-01 00:10:30,12,11,1827,244,1583,2.79%,13.36%
2020-01-01 00:10:30,12,12,8211,1142,7069,12.53%,13.91%
2020-01-01 00:10:30,13,1,1713,21,1692,2.61%,1.23%
2020-01-01 00:10:30,13,2,2027,28,1999,3.09%,1.38%
2020-01-01 00:10:30,13,3,457,0,457,0.70%,0.00%
2020-01-01 00:10:30,13,4,4294,520,3774,6.55%,12.11%
2020-01-01 00:10:30,13,5,6305,756,5549,9.62%,11.99%
2020-01-01 00:10:30,13,6,5060,576,4484,7.72%,11.38%
2020-01-01 00:10:30,13,7,4370,143,4227,6.67%,3.27%
2020-01-01 00:10:30,13,8,6674,338,6336,10.18%,5.06%
2020-01-01 00:10:30,13,9,6601,778,5823,10.07%,11.79%
2020-01-01 00:10:30,13,10,25621,5090,20531,39.09%,19.87%
2020-01-01 00:10:30,13,11,16074,2200,13874,24.53%,13.69%
2020-01-01 00:10:30,13,12,8933,1018,7915,13.63%,11.40%
2020-01-01 00:10:30,14,1,338,0,338,0.52%,0.00%
2020-01-01 00:10:30,14,2,1894,25,1869,2.89%,1.32%
2020-01-01 00:10:30,14,3,1349,14,1335,2.06%,1.04%
2020-01-01 00:10:30,14,4,3569,107,3462,5.45%,3.00%
2020-01-01 00:10:30,14,5,1287,18,1269,1.96%,1.40%
2020-01-01 00:10:30,14,6,3863,119,3744,5.89%,3.08%
2020-01-01 00:10:30,14,7,11049,868,10181,16.86%,7.86%
2020-01-01 00:10:30,14,8,12720,1152,11568,19.41%,9.06%
2020-01-01 00:10:30,14,9,1458,20,1438,2.22%,1.37%
2020-01-01 00:10:30,14,10,3832,125,3707,5.85%,3.26%
2020-01-01 00:10:30,14,11,24150,3889,20261,36.85%,16.10%
2020-01-01 00:10:30,14,12,7347,369,6978,11.21%,5.02%
2020-01-01 00:10:30,15,1,474,2,472,0.72%,0.42%
2020-01-01 00:10:30,15,2,149,0,149,0.23%,0.00%
2020-01-01 00:10:30,15,3,6742,313,6429,10.29%,4.64%
2020-01-01 00:10:30,15,4,4669,184,4485,7.12%,3.94%
2020-01-01 00:10:30,15,5,12331,1116,11215,18.82%,9.05%
2020-01-01 00:10:30,15,6,4985,231,4754,7.61%,4.63%
2020-01-01 00:10:30,15,7,3262,88,3174,4.98%,2.70%
2020-01-01 00:10:30,15,8,5333,214,5119,8.14%,4.01%
2020-01-01 00:10:30,15,9,12578,1163,11415,19.19%,9.25%
2020-01-01 00:10:30,15,10,4782,219,4563,7.30%,4.58%
2020-01-01 00:10:30,15,11,10239,786,9453,15.62%,7.68%
2020-01-01 00:10:30,15,12,28300,5699,22601,43.18%,20.14%
2020-01-01 00:10:30,16,1,392,0,392,0.60%,0.00%
2020-01-01 00:10:30,16,2,249,1,248,0.38%,0.40%
2020-01-01 00:10:30,16,3,1064,12,1052,1.62%,1.13%
2020-01-01 00:10:30,16,4,4174,121,4053,6.37%,2.90%
2020-01-01 00:10:30,16,5,7519,434,7085,11.47%,5.77%
2020-01-01 00:10:30,16,6,5018,174,4844,7.66%,3.47%
2020-01-01 00:10:30,16,7,3259,80,3179,4.97%,2.45%
2020-01-01 00:10:30,16,8,6938,384,6554,10.59%,5.53%
2020-01-01 00:10:30,16,9,7943,482,7461,12.12%,6.07%
2020-01-01 00:10:30,16,10,1702,23,1679,2.60%,1.35%
2020-01-01 00:10:30,16,11,8850,598,8252,13.50%,6.76%
2020-01-01 00:10:30,16,12,24446,4080,20366,37.30%,16.69%
2020-01-01 00:10:40,1,1,19773,2723,17050,30.17%,13.77%
2020-01-01 00:10:40,1,2,7353,431,6922,11.22%,5.86%
2020-01-01 00:10:40,1,3,450,0,450,0.69%,0.00%
2020-01-01 00:10:40,1,4,12027,1095,10932,18.35%,9.10%
2020-01-01 00:10:40,1,5,11458,1007,10451,17.48%,8.79%
2020-01-01 00:10:40,1,6,11382,996,10386,17.37%,8.75%
2020-01-01 00:10:40,1,7,6889,373,6516,10.51%,5.41%
2020-01-01 00:10:40,1,8,6097,296,5801,9.30%,4.85%
2020-01-01 00:10:40,1,9,11358,993,10365,17.33%,8.74%
2020-01-01 00:10:40,1,10,5318,222,5096,8.11%,4.17%
2020-01-01 00:10:40,1,11,5368,223,5145,8.19%,4.15%
2020-01-01 00:10:40,1,12,11334,989,10345,17.29%,8.73%
2020-01-01 00:10:40,2,1,1170,12,1158,1.79%,1.03%
2020-01-01 00:10:40,2,2,32419,6717,25702,49.47%,20.72%
2020-01-01 00:10:40,2,3,23619,3672,19947,36.04%,15.55%
2020-01-01 00:10:40,2,4,1079,11,1068,1.65%,1.02%
2020-01-01 00:10:40,2,5,14898,1528,13370,22.73%,10.26%
2020-01-01 00:10:40,2,6,47,0,47,0.07%,0.00%
2020-01-01 00:10:40,2,7,7617,410,7207,11.62%,5.38%
2020-01-01 00:10:40,2,8,6207,277,5930,9.47%,4.46%
2020-01-01 00:10:40,2,9,14833,1517,13316,22.63%,10.23%
2020-01-01 00:10:40,2,10,5500,217,5283,8.39%,3.95%
2020-01-01 00:10:40,2,11,5515,219,5296,8.42%,3.97%
2020-01-01 00:10:40,2,12,14653,1473,13180,22.36%,10.05%
2020-01-01 00:10:40,3,1,1831,26,1805,2.79%,1.42%
2020-01-01 00:10:40,3,2,25259,4290,20969,38.54%,16.98%
2020-01-01 00:10:40,3,3,77182,31802,45380,117.77%,41.20%
2020-01-01 00:10:40,3,4,11687,970,10717,17.83%,8.30%
2020-01-01 00:10:40,3,5,50854,15532,35322,77.60%,30.54%
2020-01-01 00:10:40,3,6,12755,1159,11596,19.46%,9.09%
2020-01-01 00:10:40,3,7,21672,3211,18461,33.07%,14.82%
2020-01-01 00:10:40,3,8,17534,2168,15366,26.75%,12.36%
2020-01-01 00:10:40,3,9,37033,8767,28266,56.51%,23.67%
2020-01-01 00:10:40,3,10,4193,131,4062,6.40%,3.12%
2020-01-01 00:10:40,3,11,1475,12,1463,2.25%,0.81%
2020-01-01 00:10:40,3,12,29135,5573,23562,44.46%,19.13%
2020-01-01 00:10:40,4,1,470,1,469,0.72%,0.21%
2020-01-01 00:10:40,4,2,273,1,272,0.42%,0.37%
2020-01-01 00:10:40,4,3,1044,7,1037,1.59%,0.67%
2020-01-01 00:10:40,4,4,28550,5408,23142,43.56%,18.94%
2020-01-01 00:10:40,4,5,18104,2269,15835,27.62%,12.53%
2020-01-01 00:10:40,4,6,24735,4119,20616,37.74%,16.65%
2020-01-01 00:10:40,4,7,5373,226,5147,8.20%,4.21%
2020-01-01 00:10:40,4,8,2798,75,2723,4.27%,2.68%
2020-01-01 00:10:40,4,9,16050,1823,14227,24.49%,11.36%
2020-01-01 00:10:40,4,10,2063,24,2039,3.15%,1.16%
2020-01-01 00:10:40,4,11,128,0,128,0.20%,0.00%
2020-01-01 00:10:40,4,12,12692,1159,11533,19.37%,9.13%
2020-01-01 00:10:40,5,1,2779,58,2721,4.24%,2.09%
2020-01-01 00:10:40,5,2,603,0,603,0.92%,0.00%
2020-01-01 00:10:40,5,3,1180,10,1170,1.80%,0.85%
2020-01-01 00:10:40,5,4,22339,3532,18807,34.09%,15.81%
2020-01-01 00:10:40,5,5,9510,672,8838,14.51%,7.07%
2020-01-01 00:10:40,5,6,13759,1390,12369,20.99%,10.10%
2020-01-01 00:10:40,5,7,3764,126,3638,5.74%,3.35%
2020-01-01 00:10:40,5,8,2684,50,2634,4.10%,1.86%
2020-01-01 00:10:40,5,9,8225,521,7704,12.55%,6.33%
2020-01-01 00:10:40,5,10,1127,11,1116,1.72%,0.98%
2020-01-01 00:10:40,5,11,784,8,776,1.20%,1.02%
2020-01-01 00:10:40,5,12,6903,373,6530,10.53%,5.40%
2020-01-01 00:10:40,6,1,1175,8,1167,1.79%,0.68%
2020-01-01 00:10:40,6,2,1237,9,1228,1.89%,0.73%
2020-01-01 00:10:40,6,3,1730,20,1710,2.64%,1.16%
2020-01-01 00:10:40,6,4,1168,14,1154,1.78%,1.20%
2020-01-01 00:10:40,6,5,14971,1554,13417,22.84%,10.38%
2020-01-01 00:10:40,6,6,5261,238,5023,8.03%,4.52%
2020-01-01 00:10:40,6,7,3537,98,3439,5.40%,2.77%
2020-01-01 00:10:40,6,8,2320,66,2254,3.54%,2.84%
2020-01-01 00:10:40,6,9,7627,397,7230,11.64%,5.21%
2020-01-01 00:10:40,6,10,2472,46,2426,3.77%,1.86%
2020-01-01 00:10:40,6,11,463,3,460,0.71%,0.65%
2020-01-01 00:10:40,6,12,5072,183,4889,7.74%,3.61%
2020-01-01 00:10:40,7,1,384,1,383,0.59%,0.26%
2020-01-01 00:10:40,7,2,234,0,234,0.36%,0.00%
2020-01-01 00:10:40,7,3,612,5,607,0.93%,0.82%
2020-01-01 00:10:40,7,4,1304,17,1287,1.99%,1.30%
2020-01-01 00:10:40,7,5,7812,414,7398,11.92%,5.30%
2020-01-01 00:10:40,7,6,12488,1125,11363,19.06%,9.01%
2020-01-01 00:10:40,7,7,3332,82,3250,5.08%,2.46%
2020-01-01 00:10:40,7,8,1387,14,1373,2.12%,1.01%
2020-01-01 00:10:40,7,9,7174,348,6826,10.95%,4.85%
2020-01-01 00:10:40,7,10,1289,7,1282,1.97%,0.54%
2020-01-01 00:10:40,7,11,83,0,83,0.13%,0.00%
2020-01-01 00:10:40,7,12,5847,215,5632,8.92%,3.68%
2020-01-01 00:10:40,8,1,316,0,316,0.48%,0.00%
2020-01-01 00:10:40,8,2,64,0,64,0.10%,0.00%
2020-01-01 00:10:40,8,3,1470,26,1444,2.24%,1.77%
2020-01-01 00:10:40,8,4,2604,47,2557,3.97%,1.80%
2020-01-01 00:10:40,8,5,7359,384,6975,11.23%,5.22%
2020-01-01 00:10:40,8,6,14939,1534,13405,22.80%,10.27%
2020-01-01 00:10:40,8,7,4891,192,4699,7.46%,3.93%
2020-01-01 00:10:40,8,8,2049,39,2010,3.13%,1.90%
2020-01-01 00:10:40,8,9,5536,202,5334,8.45%,3.65%
2020-01-01 00:10:40,8,10,1452,18,1434,2.22%,1.24%
2020-01-01 00:10:40,8,11,169,0,169,0.26%,0.00%
2020-01-01 00:10:40,8,12,4025,113,3912,6.14%,2.81%
2020-01-01 00:10:40,9,1,474,1,473,0.72%,0.21%
2020-01-01 00:10:40,9,2,2562,55,2507,3.91%,2.15%
2020-01-01 00:10:40,9,3,1626,16,1610,2.48%,0.98%
2020-01-01 00:10:40,9,4,7917,484,7433,12.08%,6.11%
2020-01-01 00:10:40,9,5,273,0,273,0.42%,0.00%
2020-01-01 00:10:40,9,6,8739,598,8141,13.33%,6.84%
2020-01-01 00:10:40,9,7,28590,5366,23224,43.62%,18.77%
2020-01-01 00:10:40,9,8,9557,654,8903,14.58%,6.84%
2020-01-01 00:10:40,9,9,244,0,244,0.37%,0.00%
2020-01-01 00:10:40,9,10,2483,43,2440,3.79%,1.73%
2020-01-01 00:10:40,9,11,8109,483,7626,12.37%,5.96%
2020-01-01 00:10:40,9,12,5427,218,5209,8.28%,4.02%
2020-01-01 00:10:40,10,1,1065,178,887,1.63%,16.71%
2020-01-01 00:10:40,10,2,3307,250,3057,5.05%,7.56%
2020-01-01 00:10:40,10,3,1947,36,1911,2.97%,1.85%
2020-01-01 00:10:40,10,4,3986,871,3115,6.08%,21.85%
2020-01-01 00:10:40,10,5,736,1,735,1.12%,0.14%
2020-01-01 00:10:40,10,6,6066,985,5081,9.26%,16.24%
2020-01-01 00:10:40,10,7,11593,1797,9796,17.69%,15.50%
2020-01-01 00:10:40,10,8,29475,7159,22316,44.98%,24.29%
2020-01-01 00:10:40,10,9,735,5,730,1.12%,0.68%
2020-01-01 00:10:40,10,10,2270,42,2228,3.46%,1.85%
2020-01-01 00:10:40,10,11,13576,1657,11919,20.72%,12.21%
2020-01-01 00:10:40,10,12,10323,1148,9175,15.75%,11.12%
2020-01-01 00:10:40,11,1,2138,52,2086,3.26%,2.43%
2020-01-01 00:10:40,11,2,4948,187,4761,7.55%,3.78%
2020-01-01 00:10:40,11,3,2605,40,2565,3.97%,1.54%
2020-01-01 00:10:40,11,4,4445,141,4304,6.78%,3.17%
2020-01-01 00:10:40,11,5,144,0,144,0.22%,0.00%
2020-01-01 00:10:40,11,6,5137,192,4945,7.84%,3.74%
2020-01-01 00:10:40,11,7,12276,1048,11228,18.73%,8.54%
2020-01-01 00:10:40,11,8,25944,4504,21440,39.59%,17.36%
2020-01-01 00:10:40,11,9,202,2,200,0.31%,0.99%
2020-01-01 00:10:40,11,10,2941,65,2876,4.49%,2.21%
2020-01-01 00:10:40,11,11,9944,718,9226,15.17%,7.22%
2020-01-01 00:10:40,11,12,6545,346,6199,9.99%,5.29%
2020-01-01 00:10:40,12,1,70,0,70,0.11%,0.00%
2020-01-01 00:10:40,12,2,475,169,306,0.72%,35.58%
2020-01-01 00:10:40,12,3,2524,207,2317,3.85%,8.20%
2020-01-01 00:10:40,12,4,2795,68,2727,4.26%,2.43%
2020-01-01 00:10:40,12,5,8688,687,8001,13.26%,7.91%
2020-01-01 00:10:40,12,6,5126,198,4928,7.82%,3.86%
2020-01-01 00:10:40,12,7,2154,39,2115,3.29%,1.81%
2020-01-01 00:10:40,12,8,1300,261,1039,1.98%,20.08%
2020-01-01 00:10:40,12,9,20759,3839,16920,31.68%,18.49%
2020-01-01 00:10:40,12,10,3681,355,3326,5.62%,9.64%
2020-01-01 00:10:40,12,11,1511,265,1246,2.31%,17.54%
2020-01-01 00:10:40,12,12,7908,1033,6875,12.07%,13.06%
2020-01-01 00:10:40,13,1,2416,59,2357,3.69%,2.44%
2020-01-01 00:10:40,13,2,2711,68,2643,4.14%,2.51%
2020-01-01 00:10:40,13,3,512,3,509,0.78%,0.59%
2020-01-01 00:10:40,13,4,4520,550,3970,6.90%,12.17%
2020-01-01 00:10:40,13,5,6508,750,5758,9.93%,11.52%
2020-01-01 00:10:40,13,6,5320,599,4721,8.12%,11.26%
2020-01-01 00:10:40,13,7,5092,215,4877,7.77%,4.22%
2020-01-01 00:10:40,13,8,7105,379,6726,10.84%,5.33%
2020-01-01 00:10:40,13,9,6903,779,6124,10.53%,11.28%
2020-01-01 00:10:40,13,10,25779,4969,20810,39.34%,19.28%
2020-01-01 00:10:40,13,11,15891,2032,13859,24.25%,12.79%
2020-01-01 00:10:40,13,12,8251,850,7401,12.59%,10.30%
2020-01-01 00:10:40,14,1,234,1,233,0.36%,0.43%
2020-01-01 00:10:40,14,2,1454,12,1442,2.22%,0.83%
2020-01-01 00:10:40,14,3,1053,7,1046,1.61%,0.66%
2020-01-01 00:10:40,14,4,4503,161,4342,6.87%,3.58%
2020-01-01 00:10:40,14,5,1253,13,1240,1.91%,1.04%
2020-01-01 00:10:40,14,6,4736,178,4558,7.23%,3.76%
2020-01-01 00:10:40,14,7,13093,1262,11831,19.98%,9.64%
2020-01-01 00:10:40,14,8,14838,1596,13242,22.64%,10.76%
2020-01-01 00:10:40,14,9,1424,13,1411,2.17%,0.91%
2020-01-01 00:10:40,14,10,4459,173,4286,6.80%,3.88%
2020-01-01 00:10:40,14,11,26581,4763,21818,40.56%,17.92%
2020-01-01 00:10:40,14,12,7121,388,6733,10.87%,5.45%
2020-01-01 00:10:40,15,1,610,2,608,0.93%,0.33%
2020-01-01 00:10:40,15,2,170,0,170,0.26%,0.00%
2020-01-01 00:10:40,15,3,4104,159,3945,6.26%,3.87%
2020-01-01 00:10:40,15,4,4927,174,4753,7.52%,3.53%
2020-01-01 00:10:40,15,5,9688,721,8967,14.78%,7.44%
2020-01-01 00:10:40,15,6,5164,196,4968,7.88%,3.80%
2020-01-01 00:10:40,15,7,3574,126,3448,5.45%,3.53%
2020-01-01 00:10:40,15,8,5796,324,5472,8.84%,5.59%
2020-01-01 00:10:40,15,9,9948,757,9191,15.18%,7.61%
2020-01-01 00:10:40,15,10,4559,173,4386,6.96%,3.79%
2020-01-01 00:10:40,15,11,10498,881,9617,16.02%,8.39%
2020-01-01 00:10:40,15,12,25717,4801,20916,39.24%,18.67%
2020-01-01 00:10:40,16,1,355,0,355,0.54%,0.00%
2020-01-01 00:10:40,16,2,186,0,186,0.28%,0.00%
2020-01-01 00:10:40,16,3,1190,11,1179,1.82%,0.92%
2020-01-01 00:10:40,16,4,4024,126,3898,6.14%,3.13%
2020-01-01 00:10:40,16,5,7266,414,6852,11.09%,5.70%
2020-01-01 00:10:40,16,6,4744,172,4572,7.24%,3.63%
2020-01-01 00:10:40,16,7,3418,87,3331,5.22%,2.55%
2020-01-01 00:10:40,16,8,7384,545,6839,11.27%,7.38%
2020-01-01 00:10:40,16,9,7647,458,7189,11.67%,5.99%
2020-01-01 00:10:40,16,10,1560,20,1540,2.38%,1.28%
2020-01-01 00:10:40,16,11,9232,770,8462,14.09%,8.34%
2020-01-01 00:10:40,16,12,24437,4173,20264,37.29%,17.08%
2020-01-01 00:10:50,1,1,19550,2667,16883,29.83%,13.64%
2020-01-01 00:10:50,1,2,6986,356,6630,10.66%,5.10%
2020-01-01 00:10:50,1,3,768,3,765,1.17%,0.39%
2020-01-01 00:10:50,1,4,12189,1099,11090,18.60%,9.02%
2020-01-01 00:10:50,1,5,11994,1055,10939,18.30%,8.80%
2020-01-01 00:10:50,1,6,11855,1038,10817,18.09%,8.76%
2020-01-01 00:10:50,1,7,6207,287,5920,9.47%,4.62%
2020-01-01 00:10:50,1,8,4704,154,4550,7.18%,3.27%
2020-01-01 00:10:50,1,9,11825,1031,10794,18.04%,8.72%
2020-01-01 00:10:50,1,10,4072,118,3954,6.21%,2.90%
2020-01-01 00:10:50,1,11,4171,124,4047,6.36%,2.97%
2020-01-01 00:10:50,1,12,11807,1029,10778,18.02%,8.72%
2020-01-01 00:10:50,2,1,1065,7,1058,1.63%,0.66%
2020-01-01 00:10:50,2,2,26016,4650,21366,39.70%,17.87%
2020-01-01 00:10:50,2,3,20412,2974,17438,31.15%,14.57%
2020-01-01 00:10:50,2,4,1017,6,1011,1.55%,0.59%
2020-01-01 00:10:50,2,5,13881,1397,12484,21.18%,10.06%
2020-01-01 00:10:50,2,6,23,0,23,0.04%,0.00%
2020-01-01 00:10:50,2,7,4513,161,4352,6.89%,3.57%
2020-01-01 00:10:50,2,8,3265,76,3189,4.98%,2.33%
2020-01-01 00:10:50,2,9,13750,1368,12382,20.98%,9.95%
2020-01-01 00:10:50,2,10,2664,49,2615,4.06%,1.84%
2020-01-01 00:10:50,2,11,2670,49,2621,4.07%,1.84%
2020-01-01 00:10:50,2,12,13571,1342,12229,20.71%,9.89%
2020-01-01 00:10:50,3,1,2028,26,2002,3.09%,1.28%
2020-01-01 00:10:50,3,2,22124,3386,18738,33.76%,15.30%
2020-01-01 00:10:50,3,3,69809,26897,42912,106.52%,38.53%
2020-01-01 00:10:50,3,4,9963,742,9221,15.20%,7.45%
2020-01-01 00:10:50,3,5,46694,13282,33412,71.25%,28.44%
2020-01-01 00:10:50,3,6,11211,928,10283,17.11%,8.28%
2020-01-01 00:10:50,3,7,18473,2419,16054,28.19%,13.09%
2020-01-01 00:10:50,3,8,15267,1684,13583,23.30%,11.03%
2020-01-01 00:10:50,3,9,35008,7841,27167,53.42%,22.40%
2020-01-01 00:10:50,3,10,6748,333,6415,10.30%,4.93%
2020-01-01 00:10:50,3,11,1450,17,1433,2.21%,1.17%
2020-01-01 00:10:50,3,12,26672,4693,21979,40.70%,17.60%
2020-01-01 00:10:50,4,1,494,5,489,0.75%,1.01%
2020-01-01 00:10:50,4,2,307,4,303,0.47%,1.30%
2020-01-01 00:10:50,4,3,1001,7,994,1.53%,0.70%
2020-01-01 00:10:50,4,4,27508,5030,22478,41.97%,18.29%
2020-01-01 00:10:50,4,5,17779,2230,15549,27.13%,12.54%
2020-01-01 00:10:50,4,6,24100,3918,20182,36.77%,16.26%
2020-01-01 00:10:50,4,7,5086,176,4910,7.76%,3.46%
2020-01-01 00:10:50,4,8,2953,71,2882,4.51%,2.40%
2020-01-01 00:10:50,4,9,15643,1704,13939,23.87%,10.89%
2020-01-01 00:10:50,4,10,1776,27,1749,2.71%,1.52%
2020-01-01 00:10:50,4,11,169,0,169,0.26%,0.00%
2020-01-01 00:10:50,4,12,12959,1196,11763,19.77%,9.23%
2020-01-01 00:10:50,5,1,2947,59,2888,4.50%,2.00%
2020-01-01 00:10:50,5,2,940,5,935,1.43%,0.53%
2020-01-01 00:10:50,5,3,1103,12,1091,1.68%,1.09%
2020-01-01 00:10:50,5,4,26947,4802,22145,41.12%,17.82%
2020-01-01 00:10:50,5,5,11292,938,10354,17.23%,8.31%
2020-01-01 00:10:50,5,6,17079,2068,15011,26.06%,12.11%
2020-01-01 00:10:50,5,7,5271,232,5039,8.04%,4.40%
2020-01-01 00:10:50,5,8,3537,112,3425,5.40%,3.17%
2020-01-01 00:10:50,5,9,10026,738,9288,15.30%,7.36%
2020-01-01 00:10:50,5,10,1530,19,1511,2.33%,1.24%
2020-01-01 00:10:50,5,11,950,6,944,1.45%,0.63%
2020-01-01 00:10:50,5,12,8003,475,7528,12.21%,5.94%
2020-01-01 00:10:50,6,1,1067,17,1050,1.63%,1.59%
2020-01-01 00:10:50,6,2,1193,24,1169,1.82%,2.01%
2020-01-01 00:10:50,6,3,1433,27,1406,2.19%,1.88%
2020-01-01 00:10:50,6,4,1503,17,1486,2.29%,1.13%
2020-01-01 00:10:50,6,5,16517,1905,14612,25.20%,11.53%
2020-01-01 00:10:50,6,6,5722,284,5438,8.73%,4.96%
2020-01-01 00:10:50,6,7,3637,131,3506,5.55%,3.60%
2020-01-01 00:10:50,6,8,3003,88,2915,4.58%,2.93%
2020-01-01 00:10:50,6,9,9063,588,8475,13.83%,6.49%
2020-01-01 00:10:50,6,10,2278,34,2244,3.48%,1.49%
2020-01-01 00:10:50,6,11,434,0,434,0.66%,0.00%
2020-01-01 00:10:50,6,12,6726,337,6389,10.26%,5.01%
2020-01-01 00:10:50,7,1,418,4,414,0.64%,0.96%
2020-01-01 00:10:50,7,2,195,0,195,0.30%,0.00%
2020-01-01 00:10:50,7,3,1315,11,1304,2.01%,0.84%
2020-01-01 00:10:50,7,4,2047,31,2016,3.12%,1.51%
2020-01-01 00:10:50,7,5,7407,371,7036,11.30%,5.01%
2020-01-01 00:10:50,7,6,13361,1230,12131,20.39%,9.21%
2020-01-01 00:10:50,7,7,3856,132,3724,5.88%,3.42%
2020-01-01 00:10:50,7,8,1342,14,1328,2.05%,1.04%
2020-01-01 00:10:50,7,9,6015,255,5760,9.18%,4.24%
2020-01-01 00:10:50,7,10,1500,15,1485,2.29%,1.00%
2020-01-01 00:10:50,7,11,76,0,76,0.12%,0.00%
2020-01-01 00:10:50,7,12,4526,148,4378,6.91%,3.27%
2020-01-01 00:10:50,8,1,272,0,272,0.42%,0.00%
2020-01-01 00:10:50,8,2,95,0,95,0.14%,0.00%
2020-01-01 00:10:50,8,3,1362,15,1347,2.08%,1.10%
2020-01-01 00:10:50,8,4,2886,65,2821,4.40%,2.25%
2020-01-01 00:10:50,8,5,7821,446,7375,11.93%,5.70%
2020-01-01 00:10:50,8,6,15833,1837,13996,24.16%,11.60%
2020-01-01 00:10:50,8,7,5003,212,4791,7.63%,4.24%
2020-01-01 00:10:50,8,8,1918,38,1880,2.93%,1.98%
2020-01-01 00:10:50,8,9,6043,287,5756,9.22%,4.75%
2020-01-01 00:10:50,8,10,1865,25,1840,2.85%,1.34%
2020-01-01 00:10:50,8,11,356,1,355,0.54%,0.28%
2020-01-01 00:10:50,8,12,4103,130,3973,6.26%,3.17%
2020-01-01 00:10:50,9,1,791,6,785,1.21%,0.76%
2020-01-01 00:10:50,9,2,2986,75,2911,4.56%,2.51%
2020-01-01 00:10:50,9,3,1675,24,1651,2.56%,1.43%
2020-01-01 00:10:50,9,4,6396,261,6135,9.76%,4.08%
2020-01-01 00:10:50,9,5,196,1,195,0.30%,0.51%
2020-01-01 00:10:50,9,6,6987,318,6669,10.66%,4.55%
2020-01-01 00:10:50,9,7,28114,5165,22949,42.90%,18.37%
2020-01-01 00:10:50,9,8,9653,673,8980,14.73%,6.97%
2020-01-01 00:10:50,9,9,170,1,169,0.26%,0.59%
2020-01-01 00:10:50,9,10,2921,57,2864,4.46%,1.95%
2020-01-01 00:10:50,9,11,8846,560,8286,13.50%,6.33%
2020-01-01 00:10:50,9,12,5625,235,5390,8.58%,4.18%
2020-01-01 00:10:50,10,1,1579,353,1226,2.41%,22.36%
2020-01-01 00:10:50,10,2,3333,415,2918,5.09%,12.45%
2020-01-01 00:10:50,10,3,1578,23,1555,2.41%,1.46%
2020-01-01 00:10:50,10,4,4032,978,3054,6.15%,24.26%
2020-01-01 00:10:50,10,5,867,7,860,1.32%,0.81%
2020-01-01 00:10:50,10,6,6201,1108,5093,9.46%,17.87%
2020-01-01 00:10:50,10,7,11413,2035,9378,17.41%,17.83%
2020-01-01 00:10:50,10,8,29632,7300,22332,45.21%,24.64%
2020-01-01 00:10:50,10,9,957,3,954,1.46%,0.31%
2020-01-01 00:10:50,10,10,2640,46,2594,4.03%,1.74%
2020-01-01 00:10:50,10,11,13375,1662,11713,20.41%,12.43%
2020-01-01 00:10:50,10,12,10257,1158,9099,15.65%,11.29%
2020-01-01 00:10:50,11,1,2274,39,2235,3.47%,1.72%
2020-01-01 00:10:50,11,2,3629,108,3521,5.54%,2.98%
2020-01-01 00:10:50,11,3,1220,9,1211,1.86%,0.74%
2020-01-01 00:10:50,11,4,4802,168,4634,7.33%,3.50%
2020-01-01 00:10:50,11,5,287,2,285,0.44%,0.70%
2020-01-01 00:10:50,11,6,5809,247,5562,8.86%,4.25%
2020-01-01 00:10:50,11,7,11515,938,10577,17.57%,8.15%
2020-01-01 00:10:50,11,8,25717,4502,21215,39.24%,17.51%
2020-01-01 00:10:50,11,9,190,0,190,0.29%,0.00%
2020-01-01 00:10:50,11,10,3200,102,3098,4.88%,3.19%
2020-01-01 00:10:50,11,11,9987,735,9252,15.24%,7.36%
2020-01-01 00:10:50,11,12,6505,326,6179,9.93%,5.01%
2020-01-01 00:10:50,12,1,107,0,107,0.16%,0.00%
2020-01-01 00:10:50,12,2,783,257,526,1.19%,32.82%
2020-01-01 00:10:50,12,3,3442,324,3118,5.25%,9.41%
2020-01-01 00:10:50,12,4,3253,89,3164,4.96%,2.74%
2020-01-01 00:10:50,12,5,10028,975,9053,15.30%,9.72%
2020-01-01 00:10:50,12,6,5860,332,5528,8.94%,5.67%
2020-01-01 00:10:50,12,7,2460,60,2400,3.75%,2.44%
2020-01-01 00:10:50,12,8,1186,248,938,1.81%,20.91%
2020-01-01 00:10:50,12,9,22196,4457,17739,33.87%,20.08%
2020-01-01 00:10:50,12,10,3857,348,3509,5.89%,9.02%
2020-01-01 00:10:50,12,11,1497,253,1244,2.28%,16.90%
2020-01-01 00:10:50,12,12,7331,1030,6301,11.19%,14.05%
2020-01-01 00:10:50,13,1,2294,40,2254,3.50%,1.74%
2020-01-01 00:10:50,13,2,2758,58,2700,4.21%,2.10%
2020-01-01 00:10:50,13,3,890,5,885,1.36%,0.56%
2020-01-01 00:10:50,13,4,4735,536,4199,7.23%,11.32%
2020-01-01 00:10:50,13,5,7531,911,6620,11.49%,12.10%
2020-01-01 00:10:50,13,6,5914,622,5292,9.02%,10.52%
2020-01-01 00:10:50,13,7,5231,212,5019,7.98%,4.05%
2020-01-01 00:10:50,13,8,6953,364,6589,10.61%,5.24%
2020-01-01 00:10:50,13,9,7763,946,6817,11.85%,12.19%
2020-01-01 00:10:50,13,10,29702,6365,23337,45.32%,21.43%
2020-01-01 00:10:50,13,11,18657,2714,15943,28.47%,14.55%
2020-01-01 00:10:50,13,12,11243,1257,9986,17.16%,11.18%
2020-01-01 00:10:50,14,1,502,2,500,0.77%,0.40%
2020-01-01 00:10:50,14,2,1775,25,1750,2.71%,1.41%
2020-01-01 00:10:50,14,3,1116,12,1104,1.70%,1.08%
2020-01-01 00:10:50,14,4,4883,180,4703,7.45%,3.69%
2020-01-01 00:10:50,14,5,1168,9,1159,1.78%,0.77%
2020-01-01 00:10:50,14,6,5415,221,5194,8.26%,4.08%
2020-01-01 00:10:50,14,7,12944,1184,11760,19.75%,9.15%
2020-01-01 00:10:50,14,8,14502,1492,13010,22.13%,10.29%
2020-01-01 00:10:50,14,9,1391,13,1378,2.12%,0.93%
2020-01-01 00:10:50,14,10,4065,118,3947,6.20%,2.90%
2020-01-01 00:10:50,14,11,25460,4400,21060,38.85%,17.28%
2020-01-01 00:10:50,14,12,6655,317,6338,10.15%,4.76%
2020-01-01 00:10:50,15,1,440,1,439,0.67%,0.23%
2020-01-01 00:10:50,15,2,170,0,170,0.26%,0.00%
2020-01-01 00:10:50,15,3,3762,114,3648,5.74%,3.03%
2020-01-01 00:10:50,15,4,6145,253,5892,9.38%,4.12%
2020-01-01 00:10:50,15,5,10686,841,9845,16.31%,7.87%
2020-01-01 00:10:50,15,6,6347,280,6067,9.68%,4.41%
2020-01-01 00:10:50,15,7,3506,86,3420,5.35%,2.45%
2020-01-01 00:10:50,15,8,5275,208,5067,8.05%,3.94%
2020-01-01 00:10:50,15,9,10854,869,9985,16.56%,8.01%
2020-01-01 00:10:50,15,10,4083,127,3956,6.23%,3.11%
2020-01-01 00:10:50,15,11,9549,655,8894,14.57%,6.86%
2020-01-01 00:10:50,15,12,25760,4805,20955,39.31%,18.65%
2020-01-01 00:10:50,16,1,417,3,414,0.64%,0.72%
2020-01-01 00:10:50,16,2,264,0,264,0.40%,0.00%
2020-01-01 00:10:50,16,3,1551,30,1521,2.37%,1.93%
2020-01-01 00:10:50,16,4,4189,179,4010,6.39%,4.27%
2020-01-01 00:10:50,16,5,8051,602,7449,12.28%,7.48%
2020-01-01 00:10:50,16,6,5082,237,4845,7.75%,4.66%
2020-01-01 00:10:50,16,7,3125,77,3048,4.77%,2.46%
2020-01-01 00:10:50,16,8,8963,560,8403,13.68%,6.25%
2020-01-01 00:10:50,16,9,8473,645,7828,12.93%,7.61%
2020-01-01 00:10:50,16,10,1435,29,1406,2.19%,2.02%
2020-01-01 00:10:50,16,11,10761,823,9938,16.42%,7.65%
2020-01-01 00:10:50,16,12,27809,5270,22539,42.43%,18.95%
2020-01-01 00:11:00,1,1,25728,4580,21148,39.26%,17.80%
2020-01-01 00:11:00,1,2,5111,223,4888,7.80%,4.36%
2020-01-01 00:11:00,1,3,665,2,663,1.01%,0.30%
2020-01-01 00:11:00,1,4,20239,2882,17357,30.88%,14.24%
2020-01-01 00:11:00,1,5,20084,2836,17248,30.65%,14.12%
2020-01-01 00:11:00,1,6,19968,2813,17155,30.47%,14.09%
2020-01-01 00:11:00,1,7,4433,176,4257,6.76%,3.97%
2020-01-01 00:11:00,1,8,3255,90,3165,4.97%,2.76%
2020-01-01 00:11:00,1,9,19951,2807,17144,30.44%,14.07%
2020-01-01 00:11:00,1,10,2727,66,2661,4.16%,2.42%
2020-01-01 00:11:00,1,11,2794,72,2722,4.26%,2.58%
2020-01-01 00:11:00,1,12,19924,2800,17124,30.40%,14.05%
2020-01-01 00:11:00,2,1,625,2,623,0.95%,0.32%
2020-01-01 00:11:00,2,2,31333,6447,24886,47.81%,20.58%
2020-01-01 00:11:00,2,3,25647,4425,21222,39.13%,17.25%
2020-01-01 00:11:00,2,4,571,2,569,0.87%,0.35%
2020-01-01 00:11:00,2,5,18051,2301,15750,27.54%,12.75%
2020-01-01 00:11:00,2,6,41,0,41,0.06%,0.00%
2020-01-01 00:11:00,2,7,5049,196,4853,7.70%,3.88%
2020-01-01 00:11:00,2,8,3680,104,3576,5.62%,2.83%
2020-01-01 00:11:00,2,9,17947,2278,15669,27.38%,12.69%
2020-01-01 00:11:00,2,10,2991,72,2919,4.56%,2.41%
2020-01-01 00:11:00,2,11,2994,72,2922,4.57%,2.40%
2020-01-01 00:11:00,2,12,17760,2230,15530,27.10%,12.56%
2020-01-01 00:11:00,3,1,1718,24,1694,2.62%,1.40%
2020-01-01 00:11:00,3,2,24219,3927,20292,36.96%,16.21%
2020-01-01 00:11:00,3,3,76744,31542,45202,117.10%,41.10%
2020-01-01 00:11:00,3,4,9865,687,9178,15.05%,6.96%
2020-01-01 00:11:00,3,5,51537,15981,35556,78.64%,31.01%
2020-01-01 00:11:00,3,6,11522,946,10576,17.58%,8.21%
2020-01-01 00:11:00,3,7,20973,2999,17974,32.00%,14.30%
2020-01-01 00:11:00,3,8,16044,1735,14309,24.48%,10.81%
2020-01-01 00:11:00,3,9,39656,10048,29608,60.51%,25.34%
2020-01-01 00:11:00,3,10,4358,139,4219,6.65%,3.19%
2020-01-01 00:11:00,3,11,1820,26,1794,2.78%,1.43%
2020-01-01 00:11:00,3,12,31394,6534,24860,47.90%,20.81%
2020-01-01 00:11:00,4,1,432,0,432,0.66%,0.00%
2020-01-01 00:11:00,4,2,212,0,212,0.32%,0.00%
2020-01-01 00:11:00,4,3,835,6,829,1.27%,0.72%
2020-01-01 00:11:00,4,4,28433,5251,23182,43.39%,18.47%
2020-01-01 00:11:00,4,5,17619,2197,15422,26.88%,12.47%
2020-01-01 00:11:00,4,6,24651,4013,20638,37.61%,16.28%
2020-01-01 00:11:00,4,7,5752,238,5514,8.78%,4.14%
2020-01-01 00:11:00,4,8,2754,64,2690,4.20%,2.32%
2020-01-01 00:11:00,4,9,15568,1760,13808,23.75%,11.31%
2020-01-01 00:11:00,4,10,1832,27,1805,2.80%,1.47%
2020-01-01 00:11:00,4,11,135,0,135,0.21%,0.00%
2020-01-01 00:11:00,4,12,12848,1227,11621,19.60%,9.55%
2020-01-01 00:11:00,5,1,2787,56,2731,4.25%,2.01%
2020-01-01 00:11:00,5,2,677,4,673,1.03%,0.59%
2020-01-01 00:11:00,5,3,639,2,637,0.98%,0.31%
2020-01-01 00:11:00,5,4,25489,4495,20994,38.89%,17.64%
2020-01-01 00:11:00,5,5,10276,761,9515,15.68%,7.41%
2020-01-01 00:11:00,5,6,17328,2132,15196,26.44%,12.30%
2020-01-01 00:11:00,5,7,6540,311,6229,9.98%,4.76%
2020-01-01 00:11:00,5,8,5505,231,5274,8.40%,4.20%
2020-01-01 00:11:00,5,9,9550,653,8897,14.57%,6.84%
2020-01-01 00:11:00,5,10,1115,11,1104,1.70%,0.99%
2020-01-01 00:11:00,5,11,846,6,840,1.29%,0.71%
2020-01-01 00:11:00,5,12,8073,478,7595,12.32%,5.92%
2020-01-01 00:11:00,6,1,1065,8,1057,1.63%,0.75%
2020-01-01 00:11:00,6,2,1157,12,1145,1.77%,1.04%
2020-01-01 00:11:00,6,3,1567,22,1545,2.39%,1.40%
2020-01-01 00:11:00,6,4,1002,7,995,1.53%,0.70%
2020-01-01 00:11:00,6,5,13281,1255,12026,20.27%,9.45%
2020-01-01 00:11:00,6,6,3553,100,3453,5.42%,2.81%
2020-01-01 00:11:00,6,7,2176,48,2128,3.32%,2.21%
2020-01-01 00:11:00,6,8,1620,34,1586,2.47%,2.10%
2020-01-01 00:11:00,6,9,7707,418,7289,11.76%,5.42%
2020-01-01 00:11:00,6,10,2332,32,2300,3.56%,1.37%
2020-01-01 00:11:00,6,11,373,0,373,0.57%,0.00%
2020-01-01 00:11:00,6,12,5330,208,5122,8.13%,3.90%
2020-01-01 00:11:00,7,1,410,0,410,0.63%,0.00%
2020-01-01 00:11:00,7,2,183,0,183,0.28%,0.00%
2020-01-01 00:11:00,7,3,928,8,920,1.42%,0.86%
2020-01-01 00:11:00,7,4,1170,11,1159,1.79%,0.94%
2020-01-01 00:11:00,7,5,7371,401,6970,11.25%,5.44%
2020-01-01 00:11:00,7,6,11844,976,10868,18.07%,8.24%
2020-01-01 00:11:00,7,7,3261,80,3181,4.98%,2.45%
2020-01-01 00:11:00,7,8,1142,15,1127,1.74%,1.31%
2020-01-01 00:11:00,7,9,6363,303,6060,9.71%,4.76%
2020-01-01 00:11:00,7,10,1274,16,1258,1.94%,1.26%
2020-01-01 00:11:00,7,11,76,1,75,0.12%,1.32%
2020-01-01 00:11:00,7,12,5129,187,4942,7.83%,3.65%
2020-01-01 00:11:00,8,1,311,0,311,0.47%,0.00%
2020-01-01 00:11:00,8,2,110,0,110,0.17%,0.00%
2020-01-01 00:11:00,8,3,1135,15,1120,1.73%,1.32%
2020-01-01 00:11:00,8,4,3239,89,3150,4.94%,2.75%
2020-01-01 00:11:00,8,5,7547,421,7126,11.52%,5.58%
2020-01-01 00:11:00,8,6,15465,1694,13771,23.60%,10.95%
2020-01-01 00:11:00,8,7,4599,171,4428,7.02%,3.72%
2020-01-01 00:11:00,8,8,1526,22,1504,2.33%,1.44%
2020-01-01 00:11:00,8,9,6073,282,5791,9.27%,4.64%
2020-01-01 00:11:00,8,10,1818,28,1790,2.77%,1.54%
2020-01-01 00:11:00,8,11,200,0,200,0.31%,0.00%
2020-01-01 00:11:00,8,12,4199,143,4056,6.41%,3.41%
2020-01-01 00:11:00,9,1,1768,2,1766,2.70%,0.11%
2020-01-01 00:11:00,9,2,6279,270,6009,9.58%,4.30%
2020-01-01 00:11:00,9,3,4184,143,4041,6.38%,3.42%
2020-01-01 00:11:00,9,4,3379,109,3270,5.16%,3.23%
2020-01-01 00:11:00,9,5,279,1,278,0.43%,0.36%
2020-01-01 00:11:00,9,6,4226,152,4074,6.45%,3.60%
2020-01-01 00:11:00,9,7,25238,4284,20954,38.51%,16.97%
2020-01-01 00:11:00,9,8,9423,642,8781,14.38%,6.81%
2020-01-01 00:11:00,9,9,188,0,188,0.29%,0.00%
2020-01-01 00:11:00,9,10,3258,79,3179,4.97%,2.42%
2020-01-01 00:11:00,9,11,8269,518,7751,12.62%,6.26%
2020-01-01 00:11:00,9,12,4640,168,4472,7.08%,3.62%
2020-01-01 00:11:00,10,1,1050,213,837,1.60%,20.29%
2020-01-01 00:11:00,10,2,2521,249,2272,3.85%,9.88%
2020-01-01 00:11:00,10,3,1288,14,1274,1.97%,1.09%
2020-01-01 00:11:00,10,4,3931,710,3221,6.00%,18.06%
2020-01-01 00:11:00,10,5,584,2,582,0.89%,0.34%
2020-01-01 00:11:00,10,6,5501,787,4714,8.39%,14.31%
2020-01-01 00:11:00,10,7,10762,1535,9227,16.42%,14.26%
2020-01-01 00:11:00,10,8,27996,6728,21268,42.72%,24.03%
2020-01-01 00:11:00,10,9,700,4,696,1.07%,0.57%
2020-01-01 00:11:00,10,10,2629,67,2562,4.01%,2.55%
2020-01-01 00:11:00,10,11,12809,1717,11092,19.54%,13.40%
2020-01-01 00:11:00,10,12,9657,1205,8452,14.74%,12.48%
2020-01-01 00:11:00,11,1,2062,32,2030,3.15%,1.55%
2020-01-01 00:11:00,11,2,3884,118,3766,5.93%,3.04%
2020-01-01 00:11:00,11,3,1659,20,1639,2.53%,1.21%
2020-01-01 00:11:00,11,4,3399,77,3322,5.19%,2.27%
2020-01-01 00:11:00,11,5,193,1,192,0.29%,0.52%
2020-01-01 00:11:00,11,6,4248,119,4129,6.48%,2.80%
2020-01-01 00:11:00,11,7,10079,720,9359,15.38%,7.14%
2020-01-01 00:11:00,11,8,22543,3470,19073,34.40%,15.39%
2020-01-01 00:11:00,11,9,352,2,350,0.54%,0.57%
2020-01-01 00:11:00,11,10,2965,81,2884,4.52%,2.73%
2020-01-01 00:11:00,11,11,9444,688,8756,14.41%,7.29%
2020-01-01 00:11:00,11,12,6318,302,6016,9.64%,4.78%
2020-01-01 00:11:00,12,1,86,0,86,0.13%,0.00%
2020-01-01 00:11:00,12,2,675,223,452,1.03%,33.04%
2020-01-01 00:11:00,12,3,3006,274,2732,4.59%,9.12%
2020-01-01 00:11:00,12,4,2693,48,2645,4.11%,1.78%
2020-01-01 00:11:00,12,5,9434,808,8626,14.40%,8.56%
2020-01-01 00:11:00,12,6,5787,213,5574,8.83%,3.68%
2020-01-01 00:11:00,12,7,2987,68,2919,4.56%,2.28%
2020-01-01 00:11:00,12,8,1583,316,1267,2.42%,19.96%
2020-01-01 00:11:00,12,9,22018,4475,17543,33.60%,20.32%
2020-01-01 00:11:00,12,10,4004,405,3599,6.11%,10.11%
2020-01-01 00:11:00,12,11,1797,317,1480,2.74%,17.64%
2020-01-01 00:11:00,12,12,7953,1294,6659,12.14%,16.27%
2020-01-01 00:11:00,13,1,2247,38,2209,3.43%,1.69%
2020-01-01 00:11:00,13,2,2557,50,2507,3.90%,1.96%
2020-01-01 00:11:00,13,3,570,1,569,0.87%,0.18%
2020-01-01 00:11:00,13,4,4445,356,4089,6.78%,8.01%
2020-01-01 00:11:00,13,5,6529,597,5932,9.96%,9.14%
2020-01-01 00:11:00,13,6,5194,399,4795,7.93%,7.68%
2020-01-01 00:11:00,13,7,4696,163,4533,7.17%,3.47%
2020-01-01 00:11:00,13,8,6621,325,6296,10.10%,4.91%
2020-01-01 00:11:00,13,9,6771,616,6155,10.33%,9.10%
2020-01-01 00:11:00,13,10,26840,5310,21530,40.95%,19.78%
2020-01-01 00:11:00,13,11,17186,2368,14818,26.22%,13.78%
2020-01-01 00:11:00,13,12,9870,1050,8820,15.06%,10.64%
2020-01-01 00:11:00,14,1,645,6,639,0.98%,0.93%
2020-01-01 00:11:00,14,2,1609,27,1582,2.46%,1.68%
2020-01-01 00:11:00,14,3,731,6,725,1.12%,0.82%
2020-01-01 00:11:00,14,4,5384,196,5188,8.22%,3.64%
2020-01-01 00:11:00,14,5,2087,34,2053,3.18%,1.63%
2020-01-01 00:11:00,14,6,5568,207,5361,8.50%,3.72%
2020-01-01 00:11:00,14,7,12960,1234,11726,19.78%,9.52%
2020-01-01 00:11:00,14,8,14310,1515,12795,21.84%,10.59%
2020-01-01 00:11:00,14,9,2371,41,2330,3.62%,1.73%
2020-01-01 00:11:00,14,10,5063,171,4892,7.73%,3.38%
2020-01-01 00:11:00,14,11,26820,4876,21944,40.92%,18.18%
2020-01-01 00:11:00,14,12,7173,394,6779,10.95%,5.49%
2020-01-01 00:11:00,15,1,468,1,467,0.71%,0.21%
2020-01-01 00:11:00,15,2,194,1,193,0.30%,0.52%
2020-01-01 00:11:00,15,3,3658,101,3557,5.58%,2.76%
2020-01-01 00:11:00,15,4,5470,311,5159,8.35%,5.69%
2020-01-01 00:11:00,15,5,9846,764,9082,15.02%,7.76%
2020-01-01 00:11:00,15,6,5736,337,5399,8.75%,5.88%
2020-01-01 00:11:00,15,7,3562,91,3471,5.44%,2.55%
2020-01-01 00:11:00,15,8,5638,231,5407,8.60%,4.10%
2020-01-01 00:11:00,15,9,10098,806,9292,15.41%,7.98%
2020-01-01 00:11:00,15,10,3398,103,3295,5.18%,3.03%
2020-01-01 00:11:00,15,11,9127,608,8519,13.93%,6.66%
2020-01-01 00:11:00,15,12,24608,4632,19976,37.55%,18.82%
2020-01-01 00:11:00,16,1,374,3,371,0.57%,0.80%
2020-01-01 00:11:00,16,2,266,2,264,0.41%,0.75%
2020-01-01 00:11:00,16,3,1792,29,1763,2.73%,1.62%
2020-01-01 00:11:00,16,4,4447,169,4278,6.79%,3.80%
2020-01-01 00:11:00,16,5,8196,581,7615,12.51%,7.09%
2020-01-01 00:11:00,16,6,5200,224,4976,7.93%,4.31%
2020-01-01 00:11:00,16,7,3293,79,3214,5.02%,2.40%
2020-01-01 00:11:00,16,8,8031,503,7528,12.25%,6.26%
2020-01-01 00:11:00,16,9,8574,625,7949,13.08%,7.29%
2020-01-01 00:11:00,16,10,1497,14,1483,2.28%,0.94%
2020-01-01 00:11:00,16,11,9677,716,8961,14.77%,7.40%
2020-01-01 00:11:00,16,12,25535,4442,21093,38.96%,17.40%
2020-01-01 00:11:10,1,1,23319,3768,19551,35.58%,16.16%
2020-01-01 00:11:10,1,2,6205,297,5908,9.47%,4.79%
2020-01-01 00:11:10,1,3,579,1,578,0.88%,0.17%
2020-01-01 00:11:10,1,4,16672,2003,14669,25.44%,12.01%
2020-01-01 00:11:10,1,5,16186,1899,14287,24.70%,11.73%
2020-01-01 00:11:10,1,6,16143,1886,14257,24.63%,11.68%
2020-01-01 00:11:10,1,7,5610,261,5349,8.56%,4.65%
2020-01-01 00:11:10,1,8,4255,148,4107,6.49%,3.48%
2020-01-01 00:11:10,1,9,16094,1878,14216,24.56%,11.67%
2020-01-01 00:11:10,1,10,3596,107,3489,5.49%,2.98%
2020-01-01 00:11:10,1,11,3727,117,3610,5.69%,3.14%
2020-01-01 00:11:10,1,12,16067,1875,14192,24.52%,11.67%
2020-01-01 00:11:10,2,1,409,2,407,0.62%,0.49%
2020-01-01 00:11:10,2,2,29335,5685,23650,44.76%,19.38%
2020-01-01 00:11:10,2,3,24387,4033,20354,37.21%,16.54%
2020-01-01 00:11:10,2,4,377,2,375,0.58%,0.53%
2020-01-01 00:11:10,2,5,16552,1868,14684,25.26%,11.29%
2020-01-01 00:11:10,2,6,45,0,45,0.07%,0.00%
2020-01-01 00:11:10,2,7,4505,148,4357,6.87%,3.29%
2020-01-01 00:11:10,2,8,3164,76,3088,4.83%,2.40%
2020-01-01 00:11:10,2,9,16445,1842,14603,25.09%,11.20%
2020-01-01 00:11:10,2,10,2396,37,2359,3.66%,1.54%
2020-01-01 00:11:10,2,11,2414,38,2376,3.68%,1.57%
2020-01-01 00:11:10,2,12,16264,1806,14458,24.82%,11.10%
2020-01-01 00:11:10,3,1,1210,14,1196,1.85%,1.16%
2020-01-01 00:11:10,3,2,23592,3815,19777,36.00%,16.17%
2020-01-01 00:11:10,3,3,70088,27066,43022,106.95%,38.62%
2020-01-01 00:11:10,3,4,7040,361,6679,10.74%,5.13%
2020-01-01 00:11:10,3,5,45511,12719,32792,69.44%,27.95%
2020-01-01 00:11:10,3,6,8007,470,7537,12.22%,5.87%
2020-01-01 00:11:10,3,7,20386,2846,17540,31.11%,13.96%
2020-01-01 00:11:10,3,8,17261,2048,15213,26.34%,11.86%
2020-01-01 00:11:10,3,9,37165,8724,28441,56.71%,23.47%
2020-01-01 00:11:10,3,10,6888,353,6535,10.51%,5.12%
2020-01-01 00:11:10,3,11,1873,17,1856,2.86%,0.91%
2020-01-01 00:11:10,3,12,26366,4580,21786,40.23%,17.37%
2020-01-01 00:11:10,4,1,493,2,491,0.75%,0.41%
2020-01-01 00:11:10,4,2,308,2,306,0.47%,0.65%
2020-01-01 00:11:10,4,3,862,3,859,1.32%,0.35%
2020-01-01 00:11:10,4,4,28347,5317,23030,43.25%,18.76%
2020-01-01 00:11:10,4,5,17660,2237,15423,26.95%,12.67%
2020-01-01 00:11:10,4,6,24277,3998,20279,37.04%,16.47%
2020-01-01 00:11:10,4,7,5350,230,5120,8.16%,4.30%
2020-01-01 00:11:10,4,8,2932,80,2852,4.47%,2.73%
2020-01-01 00:11:10,4,9,15684,1789,13895,23.93%,11.41%
2020-01-01 00:11:10,4,10,1761,33,1728,2.69%,1.87%
2020-01-01 00:11:10,4,11,121,0,121,0.18%,0.00%
2020-01-01 00:11:10,4,12,12412,1161,11251,18.94%,9.35%
2020-01-01 00:11:10,5,1,2674,63,2611,4.08%,2.36%
2020-01-01 00:11:10,5,2,682,6,676,1.04%,0.88%
2020-01-01 00:11:10,5,3,448,2,446,0.68%,0.45%
2020-01-01 00:11:10,5,4,24637,4129,20508,37.59%,16.76%
2020-01-01 00:11:10,5,5,8749,550,8199,13.35%,6.29%
2020-01-01 00:11:10,5,6,13101,1235,11866,19.99%,9.43%
2020-01-01 00:11:10,5,7,3869,107,3762,5.90%,2.77%
2020-01-01 00:11:10,5,8,3113,69,3044,4.75%,2.22%
2020-01-01 00:11:10,5,9,8120,489,7631,12.39%,6.02%
2020-01-01 00:11:10,5,10,980,13,967,1.50%,1.33%
2020-01-01 00:11:10,5,11,627,8,619,0.96%,1.28%
2020-01-01 00:11:10,5,12,6849,346,6503,10.45%,5.05%
2020-01-01 00:11:10,6,1,1158,9,1149,1.77%,0.78%
2020-01-01 00:11:10,6,2,1222,10,1212,1.86%,0.82%
2020-01-01 00:11:10,6,3,1640,23,1617,2.50%,1.40%
2020-01-01 00:11:10,6,4,1136,6,1130,1.73%,0.53%
2020-01-01 00:11:10,6,5,11183,893,10290,17.06%,7.99%
2020-01-01 00:11:10,6,6,3427,90,3337,5.23%,2.63%
2020-01-01 00:11:10,6,7,1894,31,1863,2.89%,1.64%
2020-01-01 00:11:10,6,8,1290,21,1269,1.97%,1.63%
2020-01-01 00:11:10,6,9,5870,267,5603,8.96%,4.55%
2020-01-01 00:11:10,6,10,1782,26,1756,2.72%,1.46%
2020-01-01 00:11:10,6,11,434,0,434,0.66%,0.00%
2020-01-01 00:11:10,6,12,4037,128,3909,6.16%,3.17%
2020-01-01 00:11:10,7,1,426,2,424,0.65%,0.47%
2020-01-01 00:11:10,7,2,203,1,202,0.31%,0.49%
2020-01-01 00:11:10,7,3,1340,8,1332,2.04%,0.60%
2020-01-01 00:11:10,7,4,1738,31,1707,2.65%,1.78%
2020-01-01 00:11:10,7,5,7774,432,7342,11.86%,5.56%
2020-01-01 00:11:10,7,6,13178,1263,11915,20.11%,9.58%
2020-01-01 00:11:10,7,7,3606,112,3494,5.50%,3.11%
2020-01-01 00:11:10,7,8,1562,28,1534,2.38%,1.79%
2020-01-01 00:11:10,7,9,6380,302,6078,9.74%,4.73%
2020-01-01 00:11:10,7,10,1289,10,1279,1.97%,0.78%
2020-01-01 00:11:10,7,11,135,0,135,0.21%,0.00%
2020-01-01 00:11:10,7,12,5117,185,4932,7.81%,3.62%
2020-01-01 00:11:10,8,1,368,4,364,0.56%,1.09%
2020-01-01 00:11:10,8,2,74,0,74,0.11%,0.00%
2020-01-01 00:11:10,8,3,1777,20,1757,2.71%,1.13%
2020-01-01 00:11:10,8,4,2745,74,2671,4.19%,2.70%
2020-01-01 00:11:10,8,5,9035,578,8457,13.79%,6.40%
2020-01-01 00:11:10,8,6,16686,1961,14725,25.46%,11.75%
2020-01-01 00:11:10,8,7,4740,181,4559,7.23%,3.82%
2020-01-01 00:11:10,8,8,1822,29,1793,2.78%,1.59%
2020-01-01 00:11:10,8,9,6103,271,5832,9.31%,4.44%
2020-01-01 00:11:10,8,10,1775,18,1757,2.71%,1.01%
2020-01-01 00:11:10,8,11,169,0,169,0.26%,0.00%
2020-01-01 00:11:10,8,12,4309,129,4180,6.58%,2.99%
2020-01-01 00:11:10,9,1,1218,9,1209,1.86%,0.74%
2020-01-01 00:11:10,9,2,2618,44,2574,3.99%,1.68%
2020-01-01 00:11:10,9,3,1051,4,1047,1.60%,0.38%
2020-01-01 00:11:10,9,4,8874,598,8276,13.54%,6.74%
2020-01-01 00:11:10,9,5,235,2,233,0.36%,0.85%
2020-01-01 00:11:10,9,6,10236,791,9445,15.62%,7.73%
2020-01-01 00:11:10,9,7,31631,6516,25115,48.27%,20.60%
2020-01-01 00:11:10,9,8,11713,939,10774,17.87%,8.02%
2020-01-01 00:11:10,9,9,136,2,134,0.21%,1.47%
2020-01-01 00:11:10,9,10,5878,251,5627,8.97%,4.27%
2020-01-01 00:11:10,9,11,10762,797,9965,16.42%,7.41%
2020-01-01 00:11:10,9,12,4519,145,4374,6.90%,3.21%
2020-01-01 00:11:10,10,1,1225,170,1055,1.87%,13.88%
2020-01-01 00:11:10,10,2,4978,343,4635,7.60%,6.89%
2020-01-01 00:11:10,10,3,3616,114,3502,5.52%,3.15%
2020-01-01 00:11:10,10,4,4050,902,3148,6.18%,22.27%
2020-01-01 00:11:10,10,5,624,38,586,0.95%,6.09%
2020-01-01 00:11:10,10,6,5700,1037,4663,8.70%,18.19%
2020-01-01 00:11:10,10,7,12684,1999,10685,19.35%,15.76%
2020-01-01 00:11:10,10,8,29281,7234,22047,44.68%,24.71%
2020-01-01 00:11:10,10,9,923,6,917,1.41%,0.65%
2020-01-01 00:11:10,10,10,2391,61,2330,3.65%,2.55%
2020-01-01 00:11:10,10,11,12866,1699,11167,19.63%,13.21%
2020-01-01 00:11:10,10,12,9781,1176,8605,14.92%,12.02%
2020-01-01 00:11:10,11,1,2479,56,2423,3.78%,2.26%
2020-01-01 00:11:10,11,2,3817,114,3703,5.82%,2.99%
2020-01-01 00:11:10,11,3,1128,11,1117,1.72%,0.98%
2020-01-01 00:11:10,11,4,3232,81,3151,4.93%,2.51%
2020-01-01 00:11:10,11,5,187,0,187,0.29%,0.00%
2020-01-01 00:11:10,11,6,4077,137,3940,6.22%,3.36%
2020-01-01 00:11:10,11,7,9398,655,8743,14.34%,6.97%
2020-01-01 00:11:10,11,8,23310,3720,19590,35.57%,15.96%
2020-01-01 00:11:10,11,9,337,0,337,0.51%,0.00%
2020-01-01 00:11:10,11,10,2720,50,2670,4.15%,1.84%
2020-01-01 00:11:10,11,11,9571,696,8875,14.60%,7.27%
2020-01-01 00:11:10,11,12,6517,346,6171,9.94%,5.31%
2020-01-01 00:11:10,12,1,80,0,80,0.12%,0.00%
2020-01-01 00:11:10,12,2,656,172,484,1.00%,26.22%
2020-01-01 00:11:10,12,3,3234,233,3001,4.93%,7.20%
2020-01-01 00:11:10,12,4,3259,92,3167,4.97%,2.82%
2020-01-01 00:11:10,12,5,9820,865,8955,14.98%,8.81%
2020-01-01 00:11:10,12,6,5792,257,5535,8.84%,4.44%
2020-01-01 00:11:10,12,7,2359,31,2328,3.60%,1.31%
2020-01-01 00:11:10,12,8,1665,305,1360,2.54%,18.32%
2020-01-01 00:11:10,12,9,22418,4253,18165,34.21%,18.97%
2020-01-01 00:11:10,12,10,4314,398,3916,6.58%,9.23%
2020-01-01 00:11:10,12,11,1827,307,1520,2.79%,16.80%
2020-01-01 00:11:10,12,12,7596,1023,6573,11.59%,13.47%
2020-01-01 00:11:10,13,1,2085,40,2045,3.18%,1.92%
2020-01-01 00:11:10,13,2,2353,51,2302,3.59%,2.17%
2020-01-01 00:11:10,13,3,820,2,818,1.25%,0.24%
2020-01-01 00:11:10,13,4,5036,544,4492,7.68%,10.80%
2020-01-01 00:11:10,13,5,7391,815,6576,11.28%,11.03%
2020-01-01 00:11:10,13,6,5735,587,5148,8.75%,10.24%
2020-01-01 00:11:10,13,7,4694,178,4516,7.16%,3.79%
2020-01-01 00:11:10,13,8,7028,372,6656,10.72%,5.29%
2020-01-01 00:11:10,13,9,7796,862,6934,11.90%,11.06%
2020-01-01 00:11:10,13,10,28621,6270,22351,43.67%,21.91%
2020-01-01 00:11:10,13,11,18045,2798,15247,27.53%,15.51%
2020-01-01 00:11:10,13,12,10519,1388,9131,16.05%,13.20%
2020-01-01 00:11:10,14,1,273,0,273,0.42%,0.00%
2020-01-01 00:11:10,14,2,1257,10,1247,1.92%,0.80%
2020-01-01 00:11:10,14,3,769,4,765,1.17%,0.52%
2020-01-01 00:11:10,14,4,4367,143,4224,6.66%,3.27%
2020-01-01 00:11:10,14,5,1481,23,1458,2.26%,1.55%
2020-01-01 00:11:10,14,6,4657,173,4484,7.11%,3.71%
2020-01-01 00:11:10,14,7,11807,976,10831,18.02%,8.27%
2020-01-01 00:11:10,14,8,13434,1278,12156,20.50%,9.51%
2020-01-01 00:11:10,14,9,1659,31,1628,2.53%,1.87%
2020-01-01 00:11:10,14,10,3922,115,3807,5.98%,2.93%
2020-01-01 00:11:10,14,11,25451,4345,21106,38.84%,17.07%
2020-01-01 00:11:10,14,12,7777,422,7355,11.87%,5.43%
2020-01-01 00:11:10,15,1,435,2,433,0.66%,0.46%
2020-01-01 00:11:10,15,2,195,0,195,0.30%,0.00%
2020-01-01 00:11:10,15,3,3685,98,3587,5.62%,2.66%
2020-01-01 00:11:10,15,4,6020,260,5760,9.19%,4.32%
2020-01-01 00:11:10,15,5,10612,821,9791,16.19%,7.74%
2020-01-01 00:11:10,15,6,6272,286,5986,9.57%,4.56%
2020-01-01 00:11:10,15,7,3359,89,3270,5.13%,2.65%
2020-01-01 00:11:10,15,8,5560,225,5335,8.48%,4.05%
2020-01-01 00:11:10,15,9,10818,865,9953,16.51%,8.00%
2020-01-01 00:11:10,15,10,5670,240,5430,8.65%,4.23%
2020-01-01 00:11:10,15,11,11489,941,10548,17.53%,8.19%
2020-01-01 00:11:10,15,12,27564,5370,22194,42.06%,19.48%
2020-01-01 00:11:10,16,1,494,1,493,0.75%,0.20%
2020-01-01 00:11:10,16,2,239,0,239,0.36%,0.00%
2020-01-01 00:11:10,16,3,1829,32,1797,2.79%,1.75%
2020-01-01 00:11:10,16,4,4374,148,4226,6.67%,3.38%
2020-01-01 00:11:10,16,5,8126,518,7608,12.40%,6.37%
2020-01-01 00:11:10,16,6,5188,194,4994,7.92%,3.74%
2020-01-01 00:11:10,16,7,3823,121,3702,5.83%,3.17%
2020-01-01 00:11:10,16,8,7416,457,6959,11.32%,6.16%
2020-01-01 00:11:10,16,9,8473,563,7910,12.93%,6.64%
2020-01-01 00:11:10,16,10,1423,16,1407,2.17%,1.12%
2020-01-01 00:11:10,16,11,9086,667,8419,13.86%,7.34%
2020-01-01 00:11:10,16,12,24876,4322,20554,37.96%,17.37%
2020-01-01 00:11:20,1,1,23216,3752,19464,35.42%,16.16%
2020-01-01 00:11:20,1,2,12040,1075,10965,18.37%,8.93%
2020-01-01 00:11:20,1,3,733,4,729,1.12%,0.55%
2020-01-01 00:11:20,1,4,10746,878,9868,16.40%,8.17%
2020-01-01 00:11:20,1,5,10428,823,9605,15.91%,7.89%
2020-01-01 00:11:20,1,6,10353,818,9535,15.80%,7.90%
2020-01-01 00:11:20,1,7,11293,936,10357,17.23%,8.29%
2020-01-01 00:11:20,1,8,7391,386,7005,11.28%,5.22%
2020-01-01 00:11:20,1,9,10320,816,9504,15.75%,7.91%
2020-01-01 00:11:20,1,10,6576,316,6260,10.03%,4.81%
2020-01-01 00:11:20,1,11,6696,326,6370,10.22%,4.87%
2020-01-01 00:11:20,1,12,10278,807,9471,15.68%,7.85%
2020-01-01 00:11:20,2,1,475,3,472,0.72%,0.63%
2020-01-01 00:11:20,2,2,27000,4797,22203,41.20%,17.77%
2020-01-01 00:11:20,2,3,21792,3158,18634,33.25%,14.49%
2020-01-01 00:11:20,2,4,397,3,394,0.61%,0.76%
2020-01-01 00:11:20,2,5,14136,1373,12763,21.57%,9.71%
2020-01-01 00:11:20,2,6,40,0,40,0.06%,0.00%
2020-01-01 00:11:20,2,7,4713,169,4544,7.19%,3.59%
2020-01-01 00:11:20,2,8,3707,112,3595,5.66%,3.02%
2020-01-01 00:11:20,2,9,14032,1354,12678,21.41%,9.65%
2020-01-01 00:11:20,2,10,2830,68,2762,4.32%,2.40%
2020-01-01 00:11:20,2,11,2838,68,2770,4.33%,2.40%
2020-01-01 00:11:20,2,12,13848,1309,12539,21.13%,9.45%
2020-01-01 00:11:20,3,1,1358,11,1347,2.07%,0.81%
2020-01-01 00:11:20,3,2,24870,4238,20632,37.95%,17.04%
2020-01-01 00:11:20,3,3,72330,28569,43761,110.37%,39.50%
2020-01-01 00:11:20,3,4,8466,537,7929,12.92%,6.34%
2020-01-01 00:11:20,3,5,45010,12594,32416,68.68%,27.98%
2020-01-01 00:11:20,3,6,9662,689,8973,14.74%,7.13%
2020-01-01 00:11:20,3,7,21561,3252,18309,32.90%,15.08%
2020-01-01 00:11:20,3,8,15944,1814,14130,24.33%,11.38%
2020-01-01 00:11:20,3,9,34922,7908,27014,53.29%,22.64%
2020-01-01 00:11:20,3,10,6834,313,6521,10.43%,4.58%
2020-01-01 00:11:20,3,11,2175,38,2137,3.32%,1.75%
2020-01-01 00:11:20,3,12,25464,4320,21144,38.85%,16.97%
2020-01-01 00:11:20,4,1,507,1,506,0.77%,0.20%
2020-01-01 00:11:20,4,2,317,0,317,0.48%,0.00%
2020-01-01 00:11:20,4,3,675,1,674,1.03%,0.15%
2020-01-01 00:11:20,4,4,27872,5200,22672,42.53%,18.66%
2020-01-01 00:11:20,4,5,17425,2093,15332,26.59%,12.01%
2020-01-01 00:11:20,4,6,24095,3980,20115,36.77%,16.52%
2020-01-01 00:11:20,4,7,5294,217,5077,8.08%,4.10%
2020-01-01 00:11:20,4,8,2752,60,2692,4.20%,2.18%
2020-01-01 00:11:20,4,9,15625,1694,13931,23.84%,10.84%
2020-01-01 00:11:20,4,10,1951,33,1918,2.98%,1.69%
2020-01-01 00:11:20,4,11,129,0,129,0.20%,0.00%
2020-01-01 00:11:20,4,12,12681,1139,11542,19.35%,8.98%
2020-01-01 00:11:20,5,1,2980,67,2913,4.55%,2.25%
2020-01-01 00:11:20,5,2,692,3,689,1.06%,0.43%
2020-01-01 00:11:20,5,3,477,1,476,0.73%,0.21%
2020-01-01 00:11:20,5,4,26127,4562,21565,39.87%,17.46%
2020-01-01 00:11:20,5,5,8771,596,8175,13.38%,6.80%
2020-01-01 00:11:20,5,6,15064,1606,13458,22.99%,10.66%
2020-01-01 00:11:20,5,7,5652,242,5410,8.62%,4.28%
2020-01-01 00:11:20,5,8,3587,108,3479,5.47%,3.01%
2020-01-01 00:11:20,5,9,8105,513,7592,12.37%,6.33%
2020-01-01 00:11:20,5,10,703,12,691,1.07%,1.71%
2020-01-01 00:11:20,5,11,768,8,760,1.17%,1.04%
2020-01-01 00:11:20,5,12,6967,378,6589,10.63%,5.43%
2020-01-01 00:11:20,6,1,867,11,856,1.32%,1.27%
2020-01-01 00:11:20,6,2,996,15,981,1.52%,1.51%
2020-01-01 00:11:20,6,3,1655,24,1631,2.53%,1.45%
2020-01-01 00:11:20,6,4,1328,10,1318,2.03%,0.75%
2020-01-01 00:11:20,6,5,16347,1887,14460,24.94%,11.54%
2020-01-01 00:11:20,6,6,5504,248,5256,8.40%,4.51%
2020-01-01 00:11:20,6,7,3613,102,3511,5.51%,2.82%
2020-01-01 00:11:20,6,8,2399,51,2348,3.66%,2.13%
2020-01-01 00:11:20,6,9,8828,587,8241,13.47%,6.65%
2020-01-01 00:11:20,6,10,2037,23,2014,3.11%,1.13%
2020-01-01 00:11:20,6,11,468,0,468,0.71%,0.00%
2020-01-01 00:11:20,6,12,6734,349,6385,10.28%,5.18%
2020-01-01 00:11:20,7,1,462,1,461,0.70%,0.22%
2020-01-01 00:11:20,7,2,201,1,200,0.31%,0.50%
2020-01-01 00:11:20,7,3,1173,9,1164,1.79%,0.77%
2020-01-01 00:11:20,7,4,1548,33,1515,2.36%,2.13%
2020-01-01 00:11:20,7,5,7215,352,6863,11.01%,4.88%
2020-01-01 00:11:20,7,6,12329,1006,11323,18.81%,8.16%
2020-01-01 00:11:20,7,7,3529,80,3449,5.38%,2.27%
2020-01-01 00:11:20,7,8,1413,15,1398,2.16%,1.06%
2020-01-01 00:11:20,7,9,6007,244,5763,9.17%,4.06%
2020-01-01 00:11:20,7,10,1106,8,1098,1.69%,0.72%
2020-01-01 00:11:20,7,11,94,0,94,0.14%,0.00%
2020-01-01 00:11:20,7,12,4914,172,4742,7.50%,3.50%
2020-01-01 00:11:20,8,1,436,4,432,0.67%,0.92%
2020-01-01 00:11:20,8,2,89,0,89,0.14%,0.00%
2020-01-01 00:11:20,8,3,1334,7,1327,2.04%,0.52%
2020-01-01 00:11:20,8,4,2623,55,2568,4.00%,2.10%
2020-01-01 00:11:20,8,5,8469,568,7901,12.92%,6.71%
2020-01-01 00:11:20,8,6,16315,1879,14436,24.89%,11.52%
2020-01-01 00:11:20,8,7,5128,196,4932,7.82%,3.82%
2020-01-01 00:11:20,8,8,2096,30,2066,3.20%,1.43%
2020-01-01 00:11:20,8,9,6456,333,6123,9.85%,5.16%
2020-01-01 00:11:20,8,10,1849,23,1826,2.82%,1.24%
2020-01-01 00:11:20,8,11,214,1,213,0.33%,0.47%
2020-01-01 00:11:20,8,12,4550,158,4392,6.94%,3.47%
2020-01-01 00:11:20,9,1,323,0,323,0.49%,0.00%
2020-01-01 00:11:20,9,2,2759,48,2711,4.21%,1.74%
2020-01-01 00:11:20,9,3,1980,27,1953,3.02%,1.36%
2020-01-01 00:11:20,9,4,8132,446,7686,12.41%,5.48%
2020-01-01 00:11:20,9,5,243,0,243,0.37%,0.00%
2020-01-01 00:11:20,9,6,9194,573,8621,14.03%,6.23%
2020-01-01 00:11:20,9,7,27507,4904,22603,41.97%,17.83%
2020-01-01 00:11:20,9,8,9049,622,8427,13.81%,6.87%
2020-01-01 00:11:20,9,9,180,0,180,0.27%,0.00%
2020-01-01 00:11:20,9,10,2237,87,2150,3.41%,3.89%
2020-01-01 00:11:20,9,11,7560,445,7115,11.54%,5.89%
2020-01-01 00:11:20,9,12,4951,181,4770,7.55%,3.66%
2020-01-01 00:11:20,10,1,1218,208,1010,1.86%,17.08%
2020-01-01 00:11:20,10,2,5241,391,4850,8.00%,7.46%
2020-01-01 00:11:20,10,3,3841,106,3735,5.86%,2.76%
2020-01-01 00:11:20,10,4,4222,907,3315,6.44%,21.48%
2020-01-01 00:11:20,10,5,549,18,531,0.84%,3.28%
2020-01-01 00:11:20,10,6,5803,1032,4771,8.85%,17.78%
2020-01-01 00:11:20,10,7,13213,2094,11119,20.16%,15.85%
2020-01-01 00:11:20,10,8,30358,7794,22564,46.32%,25.67%
2020-01-01 00:11:20,10,9,723,2,721,1.10%,0.28%
2020-01-01 00:11:20,10,10,2427,44,2383,3.70%,1.81%
2020-01-01 00:11:20,10,11,13414,1831,11583,20.47%,13.65%
2020-01-01 00:11:20,10,12,10269,1308,8961,15.67%,12.74%
2020-01-01 00:11:20,11,1,2484,44,2440,3.79%,1.77%
2020-01-01 00:11:20,11,2,3654,85,3569,5.58%,2.33%
2020-01-01 00:11:20,11,3,1017,9,1008,1.55%,0.88%
2020-01-01 00:11:20,11,4,3167,81,3086,4.83%,2.56%
2020-01-01 00:11:20,11,5,219,0,219,0.33%,0.00%
2020-01-01 00:11:20,11,6,4120,127,3993,6.29%,3.08%
2020-01-01 00:11:20,11,7,9691,675,9016,14.79%,6.97%
2020-01-01 00:11:20,11,8,23691,3922,19769,36.15%,16.55%
2020-01-01 00:11:20,11,9,249,0,249,0.38%,0.00%
2020-01-01 00:11:20,11,10,3253,87,3166,4.96%,2.67%
2020-01-01 00:11:20,11,11,10156,810,9346,15.50%,7.98%
2020-01-01 00:11:20,11,12,6521,364,6157,9.95%,5.58%
2020-01-01 00:11:20,12,1,38,0,38,0.06%,0.00%
2020-01-01 00:11:20,12,2,612,203,409,0.93%,33.17%
2020-01-01 00:11:20,12,3,2409,237,2172,3.68%,9.84%
2020-01-01 00:11:20,12,4,2837,48,2789,4.33%,1.69%
2020-01-01 00:11:20,12,5,7956,689,7267,12.14%,8.66%
2020-01-01 00:11:20,12,6,4735,178,4557,7.23%,3.76%
2020-01-01 00:11:20,12,7,1751,44,1707,2.67%,2.51%
2020-01-01 00:11:20,12,8,1307,255,1052,1.99%,19.51%
2020-01-01 00:11:20,12,9,21217,4032,17185,32.37%,19.00%
2020-01-01 00:11:20,12,10,3985,377,3608,6.08%,9.46%
2020-01-01 00:11:20,12,11,1628,264,1364,2.48%,16.22%
2020-01-01 00:11:20,12,12,8748,1142,7606,13.35%,13.05%
2020-01-01 00:11:20,13,1,2690,51,2639,4.10%,1.90%
2020-01-01 00:11:20,13,2,3009,68,2941,4.59%,2.26%
2020-01-01 00:11:20,13,3,617,2,615,0.94%,0.32%
2020-01-01 00:11:20,13,4,4399,436,3963,6.71%,9.91%
2020-01-01 00:11:20,13,5,7683,810,6873,11.72%,10.54%
2020-01-01 00:11:20,13,6,5377,503,4874,8.20%,9.35%
2020-01-01 00:11:20,13,7,5350,215,5135,8.16%,4.02%
2020-01-01 00:11:20,13,8,7287,394,6893,11.12%,5.41%
2020-01-01 00:11:20,13,9,8053,851,7202,12.29%,10.57%
2020-01-01 00:11:20,13,10,27769,5793,21976,42.37%,20.86%
2020-01-01 00:11:20,13,11,17474,2492,14982,26.66%,14.26%
2020-01-01 00:11:20,13,12,9735,1060,8675,14.85%,10.89%
2020-01-01 00:11:20,14,1,439,1,438,0.67%,0.23%
2020-01-01 00:11:20,14,2,1426,21,1405,2.18%,1.47%
2020-01-01 00:11:20,14,3,791,2,789,1.21%,0.25%
2020-01-01 00:11:20,14,4,3825,122,3703,5.84%,3.19%
2020-01-01 00:11:20,14,5,1348,12,1336,2.06%,0.89%
2020-01-01 00:11:20,14,6,4170,138,4032,6.36%,3.31%
2020-01-01 00:11:20,14,7,11339,953,10386,17.30%,8.40%
2020-01-01 00:11:20,14,8,12700,1175,11525,19.38%,9.25%
2020-01-01 00:11:20,14,9,1542,18,1524,2.35%,1.17%
2020-01-01 00:11:20,14,10,3791,113,3678,5.78%,2.98%
2020-01-01 00:11:20,14,11,24822,4174,20648,37.88%,16.82%
2020-01-01 00:11:20,14,12,8055,483,7572,12.29%,6.00%
2020-01-01 00:11:20,15,1,390,1,389,0.60%,0.26%
2020-01-01 00:11:20,15,2,247,1,246,0.38%,0.40%
2020-01-01 00:11:20,15,3,3666,95,3571,5.59%,2.59%
2020-01-01 00:11:20,15,4,5323,234,5089,8.12%,4.40%
2020-01-01 00:11:20,15,5,9594,692,8902,14.64%,7.21%
2020-01-01 00:11:20,15,6,5532,251,5281,8.44%,4.54%
2020-01-01 00:11:20,15,7,3703,118,3585,5.65%,3.19%
2020-01-01 00:11:20,15,8,5511,237,5274,8.41%,4.30%
2020-01-01 00:11:20,15,9,9838,733,9105,15.01%,7.45%
2020-01-01 00:11:20,15,10,4528,161,4367,6.91%,3.56%
2020-01-01 00:11:20,15,11,10345,823,9522,15.79%,7.96%
2020-01-01 00:11:20,15,12,25099,4698,20401,38.30%,18.72%
2020-01-01 00:11:20,16,1,515,1,514,0.79%,0.19%
2020-01-01 00:11:20,16,2,218,0,218,0.33%,0.00%
2020-01-01 00:11:20,16,3,1456,13,1443,2.22%,0.89%
2020-01-01 00:11:20,16,4,6749,306,6443,10.30%,4.53%
2020-01-01 00:11:20,16,5,10095,821,9274,15.40%,8.13%
2020-01-01 00:11:20,16,6,7553,395,7158,11.52%,5.23%
2020-01-01 00:11:20,16,7,3811,110,3701,5.82%,2.89%
2020-01-01 00:11:20,16,8,7665,429,7236,11.70%,5.60%
2020-01-01 00:11:20,16,9,10529,887,9642,16.07%,8.42%
2020-01-01 00:11:20,16,10,1581,20,1561,2.41%,1.27%
2020-01-01 00:11:20,16,11,9479,674,8805,14.46%,7.11%
2020-01-01 00:11:20,16,12,27916,5257,22659,42.60%,18.83%
2020-01-01 00:11:30,1,1,16270,1848,14422,24.83%,11.36%
2020-01-01 00:11:30,1,2,7386,374,7012,11.27%,5.06%
2020-01-01 00:11:30,1,3,758,2,756,1.16%,0.26%
2020-01-01 00:11:30,1,4,8523,534,7989,13.01%,6.27%
2020-01-01 00:11:30,1,5,8296,513,7783,12.66%,6.18%
2020-01-01 00:11:30,1,6,8036,485,7551,12.26%,6.04%
2020-01-01 00:11:30,1,7,6610,302,6308,10.09%,4.57%
2020-01-01 00:11:30,1,8,5760,226,5534,8.79%,3.92%
2020-01-01 00:11:30,1,9,8016,482,7534,12.23%,6.01%
2020-01-01 00:11:30,1,10,5023,163,4860,7.66%,3.25%
2020-01-01 00:11:30,1,11,5142,170,4972,7.85%,3.31%
2020-01-01 00:11:30,1,12,7915,468,7447,12.08%,5.91%
2020-01-01 00:11:30,2,1,511,6,505,0.78%,1.17%
2020-01-01 00:11:30,2,2,20958,3120,17838,31.98%,14.89%
2020-01-01 00:11:30,2,3,15468,1751,13717,23.60%,11.32%
2020-01-01 00:11:30,2,4,428,6,422,0.65%,1.40%
2020-01-01 00:11:30,2,5,9903,711,9192,15.11%,7.18%
2020-01-01 00:11:30,2,6,67,0,67,0.10%,0.00%
2020-01-01 00:11:30,2,7,4957,196,4761,7.56%,3.95%
2020-01-01 00:11:30,2,8,3694,119,3575,5.64%,3.22%
2020-01-01 00:11:30,2,9,9839,700,9139,15.01%,7.11%
2020-01-01 00:11:30,2,10,2976,74,2902,4.54%,2.49%
2020-01-01 00:11:30,2,11,2989,75,2914,4.56%,2.51%
2020-01-01 00:11:30,2,12,9666,676,8990,14.75%,6.99%
2020-01-01 00:11:30,3,1,1640,14,1626,2.50%,0.85%
2020-01-01 00:11:30,3,2,20856,3027,17829,31.82%,14.51%
2020-01-01 00:11:30,3,3,78858,33016,45842,120.33%,41.87%
2020-01-01 00:11:30,3,4,13913,1370,12543,21.23%,9.85%
2020-01-01 00:11:30,3,5,56419,18577,37842,86.09%,32.93%
2020-01-01 00:11:30,3,6,15231,1635,13596,23.24%,10.73%
2020-01-01 00:11:30,3,7,17636,2200,15436,26.91%,12.47%
2020-01-01 00:11:30,3,8,13813,1395,12418,21.08%,10.10%
2020-01-01 00:11:30,3,9,40861,10420,30441,62.35%,25.50%
2020-01-01 00:11:30,3,10,7492,397,7095,11.43%,5.30%
2020-01-01 00:11:30,3,11,1472,17,1455,2.25%,1.15%
2020-01-01 00:11:30,3,12,30453,6055,24398,46.47%,19.88%
2020-01-01 00:11:30,4,1,537,0,537,0.82%,0.00%
2020-01-01 00:11:30,4,2,313,0,313,0.48%,0.00%
2020-01-01 00:11:30,4,3,746,6,740,1.14%,0.80%
2020-01-01 00:11:30,4,4,28276,5370,22906,43.15%,18.99%
2020-01-01 00:11:30,4,5,17257,2096,15161,26.33%,12.15%
2020-01-01 00:11:30,4,6,24176,4007,20169,36.89%,16.57%
2020-01-01 00:11:30,4,7,5598,243,5355,8.54%,4.34%
2020-01-01 00:11:30,4,8,3003,71,2932,4.58%,2.36%
2020-01-01 00:11:30,4,9,15195,1651,13544,23.19%,10.87%
2020-01-01 00:11:30,4,10,1982,30,1952,3.02%,1.51%
2020-01-01 00:11:30,4,11,182,2,180,0.28%,1.10%
2020-01-01 00:11:30,4,12,12251,1118,11133,18.69%,9.13%
2020-01-01 00:11:30,5,1,3131,68,3063,4.78%,2.17%
2020-01-01 00:11:30,5,2,1427,12,1415,2.18%,0.84%
2020-01-01 00:11:30,5,3,1913,33,1880,2.92%,1.73%
2020-01-01 00:11:30,5,4,24658,4126,20532,37.63%,16.73%
2020-01-01 00:11:30,5,5,11763,995,10768,17.95%,8.46%
2020-01-01 00:11:30,5,6,17055,2051,15004,26.02%,12.03%
2020-01-01 00:11:30,5,7,4610,162,4448,7.03%,3.51%
2020-01-01 00:11:30,5,8,3198,88,3110,4.88%,2.75%
2020-01-01 00:11:30,5,9,9674,664,9010,14.76%,6.86%
2020-01-01 00:11:30,5,10,1986,32,1954,3.03%,1.61%
2020-01-01 00:11:30,5,11,600,5,595,0.92%,0.83%
2020-01-01 00:11:30,5,12,7369,407,6962,11.24%,5.52%
2020-01-01 00:11:30,6,1,991,7,984,1.51%,0.71%
2020-01-01 00:11:30,6,2,1135,12,1123,1.73%,1.06%
2020-01-01 00:11:30,6,3,1570,35,1535,2.40%,2.23%
2020-01-01 00:11:30,6,4,1824,27,1797,2.78%,1.48%
2020-01-01 00:11:30,6,5,15211,1676,13535,23.21%,11.02%
2020-01-01 00:11:30,6,6,5656,256,5400,8.63%,4.53%
2020-01-01 00:11:30,6,7,3265,82,3183,4.98%,2.51%
2020-01-01 00:11:30,6,8,2815,66,2749,4.30%,2.34%
2020-01-01 00:11:30,6,9,7652,437,7215,11.68%,5.71%
2020-01-01 00:11:30,6,10,1912,30,1882,2.92%,1.57%
2020-01-01 00:11:30,6,11,483,4,479,0.74%,0.83%
2020-01-01 00:11:30,6,12,5659,241,5418,8.63%,4.26%
2020-01-01 00:11:30,7,1,411,1,410,0.63%,0.24%
2020-01-01 00:11:30,7,2,196,0,196,0.30%,0.00%
2020-01-01 00:11:30,7,3,754,4,750,1.15%,0.53%
2020-01-01 00:11:30,7,4,2219,33,2186,3.39%,1.49%
2020-01-01 00:11:30,7,5,6704,342,6362,10.23%,5.10%
2020-01-01 00:11:30,7,6,12312,1152,11160,18.79%,9.36%
2020-01-01 00:11:30,7,7,3353,86,3267,5.12%,2.56%
2020-01-01 00:11:30,7,8,1453,16,1437,2.22%,1.10%
2020-01-01 00:11:30,7,9,5744,269,5475,8.76%,4.68%
2020-01-01 00:11:30,7,10,1271,16,1255,1.94%,1.26%
2020-01-01 00:11:30,7,11,78,0,78,0.12%,0.00%
2020-01-01 00:11:30,7,12,4474,172,4302,6.83%,3.84%
2020-01-01 00:11:30,8,1,452,2,450,0.69%,0.44%
2020-01-01 00:11:30,8,2,126,0,126,0.19%,0.00%
2020-01-01 00:11:30,8,3,1466,19,1447,2.24%,1.30%
2020-01-01 00:11:30,8,4,2909,67,2842,4.44%,2.30%
2020-01-01 00:11:30,8,5,8220,522,7698,12.54%,6.35%
2020-01-01 00:11:30,8,6,16287,1942,14345,24.85%,11.92%
2020-01-01 00:11:30,8,7,5108,199,4909,7.79%,3.90%
2020-01-01 00:11:30,8,8,2283,35,2248,3.48%,1.53%
2020-01-01 00:11:30,8,9,6400,312,6088,9.77%,4.88%
2020-01-01 00:11:30,8,10,1792,30,1762,2.73%,1.67%
2020-01-01 00:11:30,8,11,209,0,209,0.32%,0.00%
2020-01-01 00:11:30,8,12,4426,150,4276,6.75%,3.39%
2020-01-01 00:11:30,9,1,500,0,500,0.76%,0.00%
2020-01-01 00:11:30,9,2,5173,193,4980,7.89%,3.73%
2020-01-01 00:11:30,9,3,4324,140,4184,6.60%,3.24%
2020-01-01 00:11:30,9,4,5834,235,5599,8.90%,4.03%
2020-01-01 00:11:30,9,5,712,4,708,1.09%,0.56%
2020-01-01 00:11:30,9,6,7440,381,7059,11.35%,5.12%
2020-01-01 00:11:30,9,7,29177,5610,23567,44.52%,19.23%
2020-01-01 00:11:30,9,8,8518,543,7975,13.00%,6.37%
2020-01-01 00:11:30,9,9,344,0,344,0.52%,0.00%
2020-01-01 00:11:30,9,10,2233,53,2180,3.41%,2.37%
2020-01-01 00:11:30,9,11,7303,398,6905,11.14%,5.45%
2020-01-01 00:11:30,9,12,4770,175,4595,7.28%,3.67%
2020-01-01 00:11:30,10,1,1000,209,791,1.53%,20.90%
2020-01-01 00:11:30,10,2,2749,266,2483,4.19%,9.68%
2020-01-01 00:11:30,10,3,1644,37,1607,2.51%,2.25%
2020-01-01 00:11:30,10,4,4106,883,3223,6.27%,21.51%
2020-01-01 00:11:30,10,5,711,38,673,1.08%,5.34%
2020-01-01 00:11:30,10,6,5839,1008,4831,8.91%,17.26%
2020-01-01 00:11:30,10,7,10705,1691,9014,16.33%,15.80%
2020-01-01 00:11:30,10,8,28098,7034,21064,42.87%,25.03%
2020-01-01 00:11:30,10,9,627,2,625,0.96%,0.32%
2020-01-01 00:11:30,10,10,2569,52,2517,3.92%,2.02%
2020-01-01 00:11:30,10,11,12849,1657,11192,19.61%,12.90%
2020-01-01 00:11:30,10,12,9756,1185,8571,14.89%,12.15%
2020-01-01 00:11:30,11,1,1965,32,1933,3.00%,1.63%
2020-01-01 00:11:30,11,2,2970,62,2908,4.53%,2.09%
2020-01-01 00:11:30,11,3,763,2,761,1.16%,0.26%
2020-01-01 00:11:30,11,4,2987,92,2895,4.56%,3.08%
2020-01-01 00:11:30,11,5,209,0,209,0.32%,0.00%
2020-01-01 00:11:30,11,6,3740,122,3618,5.71%,3.26%
2020-01-01 00:11:30,11,7,8514,535,7979,12.99%,6.28%
2020-01-01 00:11:30,11,8,22904,3491,19413,34.95%,15.24%
2020-01-01 00:11:30,11,9,220,1,219,0.34%,0.45%
2020-01-01 00:11:30,11,10,2877,67,2810,4.39%,2.33%
2020-01-01 00:11:30,11,11,10198,740,9458,15.56%,7.26%
2020-01-01 00:11:30,11,12,6815,350,6465,10.40%,5.14%
2020-01-01 00:11:30,12,1,29,0,29,0.04%,0.00%
2020-01-01 00:11:30,12,2,548,179,369,0.84%,32.66%
2020-01-01 00:11:30,12,3,2139,211,1928,3.26%,9.86%
2020-01-01 00:11:30,12,4,2684,76,2608,4.10%,2.83%
2020-01-01 00:11:30,12,5,7222,593,6629,11.02%,8.21%
2020-01-01 00:11:30,12,6,4425,179,4246,6.75%,4.05%
2020-01-01 00:11:30,12,7,1578,19,1559,2.41%,1.20%
2020-01-01 00:11:30,12,8,1265,240,1025,1.93%,18.97%
2020-01-01 00:11:30,12,9,20357,3747,16610,31.06%,18.41%
2020-01-01 00:11:30,12,10,3950,345,3605,6.03%,8.73%
2020-01-01 00:11:30,12,11,1537,246,1291,2.35%,16.01%
2020-01-01 00:11:30,12,12,7814,1024,6790,11.92%,13.10%
2020-01-01 00:11:30,13,1,1953,38,1915,2.98%,1.95%
2020-01-01 00:11:30,13,2,2305,46,2259,3.52%,2.00%
2020-01-01 00:11:30,13,3,469,1,468,0.72%,0.21%
2020-01-01 00:11:30,13,4,5448,449,4999,8.31%,8.24%
2020-01-01 00:11:30,13,5,8192,843,7349,12.50%,10.29%
2020-01-01 00:11:30,13,6,6026,504,5522,9.19%,8.36%
2020-01-01 00:11:30,13,7,4832,197,4635,7.37%,4.08%
2020-01-01 00:11:30,13,8,7076,416,6660,10.80%,5.88%
2020-01-01 00:11:30,13,9,8484,871,7613,12.95%,10.27%
2020-01-01 00:11:30,13,10,26783,5227,21556,40.87%,19.52%
2020-01-01 00:11:30,13,11,16056,2004,14052,24.50%,12.48%
2020-01-01 00:11:30,13,12,8512,699,7813,12.99%,8.21%
2020-01-01 00:11:30,14,1,392,4,388,0.60%,1.02%
2020-01-01 00:11:30,14,2,1282,18,1264,1.96%,1.40%
2020-01-01 00:11:30,14,3,678,1,677,1.03%,0.15%
2020-01-01 00:11:30,14,4,3518,91,3427,5.37%,2.59%
2020-01-01 00:11:30,14,5,1183,8,1175,1.81%,0.68%
2020-01-01 00:11:30,14,6,3852,105,3747,5.88%,2.73%
2020-01-01 00:11:30,14,7,10721,851,9870,16.36%,7.94%
2020-01-01 00:11:30,14,8,12203,1104,11099,18.62%,9.05%
2020-01-01 00:11:30,14,9,1404,13,1391,2.14%,0.93%
2020-01-01 00:11:30,14,10,3645,93,3552,5.56%,2.55%
2020-01-01 00:11:30,14,11,24072,3914,20158,36.73%,16.26%
2020-01-01 00:11:30,14,12,7841,444,7397,11.96%,5.66%
2020-01-01 00:11:30,15,1,513,5,508,0.78%,0.97%
2020-01-01 00:11:30,15,2,164,0,164,0.25%,0.00%
2020-01-01 00:11:30,15,3,15100,1607,13493,23.04%,10.64%
2020-01-01 00:11:30,15,4,4693,236,4457,7.16%,5.03%
2020-01-01 00:11:30,15,5,20411,2953,17458,31.14%,14.47%
2020-01-01 00:11:30,15,6,4910,264,4646,7.49%,5.38%
2020-01-01 00:11:30,15,7,3301,84,3217,5.04%,2.54%
2020-01-01 00:11:30,15,8,5154,222,4932,7.86%,4.31%
2020-01-01 00:11:30,15,9,20622,3008,17614,31.47%,14.59%
2020-01-01 00:11:30,15,10,8391,582,7809,12.80%,6.94%
2020-01-01 00:11:30,15,11,13797,1472,12325,21.05%,10.67%
2020-01-01 00:11:30,15,12,39745,10385,29360,60.65%,26.13%
2020-01-01 00:11:30,16,1,483,1,482,0.74%,0.21%
2020-01-01 00:11:30,16,2,252,0,252,0.38%,0.00%
2020-01-01 00:11:30,16,3,1279,20,1259,1.95%,1.56%
2020-01-01 00:11:30,16,4,5247,194,5053,8.01%,3.70%
2020-01-01 00:11:30,16,5,8863,640,8223,13.52%,7.22%
2020-01-01 00:11:30,16,6,6078,271,5807,9.27%,4.46%
2020-01-01 00:11:30,16,7,3247,76,3171,4.95%,2.34%
2020-01-01 00:11:30,16,8,6879,350,6529,10.50%,5.09%
2020-01-01 00:11:30,16,9,9356,704,8652,14.28%,7.52%
2020-01-01 00:11:30,16,10,1943,28,1915,2.96%,1.44%
2020-01-01 00:11:30,16,11,9006,613,8393,13.74%,6.81%
2020-01-01 00:11:30,16,12,25979,4587,21392,39.64%,17.66%
2020-01-01 00:11:40,1,1,15934,1815,14119,24.31%,11.39%
2020-01-01 00:11:40,1,2,5468,239,5229,8.34%,4.37%
2020-01-01 00:11:40,1,3,477,2,475,0.73%,0.42%
2020-01-01 00:11:40,1,4,10045,777,9268,15.33%,7.74%
2020-01-01 00:11:40,1,5,9675,714,8961,14.76%,7.38%
2020-01-01 00:11:40,1,6,9589,708,8881,14.63%,7.38%
2020-01-01 00:11:40,1,7,4982,208,4774,7.60%,4.18%
2020-01-01 00:11:40,1,8,3209,91,3118,4.90%,2.84%
2020-01-01 00:11:40,1,9,9542,692,8850,14.56%,7.25%
2020-01-01 00:11:40,1,10,2493,56,2437,3.80%,2.25%
2020-01-01 00:11:40,1,11,2613,63,2550,3.99%,2.41%
2020-01-01 00:11:40,1,12,9502,690,8812,14.50%,7.26%
2020-01-01 00:11:40,2,1,636,0,636,0.97%,0.00%
2020-01-01 00:11:40,2,2,22899,3553,19346,34.94%,15.52%
2020-01-01 00:11:40,2,3,18106,2268,15838,27.63%,12.53%
2020-01-01 00:11:40,2,4,520,0,520,0.79%,0.00%
2020-01-01 00:11:40,2,5,10328,789,9539,15.76%,7.64%
2020-01-01 00:11:40,2,6,66,0,66,0.10%,0.00%
2020-01-01 00:11:40,2,7,4130,146,3984,6.30%,3.54%
2020-01-01 00:11:40,2,8,2883,87,2796,4.40%,3.02%
2020-01-01 00:11:40,2,9,10207,775,9432,15.57%,7.59%
2020-01-01 00:11:40,2,10,2176,46,2130,3.32%,2.11%
2020-01-01 00:11:40,2,11,2192,46,2146,3.34%,2.10%
2020-01-01 00:11:40,2,12,10052,753,9299,15.34%,7.49%
2020-01-01 00:11:40,3,1,1691,32,1659,2.58%,1.89%
2020-01-01 00:11:40,3,2,24646,4167,20479,37.61%,16.91%
2020-01-01 00:11:40,3,3,75054,30414,44640,114.52%,40.52%
2020-01-01 00:11:40,3,4,9938,737,9201,15.16%,7.42%
2020-01-01 00:11:40,3,5,49622,14829,34793,75.72%,29.88%
2020-01-01 00:11:40,3,6,10738,856,9882,16.38%,7.97%
2020-01-01 00:11:40,3,7,21423,3201,18222,32.69%,14.94%
2020-01-01 00:11:40,3,8,18704,2463,16241,28.54%,13.17%
2020-01-01 00:11:40,3,9,38402,9330,29072,58.60%,24.30%
2020-01-01 00:11:40,3,10,6375,303,6072,9.73%,4.75%
2020-01-01 00:11:40,3,11,2056,21,2035,3.14%,1.02%
2020-01-01 00:11:40,3,12,29686,5847,23839,45.30%,19.70%
2020-01-01 00:11:40,4,1,703,4,699,1.07%,0.57%
2020-01-01 00:11:40,4,2,463,3,460,0.71%,0.65%
2020-01-01 00:11:40,4,3,728,3,725,1.11%,0.41%
2020-01-01 00:11:40,4,4,28709,5522,23187,43.81%,19.23%
2020-01-01 00:11:40,4,5,16990,2058,14932,25.92%,12.11%
2020-01-01 00:11:40,4,6,23875,3872,20003,36.43%,16.22%
2020-01-01 00:11:40,4,7,5514,228,5286,8.41%,4.13%
2020-01-01 00:11:40,4,8,3144,68,3076,4.80%,2.16%
2020-01-01 00:11:40,4,9,14985,1633,13352,22.87%,10.90%
2020-01-01 00:11:40,4,10,1913,25,1888,2.92%,1.31%
2020-01-01 00:11:40,4,11,243,0,243,0.37%,0.00%
2020-01-01 00:11:40,4,12,12439,1115,11324,18.98%,8.96%
2020-01-01 00:11:40,5,1,3137,78,3059,4.79%,2.49%
2020-01-01 00:11:40,5,2,1210,10,1200,1.85%,0.83%
2020-01-01 00:11:40,5,3,455,2,453,0.69%,0.44%
2020-01-01 00:11:40,5,4,19702,2676,17026,30.06%,13.58%
2020-01-01 00:11:40,5,5,8683,593,8090,13.25%,6.83%
2020-01-01 00:11:40,5,6,13408,1287,12121,20.46%,9.60%
2020-01-01 00:11:40,5,7,4110,133,3977,6.27%,3.24%
2020-01-01 00:11:40,5,8,3030,65,2965,4.62%,2.15%
2020-01-01 00:11:40,5,9,8072,513,7559,12.32%,6.36%
2020-01-01 00:11:40,5,10,1048,11,1037,1.60%,1.05%
2020-01-01 00:11:40,5,11,456,3,453,0.70%,0.66%
2020-01-01 00:11:40,5,12,6681,347,6334,10.19%,5.19%
2020-01-01 00:11:40,6,1,1159,8,1151,1.77%,0.69%
2020-01-01 00:11:40,6,2,1304,12,1292,1.99%,0.92%
2020-01-01 00:11:40,6,3,1800,17,1783,2.75%,0.94%
2020-01-01 00:11:40,6,4,2324,31,2293,3.55%,1.33%
2020-01-01 00:11:40,6,5,14641,1540,13101,22.34%,10.52%
2020-01-01 00:11:40,6,6,6353,317,6036,9.69%,4.99%
2020-01-01 00:11:40,6,7,3546,87,3459,5.41%,2.45%
2020-01-01 00:11:40,6,8,3115,68,3047,4.75%,2.18%
2020-01-01 00:11:40,6,9,6190,288,5902,9.45%,4.65%
2020-01-01 00:11:40,6,10,1854,26,1828,2.83%,1.40%
2020-01-01 00:11:40,6,11,435,0,435,0.66%,0.00%
2020-01-01 00:11:40,6,12,4300,138,4162,6.56%,3.21%
2020-01-01 00:11:40,7,1,318,2,316,0.49%,0.63%
2020-01-01 00:11:40,7,2,260,1,259,0.40%,0.38%
2020-01-01 00:11:40,7,3,512,1,511,0.78%,0.20%
2020-01-01 00:11:40,7,4,2629,52,2577,4.01%,1.98%
2020-01-01 00:11:40,7,5,7208,358,6850,11.00%,4.97%
2020-01-01 00:11:40,7,6,13506,1280,12226,20.61%,9.48%
2020-01-01 00:11:40,7,7,3634,119,3515,5.55%,3.27%
2020-01-01 00:11:40,7,8,1542,27,1515,2.35%,1.75%
2020-01-01 00:11:40,7,9,5884,248,5636,8.98%,4.21%
2020-01-01 00:11:40,7,10,1015,5,1010,1.55%,0.49%
2020-01-01 00:11:40,7,11,70,0,70,0.11%,0.00%
2020-01-01 00:11:40,7,12,4861,171,4690,7.42%,3.52%
2020-01-01 00:11:40,8,1,526,2,524,0.80%,0.38%
2020-01-01 00:11:40,8,2,121,0,121,0.18%,0.00%
2020-01-01 00:11:40,8,3,1668,16,1652,2.55%,0.96%
2020-01-01 00:11:40,8,4,3103,59,3044,4.73%,1.90%
2020-01-01 00:11:40,8,5,8778,550,8228,13.39%,6.27%
2020-01-01 00:11:40,8,6,16539,1875,14664,25.24%,11.34%
2020-01-01 00:11:40,8,7,4614,159,4455,7.04%,3.45%
2020-01-01 00:11:40,8,8,1915,25,1890,2.92%,1.31%
2020-01-01 00:11:40,8,9,6757,341,6416,10.31%,5.05%
2020-01-01 00:11:40,8,10,1762,28,1734,2.69%,1.59%
2020-01-01 00:11:40,8,11,200,0,200,0.31%,0.00%
2020-01-01 00:11:40,8,12,5038,204,4834,7.69%,4.05%
2020-01-01 00:11:40,9,1,393,2,391,0.60%,0.51%
2020-01-01 00:11:40,9,2,2559,50,2509,3.90%,1.95%
2020-01-01 00:11:40,9,3,1666,21,1645,2.54%,1.26%
2020-01-01 00:11:40,9,4,4813,167,4646,7.34%,3.47%
2020-01-01 00:11:40,9,5,679,1,678,1.04%,0.15%
2020-01-01 00:11:40,9,6,6647,313,6334,10.14%,4.71%
2020-01-01 00:11:40,9,7,23135,3633,19502,35.30%,15.70%
2020-01-01 00:11:40,9,8,8789,592,8197,13.41%,6.74%
2020-01-01 00:11:40,9,9,304,0,304,0.46%,0.00%
2020-01-01 00:11:40,9,10,2010,33,1977,3.07%,1.64%
2020-01-01 00:11:40,9,11,7873,476,7397,12.01%,6.05%
2020-01-01 00:11:40,9,12,5569,251,5318,8.50%,4.51%
2020-01-01 00:11:40,10,1,1372,265,1107,2.09%,19.31%
2020-01-01 00:11:40,10,2,3196,319,2877,4.88%,9.98%
2020-01-01 00:11:40,10,3,1715,19,1696,2.62%,1.11%
2020-01-01 00:11:40,10,4,5521,1124,4397,8.42%,20.36%
2020-01-01 00:11:40,10,5,1054,58,996,1.61%,5.50%
2020-01-01 00:11:40,10,6,7251,1294,5957,11.06%,17.85%
2020-01-01 00:11:40,10,7,12328,2151,10177,18.81%,17.45%
2020-01-01 00:11:40,10,8,30146,7919,22227,46.00%,26.27%
2020-01-01 00:11:40,10,9,603,3,600,0.92%,0.50%
2020-01-01 00:11:40,10,10,2038,29,2009,3.11%,1.42%
2020-01-01 00:11:40,10,11,13633,1643,11990,20.80%,12.05%
2020-01-01 00:11:40,10,12,10899,1195,9704,16.63%,10.96%
2020-01-01 00:11:40,11,1,2175,55,2120,3.32%,2.53%
2020-01-01 00:11:40,11,2,3163,100,3063,4.83%,3.16%
2020-01-01 00:11:40,11,3,815,5,810,1.24%,0.61%
2020-01-01 00:11:40,11,4,5132,191,4941,7.83%,3.72%
2020-01-01 00:11:40,11,5,181,0,181,0.28%,0.00%
2020-01-01 00:11:40,11,6,5918,258,5660,9.03%,4.36%
2020-01-01 00:11:40,11,7,10907,874,10033,16.64%,8.01%
2020-01-01 00:11:40,11,8,26000,4534,21466,39.67%,17.44%
2020-01-01 00:11:40,11,9,168,0,168,0.26%,0.00%
2020-01-01 00:11:40,11,10,3091,81,3010,4.72%,2.62%
2020-01-01 00:11:40,11,11,10279,787,9492,15.68%,7.66%
2020-01-01 00:11:40,11,12,6633,323,6310,10.12%,4.87%
2020-01-01 00:11:40,12,1,43,0,43,0.07%,0.00%
2020-01-01 00:11:40,12,2,554,129,425,0.85%,23.29%
2020-01-01 00:11:40,12,3,2605,170,2435,3.97%,6.53%
2020-01-01 00:11:40,12,4,3251,87,3164,4.96%,2.68%
2020-01-01 00:11:40,12,5,8080,598,7482,12.33%,7.40%
2020-01-01 00:11:40,12,6,4801,195,4606,7.33%,4.06%
2020-01-01 00:11:40,12,7,1378,13,1365,2.10%,0.94%
2020-01-01 00:11:40,12,8,1573,310,1263,2.40%,19.71%
2020-01-01 00:11:40,12,9,21601,4156,17445,32.96%,19.24%
2020-01-01 00:11:40,12,10,4339,434,3905,6.62%,10.00%
2020-01-01 00:11:40,12,11,1801,315,1486,2.75%,17.49%
2020-01-01 00:11:40,12,12,7879,1229,6650,12.02%,15.60%
2020-01-01 00:11:40,13,1,1664,32,1632,2.54%,1.92%
2020-01-01 00:11:40,13,2,2083,41,2042,3.18%,1.97%
2020-01-01 00:11:40,13,3,669,3,666,1.02%,0.45%
2020-01-01 00:11:40,13,4,4922,634,4288,7.51%,12.88%
2020-01-01 00:11:40,13,5,7353,991,6362,11.22%,13.48%
2020-01-01 00:11:40,13,6,5494,677,4817,8.38%,12.32%
2020-01-01 00:11:40,13,7,4299,150,4149,6.56%,3.49%
2020-01-01 00:11:40,13,8,6903,362,6541,10.53%,5.24%
2020-01-01 00:11:40,13,9,7679,1024,6655,11.72%,13.34%
2020-01-01 00:11:40,13,10,29477,6409,23068,44.98%,21.74%
2020-01-01 00:11:40,13,11,18141,2542,15599,27.68%,14.01%
2020-01-01 00:11:40,13,12,10815,1063,9752,16.50%,9.83%
2020-01-01 00:11:40,14,1,277,0,277,0.42%,0.00%
2020-01-01 00:11:40,14,2,1406,15,1391,2.15%,1.07%
2020-01-01 00:11:40,14,3,887,7,880,1.35%,0.79%
2020-01-01 00:11:40,14,4,4912,178,4734,7.50%,3.62%
2020-01-01 00:11:40,14,5,1208,11,1197,1.84%,0.91%
2020-01-01 00:11:40,14,6,5247,204,5043,8.01%,3.89%
2020-01-01 00:11:40,14,7,12593,1140,11453,19.22%,9.05%
2020-01-01 00:11:40,14,8,14167,1442,12725,21.62%,10.18%
2020-01-01 00:11:40,14,9,1405,20,1385,2.14%,1.42%
2020-01-01 00:11:40,14,10,4319,155,4164,6.59%,3.59%
2020-01-01 00:11:40,14,11,27593,5051,22542,42.10%,18.31%
2020-01-01 00:11:40,14,12,8757,556,8201,13.36%,6.35%
2020-01-01 00:11:40,15,1,520,2,518,0.79%,0.38%
2020-01-01 00:11:40,15,2,145,0,145,0.22%,0.00%
2020-01-01 00:11:40,15,3,13282,1245,12037,20.27%,9.37%
2020-01-01 00:11:40,15,4,4679,274,4405,7.14%,5.86%
2020-01-01 00:11:40,15,5,19338,2900,16438,29.51%,15.00%
2020-01-01 00:11:40,15,6,5007,339,4668,7.64%,6.77%
2020-01-01 00:11:40,15,7,3038,75,2963,4.64%,2.47%
2020-01-01 00:11:40,15,8,5625,251,5374,8.58%,4.46%
2020-01-01 00:11:40,15,9,19523,2949,16574,29.79%,15.11%
2020-01-01 00:11:40,15,10,8093,638,7455,12.35%,7.88%
2020-01-01 00:11:40,15,11,13898,1538,12360,21.21%,11.07%
2020-01-01 00:11:40,15,12,39034,10171,28863,59.56%,26.06%
2020-01-01 00:11:40,16,1,414,1,413,0.63%,0.24%
2020-01-01 00:11:40,16,2,282,2,280,0.43%,0.71%
2020-01-01 00:11:40,16,3,1412,14,1398,2.15%,0.99%
2020-01-01 00:11:40,16,4,4565,119,4446,6.97%,2.61%
2020-01-01 00:11:40,16,5,8852,595,8257,13.51%,6.72%
2020-01-01 00:11:40,16,6,5599,199,5400,8.54%,3.55%
2020-01-01 00:11:40,16,7,2954,64,2890,4.51%,2.17%
2020-01-01 00:11:40,16,8,6986,399,6587,10.66%,5.71%
2020-01-01 00:11:40,16,9,9260,641,8619,14.13%,6.92%
2020-01-01 00:11:40,16,10,1495,19,1476,2.28%,1.27%
2020-01-01 00:11:40,16,11,8646,599,8047,13.19%,6.93%
2020-01-01 00:11:40,16,12,25919,4696,21223,39.55%,18.12%
2020-01-01 00:11:50,1,1,16204,1920,14284,24.73%,11.85%
2020-01-01 00:11:50,1,2,6843,380,6463,10.44%,5.55%
2020-01-01 00:11:50,1,3,716,3,713,1.09%,0.42%
2020-01-01 00:11:50,1,4,8943,636,8307,13.65%,7.11%
2020-01-01 00:11:50,1,5,8551,593,7958,13.05%,6.93%
2020-01-01 00:11:50,1,6,8528,591,7937,13.01%,6.93%
2020-01-01 00:11:50,1,7,6104,312,5792,9.31%,5.11%
2020-01-01 00:11:50,1,8,5118,216,4902,7.81%,4.22%
2020-01-01 00:11:50,1,9,8463,584,7879,12.91%,6.90%
2020-01-01 00:11:50,1,10,4331,163,4168,6.61%,3.76%
2020-01-01 00:11:50,1,11,4402,171,4231,6.72%,3.88%
2020-01-01 00:11:50,1,12,8434,584,7850,12.87%,6.92%
2020-01-01 00:11:50,2,1,706,3,703,1.08%,0.42%
2020-01-01 00:11:50,2,2,26395,4615,21780,40.28%,17.48%
2020-01-01 00:11:50,2,3,20013,2738,17275,30.54%,13.68%
2020-01-01 00:11:50,2,4,428,1,427,0.65%,0.23%
2020-01-01 00:11:50,2,5,10942,857,10085,16.70%,7.83%
2020-01-01 00:11:50,2,6,48,0,48,0.07%,0.00%
2020-01-01 00:11:50,2,7,5647,232,5415,8.62%,4.11%
2020-01-01 00:11:50,2,8,4616,163,4453,7.04%,3.53%
2020-01-01 00:11:50,2,9,10797,832,9965,16.47%,7.71%
2020-01-01 00:11:50,2,10,3771,111,3660,5.75%,2.94%
2020-01-01 00:11:50,2,11,3785,111,3674,5.78%,2.93%
2020-01-01 00:11:50,2,12,10600,808,9792,16.17%,7.62%
2020-01-01 00:11:50,3,1,2680,58,2622,4.09%,2.16%
2020-01-01 00:11:50,3,2,23101,3648,19453,35.25%,15.79%
2020-01-01 00:11:50,3,3,72403,28527,43876,110.48%,39.40%
2020-01-01 00:11:50,3,4,9656,683,8973,14.73%,7.07%
2020-01-01 00:11:50,3,5,48134,14048,34086,73.45%,29.19%
2020-01-01 00:11:50,3,6,10551,820,9731,16.10%,7.77%
2020-01-01 00:11:50,3,7,19038,2538,16500,29.05%,13.33%
2020-01-01 00:11:50,3,8,15331,1695,13636,23.39%,11.06%
2020-01-01 00:11:50,3,9,37222,8853,28369,56.80%,23.78%
2020-01-01 00:11:50,3,10,8359,544,7815,12.75%,6.51%
2020-01-01 00:11:50,3,11,2124,39,2085,3.24%,1.84%
2020-01-01 00:11:50,3,12,26478,4692,21786,40.40%,17.72%
2020-01-01 00:11:50,4,1,583,5,578,0.89%,0.86%
2020-01-01 00:11:50,4,2,385,2,383,0.59%,0.52%
2020-01-01 00:11:50,4,3,873,6,867,1.33%,0.69%
2020-01-01 00:11:50,4,4,29599,5778,23821,45.16%,19.52%
2020-01-01 00:11:50,4,5,17681,2227,15454,26.98%,12.60%
2020-01-01 00:11:50,4,6,25443,4377,21066,38.82%,17.20%
2020-01-01 00:11:50,4,7,6302,341,5961,9.62%,5.41%
2020-01-01 00:11:50,4,8,2909,64,2845,4.44%,2.20%
2020-01-01 00:11:50,4,9,15799,1816,13983,24.11%,11.49%
2020-01-01 00:11:50,4,10,1897,45,1852,2.89%,2.37%
2020-01-01 00:11:50,4,11,191,0,191,0.29%,0.00%
2020-01-01 00:11:50,4,12,13266,1285,11981,20.24%,9.69%
2020-01-01 00:11:50,5,1,3144,80,3064,4.80%,2.54%
2020-01-01 00:11:50,5,2,731,6,725,1.12%,0.82%
2020-01-01 00:11:50,5,3,418,2,416,0.64%,0.48%
2020-01-01 00:11:50,5,4,22243,3312,18931,33.94%,14.89%
2020-01-01 00:11:50,5,5,9235,642,8593,14.09%,6.95%
2020-01-01 00:11:50,5,6,15033,1612,13421,22.94%,10.72%
2020-01-01 00:11:50,5,7,5294,215,5079,8.08%,4.06%
2020-01-01 00:11:50,5,8,4445,154,4291,6.78%,3.46%
2020-01-01 00:11:50,5,9,8281,532,7749,12.64%,6.42%
2020-01-01 00:11:50,5,10,1082,12,1070,1.65%,1.11%
2020-01-01 00:11:50,5,11,755,6,749,1.15%,0.79%
2020-01-01 00:11:50,5,12,6943,374,6569,10.59%,5.39%
2020-01-01 00:11:50,6,1,1172,13,1159,1.79%,1.11%
2020-01-01 00:11:50,6,2,1318,17,1301,2.01%,1.29%
2020-01-01 00:11:50,6,3,1805,21,1784,2.75%,1.16%
2020-01-01 00:11:50,6,4,1327,22,1305,2.02%,1.66%
2020-01-01 00:11:50,6,5,15537,1704,13833,23.71%,10.97%
2020-01-01 00:11:50,6,6,6183,294,5889,9.43%,4.75%
2020-01-01 00:11:50,6,7,4310,157,4153,6.58%,3.64%
2020-01-01 00:11:50,6,8,3643,113,3530,5.56%,3.10%
2020-01-01 00:11:50,6,9,7267,406,6861,11.09%,5.59%
2020-01-01 00:11:50,6,10,2507,37,2470,3.83%,1.48%
2020-01-01 00:11:50,6,11,405,1,404,0.62%,0.25%
2020-01-01 00:11:50,6,12,4646,175,4471,7.09%,3.77%
2020-01-01 00:11:50,7,1,460,6,454,0.70%,1.30%
2020-01-01 00:11:50,7,2,211,0,211,0.32%,0.00%
2020-01-01 00:11:50,7,3,1222,10,1212,1.86%,0.82%
2020-01-01 00:11:50,7,4,1928,41,1887,2.94%,2.13%
2020-01-01 00:11:50,7,5,7611,487,7124,11.61%,6.40%
2020-01-01 00:11:50,7,6,13070,1387,11683,19.94%,10.61%
2020-01-01 00:11:50,7,7,3478,89,3389,5.31%,2.56%
2020-01-01 00:11:50,7,8,1204,8,1196,1.84%,0.66%
2020-01-01 00:11:50,7,9,6226,322,5904,9.50%,5.17%
2020-01-01 00:11:50,7,10,866,10,856,1.32%,1.15%
2020-01-01 00:11:50,7,11,77,0,77,0.12%,0.00%
2020-01-01 00:11:50,7,12,5390,240,5150,8.22%,4.45%
2020-01-01 00:11:50,8,1,491,3,488,0.75%,0.61%
2020-01-01 00:11:50,8,2,91,0,91,0.14%,0.00%
2020-01-01 00:11:50,8,3,1448,15,1433,2.21%,1.04%
2020-01-01 00:11:50,8,4,2716,67,2649,4.14%,2.47%
2020-01-01 00:11:50,8,5,8567,496,8071,13.07%,5.79%
2020-01-01 00:11:50,8,6,16321,1814,14507,24.90%,11.11%
2020-01-01 00:11:50,8,7,5004,193,4811,7.64%,3.86%
2020-01-01 00:11:50,8,8,1797,22,1775,2.74%,1.22%
2020-01-01 00:11:50,8,9,6845,330,6515,10.44%,4.82%
2020-01-01 00:11:50,8,10,1881,23,1858,2.87%,1.22%
2020-01-01 00:11:50,8,11,198,2,196,0.30%,1.01%
2020-01-01 00:11:50,8,12,4876,174,4702,7.44%,3.57%
2020-01-01 00:11:50,9,1,306,2,304,0.47%,0.65%
2020-01-01 00:11:50,9,2,3367,71,3296,5.14%,2.11%
2020-01-01 00:11:50,9,3,2673,45,2628,4.08%,1.68%
2020-01-01 00:11:50,9,4,5418,211,5207,8.27%,3.89%
2020-01-01 00:11:50,9,5,265,0,265,0.40%,0.00%
2020-01-01 00:11:50,9,6,6840,350,6490,10.44%,5.12%
2020-01-01 00:11:50,9,7,30318,5979,24339,46.26%,19.72%
2020-01-01 00:11:50,9,8,12927,1141,11786,19.73%,8.83%
2020-01-01 00:11:50,9,9,199,0,199,0.30%,0.00%
2020-01-01 00:11:50,9,10,4895,164,4731,7.47%,3.35%
2020-01-01 00:11:50,9,11,11857,961,10896,18.09%,8.10%
2020-01-01 00:11:50,9,12,6561,317,6244,10.01%,4.83%
2020-01-01 00:11:50,10,1,1426,255,1171,2.18%,17.88%
2020-01-01 00:11:50,10,2,3759,315,3444,5.74%,8.38%
2020-01-01 00:11:50,10,3,1701,15,1686,2.60%,0.88%
2020-01-01 00:11:50,10,4,4205,864,3341,6.42%,20.55%
2020-01-01 00:11:50,10,5,792,37,755,1.21%,4.67%
2020-01-01 00:11:50,10,6,6059,1031,5028,9.25%,17.02%
2020-01-01 00:11:50,10,7,11471,1813,9658,17.50%,15.81%
2020-01-01 00:11:50,10,8,29367,7406,21961,44.81%,25.22%
2020-01-01 00:11:50,10,9,601,2,599,0.92%,0.33%
2020-01-01 00:11:50,10,10,2497,41,2456,3.81%,1.64%
2020-01-01 00:11:50,10,11,14279,1794,12485,21.79%,12.56%
2020-01-01 00:11:50,10,12,11253,1292,9961,17.17%,11.48%
2020-01-01 00:11:50,11,1,2282,45,2237,3.48%,1.97%
2020-01-01 00:11:50,11,2,3305,100,3205,5.04%,3.03%
2020-01-01 00:11:50,11,3,879,8,871,1.34%,0.91%
2020-01-01 00:11:50,11,4,2964,82,2882,4.52%,2.77%
2020-01-01 00:11:50,11,5,171,1,170,0.26%,0.58%
2020-01-01 00:11:50,11,6,3668,111,3557,5.60%,3.03%
2020-01-01 00:11:50,11,7,8881,598,8283,13.55%,6.73%
2020-01-01 00:11:50,11,8,22730,3633,19097,34.68%,15.98%
2020-01-01 00:11:50,11,9,205,0,205,0.31%,0.00%
2020-01-01 00:11:50,11,10,2939,67,2872,4.48%,2.28%
2020-01-01 00:11:50,11,11,9846,695,9151,15.02%,7.06%
2020-01-01 00:11:50,11,12,6432,296,6136,9.81%,4.60%
2020-01-01 00:11:50,12,1,31,0,31,0.05%,0.00%
2020-01-01 00:11:50,12,2,549,178,371,0.84%,32.42%
2020-01-01 00:11:50,12,3,2558,218,2340,3.90%,8.52%
2020-01-01 00:11:50,12,4,3305,81,3224,5.04%,2.45%
2020-01-01 00:11:50,12,5,8781,717,8064,13.40%,8.17%
2020-01-01 00:11:50,12,6,5395,187,5208,8.23%,3.47%
2020-01-01 00:11:50,12,7,1981,31,1950,3.02%,1.56%
2020-01-01 00:11:50,12,8,1409,352,1057,2.15%,24.98%
2020-01-01 00:11:50,12,9,22291,4445,17846,34.01%,19.94%
2020-01-01 00:11:50,12,10,4414,457,3957,6.74%,10.35%
2020-01-01 00:11:50,12,11,1837,359,1478,2.80%,19.54%
2020-01-01 00:11:50,12,12,8147,1305,6842,12.43%,16.02%
2020-01-01 00:11:50,13,1,1922,29,1893,2.93%,1.51%
2020-01-01 00:11:50,13,2,2278,44,2234,3.48%,1.93%
2020-01-01 00:11:50,13,3,646,4,642,0.99%,0.62%
2020-01-01 00:11:50,13,4,5734,607,5127,8.75%,10.59%
2020-01-01 00:11:50,13,5,7947,977,6970,12.13%,12.29%
2020-01-01 00:11:50,13,6,6440,668,5772,9.83%,10.37%
2020-01-01 00:11:50,13,7,4802,148,4654,7.33%,3.08%
2020-01-01 00:11:50,13,8,7261,354,6907,11.08%,4.88%
2020-01-01 00:11:50,13,9,8303,1015,7288,12.67%,12.22%
2020-01-01 00:11:50,13,10,30750,6808,23942,46.92%,22.14%
2020-01-01 00:11:50,13,11,18003,2536,15467,27.47%,14.09%
2020-01-01 00:11:50,13,12,10254,1121,9133,15.65%,10.93%
2020-01-01 00:11:50,14,1,319,0,319,0.49%,0.00%
2020-01-01 00:11:50,14,2,1598,12,1586,2.44%,0.75%
2020-01-01 00:11:50,14,3,1152,5,1147,1.76%,0.43%
2020-01-01 00:11:50,14,4,4951,179,4772,7.55%,3.62%
2020-01-01 00:11:50,14,5,1525,25,1500,2.33%,1.64%
2020-01-01 00:11:50,14,6,5290,211,5079,8.07%,3.99%
2020-01-01 00:11:50,14,7,12653,1146,11507,19.31%,9.06%
2020-01-01 00:11:50,14,8,14226,1434,12792,21.71%,10.08%
2020-01-01 00:11:50,14,9,1713,34,1679,2.61%,1.98%
2020-01-01 00:11:50,14,10,4800,173,4627,7.32%,3.60%
2020-01-01 00:11:50,14,11,30000,5874,24126,45.78%,19.58%
2020-01-01 00:11:50,14,12,10627,818,9809,16.22%,7.70%
2020-01-01 00:11:50,15,1,537,2,535,0.82%,0.37%
2020-01-01 00:11:50,15,2,161,0,161,0.25%,0.00%
2020-01-01 00:11:50,15,3,3361,88,3273,5.13%,2.62%
2020-01-01 00:11:50,15,4,5426,292,5134,8.28%,5.38%
2020-01-01 00:11:50,15,5,9971,948,9023,15.21%,9.51%
2020-01-01 00:11:50,15,6,5777,338,5439,8.82%,5.85%
2020-01-01 00:11:50,15,7,3378,73,3305,5.15%,2.16%
2020-01-01 00:11:50,15,8,5443,205,5238,8.31%,3.77%
2020-01-01 00:11:50,15,9,10217,983,9234,15.59%,9.62%
2020-01-01 00:11:50,15,10,6421,394,6027,9.80%,6.14%
2020-01-01 00:11:50,15,11,11987,1076,10911,18.29%,8.98%
2020-01-01 00:11:50,15,12,27841,5678,22163,42.48%,20.39%
2020-01-01 00:11:50,16,1,398,4,394,0.61%,1.01%
2020-01-01 00:11:50,16,2,257,1,256,0.39%,0.39%
2020-01-01 00:11:50,16,3,1338,16,1322,2.04%,1.20%
2020-01-01 00:11:50,16,4,3887,136,3751,5.93%,3.50%
2020-01-01 00:11:50,16,5,7551,513,7038,11.52%,6.79%
2020-01-01 00:11:50,16,6,4902,187,4715,7.48%,3.81%
2020-01-01 00:11:50,16,7,3280,91,3189,5.00%,2.77%
2020-01-01 00:11:50,16,8,7265,461,6804,11.09%,6.35%
2020-01-01 00:11:50,16,9,7958,559,7399,12.14%,7.02%
2020-01-01 00:11:50,16,10,1484,20,1464,2.26%,1.35%
2020-01-01 00:11:50,16,11,8972,661,8311,13.69%,7.37%
2020-01-01 00:11:50,16,12,24838,4370,20468,37.90%,17.59%
2020-01-01 00:12:00,1,1,15879,1807,14072,24.23%,11.38%
2020-01-01 00:12:00,1,2,6427,323,6104,9.81%,5.03%
2020-01-01 00:12:00,1,3,625,6,619,0.95%,0.96%
2020-01-01 00:12:00,1,4,8988,607,8381,13.71%,6.75%
2020-01-01 00:12:00,1,5,8584,563,8021,13.10%,6.56%
2020-01-01 00:12:00,1,6,8512,552,7960,12.99%,6.48%
2020-01-01 00:12:00,1,7,5780,256,5524,8.82%,4.43%
2020-01-01 00:12:00,1,8,4737,179,4558,7.23%,3.78%
2020-01-01 00:12:00,1,9,8473,548,7925,12.93%,6.47%
2020-01-01 00:12:00,1,10,4062,131,3931,6.20%,3.23%
2020-01-01 00:12:00,1,11,4147,134,4013,6.33%,3.23%
2020-01-01 00:12:00,1,12,8409,541,7868,12.83%,6.43%
2020-01-01 00:12:00,2,1,996,4,992,1.52%,0.40%
2020-01-01 00:12:00,2,2,30266,6076,24190,46.18%,20.08%
2020-01-01 00:12:00,2,3,24163,3990,20173,36.87%,16.51%
2020-01-01 00:12:00,2,4,869,3,866,1.33%,0.35%
2020-01-01 00:12:00,2,5,15213,1686,13527,23.21%,11.08%
2020-01-01 00:12:00,2,6,44,0,44,0.07%,0.00%
2020-01-01 00:12:00,2,7,5089,216,4873,7.77%,4.24%
2020-01-01 00:12:00,2,8,3584,97,3487,5.47%,2.71%
2020-01-01 00:12:00,2,9,15065,1653,13412,22.99%,10.97%
2020-01-01 00:12:00,2,10,2845,61,2784,4.34%,2.14%
2020-01-01 00:12:00,2,11,2856,61,2795,4.36%,2.14%
2020-01-01 00:12:00,2,12,14879,1609,13270,22.70%,10.81%
2020-01-01 00:12:00,3,1,1448,16,1432,2.21%,1.10%
2020-01-01 00:12:00,3,2,22429,3415,19014,34.22%,15.23%
2020-01-01 00:12:00,3,3,66432,24709,41723,101.37%,37.19%
2020-01-01 00:12:00,3,4,5441,225,5216,8.30%,4.14%
2020-01-01 00:12:00,3,5,43201,11555,31646,65.92%,26.75%
2020-01-01 00:12:00,3,6,6341,290,6051,9.68%,4.57%
2020-01-01 00:12:00,3,7,19373,2592,16781,29.56%,13.38%
2020-01-01 00:12:00,3,8,15369,1668,13701,23.45%,10.85%
2020-01-01 00:12:00,3,9,36464,8455,28009,55.64%,23.19%
2020-01-01 00:12:00,3,10,7999,493,7506,12.21%,6.16%
2020-01-01 00:12:00,3,11,2326,45,2281,3.55%,1.93%
2020-01-01 00:12:00,3,12,25667,4320,21347,39.16%,16.83%
2020-01-01 00:12:00,4,1,552,3,549,0.84%,0.54%
2020-01-01 00:12:00,4,2,327,1,326,0.50%,0.31%
2020-01-01 00:12:00,4,3,736,4,732,1.12%,0.54%
2020-01-01 00:12:00,4,4,29079,5481,23598,44.37%,18.85%
2020-01-01 00:12:00,4,5,17481,2155,15326,26.67%,12.33%
2020-01-01 00:12:00,4,6,25143,4207,20936,38.37%,16.73%
2020-01-01 00:12:00,4,7,6263,263,6000,9.56%,4.20%
2020-01-01 00:12:00,4,8,2703,54,2649,4.12%,2.00%
2020-01-01 00:12:00,4,9,15579,1732,13847,23.77%,11.12%
2020-01-01 00:12:00,4,10,1954,35,1919,2.98%,1.79%
2020-01-01 00:12:00,4,11,202,0,202,0.31%,0.00%
2020-01-01 00:12:00,4,12,12784,1177,11607,19.51%,9.21%
2020-01-01 00:12:00,5,1,2875,87,2788,4.39%,3.03%
2020-01-01 00:12:00,5,2,725,10,715,1.11%,1.38%
2020-01-01 00:12:00,5,3,429,1,428,0.65%,0.23%
2020-01-01 00:12:00,5,4,26333,4583,21750,40.18%,17.40%
2020-01-01 00:12:00,5,5,9847,685,9162,15.03%,6.96%
2020-01-01 00:12:00,5,6,15908,1730,14178,24.27%,10.88%
2020-01-01 00:12:00,5,7,5549,219,5330,8.47%,3.95%
2020-01-01 00:12:00,5,8,3419,73,3346,5.22%,2.14%
2020-01-01 00:12:00,5,9,9205,612,8593,14.05%,6.65%
2020-01-01 00:12:00,5,10,1333,15,1318,2.03%,1.13%
2020-01-01 00:12:00,5,11,685,3,682,1.05%,0.44%
2020-01-01 00:12:00,5,12,7610,436,7174,11.61%,5.73%
2020-01-01 00:12:00,6,1,1127,12,1115,1.72%,1.06%
2020-01-01 00:12:00,6,2,1281,17,1264,1.95%,1.33%
2020-01-01 00:12:00,6,3,1800,23,1777,2.75%,1.28%
2020-01-01 00:12:00,6,4,1103,6,1097,1.68%,0.54%
2020-01-01 00:12:00,6,5,13148,1246,11902,20.06%,9.48%
2020-01-01 00:12:00,6,6,4646,193,4453,7.09%,4.15%
2020-01-01 00:12:00,6,7,3097,80,3017,4.73%,2.58%
2020-01-01 00:12:00,6,8,2533,48,2485,3.87%,1.89%
2020-01-01 00:12:00,6,9,6337,328,6009,9.67%,5.18%
2020-01-01 00:12:00,6,10,2012,34,1978,3.07%,1.69%
2020-01-01 00:12:00,6,11,382,0,382,0.58%,0.00%
2020-01-01 00:12:00,6,12,4265,135,4130,6.51%,3.17%
2020-01-01 00:12:00,7,1,377,1,376,0.58%,0.27%
2020-01-01 00:12:00,7,2,191,0,191,0.29%,0.00%
2020-01-01 00:12:00,7,3,990,6,984,1.51%,0.61%
2020-01-01 00:12:00,7,4,1897,42,1855,2.89%,2.21%
2020-01-01 00:12:00,7,5,7584,415,7169,11.57%,5.47%
2020-01-01 00:12:00,7,6,12952,1199,11753,19.76%,9.26%
2020-01-01 00:12:00,7,7,3421,89,3332,5.22%,2.60%
2020-01-01 00:12:00,7,8,1218,9,1209,1.86%,0.74%
2020-01-01 00:12:00,7,9,6335,286,6049,9.67%,4.51%
2020-01-01 00:12:00,7,10,970,13,957,1.48%,1.34%
2020-01-01 00:12:00,7,11,91,0,91,0.14%,0.00%
2020-01-01 00:12:00,7,12,5320,189,5131,8.12%,3.55%
2020-01-01 00:12:00,8,1,541,2,539,0.83%,0.37%
2020-01-01 00:12:00,8,2,43,0,43,0.07%,0.00%
2020-01-01 00:12:00,8,3,1404,19,1385,2.14%,1.35%
2020-01-01 00:12:00,8,4,2855,53,2802,4.36%,1.86%
2020-01-01 00:12:00,8,5,8994,623,8371,13.72%,6.93%
2020-01-01 00:12:00,8,6,16937,2028,14909,25.84%,11.97%
2020-01-01 00:12:00,8,7,5035,197,4838,7.68%,3.91%
2020-01-01 00:12:00,8,8,2177,41,2136,3.32%,1.88%
2020-01-01 00:12:00,8,9,7277,415,6862,11.10%,5.70%
2020-01-01 00:12:00,8,10,1848,25,1823,2.82%,1.35%
2020-01-01 00:12:00,8,11,198,0,198,0.30%,0.00%
2020-01-01 00:12:00,8,12,5369,235,5134,8.19%,4.38%
2020-01-01 00:12:00,9,1,671,2,669,1.02%,0.30%
2020-01-01 00:12:00,9,2,2861,62,2799,4.37%,2.17%
2020-01-01 00:12:00,9,3,1756,19,1737,2.68%,1.08%
2020-01-01 00:12:00,9,4,4878,214,4664,7.44%,4.39%
2020-01-01 00:12:00,9,5,257,0,257,0.39%,0.00%
2020-01-01 00:12:00,9,6,5917,299,5618,9.03%,5.05%
2020-01-01 00:12:00,9,7,24416,4189,20227,37.26%,17.16%
2020-01-01 00:12:00,9,8,9074,660,8414,13.85%,7.27%
2020-01-01 00:12:00,9,9,177,0,177,0.27%,0.00%
2020-01-01 00:12:00,9,10,2865,133,2732,4.37%,4.64%
2020-01-01 00:12:00,9,11,7887,516,7371,12.03%,6.54%
2020-01-01 00:12:00,9,12,4609,173,4436,7.03%,3.75%
2020-01-01 00:12:00,10,1,1391,260,1131,2.12%,18.69%
2020-01-01 00:12:00,10,2,3414,331,3083,5.21%,9.70%
2020-01-01 00:12:00,10,3,1479,18,1461,2.26%,1.22%
2020-01-01 00:12:00,10,4,5449,968,4481,8.31%,17.76%
2020-01-01 00:12:00,10,5,979,34,945,1.49%,3.47%
2020-01-01 00:12:00,10,6,7390,1167,6223,11.28%,15.79%
2020-01-01 00:12:00,10,7,12761,2099,10662,19.47%,16.45%
2020-01-01 00:12:00,10,8,29546,7337,22209,45.08%,24.83%
2020-01-01 00:12:00,10,9,592,3,589,0.90%,0.51%
2020-01-01 00:12:00,10,10,2016,37,1979,3.08%,1.84%
2020-01-01 00:12:00,10,11,12792,1494,11298,19.52%,11.68%
2020-01-01 00:12:00,10,12,10133,1075,9058,15.46%,10.61%
2020-01-01 00:12:00,11,1,2309,42,2267,3.52%,1.82%
2020-01-01 00:12:00,11,2,5324,205,5119,8.12%,3.85%
2020-01-01 00:12:00,11,3,2832,58,2774,4.32%,2.05%
2020-01-01 00:12:00,11,4,5666,233,5433,8.65%,4.11%
2020-01-01 00:12:00,11,5,254,0,254,0.39%,0.00%
2020-01-01 00:12:00,11,6,6558,298,6260,10.01%,4.54%
2020-01-01 00:12:00,11,7,13784,1323,12461,21.03%,9.60%
2020-01-01 00:12:00,11,8,28086,5287,22799,42.86%,18.82%
2020-01-01 00:12:00,11,9,200,2,198,0.31%,1.00%
2020-01-01 00:12:00,11,10,3059,86,2973,4.67%,2.81%
2020-01-01 00:12:00,11,11,9935,767,9168,15.16%,7.72%
2020-01-01 00:12:00,11,12,6414,336,6078,9.79%,5.24%
2020-01-01 00:12:00,12,1,52,0,52,0.08%,0.00%
2020-01-01 00:12:00,12,2,517,164,353,0.79%,31.72%
2020-01-01 00:12:00,12,3,3187,252,2935,4.86%,7.91%
2020-01-01 00:12:00,12,4,2860,60,2800,4.36%,2.10%
2020-01-01 00:12:00,12,5,8860,712,8148,13.52%,8.04%
2020-01-01 00:12:00,12,6,4955,183,4772,7.56%,3.69%
2020-01-01 00:12:00,12,7,1967,37,1930,3.00%,1.88%
2020-01-01 00:12:00,12,8,1429,368,1061,2.18%,25.75%
2020-01-01 00:12:00,12,9,21990,4353,17637,33.55%,19.80%
2020-01-01 00:12:00,12,10,4192,440,3752,6.40%,10.50%
2020-01-01 00:12:00,12,11,1832,371,1461,2.80%,20.25%
2020-01-01 00:12:00,12,12,8066,1319,6747,12.31%,16.35%
2020-01-01 00:12:00,13,1,1991,40,1951,3.04%,2.01%
2020-01-01 00:12:00,13,2,2354,50,2304,3.59%,2.12%
2020-01-01 00:12:00,13,3,653,2,651,1.00%,0.31%
2020-01-01 00:12:00,13,4,5381,619,4762,8.21%,11.50%
2020-01-01 00:12:00,13,5,7741,989,6752,11.81%,12.78%
2020-01-01 00:12:00,13,6,6039,679,5360,9.21%,11.24%
2020-01-01 00:12:00,13,7,5417,223,5194,8.27%,4.12%
2020-01-01 00:12:00,13,8,7555,406,7149,11.53%,5.37%
2020-01-01 00:12:00,13,9,8057,1015,7042,12.29%,12.60%
2020-01-01 00:12:00,13,10,31599,7149,24450,48.22%,22.62%
2020-01-01 00:12:00,13,11,19145,2835,16310,29.21%,14.81%
2020-01-01 00:12:00,13,12,11166,1209,9957,17.04%,10.83%
2020-01-01 00:12:00,14,1,398,1,397,0.61%,0.25%
2020-01-01 00:12:00,14,2,1634,21,1613,2.49%,1.29%
2020-01-01 00:12:00,14,3,1089,10,1079,1.66%,0.92%
2020-01-01 00:12:00,14,4,3712,106,3606,5.66%,2.86%
2020-01-01 00:12:00,14,5,1121,4,1117,1.71%,0.36%
2020-01-01 00:12:00,14,6,4053,126,3927,6.18%,3.11%
2020-01-01 00:12:00,14,7,11729,983,10746,17.90%,8.38%
2020-01-01 00:12:00,14,8,13311,1263,12048,20.31%,9.49%
2020-01-01 00:12:00,14,9,1365,6,1359,2.08%,0.44%
2020-01-01 00:12:00,14,10,4125,117,4008,6.29%,2.84%
2020-01-01 00:12:00,14,11,27388,4919,22469,41.79%,17.96%
2020-01-01 00:12:00,14,12,9495,655,8840,14.49%,6.90%
2020-01-01 00:12:00,15,1,476,0,476,0.73%,0.00%
2020-01-01 00:12:00,15,2,132,0,132,0.20%,0.00%
2020-01-01 00:12:00,15,3,6496,279,6217,9.91%,4.29%
2020-01-01 00:12:00,15,4,5155,279,4876,7.87%,5.41%
2020-01-01 00:12:00,15,5,12609,1198,11411,19.24%,9.50%
2020-01-01 00:12:00,15,6,5426,323,5103,8.28%,5.95%
2020-01-01 00:12:00,15,7,3518,87,3431,5.37%,2.47%
2020-01-01 00:12:00,15,8,6050,266,5784,9.23%,4.40%
2020-01-01 00:12:00,15,9,12898,1252,11646,19.68%,9.71%
2020-01-01 00:12:00,15,10,5150,306,4844,7.86%,5.94%
2020-01-01 00:12:00,15,11,11359,983,10376,17.33%,8.65%
2020-01-01 00:12:00,15,12,29693,6195,23498,45.31%,20.86%
2020-01-01 00:12:00,16,1,425,2,423,0.65%,0.47%
2020-01-01 00:12:00,16,2,222,0,222,0.34%,0.00%
2020-01-01 00:12:00,16,3,1491,14,1477,2.28%,0.94%
2020-01-01 00:12:00,16,4,3909,119,3790,5.96%,3.04%
2020-01-01 00:12:00,16,5,7818,545,7273,11.93%,6.97%
2020-01-01 00:12:00,16,6,4858,180,4678,7.41%,3.71%
2020-01-01 00:12:00,16,7,3452,76,3376,5.27%,2.20%
2020-01-01 00:12:00,16,8,8286,518,7768,12.64%,6.25%
2020-01-01 00:12:00,16,9,8200,593,7607,12.51%,7.23%
2020-01-01 00:12:00,16,10,1826,13,1813,2.79%,0.71%
2020-01-01 00:12:00,16,11,10328,770,9558,15.76%,7.46%
2020-01-01 00:12:00,16,12,26155,4669,21486,39.91%,17.85%
2020-01-01 00:12:10,1,1,13839,1375,12464,21.12%,9.94%
2020-01-01 00:12:10,1,2,5174,188,4986,7.89%,3.63%
2020-01-01 00:12:10,1,3,413,1,412,0.63%,0.24%
2020-01-01 00:12:10,1,4,8213,528,7685,12.53%,6.43%
2020-01-01 00:12:10,1,5,7779,479,7300,11.87%,6.16%
2020-01-01 00:12:10,1,6,7759,477,7282,11.84%,6.15%
2020-01-01 00:12:10,1,7,4753,156,4597,7.25%,3.28%
2020-01-01 00:12:10,1,8,3727,93,3634,5.69%,2.50%
2020-01-01 00:12:10,1,9,7720,473,7247,11.78%,6.13%
2020-01-01 00:12:10,1,10,3010,48,2962,4.59%,1.59%
2020-01-01 00:12:10,1,11,3116,50,3066,4.75%,1.60%
2020-01-01 00:12:10,1,12,7683,467,7216,11.72%,6.08%
2020-01-01 00:12:10,2,1,1185,8,1177,1.81%,0.68%
2020-01-01 00:12:10,2,2,28842,5504,23338,44.01%,19.08%
2020-01-01 00:12:10,2,3,23635,3788,19847,36.06%,16.03%
2020-01-01 00:12:10,2,4,1094,5,1089,1.67%,0.46%
2020-01-01 00:12:10,2,5,15786,1750,14036,24.09%,11.09%
2020-01-01 00:12:10,2,6,95,0,95,0.14%,0.00%
2020-01-01 00:12:10,2,7,3988,114,3874,6.09%,2.86%
2020-01-01 00:12:10,2,8,2804,72,2732,4.28%,2.57%
2020-01-01 00:12:10,2,9,15648,1721,13927,23.88%,11.00%
2020-01-01 00:12:10,2,10,2040,42,1998,3.11%,2.06%
2020-01-01 00:12:10,2,11,2054,43,2011,3.13%,2.09%
2020-01-01 00:12:10,2,12,15433,1666,13767,23.55%,10.80%
2020-01-01 00:12:10,3,1,1710,32,1678,2.61%,1.87%
2020-01-01 00:12:10,3,2,21716,3305,18411,33.14%,15.22%
2020-01-01 00:12:10,3,3,62451,22247,40204,95.29%,35.62%
2020-01-01 00:12:10,3,4,5185,235,4950,7.91%,4.53%
2020-01-01 00:12:10,3,5,39718,9975,29743,60.60%,25.11%
2020-01-01 00:12:10,3,6,5987,316,5671,9.14%,5.28%
2020-01-01 00:12:10,3,7,18359,2388,15971,28.01%,13.01%
2020-01-01 00:12:10,3,8,15219,1660,13559,23.22%,10.91%
2020-01-01 00:12:10,3,9,33423,7256,26167,51.00%,21.71%
2020-01-01 00:12:10,3,10,5483,236,5247,8.37%,4.30%
2020-01-01 00:12:10,3,11,2137,24,2113,3.26%,1.12%
2020-01-01 00:12:10,3,12,25074,4249,20825,38.26%,16.95%
2020-01-01 00:12:10,4,1,530,4,526,0.81%,0.75%
2020-01-01 00:12:10,4,2,316,1,315,0.48%,0.32%
2020-01-01 00:12:10,4,3,878,14,864,1.34%,1.59%
2020-01-01 00:12:10,4,4,28041,5231,22810,42.79%,18.65%
2020-01-01 00:12:10,4,5,16923,2027,14896,25.82%,11.98%
2020-01-01 00:12:10,4,6,23201,3728,19473,35.40%,16.07%
2020-01-01 00:12:10,4,7,5098,221,4877,7.78%,4.34%
2020-01-01 00:12:10,4,8,2750,53,2697,4.20%,1.93%
2020-01-01 00:12:10,4,9,14903,1601,13302,22.74%,10.74%
2020-01-01 00:12:10,4,10,1831,26,1805,2.79%,1.42%
2020-01-01 00:12:10,4,11,209,0,209,0.32%,0.00%
2020-01-01 00:12:10,4,12,12375,1130,11245,18.88%,9.13%
2020-01-01 00:12:10,5,1,2865,54,2811,4.37%,1.88%
2020-01-01 00:12:10,5,2,778,1,777,1.19%,0.13%
2020-01-01 00:12:10,5,3,464,2,462,0.71%,0.43%
2020-01-01 00:12:10,5,4,42413,11316,31097,64.72%,26.68%
2020-01-01 00:12:10,5,5,9228,632,8596,14.08%,6.85%
2020-01-01 00:12:10,5,6,16880,1986,14894,25.76%,11.77%
2020-01-01 00:12:10,5,7,7264,366,6898,11.08%,5.04%
2020-01-01 00:12:10,5,8,3373,82,3291,5.15%,2.43%
2020-01-01 00:12:10,5,9,8572,555,8017,13.08%,6.47%
2020-01-01 00:12:10,5,10,1112,12,1100,1.70%,1.08%
2020-01-01 00:12:10,5,11,762,5,757,1.16%,0.66%
2020-01-01 00:12:10,5,12,7118,363,6755,10.86%,5.10%
2020-01-01 00:12:10,6,1,1035,15,1020,1.58%,1.45%
2020-01-01 00:12:10,6,2,1210,15,1195,1.85%,1.24%
2020-01-01 00:12:10,6,3,1811,34,1777,2.76%,1.88%
2020-01-01 00:12:10,6,4,1067,12,1055,1.63%,1.12%
2020-01-01 00:12:10,6,5,14321,1468,12853,21.85%,10.25%
2020-01-01 00:12:10,6,6,4292,159,4133,6.55%,3.70%
2020-01-01 00:12:10,6,7,2795,81,2714,4.26%,2.90%
2020-01-01 00:12:10,6,8,2327,63,2264,3.55%,2.71%
2020-01-01 00:12:10,6,9,7818,462,7356,11.93%,5.91%
2020-01-01 00:12:10,6,10,2132,43,2089,3.25%,2.02%
2020-01-01 00:12:10,6,11,461,1,460,0.70%,0.22%
2020-01-01 00:12:10,6,12,5598,254,5344,8.54%,4.54%
2020-01-01 00:12:10,7,1,571,2,569,0.87%,0.35%
2020-01-01 00:12:10,7,2,185,0,185,0.28%,0.00%
2020-01-01 00:12:10,7,3,650,3,647,0.99%,0.46%
2020-01-01 00:12:10,7,4,2183,50,2133,3.33%,2.29%
2020-01-01 00:12:10,7,5,7085,376,6709,10.81%,5.31%
2020-01-01 00:12:10,7,6,12481,1167,11314,19.04%,9.35%
2020-01-01 00:12:10,7,7,3172,76,3096,4.84%,2.40%
2020-01-01 00:12:10,7,8,1147,17,1130,1.75%,1.48%
2020-01-01 00:12:10,7,9,6040,272,5768,9.22%,4.50%
2020-01-01 00:12:10,7,10,1197,8,1189,1.83%,0.67%
2020-01-01 00:12:10,7,11,89,0,89,0.14%,0.00%
2020-01-01 00:12:10,7,12,4872,193,4679,7.43%,3.96%
2020-01-01 00:12:10,8,1,482,2,480,0.74%,0.41%
2020-01-01 00:12:10,8,2,77,0,77,0.12%,0.00%
2020-01-01 00:12:10,8,3,1812,24,1788,2.76%,1.32%
2020-01-01 00:12:10,8,4,2993,47,2946,4.57%,1.57%
2020-01-01 00:12:10,8,5,9063,579,8484,13.83%,6.39%
2020-01-01 00:12:10,8,6,17231,1993,15238,26.29%,11.57%
2020-01-01 00:12:10,8,7,5117,205,4912,7.81%,4.01%
2020-01-01 00:12:10,8,8,2142,39,2103,3.27%,1.82%
2020-01-01 00:12:10,8,9,6943,366,6577,10.59%,5.27%
2020-01-01 00:12:10,8,10,1809,23,1786,2.76%,1.27%
2020-01-01 00:12:10,8,11,181,1,180,0.28%,0.55%
2020-01-01 00:12:10,8,12,5110,222,4888,7.80%,4.34%
2020-01-01 00:12:10,9,1,503,2,501,0.77%,0.40%
2020-01-01 00:12:10,9,2,1984,30,1954,3.03%,1.51%
2020-01-01 00:12:10,9,3,1126,6,1120,1.72%,0.53%
2020-01-01 00:12:10,9,4,7882,487,7395,12.03%,6.18%
2020-01-01 00:12:10,9,5,452,0,452,0.69%,0.00%
2020-01-01 00:12:10,9,6,9270,673,8597,14.14%,7.26%
2020-01-01 00:12:10,9,7,27342,5027,22315,41.72%,18.39%
2020-01-01 00:12:10,9,8,10838,849,9989,16.54%,7.83%
2020-01-01 00:12:10,9,9,270,0,270,0.41%,0.00%
2020-01-01 00:12:10,9,10,3705,104,3601,5.65%,2.81%
2020-01-01 00:12:10,9,11,9602,680,8922,14.65%,7.08%
2020-01-01 00:12:10,9,12,5515,235,5280,8.42%,4.26%
2020-01-01 00:12:10,10,1,1431,280,1151,2.18%,19.57%
2020-01-01 00:12:10,10,2,3134,333,2801,4.78%,10.63%
2020-01-01 00:12:10,10,3,1550,10,1540,2.37%,0.65%
2020-01-01 00:12:10,10,4,4313,1051,3262,6.58%,24.37%
2020-01-01 00:12:10,10,5,766,32,734,1.17%,4.18%
2020-01-01 00:12:10,10,6,6058,1195,4863,9.24%,19.73%
2020-01-01 00:12:10,10,7,11360,2038,9322,17.33%,17.94%
2020-01-01 00:12:10,10,8,28001,7010,20991,42.73%,25.03%
2020-01-01 00:12:10,10,9,682,1,681,1.04%,0.15%
2020-01-01 00:12:10,10,10,2108,47,2061,3.22%,2.23%
2020-01-01 00:12:10,10,11,12444,1463,10981,18.99%,11.76%
2020-01-01 00:12:10,10,12,9513,1044,8469,14.52%,10.97%
2020-01-01 00:12:10,11,1,2316,39,2277,3.53%,1.68%
2020-01-01 00:12:10,11,2,3692,90,3602,5.63%,2.44%
2020-01-01 00:12:10,11,3,1224,9,1215,1.87%,0.74%
2020-01-01 00:12:10,11,4,4513,186,4327,6.89%,4.12%
2020-01-01 00:12:10,11,5,191,1,190,0.29%,0.52%
2020-01-01 00:12:10,11,6,5421,267,5154,8.27%,4.93%
2020-01-01 00:12:10,11,7,11171,931,10240,17.05%,8.33%
2020-01-01 00:12:10,11,8,25244,4421,20823,38.52%,17.51%
2020-01-01 00:12:10,11,9,165,1,164,0.25%,0.61%
2020-01-01 00:12:10,11,10,3019,58,2961,4.61%,1.92%
2020-01-01 00:12:10,11,11,10049,737,9312,15.33%,7.33%
2020-01-01 00:12:10,11,12,6574,346,6228,10.03%,5.26%
2020-01-01 00:12:10,12,1,30,0,30,0.05%,0.00%
2020-01-01 00:12:10,12,2,599,160,439,0.91%,26.71%
2020-01-01 00:12:10,12,3,2730,217,2513,4.17%,7.95%
2020-01-01 00:12:10,12,4,3135,105,3030,4.78%,3.35%
2020-01-01 00:12:10,12,5,9022,756,8266,13.77%,8.38%
2020-01-01 00:12:10,12,6,5495,242,5253,8.38%,4.40%
2020-01-01 00:12:10,12,7,2225,37,2188,3.40%,1.66%
2020-01-01 00:12:10,12,8,1458,287,1171,2.22%,19.68%
2020-01-01 00:12:10,12,9,21234,4068,17166,32.40%,19.16%
2020-01-01 00:12:10,12,10,4024,376,3648,6.14%,9.34%
2020-01-01 00:12:10,12,11,1643,289,1354,2.51%,17.59%
2020-01-01 00:12:10,12,12,7140,1126,6014,10.89%,15.77%
2020-01-01 00:12:10,13,1,1664,19,1645,2.54%,1.14%
2020-01-01 00:12:10,13,2,2003,29,1974,3.06%,1.45%
2020-01-01 00:12:10,13,3,514,4,510,0.78%,0.78%
2020-01-01 00:12:10,13,4,4819,631,4188,7.35%,13.09%
2020-01-01 00:12:10,13,5,7135,934,6201,10.89%,13.09%
2020-01-01 00:12:10,13,6,5492,683,4809,8.38%,12.44%
2020-01-01 00:12:10,13,7,4355,155,4200,6.65%,3.56%
2020-01-01 00:12:10,13,8,6117,291,5826,9.33%,4.76%
2020-01-01 00:12:10,13,9,7463,990,6473,11.39%,13.27%
2020-01-01 00:12:10,13,10,28702,6156,22546,43.80%,21.45%
2020-01-01 00:12:10,13,11,17800,2421,15379,27.16%,13.60%
2020-01-01 00:12:10,13,12,11285,1144,10141,17.22%,10.14%
2020-01-01 00:12:10,14,1,357,1,356,0.54%,0.28%
2020-01-01 00:12:10,14,2,1529,24,1505,2.33%,1.57%
2020-01-01 00:12:10,14,3,1025,11,1014,1.56%,1.07%
2020-01-01 00:12:10,14,4,5236,205,5031,7.99%,3.92%
2020-01-01 00:12:10,14,5,1138,12,1126,1.74%,1.05%
2020-01-01 00:12:10,14,6,5624,245,5379,8.58%,4.36%
2020-01-01 00:12:10,14,7,12798,1163,11635,19.53%,9.09%
2020-01-01 00:12:10,14,8,14532,1516,13016,22.17%,10.43%
2020-01-01 00:12:10,14,9,1534,21,1513,2.34%,1.37%
2020-01-01 00:12:10,14,10,4200,150,4050,6.41%,3.57%
2020-01-01 00:12:10,14,11,26471,4771,21700,40.39%,18.02%
2020-01-01 00:12:10,14,12,7442,411,7031,11.36%,5.52%
2020-01-01 00:12:10,15,1,429,2,427,0.65%,0.47%
2020-01-01 00:12:10,15,2,159,0,159,0.24%,0.00%
2020-01-01 00:12:10,15,3,5013,188,4825,7.65%,3.75%
2020-01-01 00:12:10,15,4,5981,340,5641,9.13%,5.68%
2020-01-01 00:12:10,15,5,12342,1195,11147,18.83%,9.68%
2020-01-01 00:12:10,15,6,6222,394,5828,9.49%,6.33%
2020-01-01 00:12:10,15,7,3414,91,3323,5.21%,2.67%
2020-01-01 00:12:10,15,8,5714,244,5470,8.72%,4.27%
2020-01-01 00:12:10,15,9,12590,1234,11356,19.21%,9.80%
2020-01-01 00:12:10,15,10,4251,267,3984,6.49%,6.28%
2020-01-01 00:12:10,15,11,10176,901,9275,15.53%,8.85%
2020-01-01 00:12:10,15,12,28514,5809,22705,43.51%,20.37%
2020-01-01 00:12:10,16,1,350,4,346,0.53%,1.14%
2020-01-01 00:12:10,16,2,293,2,291,0.45%,0.68%
2020-01-01 00:12:10,16,3,1368,15,1353,2.09%,1.10%
2020-01-01 00:12:10,16,4,3995,126,3869,6.10%,3.15%
2020-01-01 00:12:10,16,5,7468,464,7004,11.40%,6.21%
2020-01-01 00:12:10,16,6,4797,175,4622,7.32%,3.65%
2020-01-01 00:12:10,16,7,3641,122,3519,5.56%,3.35%
2020-01-01 00:12:10,16,8,7619,515,7104,11.63%,6.76%
2020-01-01 00:12:10,16,9,7850,502,7348,11.98%,6.39%
2020-01-01 00:12:10,16,10,1404,16,1388,2.14%,1.14%
2020-01-01 00:12:10,16,11,9211,676,8535,14.05%,7.34%
2020-01-01 00:12:10,16,12,24755,4243,20512,37.77%,17.14%
2020-01-01 00:12:20,1,1,18722,2436,16286,28.57%,13.01%
2020-01-01 00:12:20,1,2,7268,403,6865,11.09%,5.54%
2020-01-01 00:12:20,1,3,701,3,698,1.07%,0.43%
2020-01-01 00:12:20,1,4,11156,860,10296,17.02%,7.71%
2020-01-01 00:12:20,1,5,10710,805,9905,16.34%,7.52%
2020-01-01 00:12:20,1,6,10698,803,9895,16.32%,7.51%
2020-01-01 00:12:20,1,7,6554,326,6228,10.00%,4.97%
2020-01-01 00:12:20,1,8,5949,277,5672,9.08%,4.66%
2020-01-01 00:12:20,1,9,10643,795,9848,16.24%,7.47%
2020-01-01 00:12:20,1,10,5227,207,5020,7.98%,3.96%
2020-01-01 00:12:20,1,11,5285,213,5072,8.06%,4.03%
2020-01-01 00:12:20,1,12,10608,793,9815,16.19%,7.48%
2020-01-01 00:12:20,2,1,551,3,548,0.84%,0.54%
2020-01-01 00:12:20,2,2,26520,4774,21746,40.47%,18.00%
2020-01-01 00:12:20,2,3,21579,3255,18324,32.93%,15.08%
2020-01-01 00:12:20,2,4,493,3,490,0.75%,0.61%
2020-01-01 00:12:20,2,5,12785,1178,11607,19.51%,9.21%
2020-01-01 00:12:20,2,6,64,1,63,0.10%,1.56%
2020-01-01 00:12:20,2,7,4359,136,4223,6.65%,3.12%
2020-01-01 00:12:20,2,8,3240,75,3165,4.94%,2.31%
2020-01-01 00:12:20,2,9,12646,1147,11499,19.30%,9.07%
2020-01-01 00:12:20,2,10,2500,45,2455,3.81%,1.80%
2020-01-01 00:12:20,2,11,2518,46,2472,3.84%,1.83%
2020-01-01 00:12:20,2,12,12428,1109,11319,18.96%,8.92%
2020-01-01 00:12:20,3,1,2241,35,2206,3.42%,1.56%
2020-01-01 00:12:20,3,2,23135,3693,19442,35.30%,15.96%
2020-01-01 00:12:20,3,3,66540,24793,41747,101.53%,37.26%
2020-01-01 00:12:20,3,4,4979,191,4788,7.60%,3.84%
2020-01-01 00:12:20,3,5,41321,10670,30651,63.05%,25.82%
2020-01-01 00:12:20,3,6,6364,301,6063,9.71%,4.73%
2020-01-01 00:12:20,3,7,19295,2590,16705,29.44%,13.42%
2020-01-01 00:12:20,3,8,16048,1856,14192,24.49%,11.57%
2020-01-01 00:12:20,3,9,34567,7702,26865,52.75%,22.28%
2020-01-01 00:12:20,3,10,4819,170,4649,7.35%,3.53%
2020-01-01 00:12:20,3,11,2188,44,2144,3.34%,2.01%
2020-01-01 00:12:20,3,12,26896,4809,22087,41.04%,17.88%
2020-01-01 00:12:20,4,1,491,2,489,0.75%,0.41%
2020-01-01 00:12:20,4,2,267,1,266,0.41%,0.37%
2020-01-01 00:12:20,4,3,1148,8,1140,1.75%,0.70%
2020-01-01 00:12:20,4,4,28310,5191,23119,43.20%,18.34%
2020-01-01 00:12:20,4,5,17560,2097,15463,26.79%,11.94%
2020-01-01 00:12:20,4,6,23546,3711,19835,35.93%,15.76%
2020-01-01 00:12:20,4,7,4936,181,4755,7.53%,3.67%
2020-01-01 00:12:20,4,8,2651,43,2608,4.05%,1.62%
2020-01-01 00:12:20,4,9,15269,1613,13656,23.30%,10.56%
2020-01-01 00:12:20,4,10,1915,17,1898,2.92%,0.89%
2020-01-01 00:12:20,4,11,134,0,134,0.20%,0.00%
2020-01-01 00:12:20,4,12,12754,1105,11649,19.46%,8.66%
2020-01-01 00:12:20,5,1,3153,71,3082,4.81%,2.25%
2020-01-01 00:12:20,5,2,779,7,772,1.19%,0.90%
2020-01-01 00:12:20,5,3,369,0,369,0.56%,0.00%
2020-01-01 00:12:20,5,4,24649,4112,20537,37.61%,16.68%
2020-01-01 00:12:20,5,5,9294,703,8591,14.18%,7.56%
2020-01-01 00:12:20,5,6,15307,1699,13608,23.36%,11.10%
2020-01-01 00:12:20,5,7,5585,235,5350,8.52%,4.21%
2020-01-01 00:12:20,5,8,3661,105,3556,5.59%,2.87%
2020-01-01 00:12:20,5,9,8787,618,8169,13.41%,7.03%
2020-01-01 00:12:20,5,10,928,11,917,1.42%,1.19%
2020-01-01 00:12:20,5,11,1076,10,1066,1.64%,0.93%
2020-01-01 00:12:20,5,12,7101,414,6687,10.84%,5.83%
2020-01-01 00:12:20,6,1,1093,11,1082,1.67%,1.01%
2020-01-01 00:12:20,6,2,1190,12,1178,1.82%,1.01%
2020-01-01 00:12:20,6,3,1693,24,1669,2.58%,1.42%
2020-01-01 00:12:20,6,4,1395,26,1369,2.13%,1.86%
2020-01-01 00:12:20,6,5,18802,2483,16319,28.69%,13.21%
2020-01-01 00:12:20,6,6,5861,296,5565,8.94%,5.05%
2020-01-01 00:12:20,6,7,4024,138,3886,6.14%,3.43%
2020-01-01 00:12:20,6,8,3531,101,3430,5.39%,2.86%
2020-01-01 00:12:20,6,9,10779,794,9985,16.45%,7.37%
2020-01-01 00:12:20,6,10,2857,49,2808,4.36%,1.72%
2020-01-01 00:12:20,6,11,500,3,497,0.76%,0.60%
2020-01-01 00:12:20,6,12,7835,420,7415,11.96%,5.36%
2020-01-01 00:12:20,7,1,432,2,430,0.66%,0.46%
2020-01-01 00:12:20,7,2,97,0,97,0.15%,0.00%
2020-01-01 00:12:20,7,3,1417,14,1403,2.16%,0.99%
2020-01-01 00:12:20,7,4,1875,17,1858,2.86%,0.91%
2020-01-01 00:12:20,7,5,7921,469,7452,12.09%,5.92%
2020-01-01 00:12:20,7,6,12590,1115,11475,19.21%,8.86%
2020-01-01 00:12:20,7,7,2774,67,2707,4.23%,2.42%
2020-01-01 00:12:20,7,8,897,3,894,1.37%,0.33%
2020-01-01 00:12:20,7,9,6392,295,6097,9.75%,4.62%
2020-01-01 00:12:20,7,10,1740,24,1716,2.66%,1.38%
2020-01-01 00:12:20,7,11,81,0,81,0.12%,0.00%
2020-01-01 00:12:20,7,12,4703,157,4546,7.18%,3.34%
2020-01-01 00:12:20,8,1,422,0,422,0.64%,0.00%
2020-01-01 00:12:20,8,2,126,0,126,0.19%,0.00%
2020-01-01 00:12:20,8,3,2024,23,2001,3.09%,1.14%
2020-01-01 00:12:20,8,4,2771,32,2739,4.23%,1.15%
2020-01-01 00:12:20,8,5,8198,513,7685,12.51%,6.26%
2020-01-01 00:12:20,8,6,16538,1957,14581,25.23%,11.83%
2020-01-01 00:12:20,8,7,5554,242,5312,8.47%,4.36%
2020-01-01 00:12:20,8,8,2259,49,2210,3.45%,2.17%
2020-01-01 00:12:20,8,9,5948,274,5674,9.08%,4.61%
2020-01-01 00:12:20,8,10,1661,22,1639,2.53%,1.32%
2020-01-01 00:12:20,8,11,250,0,250,0.38%,0.00%
2020-01-01 00:12:20,8,12,4140,131,4009,6.32%,3.16%
2020-01-01 00:12:20,9,1,477,2,475,0.73%,0.42%
2020-01-01 00:12:20,9,2,2649,60,2589,4.04%,2.27%
2020-01-01 00:12:20,9,3,1552,23,1529,2.37%,1.48%
2020-01-01 00:12:20,9,4,9551,628,8923,14.57%,6.58%
2020-01-01 00:12:20,9,5,461,2,459,0.70%,0.43%
2020-01-01 00:12:20,9,6,10796,825,9971,16.47%,7.64%
2020-01-01 00:12:20,9,7,34508,7691,26817,52.66%,22.29%
2020-01-01 00:12:20,9,8,15088,1653,13435,23.02%,10.96%
2020-01-01 00:12:20,9,9,375,0,375,0.57%,0.00%
2020-01-01 00:12:20,9,10,6632,335,6297,10.12%,5.05%
2020-01-01 00:12:20,9,11,13277,1288,11989,20.26%,9.70%
2020-01-01 00:12:20,9,12,6302,269,6033,9.62%,4.27%
2020-01-01 00:12:20,10,1,1228,281,947,1.87%,22.88%
2020-01-01 00:12:20,10,2,4162,391,3771,6.35%,9.39%
2020-01-01 00:12:20,10,3,2751,56,2695,4.20%,2.04%
2020-01-01 00:12:20,10,4,4713,1088,3625,7.19%,23.09%
2020-01-01 00:12:20,10,5,540,3,537,0.82%,0.56%
2020-01-01 00:12:20,10,6,6576,1218,5358,10.03%,18.52%
2020-01-01 00:12:20,10,7,12748,2213,10535,19.45%,17.36%
2020-01-01 00:12:20,10,8,29001,7352,21649,44.25%,25.35%
2020-01-01 00:12:20,10,9,823,11,812,1.26%,1.34%
2020-01-01 00:12:20,10,10,2437,54,2383,3.72%,2.22%
2020-01-01 00:12:20,10,11,12139,1449,10690,18.52%,11.94%
2020-01-01 00:12:20,10,12,9057,1011,8046,13.82%,11.16%
2020-01-01 00:12:20,11,1,2288,50,2238,3.49%,2.19%
2020-01-01 00:12:20,11,2,3425,88,3337,5.23%,2.57%
2020-01-01 00:12:20,11,3,998,6,992,1.52%,0.60%
2020-01-01 00:12:20,11,4,3499,103,3396,5.34%,2.94%
2020-01-01 00:12:20,11,5,408,0,408,0.62%,0.00%
2020-01-01 00:12:20,11,6,4660,176,4484,7.11%,3.78%
2020-01-01 00:12:20,11,7,10741,817,9924,16.39%,7.61%
2020-01-01 00:12:20,11,8,23985,3839,20146,36.60%,16.01%
2020-01-01 00:12:20,11,9,170,0,170,0.26%,0.00%
2020-01-01 00:12:20,11,10,3140,78,3062,4.79%,2.48%
2020-01-01 00:12:20,11,11,9875,711,9164,15.07%,7.20%
2020-01-01 00:12:20,11,12,6489,313,6176,9.90%,4.82%
2020-01-01 00:12:20,12,1,44,0,44,0.07%,0.00%
2020-01-01 00:12:20,12,2,773,223,550,1.18%,28.85%
2020-01-01 00:12:20,12,3,3011,278,2733,4.59%,9.23%
2020-01-01 00:12:20,12,4,2557,61,2496,3.90%,2.39%
2020-01-01 00:12:20,12,5,9584,915,8669,14.62%,9.55%
2020-01-01 00:12:20,12,6,5702,276,5426,8.70%,4.84%
2020-01-01 00:12:20,12,7,3038,100,2938,4.64%,3.29%
2020-01-01 00:12:20,12,8,1362,273,1089,2.08%,20.04%
2020-01-01 00:12:20,12,9,22415,4488,17927,34.20%,20.02%
2020-01-01 00:12:20,12,10,4105,407,3698,6.26%,9.91%
2020-01-01 00:12:20,12,11,1466,273,1193,2.24%,18.62%
2020-01-01 00:12:20,12,12,7605,1098,6507,11.60%,14.44%
2020-01-01 00:12:20,13,1,2360,47,2313,3.60%,1.99%
2020-01-01 00:12:20,13,2,2669,58,2611,4.07%,2.17%
2020-01-01 00:12:20,13,3,532,4,528,0.81%,0.75%
2020-01-01 00:12:20,13,4,4476,511,3965,6.83%,11.42%
2020-01-01 00:12:20,13,5,6572,796,5776,10.03%,12.11%
2020-01-01 00:12:20,13,6,5370,570,4800,8.19%,10.61%
2020-01-01 00:12:20,13,7,5207,201,5006,7.95%,3.86%
2020-01-01 00:12:20,13,8,6914,374,6540,10.55%,5.41%
2020-01-01 00:12:20,13,9,6933,853,6080,10.58%,12.30%
2020-01-01 00:12:20,13,10,26847,5428,21419,40.97%,20.22%
2020-01-01 00:12:20,13,11,16927,2269,14658,25.83%,13.40%
2020-01-01 00:12:20,13,12,9490,916,8574,14.48%,9.65%
2020-01-01 00:12:20,14,1,359,1,358,0.55%,0.28%
2020-01-01 00:12:20,14,2,1648,20,1628,2.51%,1.21%
2020-01-01 00:12:20,14,3,1144,4,1140,1.75%,0.35%
2020-01-01 00:12:20,14,4,4107,125,3982,6.27%,3.04%
2020-01-01 00:12:20,14,5,1256,18,1238,1.92%,1.43%
2020-01-01 00:12:20,14,6,4325,139,4186,6.60%,3.21%
2020-01-01 00:12:20,14,7,11321,933,10388,17.27%,8.24%
2020-01-01 00:12:20,14,8,13440,1288,12152,20.51%,9.58%
2020-01-01 00:12:20,14,9,1562,26,1536,2.38%,1.66%
2020-01-01 00:12:20,14,10,4132,137,3995,6.30%,3.32%
2020-01-01 00:12:20,14,11,24704,4152,20552,37.70%,16.81%
2020-01-01 00:12:20,14,12,6906,320,6586,10.54%,4.63%
2020-01-01 00:12:20,15,1,539,1,538,0.82%,0.19%
2020-01-01 00:12:20,15,2,147,0,147,0.22%,0.00%
2020-01-01 00:12:20,15,3,3596,112,3484,5.49%,3.11%
2020-01-01 00:12:20,15,4,6101,301,5800,9.31%,4.93%
2020-01-01 00:12:20,15,5,11410,952,10458,17.41%,8.34%
2020-01-01 00:12:20,15,6,6332,312,6020,9.66%,4.93%
2020-01-01 00:12:20,15,7,3536,107,3429,5.40%,3.03%
2020-01-01 00:12:20,15,8,5634,259,5375,8.60%,4.60%
2020-01-01 00:12:20,15,9,11640,989,10651,17.76%,8.50%
2020-01-01 00:12:20,15,10,4670,207,4463,7.13%,4.43%
2020-01-01 00:12:20,15,11,10547,878,9669,16.09%,8.32%
2020-01-01 00:12:20,15,12,28499,5759,22740,43.49%,20.21%
2020-01-01 00:12:20,16,1,411,2,409,0.63%,0.49%
2020-01-01 00:12:20,16,2,274,4,270,0.42%,1.46%
2020-01-01 00:12:20,16,3,1248,28,1220,1.90%,2.24%
2020-01-01 00:12:20,16,4,5328,227,5101,8.13%,4.26%
2020-01-01 00:12:20,16,5,9142,673,8469,13.95%,7.36%
2020-01-01 00:12:20,16,6,6117,288,5829,9.33%,4.71%
2020-01-01 00:12:20,16,7,3859,154,3705,5.89%,3.99%
2020-01-01 00:12:20,16,8,8001,506,7495,12.21%,6.32%
2020-01-01 00:12:20,16,9,9496,722,8774,14.49%,7.60%
2020-01-01 00:12:20,16,10,1615,22,1593,2.46%,1.36%
2020-01-01 00:12:20,16,11,9769,729,9040,14.91%,7.46%
2020-01-01 00:12:20,16,12,27251,5071,22180,41.58%,18.61%
2020-01-01 00:12:30,1,1,15154,1724,13430,23.12%,11.38%
2020-01-01 00:12:30,1,2,7287,425,6862,11.12%,5.83%
2020-01-01 00:12:30,1,3,479,1,478,0.73%,0.21%
2020-01-01 00:12:30,1,4,7498,477,7021,11.44%,6.36%
2020-01-01 00:12:30,1,5,7233,446,6787,11.04%,6.17%
2020-01-01 00:12:30,1,6,7209,441,6768,11.00%,6.12%
2020-01-01 00:12:30,1,7,6778,362,6416,10.34%,5.34%
2020-01-01 00:12:30,1,8,5918,275,5643,9.03%,4.65%
2020-01-01 00:12:30,1,9,7153,435,6718,10.91%,6.08%
2020-01-01 00:12:30,1,10,5277,204,5073,8.05%,3.87%
2020-01-01 00:12:30,1,11,5353,215,5138,8.17%,4.02%
2020-01-01 00:12:30,1,12,7129,435,6694,10.88%,6.10%
2020-01-01 00:12:30,2,1,660,2,658,1.01%,0.30%
2020-01-01 00:12:30,2,2,31144,6350,24794,47.52%,20.39%
2020-01-01 00:12:30,2,3,25081,4181,20900,38.27%,16.67%
2020-01-01 00:12:30,2,4,577,2,575,0.88%,0.35%
2020-01-01 00:12:30,2,5,15643,1705,13938,23.87%,10.90%
2020-01-01 00:12:30,2,6,51,0,51,0.08%,0.00%
2020-01-01 00:12:30,2,7,5373,213,5160,8.20%,3.96%
2020-01-01 00:12:30,2,8,4132,119,4013,6.30%,2.88%
2020-01-01 00:12:30,2,9,15557,1688,13869,23.74%,10.85%
2020-01-01 00:12:30,2,10,3190,75,3115,4.87%,2.35%
2020-01-01 00:12:30,2,11,3207,75,3132,4.89%,2.34%
2020-01-01 00:12:30,2,12,15373,1650,13723,23.46%,10.73%
2020-01-01 00:12:30,3,1,1600,21,1579,2.44%,1.31%
2020-01-01 00:12:30,3,2,23163,3675,19488,35.34%,15.87%
2020-01-01 00:12:30,3,3,71448,28062,43386,109.02%,39.28%
2020-01-01 00:12:30,3,4,7772,461,7311,11.86%,5.93%
2020-01-01 00:12:30,3,5,41862,11083,30779,63.88%,26.48%
2020-01-01 00:12:30,3,6,8841,593,8248,13.49%,6.71%
2020-01-01 00:12:30,3,7,19689,2705,16984,30.04%,13.74%
2020-01-01 00:12:30,3,8,16756,1949,14807,25.57%,11.63%
2020-01-01 00:12:30,3,9,32510,7033,25477,49.61%,21.63%
2020-01-01 00:12:30,3,10,4902,198,4704,7.48%,4.04%
2020-01-01 00:12:30,3,11,2115,32,2083,3.23%,1.51%
2020-01-01 00:12:30,3,12,24386,4100,20286,37.21%,16.81%
2020-01-01 00:12:30,4,1,498,1,497,0.76%,0.20%
2020-01-01 00:12:30,4,2,339,0,339,0.52%,0.00%
2020-01-01 00:12:30,4,3,904,7,897,1.38%,0.77%
2020-01-01 00:12:30,4,4,27981,5120,22861,42.70%,18.30%
2020-01-01 00:12:30,4,5,17459,2102,15357,26.64%,12.04%
2020-01-01 00:12:30,4,6,24106,3849,20257,36.78%,15.97%
2020-01-01 00:12:30,4,7,5424,230,5194,8.28%,4.24%
2020-01-01 00:12:30,4,8,3172,91,3081,4.84%,2.87%
2020-01-01 00:12:30,4,9,15348,1646,13702,23.42%,10.72%
2020-01-01 00:12:30,4,10,2069,29,2040,3.16%,1.40%
2020-01-01 00:12:30,4,11,179,1,178,0.27%,0.56%
2020-01-01 00:12:30,4,12,12136,1055,11081,18.52%,8.69%
2020-01-01 00:12:30,5,1,3054,68,2986,4.66%,2.23%
2020-01-01 00:12:30,5,2,898,5,893,1.37%,0.56%
2020-01-01 00:12:30,5,3,438,2,436,0.67%,0.46%
2020-01-01 00:12:30,5,4,22361,3416,18945,34.12%,15.28%
2020-01-01 00:12:30,5,5,9947,720,9227,15.18%,7.24%
2020-01-01 00:12:30,5,6,15086,1610,13476,23.02%,10.67%
2020-01-01 00:12:30,5,7,4667,154,4513,7.12%,3.30%
2020-01-01 00:12:30,5,8,3186,70,3116,4.86%,2.20%
2020-01-01 00:12:30,5,9,9315,640,8675,14.21%,6.87%
2020-01-01 00:12:30,5,10,1099,8,1091,1.68%,0.73%
2020-01-01 00:12:30,5,11,832,7,825,1.27%,0.84%
2020-01-01 00:12:30,5,12,7602,450,7152,11.60%,5.92%
2020-01-01 00:12:30,6,1,982,8,974,1.50%,0.81%
2020-01-01 00:12:30,6,2,1045,9,1036,1.59%,0.86%
2020-01-01 00:12:30,6,3,1903,26,1877,2.90%,1.37%
2020-01-01 00:12:30,6,4,1732,25,1707,2.64%,1.44%
2020-01-01 00:12:30,6,5,17662,2261,15401,26.95%,12.80%
2020-01-01 00:12:30,6,6,6142,276,5866,9.37%,4.49%
2020-01-01 00:12:30,6,7,3928,114,3814,5.99%,2.90%
2020-01-01 00:12:30,6,8,3366,77,3289,5.14%,2.29%
2020-01-01 00:12:30,6,9,9314,650,8664,14.21%,6.98%
2020-01-01 00:12:30,6,10,2599,54,2545,3.97%,2.08%
2020-01-01 00:12:30,6,11,463,0,463,0.71%,0.00%
2020-01-01 00:12:30,6,12,6657,333,6324,10.16%,5.00%
2020-01-01 00:12:30,7,1,456,2,454,0.70%,0.44%
2020-01-01 00:12:30,7,2,178,0,178,0.27%,0.00%
2020-01-01 00:12:30,7,3,1215,10,1205,1.85%,0.82%
2020-01-01 00:12:30,7,4,2263,61,2202,3.45%,2.70%
2020-01-01 00:12:30,7,5,8102,500,7602,12.36%,6.17%
2020-01-01 00:12:30,7,6,13564,1401,12163,20.70%,10.33%
2020-01-01 00:12:30,7,7,3162,114,3048,4.82%,3.61%
2020-01-01 00:12:30,7,8,1210,37,1173,1.85%,3.06%
2020-01-01 00:12:30,7,9,6734,369,6365,10.28%,5.48%
2020-01-01 00:12:30,7,10,1655,18,1637,2.53%,1.09%
2020-01-01 00:12:30,7,11,97,0,97,0.15%,0.00%
2020-01-01 00:12:30,7,12,5102,243,4859,7.79%,4.76%
2020-01-01 00:12:30,8,1,515,4,511,0.79%,0.78%
2020-01-01 00:12:30,8,2,90,0,90,0.14%,0.00%
2020-01-01 00:12:30,8,3,1737,25,1712,2.65%,1.44%
2020-01-01 00:12:30,8,4,2953,65,2888,4.51%,2.20%
2020-01-01 00:12:30,8,5,8178,501,7677,12.48%,6.13%
2020-01-01 00:12:30,8,6,16468,1913,14555,25.13%,11.62%
2020-01-01 00:12:30,8,7,5253,173,5080,8.02%,3.29%
2020-01-01 00:12:30,8,8,1974,23,1951,3.01%,1.17%
2020-01-01 00:12:30,8,9,6203,285,5918,9.47%,4.59%
2020-01-01 00:12:30,8,10,1876,31,1845,2.86%,1.65%
2020-01-01 00:12:30,8,11,125,0,125,0.19%,0.00%
2020-01-01 00:12:30,8,12,4082,105,3977,6.23%,2.57%
2020-01-01 00:12:30,9,1,395,2,393,0.60%,0.51%
2020-01-01 00:12:30,9,2,2277,54,2223,3.47%,2.37%
2020-01-01 00:12:30,9,3,1134,15,1119,1.73%,1.32%
2020-01-01 00:12:30,9,4,6582,323,6259,10.04%,4.91%
2020-01-01 00:12:30,9,5,456,4,452,0.70%,0.88%
2020-01-01 00:12:30,9,6,7816,462,7354,11.93%,5.91%
2020-01-01 00:12:30,9,7,29208,5583,23625,44.57%,19.11%
2020-01-01 00:12:30,9,8,12506,1076,11430,19.08%,8.60%
2020-01-01 00:12:30,9,9,426,4,422,0.65%,0.94%
2020-01-01 00:12:30,9,10,3736,84,3652,5.70%,2.25%
2020-01-01 00:12:30,9,11,9823,657,9166,14.99%,6.69%
2020-01-01 00:12:30,9,12,5699,242,5457,8.70%,4.25%
2020-01-01 00:12:30,10,1,1283,277,1006,1.96%,21.59%
2020-01-01 00:12:30,10,2,2910,316,2594,4.44%,10.86%
2020-01-01 00:12:30,10,3,1440,21,1419,2.20%,1.46%
2020-01-01 00:12:30,10,4,4405,1123,3282,6.72%,25.49%
2020-01-01 00:12:30,10,5,579,24,555,0.88%,4.15%
2020-01-01 00:12:30,10,6,6196,1259,4937,9.45%,20.32%
2020-01-01 00:12:30,10,7,11249,2050,9199,17.16%,18.22%
2020-01-01 00:12:30,10,8,28517,7248,21269,43.51%,25.42%
2020-01-01 00:12:30,10,9,731,3,728,1.12%,0.41%
2020-01-01 00:12:30,10,10,2635,60,2575,4.02%,2.28%
2020-01-01 00:12:30,10,11,13214,1585,11629,20.16%,11.99%
2020-01-01 00:12:30,10,12,9817,1055,8762,14.98%,10.75%
2020-01-01 00:12:30,11,1,2283,37,2246,3.48%,1.62%
2020-01-01 00:12:30,11,2,3802,99,3703,5.80%,2.60%
2020-01-01 00:12:30,11,3,1355,13,1342,2.07%,0.96%
2020-01-01 00:12:30,11,4,3446,99,3347,5.26%,2.87%
2020-01-01 00:12:30,11,5,314,1,313,0.48%,0.32%
2020-01-01 00:12:30,11,6,4488,162,4326,6.85%,3.61%
2020-01-01 00:12:30,11,7,10017,709,9308,15.28%,7.08%
2020-01-01 00:12:30,11,8,23832,3803,20029,36.36%,15.96%
2020-01-01 00:12:30,11,9,232,1,231,0.35%,0.43%
2020-01-01 00:12:30,11,10,3447,124,3323,5.26%,3.60%
2020-01-01 00:12:30,11,11,10706,865,9841,16.34%,8.08%
2020-01-01 00:12:30,11,12,6860,363,6497,10.47%,5.29%
2020-01-01 00:12:30,12,1,30,0,30,0.05%,0.00%
2020-01-01 00:12:30,12,2,740,202,538,1.13%,27.30%
2020-01-01 00:12:30,12,3,2942,265,2677,4.49%,9.01%
2020-01-01 00:12:30,12,4,2726,66,2660,4.16%,2.42%
2020-01-01 00:12:30,12,5,9177,843,8334,14.00%,9.19%
2020-01-01 00:12:30,12,6,5411,226,5185,8.26%,4.18%
2020-01-01 00:12:30,12,7,2550,54,2496,3.89%,2.12%
2020-01-01 00:12:30,12,8,1340,275,1065,2.04%,20.52%
2020-01-01 00:12:30,12,9,22446,4490,17956,34.25%,20.00%
2020-01-01 00:12:30,12,10,4348,416,3932,6.63%,9.57%
2020-01-01 00:12:30,12,11,1510,278,1232,2.30%,18.41%
2020-01-01 00:12:30,12,12,8341,1155,7186,12.73%,13.85%
2020-01-01 00:12:30,13,1,2154,40,2114,3.29%,1.86%
2020-01-01 00:12:30,13,2,2592,61,2531,3.96%,2.35%
2020-01-01 00:12:30,13,3,816,3,813,1.25%,0.37%
2020-01-01 00:12:30,13,4,6015,594,5421,9.18%,9.88%
2020-01-01 00:12:30,13,5,9702,1144,8558,14.80%,11.79%
2020-01-01 00:12:30,13,6,7196,691,6505,10.98%,9.60%
2020-01-01 00:12:30,13,7,5651,246,5405,8.62%,4.35%
2020-01-01 00:12:30,13,8,7955,449,7506,12.14%,5.64%
2020-01-01 00:12:30,13,9,10176,1213,8963,15.53%,11.92%
2020-01-01 00:12:30,13,10,31436,7072,24364,47.97%,22.50%
2020-01-01 00:12:30,13,11,18074,2605,15469,27.58%,14.41%
2020-01-01 00:12:30,13,12,9422,1068,8354,14.38%,11.34%
2020-01-01 00:12:30,14,1,301,1,300,0.46%,0.33%
2020-01-01 00:12:30,14,2,1475,13,1462,2.25%,0.88%
2020-01-01 00:12:30,14,3,961,4,957,1.47%,0.42%
2020-01-01 00:12:30,14,4,3580,99,3481,5.46%,2.77%
2020-01-01 00:12:30,14,5,1152,12,1140,1.76%,1.04%
2020-01-01 00:12:30,14,6,3834,110,3724,5.85%,2.87%
2020-01-01 00:12:30,14,7,10894,923,9971,16.62%,8.47%
2020-01-01 00:12:30,14,8,12780,1222,11558,19.50%,9.56%
2020-01-01 00:12:30,14,9,1413,15,1398,2.16%,1.06%
2020-01-01 00:12:30,14,10,3750,102,3648,5.72%,2.72%
2020-01-01 00:12:30,14,11,24504,4077,20427,37.39%,16.64%
2020-01-01 00:12:30,14,12,7761,420,7341,11.84%,5.41%
2020-01-01 00:12:30,15,1,457,2,455,0.70%,0.44%
2020-01-01 00:12:30,15,2,135,1,134,0.21%,0.74%
2020-01-01 00:12:30,15,3,3873,108,3765,5.91%,2.79%
2020-01-01 00:12:30,15,4,5027,229,4798,7.67%,4.56%
2020-01-01 00:12:30,15,5,10219,803,9416,15.59%,7.86%
2020-01-01 00:12:30,15,6,5292,241,5051,8.07%,4.55%
2020-01-01 00:12:30,15,7,3746,113,3633,5.72%,3.02%
2020-01-01 00:12:30,15,8,5720,256,5464,8.73%,4.48%
2020-01-01 00:12:30,15,9,10456,845,9611,15.95%,8.08%
2020-01-01 00:12:30,15,10,4035,161,3874,6.16%,3.99%
2020-01-01 00:12:30,15,11,9871,764,9107,15.06%,7.74%
2020-01-01 00:12:30,15,12,26638,5044,21594,40.65%,18.94%
2020-01-01 00:12:30,16,1,313,4,309,0.48%,1.28%
2020-01-01 00:12:30,16,2,253,0,253,0.39%,0.00%
2020-01-01 00:12:30,16,3,1375,9,1366,2.10%,0.65%
2020-01-01 00:12:30,16,4,5997,255,5742,9.15%,4.25%
2020-01-01 00:12:30,16,5,9307,721,8586,14.20%,7.75%
2020-01-01 00:12:30,16,6,6904,351,6553,10.53%,5.08%
2020-01-01 00:12:30,16,7,3625,122,3503,5.53%,3.37%
2020-01-01 00:12:30,16,8,8316,577,7739,12.69%,6.94%
2020-01-01 00:12:30,16,9,9673,776,8897,14.76%,8.02%
2020-01-01 00:12:30,16,10,1346,10,1336,2.05%,0.74%
2020-01-01 00:12:30,16,11,9937,787,9150,15.16%,7.92%
2020-01-01 00:12:30,16,12,27548,5286,22262,42.03%,19.19%
2020-01-01 00:12:40,1,1,16106,1853,14253,24.58%,11.51%
2020-01-01 00:12:40,1,2,8678,549,8129,13.24%,6.33%
2020-01-01 00:12:40,1,3,890,8,882,1.36%,0.90%
2020-01-01 00:12:40,1,4,7026,396,6630,10.72%,5.64%
2020-01-01 00:12:40,1,5,6772,363,6409,10.33%,5.36%
2020-01-01 00:12:40,1,6,6689,353,6336,10.21%,5.28%
2020-01-01 00:12:40,1,7,7773,440,7333,11.86%,5.66%
2020-01-01 00:12:40,1,8,6542,314,6228,9.98%,4.80%
2020-01-01 00:12:40,1,9,6623,349,6274,10.11%,5.27%
2020-01-01 00:12:40,1,10,6065,264,5801,9.25%,4.35%
2020-01-01 00:12:40,1,11,6179,277,5902,9.43%,4.48%
2020-01-01 00:12:40,1,12,6588,344,6244,10.05%,5.22%
2020-01-01 00:12:40,2,1,890,3,887,1.36%,0.34%
2020-01-01 00:12:40,2,2,28657,5430,23227,43.73%,18.95%
2020-01-01 00:12:40,2,3,22771,3516,19255,34.75%,15.44%
2020-01-01 00:12:40,2,4,814,3,811,1.24%,0.37%
2020-01-01 00:12:40,2,5,16999,1978,15021,25.94%,11.64%
2020-01-01 00:12:40,2,6,352,0,352,0.54%,0.00%
2020-01-01 00:12:40,2,7,4970,215,4755,7.58%,4.33%
2020-01-01 00:12:40,2,8,3258,100,3158,4.97%,3.07%
2020-01-01 00:12:40,2,9,16919,1960,14959,25.82%,11.58%
2020-01-01 00:12:40,2,10,2333,48,2285,3.56%,2.06%
2020-01-01 00:12:40,2,11,2345,49,2296,3.58%,2.09%
2020-01-01 00:12:40,2,12,16775,1926,14849,25.60%,11.48%
2020-01-01 00:12:40,3,1,2707,54,2653,4.13%,1.99%
2020-01-01 00:12:40,3,2,23403,3653,19750,35.71%,15.61%
2020-01-01 00:12:40,3,3,67617,25375,42242,103.18%,37.53%
2020-01-01 00:12:40,3,4,8008,448,7560,12.22%,5.59%
2020-01-01 00:12:40,3,5,42267,11072,31195,64.49%,26.20%
2020-01-01 00:12:40,3,6,9080,570,8510,13.85%,6.28%
2020-01-01 00:12:40,3,7,18503,2321,16182,28.23%,12.54%
2020-01-01 00:12:40,3,8,15706,1710,13996,23.97%,10.89%
2020-01-01 00:12:40,3,9,32861,7001,25860,50.14%,21.30%
2020-01-01 00:12:40,3,10,6343,297,6046,9.68%,4.68%
2020-01-01 00:12:40,3,11,1874,26,1848,2.86%,1.39%
2020-01-01 00:12:40,3,12,22751,3616,19135,34.72%,15.89%
2020-01-01 00:12:40,4,1,561,3,558,0.86%,0.53%
2020-01-01 00:12:40,4,2,353,1,352,0.54%,0.28%
2020-01-01 00:12:40,4,3,775,4,771,1.18%,0.52%
2020-01-01 00:12:40,4,4,29610,5757,23853,45.18%,19.44%
2020-01-01 00:12:40,4,5,17578,2123,15455,26.82%,12.08%
2020-01-01 00:12:40,4,6,24895,4121,20774,37.99%,16.55%
2020-01-01 00:12:40,4,7,5820,269,5551,8.88%,4.62%
2020-01-01 00:12:40,4,8,3324,94,3230,5.07%,2.83%
2020-01-01 00:12:40,4,9,15743,1732,14011,24.02%,11.00%
2020-01-01 00:12:40,4,10,2059,37,2022,3.14%,1.80%
2020-01-01 00:12:40,4,11,212,0,212,0.32%,0.00%
2020-01-01 00:12:40,4,12,12362,1090,11272,18.86%,8.82%
2020-01-01 00:12:40,5,1,3119,71,3048,4.76%,2.28%
2020-01-01 00:12:40,5,2,1134,4,1130,1.73%,0.35%
2020-01-01 00:12:40,5,3,1636,21,1615,2.50%,1.28%
2020-01-01 00:12:40,5,4,24468,4076,20392,37.34%,16.66%
2020-01-01 00:12:40,5,5,10522,875,9647,16.06%,8.32%
2020-01-01 00:12:40,5,6,15885,1836,14049,24.24%,11.56%
2020-01-01 00:12:40,5,7,4701,170,4531,7.17%,3.62%
2020-01-01 00:12:40,5,8,3623,116,3507,5.53%,3.20%
2020-01-01 00:12:40,5,9,8763,613,8150,13.37%,7.00%
2020-01-01 00:12:40,5,10,1143,15,1128,1.74%,1.31%
2020-01-01 00:12:40,5,11,609,2,607,0.93%,0.33%
2020-01-01 00:12:40,5,12,7311,433,6878,11.16%,5.92%
2020-01-01 00:12:40,6,1,1054,9,1045,1.61%,0.85%
2020-01-01 00:12:40,6,2,1148,14,1134,1.75%,1.22%
2020-01-01 00:12:40,6,3,1830,26,1804,2.79%,1.42%
2020-01-01 00:12:40,6,4,1782,15,1767,2.72%,0.84%
2020-01-01 00:12:40,6,5,14210,1410,12800,21.68%,9.92%
2020-01-01 00:12:40,6,6,5757,233,5524,8.78%,4.05%
2020-01-01 00:12:40,6,7,3355,93,3262,5.12%,2.77%
2020-01-01 00:12:40,6,8,2744,67,2677,4.19%,2.44%
2020-01-01 00:12:40,6,9,6349,293,6056,9.69%,4.61%
2020-01-01 00:12:40,6,10,1788,21,1767,2.73%,1.17%
2020-01-01 00:12:40,6,11,350,0,350,0.53%,0.00%
2020-01-01 00:12:40,6,12,4500,150,4350,6.87%,3.33%
2020-01-01 00:12:40,7,1,599,2,597,0.91%,0.33%
2020-01-01 00:12:40,7,2,188,0,188,0.29%,0.00%
2020-01-01 00:12:40,7,3,668,6,662,1.02%,0.90%
2020-01-01 00:12:40,7,4,2805,57,2748,4.28%,2.03%
2020-01-01 00:12:40,7,5,8200,482,7718,12.51%,5.88%
2020-01-01 00:12:40,7,6,14383,1574,12809,21.95%,10.94%
2020-01-01 00:12:40,7,7,3336,96,3240,5.09%,2.88%
2020-01-01 00:12:40,7,8,1517,21,1496,2.31%,1.38%
2020-01-01 00:12:40,7,9,7213,374,6839,11.01%,5.19%
2020-01-01 00:12:40,7,10,1997,21,1976,3.05%,1.05%
2020-01-01 00:12:40,7,11,71,0,71,0.11%,0.00%
2020-01-01 00:12:40,7,12,5210,196,5014,7.95%,3.76%
2020-01-01 00:12:40,8,1,555,5,550,0.85%,0.90%
2020-01-01 00:12:40,8,2,90,0,90,0.14%,0.00%
2020-01-01 00:12:40,8,3,1623,15,1608,2.48%,0.92%
2020-01-01 00:12:40,8,4,3269,79,3190,4.99%,2.42%
2020-01-01 00:12:40,8,5,7921,454,7467,12.09%,5.73%
2020-01-01 00:12:40,8,6,17276,2127,15149,26.36%,12.31%
2020-01-01 00:12:40,8,7,5981,298,5683,9.13%,4.98%
2020-01-01 00:12:40,8,8,3048,78,2970,4.65%,2.56%
2020-01-01 00:12:40,8,9,6114,276,5838,9.33%,4.51%
2020-01-01 00:12:40,8,10,1751,37,1714,2.67%,2.11%
2020-01-01 00:12:40,8,11,124,0,124,0.19%,0.00%
2020-01-01 00:12:40,8,12,4322,128,4194,6.59%,2.96%
2020-01-01 00:12:40,9,1,343,1,342,0.52%,0.29%
2020-01-01 00:12:40,9,2,2103,48,2055,3.21%,2.28%
2020-01-01 00:12:40,9,3,1250,18,1232,1.91%,1.44%
2020-01-01 00:12:40,9,4,7320,396,6924,11.17%,5.41%
2020-01-01 00:12:40,9,5,553,4,549,0.84%,0.72%
2020-01-01 00:12:40,9,6,8878,597,8281,13.55%,6.72%
2020-01-01 00:12:40,9,7,28880,5671,23209,44.07%,19.64%
2020-01-01 00:12:40,9,8,10725,827,9898,16.37%,7.71%
2020-01-01 00:12:40,9,9,333,2,331,0.51%,0.60%
2020-01-01 00:12:40,9,10,3289,96,3193,5.02%,2.92%
2020-01-01 00:12:40,9,11,8883,583,8300,13.55%,6.56%
2020-01-01 00:12:40,9,12,5278,203,5075,8.05%,3.85%
2020-01-01 00:12:40,10,1,1383,257,1126,2.11%,18.58%
2020-01-01 00:12:40,10,2,3195,336,2859,4.88%,10.52%
2020-01-01 00:12:40,10,3,1674,43,1631,2.55%,2.57%
2020-01-01 00:12:40,10,4,3904,1119,2785,5.96%,28.66%
2020-01-01 00:12:40,10,5,816,60,756,1.25%,7.35%
2020-01-01 00:12:40,10,6,5756,1274,4482,8.78%,22.13%
2020-01-01 00:12:40,10,7,10751,1982,8769,16.40%,18.44%
2020-01-01 00:12:40,10,8,29290,7685,21605,44.69%,26.24%
2020-01-01 00:12:40,10,9,704,5,699,1.07%,0.71%
2020-01-01 00:12:40,10,10,2501,47,2454,3.82%,1.88%
2020-01-01 00:12:40,10,11,14099,1820,12279,21.51%,12.91%
2020-01-01 00:12:40,10,12,10731,1278,9453,16.37%,11.91%
2020-01-01 00:12:40,11,1,2359,45,2314,3.60%,1.91%
2020-01-01 00:12:40,11,2,4233,140,4093,6.46%,3.31%
2020-01-01 00:12:40,11,3,1726,21,1705,2.63%,1.22%
2020-01-01 00:12:40,11,4,4831,174,4657,7.37%,3.60%
2020-01-01 00:12:40,11,5,194,0,194,0.30%,0.00%
2020-01-01 00:12:40,11,6,5802,248,5554,8.85%,4.27%
2020-01-01 00:12:40,11,7,11700,987,10713,17.85%,8.44%
2020-01-01 00:12:40,11,8,25850,4506,21344,39.44%,17.43%
2020-01-01 00:12:40,11,9,253,0,253,0.39%,0.00%
2020-01-01 00:12:40,11,10,3135,85,3050,4.78%,2.71%
2020-01-01 00:12:40,11,11,10473,798,9675,15.98%,7.62%
2020-01-01 00:12:40,11,12,6950,366,6584,10.60%,5.27%
2020-01-01 00:12:40,12,1,50,0,50,0.08%,0.00%
2020-01-01 00:12:40,12,2,604,147,457,0.92%,24.34%
2020-01-01 00:12:40,12,3,2723,192,2531,4.15%,7.05%
2020-01-01 00:12:40,12,4,2702,45,2657,4.12%,1.67%
2020-01-01 00:12:40,12,5,7884,584,7300,12.03%,7.41%
2020-01-01 00:12:40,12,6,4405,140,4265,6.72%,3.18%
2020-01-01 00:12:40,12,7,1549,21,1528,2.36%,1.36%
2020-01-01 00:12:40,12,8,1466,291,1175,2.24%,19.85%
2020-01-01 00:12:40,12,9,22380,4146,18234,34.15%,18.53%
2020-01-01 00:12:40,12,10,4326,403,3923,6.60%,9.32%
2020-01-01 00:12:40,12,11,1667,295,1372,2.54%,17.70%
2020-01-01 00:12:40,12,12,9283,1141,8142,14.16%,12.29%
2020-01-01 00:12:40,13,1,2129,40,2089,3.25%,1.88%
2020-01-01 00:12:40,13,2,2394,54,2340,3.65%,2.26%
2020-01-01 00:12:40,13,3,663,3,660,1.01%,0.45%
2020-01-01 00:12:40,13,4,4744,545,4199,7.24%,11.49%
2020-01-01 00:12:40,13,5,8656,1024,7632,13.21%,11.83%
2020-01-01 00:12:40,13,6,5787,614,5173,8.83%,10.61%
2020-01-01 00:12:40,13,7,5366,209,5157,8.19%,3.89%
2020-01-01 00:12:40,13,8,8028,470,7558,12.25%,5.85%
2020-01-01 00:12:40,13,9,9099,1071,8028,13.88%,11.77%
2020-01-01 00:12:40,13,10,29191,6212,22979,44.54%,21.28%
2020-01-01 00:12:40,13,11,17070,2333,14737,26.05%,13.67%
2020-01-01 00:12:40,13,12,8558,892,7666,13.06%,10.42%
2020-01-01 00:12:40,14,1,226,0,226,0.34%,0.00%
2020-01-01 00:12:40,14,2,4494,157,4337,6.86%,3.49%
2020-01-01 00:12:40,14,3,4029,129,3900,6.15%,3.20%
2020-01-01 00:12:40,14,4,3464,93,3371,5.29%,2.68%
2020-01-01 00:12:40,14,5,1230,13,1217,1.88%,1.06%
2020-01-01 00:12:40,14,6,3779,116,3663,5.77%,3.07%
2020-01-01 00:12:40,14,7,14723,1554,13169,22.47%,10.55%
2020-01-01 00:12:40,14,8,16529,1954,14575,25.22%,11.82%
2020-01-01 00:12:40,14,9,1433,15,1418,2.19%,1.05%
2020-01-01 00:12:40,14,10,4061,120,3941,6.20%,2.95%
2020-01-01 00:12:40,14,11,31471,6441,25030,48.02%,20.47%
2020-01-01 00:12:40,14,12,10588,785,9803,16.16%,7.41%
2020-01-01 00:12:40,15,1,535,3,532,0.82%,0.56%
2020-01-01 00:12:40,15,2,94,0,94,0.14%,0.00%
2020-01-01 00:12:40,15,3,4399,141,4258,6.71%,3.21%
2020-01-01 00:12:40,15,4,4443,192,4251,6.78%,4.32%
2020-01-01 00:12:40,15,5,9829,768,9061,15.00%,7.81%
2020-01-01 00:12:40,15,6,4685,223,4462,7.15%,4.76%
2020-01-01 00:12:40,15,7,3408,88,3320,5.20%,2.58%
2020-01-01 00:12:40,15,8,5525,233,5292,8.43%,4.22%
2020-01-01 00:12:40,15,9,10053,805,9248,15.34%,8.01%
2020-01-01 00:12:40,15,10,4322,256,4066,6.59%,5.92%
2020-01-01 00:12:40,15,11,10017,856,9161,15.28%,8.55%
2020-01-01 00:12:40,15,12,25394,4802,20592,38.75%,18.91%
2020-01-01 00:12:40,16,1,371,3,368,0.57%,0.81%
2020-01-01 00:12:40,16,2,236,0,236,0.36%,0.00%
2020-01-01 00:12:40,16,3,1340,10,1330,2.04%,0.75%
2020-01-01 00:12:40,16,4,3736,99,3637,5.70%,2.65%
2020-01-01 00:12:40,16,5,6938,404,6534,10.59%,5.82%
2020-01-01 00:12:40,16,6,4476,138,4338,6.83%,3.08%
2020-01-01 00:12:40,16,7,3122,73,3049,4.76%,2.34%
2020-01-01 00:12:40,16,8,7859,508,7351,11.99%,6.46%
2020-01-01 00:12:40,16,9,7292,439,6853,11.13%,6.02%
2020-01-01 00:12:40,16,10,1650,21,1629,2.52%,1.27%
2020-01-01 00:12:40,16,11,9742,771,8971,14.87%,7.91%
2020-01-01 00:12:40,16,12,25134,4296,20838,38.35%,17.09%
2020-01-01 00:12:50,1,1,19214,2650,16564,29.32%,13.79%
2020-01-01 00:12:50,1,2,8170,514,7656,12.47%,6.29%
2020-01-01 00:12:50,1,3,487,5,482,0.74%,1.03%
2020-01-01 00:12:50,1,4,10734,891,9843,16.38%,8.30%
2020-01-01 00:12:50,1,5,10373,835,9538,15.83%,8.05%
2020-01-01 00:12:50,1,6,10364,833,9531,15.81%,8.04%
2020-01-01 00:12:50,1,7,7668,451,7217,11.70%,5.88%
2020-01-01 00:12:50,1,8,5874,266,5608,8.96%,4.53%
2020-01-01 00:12:50,1,9,10312,827,9485,15.73%,8.02%
2020-01-01 00:12:50,1,10,5335,215,5120,8.14%,4.03%
2020-01-01 00:12:50,1,11,5441,218,5223,8.30%,4.01%
2020-01-01 00:12:50,1,12,10263,815,9448,15.66%,7.94%
2020-01-01 00:12:50,2,1,1986,32,1954,3.03%,1.61%
2020-01-01 00:12:50,2,2,25840,4481,21359,39.43%,17.34%
2020-01-01 00:12:50,2,3,19094,2548,16546,29.14%,13.34%
2020-01-01 00:12:50,2,4,1888,29,1859,2.88%,1.54%
2020-01-01 00:12:50,2,5,11971,1025,10946,18.27%,8.56%
2020-01-01 00:12:50,2,6,78,0,78,0.12%,0.00%
2020-01-01 00:12:50,2,7,4731,181,4550,7.22%,3.83%
2020-01-01 00:12:50,2,8,3575,111,3464,5.46%,3.10%
2020-01-01 00:12:50,2,9,11891,1013,10878,18.14%,8.52%
2020-01-01 00:12:50,2,10,2605,68,2537,3.97%,2.61%
2020-01-01 00:12:50,2,11,2626,68,2558,4.01%,2.59%
2020-01-01 00:12:50,2,12,11761,996,10765,17.95%,8.47%
2020-01-01 00:12:50,3,1,1301,19,1282,1.99%,1.46%
2020-01-01 00:12:50,3,2,23923,3917,20006,36.50%,16.37%
2020-01-01 00:12:50,3,3,72009,28076,43933,109.88%,38.99%
2020-01-01 00:12:50,3,4,10572,837,9735,16.13%,7.92%
2020-01-01 00:12:50,3,5,47438,13587,33851,72.38%,28.64%
2020-01-01 00:12:50,3,6,11974,1035,10939,18.27%,8.64%
2020-01-01 00:12:50,3,7,20453,2884,17569,31.21%,14.10%
2020-01-01 00:12:50,3,8,17914,2225,15689,27.33%,12.42%
2020-01-01 00:12:50,3,9,35147,7947,27200,53.63%,22.61%
2020-01-01 00:12:50,3,10,5262,205,5057,8.03%,3.90%
2020-01-01 00:12:50,3,11,1682,19,1663,2.57%,1.13%
2020-01-01 00:12:50,3,12,26933,4855,22078,41.10%,18.03%
2020-01-01 00:12:50,4,1,494,2,492,0.75%,0.40%
2020-01-01 00:12:50,4,2,303,2,301,0.46%,0.66%
2020-01-01 00:12:50,4,3,900,4,896,1.37%,0.44%
2020-01-01 00:12:50,4,4,27546,5081,22465,42.03%,18.45%
2020-01-01 00:12:50,4,5,17102,2009,15093,26.10%,11.75%
2020-01-01 00:12:50,4,6,23470,3753,19717,35.81%,15.99%
2020-01-01 00:12:50,4,7,4755,161,4594,7.26%,3.39%
2020-01-01 00:12:50,4,8,2766,58,2708,4.22%,2.10%
2020-01-01 00:12:50,4,9,14764,1493,13271,22.53%,10.11%
2020-01-01 00:12:50,4,10,1976,31,1945,3.02%,1.57%
2020-01-01 00:12:50,4,11,233,0,233,0.36%,0.00%
2020-01-01 00:12:50,4,12,12231,1057,11174,18.66%,8.64%
2020-01-01 00:12:50,5,1,2699,52,2647,4.12%,1.93%
2020-01-01 00:12:50,5,2,1343,11,1332,2.05%,0.82%
2020-01-01 00:12:50,5,3,441,1,440,0.67%,0.23%
2020-01-01 00:12:50,5,4,21565,3292,18273,32.91%,15.27%
2020-01-01 00:12:50,5,5,9275,663,8612,14.15%,7.15%
2020-01-01 00:12:50,5,6,14342,1521,12821,21.88%,10.61%
2020-01-01 00:12:50,5,7,4463,173,4290,6.81%,3.88%
2020-01-01 00:12:50,5,8,3397,104,3293,5.18%,3.06%
2020-01-01 00:12:50,5,9,8648,580,8068,13.20%,6.71%
2020-01-01 00:12:50,5,10,1075,21,1054,1.64%,1.95%
2020-01-01 00:12:50,5,11,653,3,650,1.00%,0.46%
2020-01-01 00:12:50,5,12,7185,400,6785,10.96%,5.57%
2020-01-01 00:12:50,6,1,1143,8,1135,1.74%,0.70%
2020-01-01 00:12:50,6,2,1260,10,1250,1.92%,0.79%
2020-01-01 00:12:50,6,3,1963,34,1929,3.00%,1.73%
2020-01-01 00:12:50,6,4,1583,97,1486,2.42%,6.13%
2020-01-01 00:12:50,6,5,14463,1557,12906,22.07%,10.77%
2020-01-01 00:12:50,6,6,4934,299,4635,7.53%,6.06%
2020-01-01 00:12:50,6,7,3011,85,2926,4.59%,2.82%
2020-01-01 00:12:50,6,8,2502,63,2439,3.82%,2.52%
2020-01-01 00:12:50,6,9,7373,421,6952,11.25%,5.71%
2020-01-01 00:12:50,6,10,2129,39,2090,3.25%,1.83%
2020-01-01 00:12:50,6,11,368,1,367,0.56%,0.27%
2020-01-01 00:12:50,6,12,5177,184,4993,7.90%,3.55%
2020-01-01 00:12:50,7,1,375,1,374,0.57%,0.27%
2020-01-01 00:12:50,7,2,185,0,185,0.28%,0.00%
2020-01-01 00:12:50,7,3,1024,5,1019,1.56%,0.49%
2020-01-01 00:12:50,7,4,1886,29,1857,2.88%,1.54%
2020-01-01 00:12:50,7,5,6878,350,6528,10.49%,5.09%
2020-01-01 00:12:50,7,6,12638,1203,11435,19.28%,9.52%
2020-01-01 00:12:50,7,7,3829,116,3713,5.84%,3.03%
2020-01-01 00:12:50,7,8,1680,28,1652,2.56%,1.67%
2020-01-01 00:12:50,7,9,5618,241,5377,8.57%,4.29%
2020-01-01 00:12:50,7,10,1284,13,1271,1.96%,1.01%
2020-01-01 00:12:50,7,11,51,0,51,0.08%,0.00%
2020-01-01 00:12:50,7,12,4348,154,4194,6.63%,3.54%
2020-01-01 00:12:50,8,1,428,2,426,0.65%,0.47%
2020-01-01 00:12:50,8,2,69,0,69,0.11%,0.00%
2020-01-01 00:12:50,8,3,1377,17,1360,2.10%,1.23%
2020-01-01 00:12:50,8,4,2903,58,2845,4.43%,2.00%
2020-01-01 00:12:50,8,5,7587,440,7147,11.58%,5.80%
2020-01-01 00:12:50,8,6,16300,1858,14442,24.87%,11.40%
2020-01-01 00:12:50,8,7,5763,244,5519,8.79%,4.23%
2020-01-01 00:12:50,8,8,2938,72,2866,4.48%,2.45%
2020-01-01 00:12:50,8,9,5978,265,5713,9.12%,4.43%
2020-01-01 00:12:50,8,10,1712,26,1686,2.61%,1.52%
2020-01-01 00:12:50,8,11,207,1,206,0.32%,0.48%
2020-01-01 00:12:50,8,12,4126,135,3991,6.30%,3.27%
2020-01-01 00:12:50,9,1,359,2,357,0.55%,0.56%
2020-01-01 00:12:50,9,2,2086,34,2052,3.18%,1.63%
2020-01-01 00:12:50,9,3,1085,5,1080,1.66%,0.46%
2020-01-01 00:12:50,9,4,5783,245,5538,8.82%,4.24%
2020-01-01 00:12:50,9,5,933,9,924,1.42%,0.96%
2020-01-01 00:12:50,9,6,7668,451,7217,11.70%,5.88%
2020-01-01 00:12:50,9,7,31040,6240,24800,47.36%,20.10%
2020-01-01 00:12:50,9,8,13957,1364,12593,21.30%,9.77%
2020-01-01 00:12:50,9,9,513,1,512,0.78%,0.19%
2020-01-01 00:12:50,9,10,5197,171,5026,7.93%,3.29%
2020-01-01 00:12:50,9,11,11498,937,10561,17.54%,8.15%
2020-01-01 00:12:50,9,12,6007,269,5738,9.17%,4.48%
2020-01-01 00:12:50,10,1,1224,225,999,1.87%,18.38%
2020-01-01 00:12:50,10,2,3254,299,2955,4.97%,9.19%
2020-01-01 00:12:50,10,3,1901,41,1860,2.90%,2.16%
2020-01-01 00:12:50,10,4,3919,970,2949,5.98%,24.75%
2020-01-01 00:12:50,10,5,838,39,799,1.28%,4.65%
2020-01-01 00:12:50,10,6,5692,1098,4594,8.69%,19.29%
2020-01-01 00:12:50,10,7,10579,1800,8779,16.14%,17.01%
2020-01-01 00:12:50,10,8,28123,7213,20910,42.91%,25.65%
2020-01-01 00:12:50,10,9,572,2,570,0.87%,0.35%
2020-01-01 00:12:50,10,10,2160,36,2124,3.30%,1.67%
2020-01-01 00:12:50,10,11,13378,1728,11650,20.41%,12.92%
2020-01-01 00:12:50,10,12,10530,1251,9279,16.07%,11.88%
2020-01-01 00:12:50,11,1,2060,38,2022,3.14%,1.84%
2020-01-01 00:12:50,11,2,3289,84,3205,5.02%,2.55%
2020-01-01 00:12:50,11,3,1045,9,1036,1.59%,0.86%
2020-01-01 00:12:50,11,4,5162,222,4940,7.88%,4.30%
2020-01-01 00:12:50,11,5,172,0,172,0.26%,0.00%
2020-01-01 00:12:50,11,6,5895,282,5613,9.00%,4.78%
2020-01-01 00:12:50,11,7,11080,933,10147,16.91%,8.42%
2020-01-01 00:12:50,11,8,25693,4552,21141,39.20%,17.72%
2020-01-01 00:12:50,11,9,175,0,175,0.27%,0.00%
2020-01-01 00:12:50,11,10,2762,68,2694,4.21%,2.46%
2020-01-01 00:12:50,11,11,10628,820,9808,16.22%,7.72%
2020-01-01 00:12:50,11,12,7451,421,7030,11.37%,5.65%
2020-01-01 00:12:50,12,1,53,0,53,0.08%,0.00%
2020-01-01 00:12:50,12,2,442,151,291,0.67%,34.16%
2020-01-01 00:12:50,12,3,2088,180,1908,3.19%,8.62%
2020-01-01 00:12:50,12,4,2507,52,2455,3.83%,2.07%
2020-01-01 00:12:50,12,5,7130,519,6611,10.88%,7.28%
2020-01-01 00:12:50,12,6,4147,165,3982,6.33%,3.98%
2020-01-01 00:12:50,12,7,1499,12,1487,2.29%,0.80%
2020-01-01 00:12:50,12,8,1348,236,1112,2.06%,17.51%
2020-01-01 00:12:50,12,9,20576,3637,16939,31.40%,17.68%
2020-01-01 00:12:50,12,10,3883,322,3561,5.92%,8.29%
2020-01-01 00:12:50,12,11,1520,239,1281,2.32%,15.72%
2020-01-01 00:12:50,12,12,7758,920,6838,11.84%,11.86%
2020-01-01 00:12:50,13,1,1784,25,1759,2.72%,1.40%
2020-01-01 00:12:50,13,2,2069,42,2027,3.16%,2.03%
2020-01-01 00:12:50,13,3,572,1,571,0.87%,0.17%
2020-01-01 00:12:50,13,4,4282,458,3824,6.53%,10.70%
2020-01-01 00:12:50,13,5,6748,778,5970,10.30%,11.53%
2020-01-01 00:12:50,13,6,4893,512,4381,7.47%,10.46%
2020-01-01 00:12:50,13,7,4284,143,4141,6.54%,3.34%
2020-01-01 00:12:50,13,8,6610,319,6291,10.09%,4.83%
2020-01-01 00:12:50,13,9,7197,821,6376,10.98%,11.41%
2020-01-01 00:12:50,13,10,28937,6121,22816,44.15%,21.15%
2020-01-01 00:12:50,13,11,17320,2362,14958,26.43%,13.64%
2020-01-01 00:12:50,13,12,10301,1081,9220,15.72%,10.49%
2020-01-01 00:12:50,14,1,364,0,364,0.56%,0.00%
2020-01-01 00:12:50,14,2,8716,551,8165,13.30%,6.32%
2020-01-01 00:12:50,14,3,8186,494,7692,12.49%,6.03%
2020-01-01 00:12:50,14,4,3849,89,3760,5.87%,2.31%
2020-01-01 00:12:50,14,5,1469,30,1439,2.24%,2.04%
2020-01-01 00:12:50,14,6,4075,107,3968,6.22%,2.63%
2020-01-01 00:12:50,14,7,17830,2170,15660,27.21%,12.17%
2020-01-01 00:12:50,14,8,19637,2594,17043,29.96%,13.21%
2020-01-01 00:12:50,14,9,1917,37,1880,2.93%,1.93%
2020-01-01 00:12:50,14,10,4313,162,4151,6.58%,3.76%
2020-01-01 00:12:50,14,11,32149,6678,25471,49.06%,20.77%
2020-01-01 00:12:50,14,12,7813,452,7361,11.92%,5.79%
2020-01-01 00:12:50,15,1,628,5,623,0.96%,0.80%
2020-01-01 00:12:50,15,2,142,1,141,0.22%,0.70%
2020-01-01 00:12:50,15,3,6656,329,6327,10.16%,4.94%
2020-01-01 00:12:50,15,4,4740,291,4449,7.23%,6.14%
2020-01-01 00:12:50,15,5,12556,1287,11269,19.16%,10.25%
2020-01-01 00:12:50,15,6,5003,342,4661,7.63%,6.84%
2020-01-01 00:12:50,15,7,3270,76,3194,4.99%,2.32%
2020-01-01 00:12:50,15,8,5493,234,5259,8.38%,4.26%
2020-01-01 00:12:50,15,9,12731,1313,11418,19.43%,10.31%
2020-01-01 00:12:50,15,10,5455,299,5156,8.32%,5.48%
2020-01-01 00:12:50,15,11,11094,963,10131,16.93%,8.68%
2020-01-01 00:12:50,15,12,29236,6154,23082,44.61%,21.05%
2020-01-01 00:12:50,16,1,409,0,409,0.62%,0.00%
2020-01-01 00:12:50,16,2,171,0,171,0.26%,0.00%
2020-01-01 00:12:50,16,3,980,12,968,1.50%,1.22%
2020-01-01 00:12:50,16,4,4030,156,3874,6.15%,3.87%
2020-01-01 00:12:50,16,5,7313,467,6846,11.16%,6.39%
2020-01-01 00:12:50,16,6,4848,220,4628,7.40%,4.54%
2020-01-01 00:12:50,16,7,3777,92,3685,5.76%,2.44%
2020-01-01 00:12:50,16,8,7516,409,7107,11.47%,5.44%
2020-01-01 00:12:50,16,9,7821,534,7287,11.93%,6.83%
2020-01-01 00:12:50,16,10,1521,18,1503,2.32%,1.18%
2020-01-01 00:12:50,16,11,9237,594,8643,14.09%,6.43%
2020-01-01 00:12:50,16,12,24616,4155,20461,37.56%,16.88%
2020-01-01 00:13:00,1,1,18017,2286,15731,27.49%,12.69%
2020-01-01 00:13:00,1,2,8105,474,7631,12.37%,5.85%
2020-01-01 00:13:00,1,3,1417,10,1407,2.16%,0.71%
2020-01-01 00:13:00,1,4,9506,714,8792,14.51%,7.51%
2020-01-01 00:13:00,1,5,9023,644,8379,13.77%,7.14%
2020-01-01 00:13:00,1,6,8998,639,8359,13.73%,7.10%
2020-01-01 00:13:00,1,7,6674,324,6350,10.18%,4.85%
2020-01-01 00:13:00,1,8,4902,185,4717,7.48%,3.77%
2020-01-01 00:13:00,1,9,8960,637,8323,13.67%,7.11%
2020-01-01 00:13:00,1,10,4112,119,3993,6.27%,2.89%
2020-01-01 00:13:00,1,11,4215,134,4081,6.43%,3.18%
2020-01-01 00:13:00,1,12,8933,635,8298,13.63%,7.11%
2020-01-01 00:13:00,2,1,889,5,884,1.36%,0.56%
2020-01-01 00:13:00,2,2,26346,4606,21740,40.20%,17.48%
2020-01-01 00:13:00,2,3,20904,2960,17944,31.90%,14.16%
2020-01-01 00:13:00,2,4,819,4,815,1.25%,0.49%
2020-01-01 00:13:00,2,5,14446,1435,13011,22.04%,9.93%
2020-01-01 00:13:00,2,6,62,0,62,0.09%,0.00%
2020-01-01 00:13:00,2,7,4535,156,4379,6.92%,3.44%
2020-01-01 00:13:00,2,8,3459,98,3361,5.28%,2.83%
2020-01-01 00:13:00,2,9,14293,1406,12887,21.81%,9.84%
2020-01-01 00:13:00,2,10,2649,62,2587,4.04%,2.34%
2020-01-01 00:13:00,2,11,2669,64,2605,4.07%,2.40%
2020-01-01 00:13:00,2,12,14084,1365,12719,21.49%,9.69%
2020-01-01 00:13:00,3,1,1678,15,1663,2.56%,0.89%
2020-01-01 00:13:00,3,2,21764,3351,18413,33.21%,15.40%
2020-01-01 00:13:00,3,3,74525,30032,44493,113.72%,40.30%
2020-01-01 00:13:00,3,4,13849,1368,12481,21.13%,9.88%
2020-01-01 00:13:00,3,5,51101,15536,35565,77.97%,30.40%
2020-01-01 00:13:00,3,6,15002,1582,13420,22.89%,10.55%
2020-01-01 00:13:00,3,7,17992,2322,15670,27.45%,12.91%
2020-01-01 00:13:00,3,8,15266,1680,13586,23.29%,11.00%
2020-01-01 00:13:00,3,9,35517,8041,27476,54.19%,22.64%
2020-01-01 00:13:00,3,10,4796,183,4613,7.32%,3.82%
2020-01-01 00:13:00,3,11,2124,40,2084,3.24%,1.88%
2020-01-01 00:13:00,3,12,29026,5536,23490,44.29%,19.07%
2020-01-01 00:13:00,4,1,450,0,450,0.69%,0.00%
2020-01-01 00:13:00,4,2,304,0,304,0.46%,0.00%
2020-01-01 00:13:00,4,3,1861,37,1824,2.84%,1.99%
2020-01-01 00:13:00,4,4,28091,5136,22955,42.86%,18.28%
2020-01-01 00:13:00,4,5,18417,2348,16069,28.10%,12.75%
2020-01-01 00:13:00,4,6,24260,3933,20327,37.02%,16.21%
2020-01-01 00:13:00,4,7,4480,164,4316,6.84%,3.66%
2020-01-01 00:13:00,4,8,2938,64,2874,4.48%,2.18%
2020-01-01 00:13:00,4,9,15259,1632,13627,23.28%,10.70%
2020-01-01 00:13:00,4,10,1895,24,1871,2.89%,1.27%
2020-01-01 00:13:00,4,11,145,0,145,0.22%,0.00%
2020-01-01 00:13:00,4,12,12732,1163,11569,19.43%,9.13%
2020-01-01 00:13:00,5,1,2357,36,2321,3.60%,1.53%
2020-01-01 00:13:00,5,2,606,3,603,0.92%,0.50%
2020-01-01 00:13:00,5,3,489,1,488,0.75%,0.20%
2020-01-01 00:13:00,5,4,22813,3549,19264,34.81%,15.56%
2020-01-01 00:13:00,5,5,8970,594,8376,13.69%,6.62%
2020-01-01 00:13:00,5,6,15457,1715,13742,23.59%,11.10%
2020-01-01 00:13:00,5,7,5983,255,5728,9.13%,4.26%
2020-01-01 00:13:00,5,8,3142,82,3060,4.79%,2.61%
2020-01-01 00:13:00,5,9,8320,509,7811,12.70%,6.12%
2020-01-01 00:13:00,5,10,802,9,793,1.22%,1.12%
2020-01-01 00:13:00,5,11,599,3,596,0.91%,0.50%
2020-01-01 00:13:00,5,12,7213,378,6835,11.01%,5.24%
2020-01-01 00:13:00,6,1,1040,3,1037,1.59%,0.29%
2020-01-01 00:13:00,6,2,1170,6,1164,1.79%,0.51%
2020-01-01 00:13:00,6,3,2591,53,2538,3.95%,2.05%
2020-01-01 00:13:00,6,4,1561,33,1528,2.38%,2.11%
2020-01-01 00:13:00,6,5,16973,2058,14915,25.90%,12.13%
2020-01-01 00:13:00,6,6,5935,244,5691,9.06%,4.11%
2020-01-01 00:13:00,6,7,4104,98,4006,6.26%,2.39%
2020-01-01 00:13:00,6,8,3476,66,3410,5.30%,1.90%
2020-01-01 00:13:00,6,9,8245,537,7708,12.58%,6.51%
2020-01-01 00:13:00,6,10,1816,21,1795,2.77%,1.16%
2020-01-01 00:13:00,6,11,371,1,370,0.57%,0.27%
2020-01-01 00:13:00,6,12,6377,346,6031,9.73%,5.43%
2020-01-01 00:13:00,7,1,453,1,452,0.69%,0.22%
2020-01-01 00:13:00,7,2,188,0,188,0.29%,0.00%
2020-01-01 00:13:00,7,3,1653,11,1642,2.52%,0.67%
2020-01-01 00:13:00,7,4,1710,15,1695,2.61%,0.88%
2020-01-01 00:13:00,7,5,7463,421,7042,11.39%,5.64%
2020-01-01 00:13:00,7,6,12640,1123,11517,19.29%,8.88%
2020-01-01 00:13:00,7,7,3422,86,3336,5.22%,2.51%
2020-01-01 00:13:00,7,8,1260,14,1246,1.92%,1.11%
2020-01-01 00:13:00,7,9,5743,252,5491,8.76%,4.39%
2020-01-01 00:13:00,7,10,1263,7,1256,1.93%,0.55%
2020-01-01 00:13:00,7,11,71,0,71,0.11%,0.00%
2020-01-01 00:13:00,7,12,4505,167,4338,6.87%,3.71%
2020-01-01 00:13:00,8,1,435,2,433,0.66%,0.46%
2020-01-01 00:13:00,8,2,105,1,104,0.16%,0.95%
2020-01-01 00:13:00,8,3,1493,30,1463,2.28%,2.01%
2020-01-01 00:13:00,8,4,2666,52,2614,4.07%,1.95%
2020-01-01 00:13:00,8,5,7788,461,7327,11.88%,5.92%
2020-01-01 00:13:00,8,6,15169,1652,13517,23.15%,10.89%
2020-01-01 00:13:00,8,7,4651,152,4499,7.10%,3.27%
2020-01-01 00:13:00,8,8,1613,21,1592,2.46%,1.30%
2020-01-01 00:13:00,8,9,6044,260,5784,9.22%,4.30%
2020-01-01 00:13:00,8,10,1858,24,1834,2.84%,1.29%
2020-01-01 00:13:00,8,11,273,0,273,0.42%,0.00%
2020-01-01 00:13:00,8,12,4072,120,3952,6.21%,2.95%
2020-01-01 00:13:00,9,1,644,4,640,0.98%,0.62%
2020-01-01 00:13:00,9,2,3662,103,3559,5.59%,2.81%
2020-01-01 00:13:00,9,3,2550,54,2496,3.89%,2.12%
2020-01-01 00:13:00,9,4,9799,705,9094,14.95%,7.19%
2020-01-01 00:13:00,9,5,303,0,303,0.46%,0.00%
2020-01-01 00:13:00,9,6,10567,814,9753,16.12%,7.70%
2020-01-01 00:13:00,9,7,32080,6684,25396,48.95%,20.84%
2020-01-01 00:13:00,9,8,12513,1150,11363,19.09%,9.19%
2020-01-01 00:13:00,9,9,179,0,179,0.27%,0.00%
2020-01-01 00:13:00,9,10,3966,104,3862,6.05%,2.62%
2020-01-01 00:13:00,9,11,11453,955,10498,17.48%,8.34%
2020-01-01 00:13:00,9,12,7229,416,6813,11.03%,5.75%
2020-01-01 00:13:00,10,1,1220,267,953,1.86%,21.89%
2020-01-01 00:13:00,10,2,2931,315,2616,4.47%,10.75%
2020-01-01 00:13:00,10,3,1533,19,1514,2.34%,1.24%
2020-01-01 00:13:00,10,4,3937,1026,2911,6.01%,26.06%
2020-01-01 00:13:00,10,5,786,37,749,1.20%,4.71%
2020-01-01 00:13:00,10,6,5914,1190,4724,9.02%,20.12%
2020-01-01 00:13:00,10,7,10683,1917,8766,16.30%,17.94%
2020-01-01 00:13:00,10,8,26709,6660,20049,40.75%,24.94%
2020-01-01 00:13:00,10,9,535,3,532,0.82%,0.56%
2020-01-01 00:13:00,10,10,2260,45,2215,3.45%,1.99%
2020-01-01 00:13:00,10,11,12139,1412,10727,18.52%,11.63%
2020-01-01 00:13:00,10,12,9326,1009,8317,14.23%,10.82%
2020-01-01 00:13:00,11,1,2163,27,2136,3.30%,1.25%
2020-01-01 00:13:00,11,2,3811,125,3686,5.82%,3.28%
2020-01-01 00:13:00,11,3,1507,50,1457,2.30%,3.32%
2020-01-01 00:13:00,11,4,4976,186,4790,7.59%,3.74%
2020-01-01 00:13:00,11,5,267,0,267,0.41%,0.00%
2020-01-01 00:13:00,11,6,5999,284,5715,9.15%,4.73%
2020-01-01 00:13:00,11,7,11550,1003,10547,17.62%,8.68%
2020-01-01 00:13:00,11,8,27697,5197,22500,42.26%,18.76%
2020-01-01 00:13:00,11,9,268,1,267,0.41%,0.37%
2020-01-01 00:13:00,11,10,3055,55,3000,4.66%,1.80%
2020-01-01 00:13:00,11,11,12271,1071,11200,18.72%,8.73%
2020-01-01 00:13:00,11,12,8778,536,8242,13.39%,6.11%
2020-01-01 00:13:00,12,1,96,0,96,0.15%,0.00%
2020-01-01 00:13:00,12,2,623,218,405,0.95%,34.99%
2020-01-01 00:13:00,12,3,2905,271,2634,4.43%,9.33%
2020-01-01 00:13:00,12,4,2856,47,2809,4.36%,1.65%
2020-01-01 00:13:00,12,5,9080,782,8298,13.85%,8.61%
2020-01-01 00:13:00,12,6,4937,156,4781,7.53%,3.16%
2020-01-01 00:13:00,12,7,1956,26,1930,2.98%,1.33%
2020-01-01 00:13:00,12,8,1169,251,918,1.78%,21.47%
2020-01-01 00:13:00,12,9,23361,4643,18718,35.65%,19.88%
2020-01-01 00:13:00,12,10,4056,371,3685,6.19%,9.15%
2020-01-01 00:13:00,12,11,1362,254,1108,2.08%,18.65%
2020-01-01 00:13:00,12,12,8623,1151,7472,13.16%,13.35%
2020-01-01 00:13:00,13,1,2380,33,2347,3.63%,1.39%
2020-01-01 00:13:00,13,2,2670,36,2634,4.07%,1.35%
2020-01-01 00:13:00,13,3,656,1,655,1.00%,0.15%
2020-01-01 00:13:00,13,4,4623,483,4140,7.05%,10.45%
2020-01-01 00:13:00,13,5,6813,750,6063,10.40%,11.01%
2020-01-01 00:13:00,13,6,5220,518,4702,7.97%,9.92%
2020-01-01 00:13:00,13,7,5066,197,4869,7.73%,3.89%
2020-01-01 00:13:00,13,8,7214,400,6814,11.01%,5.54%
2020-01-01 00:13:00,13,9,7146,783,6363,10.90%,10.96%
2020-01-01 00:13:00,13,10,26595,5270,21325,40.58%,19.82%
2020-01-01 00:13:00,13,11,16627,2274,14353,25.37%,13.68%
2020-01-01 00:13:00,13,12,9005,916,8089,13.74%,10.17%
2020-01-01 00:13:00,14,1,463,3,460,0.71%,0.65%
2020-01-01 00:13:00,14,2,1681,23,1658,2.57%,1.37%
2020-01-01 00:13:00,14,3,1025,8,1017,1.56%,0.78%
2020-01-01 00:13:00,14,4,4134,135,3999,6.31%,3.27%
2020-01-01 00:13:00,14,5,1539,17,1522,2.35%,1.10%
2020-01-01 00:13:00,14,6,4525,163,4362,6.90%,3.60%
2020-01-01 00:13:00,14,7,11665,1052,10613,17.80%,9.02%
2020-01-01 00:13:00,14,8,13060,1287,11773,19.93%,9.85%
2020-01-01 00:13:00,14,9,1791,28,1763,2.73%,1.56%
2020-01-01 00:13:00,14,10,4527,167,4360,6.91%,3.69%
2020-01-01 00:13:00,14,11,24391,4059,20332,37.22%,16.64%
2020-01-01 00:13:00,14,12,6575,331,6244,10.03%,5.03%
2020-01-01 00:13:00,15,1,610,4,606,0.93%,0.66%
2020-01-01 00:13:00,15,2,134,0,134,0.20%,0.00%
2020-01-01 00:13:00,15,3,3804,103,3701,5.80%,2.71%
2020-01-01 00:13:00,15,4,5141,187,4954,7.84%,3.64%
2020-01-01 00:13:00,15,5,10547,764,9783,16.09%,7.24%
2020-01-01 00:13:00,15,6,5319,200,5119,8.12%,3.76%
2020-01-01 00:13:00,15,7,4073,118,3955,6.21%,2.90%
2020-01-01 00:13:00,15,8,6027,261,5766,9.20%,4.33%
2020-01-01 00:13:00,15,9,10693,773,9920,16.32%,7.23%
2020-01-01 00:13:00,15,10,5315,277,5038,8.11%,5.21%
2020-01-01 00:13:00,15,11,11470,991,10479,17.50%,8.64%
2020-01-01 00:13:00,15,12,28534,5646,22888,43.54%,19.79%
2020-01-01 00:13:00,16,1,495,1,494,0.76%,0.20%
2020-01-01 00:13:00,16,2,221,0,221,0.34%,0.00%
2020-01-01 00:13:00,16,3,1106,8,1098,1.69%,0.72%
2020-01-01 00:13:00,16,4,4978,219,4759,7.60%,4.40%
2020-01-01 00:13:00,16,5,7815,542,7273,11.92%,6.94%
2020-01-01 00:13:00,16,6,5743,277,5466,8.76%,4.82%
2020-01-01 00:13:00,16,7,4135,120,4015,6.31%,2.90%
2020-01-01 00:13:00,16,8,7676,427,7249,11.71%,5.56%
2020-01-01 00:13:00,16,9,8428,621,7807,12.86%,7.37%
2020-01-01 00:13:00,16,10,1318,13,1305,2.01%,0.99%
2020-01-01 00:13:00,16,11,9146,585,8561,13.96%,6.40%
2020-01-01 00:13:00,16,12,25955,4660,21295,39.60%,17.95%
2020-01-01 00:13:10,1,1,23568,3720,19848,35.96%,15.78%
2020-01-01 00:13:10,1,2,7927,445,7482,12.10%,5.61%
2020-01-01 00:13:10,1,3,555,6,549,0.85%,1.08%
2020-01-01 00:13:10,1,4,15139,1568,13571,23.10%,10.36%
2020-01-01 00:13:10,1,5,14811,1494,13317,22.60%,10.09%
2020-01-01 00:13:10,1,6,14770,1493,13277,22.54%,10.11%
2020-01-01 00:13:10,1,7,7353,380,6973,11.22%,5.17%
2020-01-01 00:13:10,1,8,5265,207,5058,8.03%,3.93%
2020-01-01 00:13:10,1,9,14732,1481,13251,22.48%,10.05%
2020-01-01 00:13:10,1,10,4330,152,4178,6.61%,3.51%
2020-01-01 00:13:10,1,11,4415,155,4260,6.74%,3.51%
2020-01-01 00:13:10,1,12,14700,1477,13223,22.43%,10.05%
2020-01-01 00:13:10,2,1,954,7,947,1.46%,0.73%
2020-01-01 00:13:10,2,2,26065,4535,21530,39.77%,17.40%
2020-01-01 00:13:10,2,3,21782,3244,18538,33.24%,14.89%
2020-01-01 00:13:10,2,4,752,3,749,1.15%,0.40%
2020-01-01 00:13:10,2,5,12933,1204,11729,19.73%,9.31%
2020-01-01 00:13:10,2,6,44,0,44,0.07%,0.00%
2020-01-01 00:13:10,2,7,3299,55,3244,5.03%,1.67%
2020-01-01 00:13:10,2,8,2224,23,2201,3.39%,1.03%
2020-01-01 00:13:10,2,9,12871,1191,11680,19.64%,9.25%
2020-01-01 00:13:10,2,10,1460,11,1449,2.23%,0.75%
2020-01-01 00:13:10,2,11,1487,12,1475,2.27%,0.81%
2020-01-01 00:13:10,2,12,12671,1148,11523,19.33%,9.06%
2020-01-01 00:13:10,3,1,1242,20,1222,1.90%,1.61%
2020-01-01 00:13:10,3,2,21243,3074,18169,32.41%,14.47%
2020-01-01 00:13:10,3,3,66460,24657,41803,101.41%,37.10%
2020-01-01 00:13:10,3,4,8173,458,7715,12.47%,5.60%
2020-01-01 00:13:10,3,5,43155,11540,31615,65.85%,26.74%
2020-01-01 00:13:10,3,6,9367,610,8757,14.29%,6.51%
2020-01-01 00:13:10,3,7,18014,2244,15770,27.49%,12.46%
2020-01-01 00:13:10,3,8,15440,1670,13770,23.56%,10.82%
2020-01-01 00:13:10,3,9,33142,7232,25910,50.57%,21.82%
2020-01-01 00:13:10,3,10,5840,262,5578,8.91%,4.49%
2020-01-01 00:13:10,3,11,2255,30,2225,3.44%,1.33%
2020-01-01 00:13:10,3,12,24883,4256,20627,37.97%,17.10%
2020-01-01 00:13:10,4,1,588,3,585,0.90%,0.51%
2020-01-01 00:13:10,4,2,379,2,377,0.58%,0.53%
2020-01-01 00:13:10,4,3,756,11,745,1.15%,1.46%
2020-01-01 00:13:10,4,4,27784,5167,22617,42.40%,18.60%
2020-01-01 00:13:10,4,5,16806,1959,14847,25.64%,11.66%
2020-01-01 00:13:10,4,6,23338,3686,19652,35.61%,15.79%
2020-01-01 00:13:10,4,7,5172,203,4969,7.89%,3.92%
2020-01-01 00:13:10,4,8,3091,79,3012,4.72%,2.56%
2020-01-01 00:13:10,4,9,14759,1540,13219,22.52%,10.43%
2020-01-01 00:13:10,4,10,2035,30,2005,3.11%,1.47%
2020-01-01 00:13:10,4,11,184,0,184,0.28%,0.00%
2020-01-01 00:13:10,4,12,12084,1063,11021,18.44%,8.80%
2020-01-01 00:13:10,5,1,2463,51,2412,3.76%,2.07%
2020-01-01 00:13:10,5,2,672,1,671,1.03%,0.15%
2020-01-01 00:13:10,5,3,766,1,765,1.17%,0.13%
2020-01-01 00:13:10,5,4,22307,3443,18864,34.04%,15.43%
2020-01-01 00:13:10,5,5,9350,662,8688,14.27%,7.08%
2020-01-01 00:13:10,5,6,14242,1425,12817,21.73%,10.01%
2020-01-01 00:13:10,5,7,4402,178,4224,6.72%,4.04%
2020-01-01 00:13:10,5,8,3014,90,2924,4.60%,2.99%
2020-01-01 00:13:10,5,9,8492,550,7942,12.96%,6.48%
2020-01-01 00:13:10,5,10,1089,16,1073,1.66%,1.47%
2020-01-01 00:13:10,5,11,453,3,450,0.69%,0.66%
2020-01-01 00:13:10,5,12,7135,380,6755,10.89%,5.33%
2020-01-01 00:13:10,6,1,1031,10,1021,1.57%,0.97%
2020-01-01 00:13:10,6,2,1106,13,1093,1.69%,1.18%
2020-01-01 00:13:10,6,3,1835,28,1807,2.80%,1.53%
2020-01-01 00:13:10,6,4,1181,6,1175,1.80%,0.51%
2020-01-01 00:13:10,6,5,13399,1282,12117,20.45%,9.57%
2020-01-01 00:13:10,6,6,5390,218,5172,8.22%,4.04%
2020-01-01 00:13:10,6,7,3765,103,3662,5.74%,2.74%
2020-01-01 00:13:10,6,8,2878,59,2819,4.39%,2.05%
2020-01-01 00:13:10,6,9,5984,262,5722,9.13%,4.38%
2020-01-01 00:13:10,6,10,1695,18,1677,2.59%,1.06%
2020-01-01 00:13:10,6,11,402,0,402,0.61%,0.00%
2020-01-01 00:13:10,6,12,4240,151,4089,6.47%,3.56%
2020-01-01 00:13:10,7,1,655,5,650,1.00%,0.76%
2020-01-01 00:13:10,7,2,195,0,195,0.30%,0.00%
2020-01-01 00:13:10,7,3,619,2,617,0.94%,0.32%
2020-01-01 00:13:10,7,4,2779,57,2722,4.24%,2.05%
2020-01-01 00:13:10,7,5,7247,394,6853,11.06%,5.44%
2020-01-01 00:13:10,7,6,13540,1293,12247,20.66%,9.55%
2020-01-01 00:13:10,7,7,3449,103,3346,5.26%,2.99%
2020-01-01 00:13:10,7,8,1604,22,1582,2.45%,1.37%
2020-01-01 00:13:10,7,9,6421,315,6106,9.80%,4.91%
2020-01-01 00:13:10,7,10,838,1,837,1.28%,0.12%
2020-01-01 00:13:10,7,11,139,0,139,0.21%,0.00%
2020-01-01 00:13:10,7,12,5552,251,5301,8.47%,4.52%
2020-01-01 00:13:10,8,1,738,7,731,1.13%,0.95%
2020-01-01 00:13:10,8,2,90,0,90,0.14%,0.00%
2020-01-01 00:13:10,8,3,1811,18,1793,2.76%,0.99%
2020-01-01 00:13:10,8,4,2792,52,2740,4.26%,1.86%
2020-01-01 00:13:10,8,5,9038,606,8432,13.79%,6.71%
2020-01-01 00:13:10,8,6,16928,1959,14969,25.83%,11.57%
2020-01-01 00:13:10,8,7,4962,154,4808,7.57%,3.10%
2020-01-01 00:13:10,8,8,2097,34,2063,3.20%,1.62%
2020-01-01 00:13:10,8,9,6752,346,6406,10.30%,5.12%
2020-01-01 00:13:10,8,10,1905,36,1869,2.91%,1.89%
2020-01-01 00:13:10,8,11,191,0,191,0.29%,0.00%
2020-01-01 00:13:10,8,12,4849,170,4679,7.40%,3.51%
2020-01-01 00:13:10,9,1,327,2,325,0.50%,0.61%
2020-01-01 00:13:10,9,2,1942,32,1910,2.96%,1.65%
2020-01-01 00:13:10,9,3,1223,10,1213,1.87%,0.82%
2020-01-01 00:13:10,9,4,14459,1511,12948,22.06%,10.45%
2020-01-01 00:13:10,9,5,593,0,593,0.90%,0.00%
2020-01-01 00:13:10,9,6,15684,1781,13903,23.93%,11.36%
2020-01-01 00:13:10,9,7,38820,9510,29310,59.23%,24.50%
2020-01-01 00:13:10,9,8,13872,1327,12545,21.17%,9.57%
2020-01-01 00:13:10,9,9,116,0,116,0.18%,0.00%
2020-01-01 00:13:10,9,10,5484,198,5286,8.37%,3.61%
2020-01-01 00:13:10,9,11,13042,1159,11883,19.90%,8.89%
2020-01-01 00:13:10,9,12,7149,321,6828,10.91%,4.49%
2020-01-01 00:13:10,10,1,1535,277,1258,2.34%,18.05%
2020-01-01 00:13:10,10,2,3507,348,3159,5.35%,9.92%
2020-01-01 00:13:10,10,3,1808,22,1786,2.76%,1.22%
2020-01-01 00:13:10,10,4,3741,980,2761,5.71%,26.20%
2020-01-01 00:13:10,10,5,1050,101,949,1.60%,9.62%
2020-01-01 00:13:10,10,6,6262,1222,5040,9.56%,19.51%
2020-01-01 00:13:10,10,7,11552,2074,9478,17.63%,17.95%
2020-01-01 00:13:10,10,8,29331,7518,21813,44.76%,25.63%
2020-01-01 00:13:10,10,9,487,3,484,0.74%,0.62%
2020-01-01 00:13:10,10,10,2518,49,2469,3.84%,1.95%
2020-01-01 00:13:10,10,11,13432,1556,11876,20.50%,11.58%
2020-01-01 00:13:10,10,12,10137,1049,9088,15.47%,10.35%
2020-01-01 00:13:10,11,1,2410,41,2369,3.68%,1.70%
2020-01-01 00:13:10,11,2,3366,85,3281,5.14%,2.53%
2020-01-01 00:13:10,11,3,725,3,722,1.11%,0.41%
2020-01-01 00:13:10,11,4,3466,98,3368,5.29%,2.83%
2020-01-01 00:13:10,11,5,253,1,252,0.39%,0.40%
2020-01-01 00:13:10,11,6,4434,159,4275,6.77%,3.59%
2020-01-01 00:13:10,11,7,9681,722,8959,14.77%,7.46%
2020-01-01 00:13:10,11,8,24508,4109,20399,37.40%,16.77%
2020-01-01 00:13:10,11,9,288,0,288,0.44%,0.00%
2020-01-01 00:13:10,11,10,3083,77,3006,4.70%,2.50%
2020-01-01 00:13:10,11,11,10309,740,9569,15.73%,7.18%
2020-01-01 00:13:10,11,12,6721,315,6406,10.26%,4.69%
2020-01-01 00:13:10,12,1,117,0,117,0.18%,0.00%
2020-01-01 00:13:10,12,2,597,109,488,0.91%,18.26%
2020-01-01 00:13:10,12,3,2816,182,2634,4.30%,6.46%
2020-01-01 00:13:10,12,4,2916,69,2847,4.45%,2.37%
2020-01-01 00:13:10,12,5,8940,679,8261,13.64%,7.60%
2020-01-01 00:13:10,12,6,4410,141,4269,6.73%,3.20%
2020-01-01 00:13:10,12,7,1373,11,1362,2.10%,0.80%
2020-01-01 00:13:10,12,8,1453,253,1200,2.22%,17.41%
2020-01-01 00:13:10,12,9,21165,3914,17251,32.30%,18.49%
2020-01-01 00:13:10,12,10,4665,376,4289,7.12%,8.06%
2020-01-01 00:13:10,12,11,1789,262,1527,2.73%,14.65%
2020-01-01 00:13:10,12,12,7088,1071,6017,10.82%,15.11%
2020-01-01 00:13:10,13,1,2068,35,2033,3.16%,1.69%
2020-01-01 00:13:10,13,2,2399,48,2351,3.66%,2.00%
2020-01-01 00:13:10,13,3,794,2,792,1.21%,0.25%
2020-01-01 00:13:10,13,4,5209,749,4460,7.95%,14.38%
2020-01-01 00:13:10,13,5,7510,1040,6470,11.46%,13.85%
2020-01-01 00:13:10,13,6,5768,783,4985,8.80%,13.57%
2020-01-01 00:13:10,13,7,4475,150,4325,6.83%,3.35%
2020-01-01 00:13:10,13,8,8146,502,7644,12.43%,6.16%
2020-01-01 00:13:10,13,9,7801,1070,6731,11.90%,13.72%
2020-01-01 00:13:10,13,10,29859,6453,23406,45.56%,21.61%
2020-01-01 00:13:10,13,11,19042,2741,16301,29.06%,14.39%
2020-01-01 00:13:10,13,12,10543,1057,9486,16.09%,10.03%
2020-01-01 00:13:10,14,1,309,3,306,0.47%,0.97%
2020-01-01 00:13:10,14,2,1481,16,1465,2.26%,1.08%
2020-01-01 00:13:10,14,3,942,3,939,1.44%,0.32%
2020-01-01 00:13:10,14,4,3004,66,2938,4.58%,2.20%
2020-01-01 00:13:10,14,5,1462,13,1449,2.23%,0.89%
2020-01-01 00:13:10,14,6,3318,81,3237,5.06%,2.44%
2020-01-01 00:13:10,14,7,10815,867,9948,16.50%,8.02%
2020-01-01 00:13:10,14,8,12658,1176,11482,19.31%,9.29%
2020-01-01 00:13:10,14,9,1610,14,1596,2.46%,0.87%
2020-01-01 00:13:10,14,10,4524,174,4350,6.90%,3.85%
2020-01-01 00:13:10,14,11,25562,4361,21201,39.00%,17.06%
2020-01-01 00:13:10,14,12,8036,479,7557,12.26%,5.96%
2020-01-01 00:13:10,15,1,526,1,525,0.80%,0.19%
2020-01-01 00:13:10,15,2,134,0,134,0.20%,0.00%
2020-01-01 00:13:10,15,3,4038,144,3894,6.16%,3.57%
2020-01-01 00:13:10,15,4,4438,201,4237,6.77%,4.53%
2020-01-01 00:13:10,15,5,9528,705,8823,14.54%,7.40%
2020-01-01 00:13:10,15,6,4707,224,4483,7.18%,4.76%
2020-01-01 00:13:10,15,7,3576,107,3469,5.46%,2.99%
2020-01-01 00:13:10,15,8,5457,237,5220,8.33%,4.34%
2020-01-01 00:13:10,15,9,9738,735,9003,14.86%,7.55%
2020-01-01 00:13:10,15,10,5358,479,4879,8.18%,8.94%
2020-01-01 00:13:10,15,11,10948,1121,9827,16.71%,10.24%
2020-01-01 00:13:10,15,12,26405,5235,21170,40.29%,19.83%
2020-01-01 00:13:10,16,1,323,2,321,0.49%,0.62%
2020-01-01 00:13:10,16,2,247,1,246,0.38%,0.40%
2020-01-01 00:13:10,16,3,1248,16,1232,1.90%,1.28%
2020-01-01 00:13:10,16,4,4194,114,4080,6.40%,2.72%
2020-01-01 00:13:10,16,5,7398,447,6951,11.29%,6.04%
2020-01-01 00:13:10,16,6,5088,176,4912,7.76%,3.46%
2020-01-01 00:13:10,16,7,3353,87,3266,5.12%,2.59%
2020-01-01 00:13:10,16,8,6918,382,6536,10.56%,5.52%
2020-01-01 00:13:10,16,9,7983,503,7480,12.18%,6.30%
2020-01-01 00:13:10,16,10,1632,17,1615,2.49%,1.04%
2020-01-01 00:13:10,16,11,8748,581,8167,13.35%,6.64%
2020-01-01 00:13:10,16,12,24246,3943,20303,37.00%,16.26%
2020-01-01 00:13:20,1,1,15507,1689,13818,23.66%,10.89%
2020-01-01 00:13:20,1,2,5700,234,5466,8.70%,4.11%
2020-01-01 00:13:20,1,3,317,0,317,0.48%,0.00%
2020-01-01 00:13:20,1,4,9307,621,8686,14.20%,6.67%
2020-01-01 00:13:20,1,5,9026,586,8440,13.77%,6.49%
2020-01-01 00:13:20,1,6,9001,581,8420,13.73%,6.45%
2020-01-01 00:13:20,1,7,5371,210,5161,8.20%,3.91%
2020-01-01 00:13:20,1,8,4533,140,4393,6.92%,3.09%
2020-01-01 00:13:20,1,9,8959,579,8380,13.67%,6.46%
2020-01-01 00:13:20,1,10,3803,106,3697,5.80%,2.79%
2020-01-01 00:13:20,1,11,3889,109,3780,5.93%,2.80%
2020-01-01 00:13:20,1,12,8927,578,8349,13.62%,6.47%
2020-01-01 00:13:20,2,1,786,3,783,1.20%,0.38%
2020-01-01 00:13:20,2,2,25209,4339,20870,38.47%,17.21%
2020-01-01 00:13:20,2,3,18311,2395,15916,27.94%,13.08%
2020-01-01 00:13:20,2,4,683,1,682,1.04%,0.15%
2020-01-01 00:13:20,2,5,10845,870,9975,16.55%,8.02%
2020-01-01 00:13:20,2,6,65,0,65,0.10%,0.00%
2020-01-01 00:13:20,2,7,6093,281,5812,9.30%,4.61%
2020-01-01 00:13:20,2,8,4243,151,4092,6.47%,3.56%
2020-01-01 00:13:20,2,9,10769,862,9907,16.43%,8.00%
2020-01-01 00:13:20,2,10,3338,101,3237,5.09%,3.03%
2020-01-01 00:13:20,2,11,3366,103,3263,5.14%,3.06%
2020-01-01 00:13:20,2,12,10585,830,9755,16.15%,7.84%
2020-01-01 00:13:20,3,1,1373,19,1354,2.10%,1.38%
2020-01-01 00:13:20,3,2,23162,3662,19500,35.34%,15.81%
2020-01-01 00:13:20,3,3,64220,23376,40844,97.99%,36.40%
2020-01-01 00:13:20,3,4,7257,378,6879,11.07%,5.21%
2020-01-01 00:13:20,3,5,40176,10129,30047,61.30%,25.21%
2020-01-01 00:13:20,3,6,8068,468,7600,12.31%,5.80%
2020-01-01 00:13:20,3,7,20018,2791,17227,30.55%,13.94%
2020-01-01 00:13:20,3,8,17239,2106,15133,26.30%,12.22%
2020-01-01 00:13:20,3,9,31559,6513,25046,48.16%,20.64%
2020-01-01 00:13:20,3,10,5817,238,5579,8.88%,4.09%
2020-01-01 00:13:20,3,11,2642,41,2601,4.03%,1.55%
2020-01-01 00:13:20,3,12,22217,3417,18800,33.90%,15.38%
2020-01-01 00:13:20,4,1,570,1,569,0.87%,0.18%
2020-01-01 00:13:20,4,2,364,1,363,0.56%,0.27%
2020-01-01 00:13:20,4,3,908,2,906,1.39%,0.22%
2020-01-01 00:13:20,4,4,29083,5632,23451,44.38%,19.37%
2020-01-01 00:13:20,4,5,17572,2170,15402,26.81%,12.35%
2020-01-01 00:13:20,4,6,24249,3984,20265,37.00%,16.43%
2020-01-01 00:13:20,4,7,5427,215,5212,8.28%,3.96%
2020-01-01 00:13:20,4,8,3190,75,3115,4.87%,2.35%
2020-01-01 00:13:20,4,9,15378,1678,13700,23.46%,10.91%
2020-01-01 00:13:20,4,10,2079,24,2055,3.17%,1.15%
2020-01-01 00:13:20,4,11,264,0,264,0.40%,0.00%
2020-01-01 00:13:20,4,12,12611,1148,11463,19.24%,9.10%
2020-01-01 00:13:20,5,1,2986,69,2917,4.56%,2.31%
2020-01-01 00:13:20,5,2,816,4,812,1.25%,0.49%
2020-01-01 00:13:20,5,3,512,3,509,0.78%,0.59%
2020-01-01 00:13:20,5,4,28682,5513,23169,43.77%,19.22%
2020-01-01 00:13:20,5,5,9603,725,8878,14.65%,7.55%
2020-01-01 00:13:20,5,6,14363,1576,12787,21.92%,10.97%
2020-01-01 00:13:20,5,7,4110,168,3942,6.27%,4.09%
2020-01-01 00:13:20,5,8,3142,111,3031,4.79%,3.53%
2020-01-01 00:13:20,5,9,8912,632,8280,13.60%,7.09%
2020-01-01 00:13:20,5,10,1607,17,1590,2.45%,1.06%
2020-01-01 00:13:20,5,11,483,3,480,0.74%,0.62%
2020-01-01 00:13:20,5,12,7161,416,6745,10.93%,5.81%
2020-01-01 00:13:20,6,1,1154,21,1133,1.76%,1.82%
2020-01-01 00:13:20,6,2,1243,22,1221,1.90%,1.77%
2020-01-01 00:13:20,6,3,1985,36,1949,3.03%,1.81%
2020-01-01 00:13:20,6,4,1900,27,1873,2.90%,1.42%
2020-01-01 00:13:20,6,5,16299,1902,14397,24.87%,11.67%
2020-01-01 00:13:20,6,6,6772,369,6403,10.33%,5.45%
2020-01-01 00:13:20,6,7,4350,143,4207,6.64%,3.29%
2020-01-01 00:13:20,6,8,3669,104,3565,5.60%,2.83%
2020-01-01 00:13:20,6,9,7242,343,6899,11.05%,4.74%
2020-01-01 00:13:20,6,10,2114,32,2082,3.23%,1.51%
2020-01-01 00:13:20,6,11,448,2,446,0.68%,0.45%
2020-01-01 00:13:20,6,12,5080,163,4917,7.75%,3.21%
2020-01-01 00:13:20,7,1,432,4,428,0.66%,0.93%
2020-01-01 00:13:20,7,2,197,0,197,0.30%,0.00%
2020-01-01 00:13:20,7,3,640,4,636,0.98%,0.62%
2020-01-01 00:13:20,7,4,2314,44,2270,3.53%,1.90%
2020-01-01 00:13:20,7,5,7578,435,7143,11.56%,5.74%
2020-01-01 00:13:20,7,6,13956,1414,12542,21.30%,10.13%
2020-01-01 00:13:20,7,7,4005,135,3870,6.11%,3.37%
2020-01-01 00:13:20,7,8,1983,41,1942,3.03%,2.07%
2020-01-01 00:13:20,7,9,5554,241,5313,8.47%,4.34%
2020-01-01 00:13:20,7,10,742,3,739,1.13%,0.40%
2020-01-01 00:13:20,7,11,241,1,240,0.37%,0.41%
2020-01-01 00:13:20,7,12,4819,191,4628,7.35%,3.96%
2020-01-01 00:13:20,8,1,532,0,532,0.81%,0.00%
2020-01-01 00:13:20,8,2,81,0,81,0.12%,0.00%
2020-01-01 00:13:20,8,3,1921,19,1902,2.93%,0.99%
2020-01-01 00:13:20,8,4,2981,69,2912,4.55%,2.31%
2020-01-01 00:13:20,8,5,9087,589,8498,13.87%,6.48%
2020-01-01 00:13:20,8,6,17257,2114,15143,26.33%,12.25%
2020-01-01 00:13:20,8,7,5100,185,4915,7.78%,3.63%
2020-01-01 00:13:20,8,8,2249,39,2210,3.43%,1.73%
2020-01-01 00:13:20,8,9,6949,340,6609,10.60%,4.89%
2020-01-01 00:13:20,8,10,2034,25,2009,3.10%,1.23%
2020-01-01 00:13:20,8,11,117,0,117,0.18%,0.00%
2020-01-01 00:13:20,8,12,4920,186,4734,7.51%,3.78%
2020-01-01 00:13:20,9,1,489,3,486,0.75%,0.61%
2020-01-01 00:13:20,9,2,1861,23,1838,2.84%,1.24%
2020-01-01 00:13:20,9,3,1071,9,1062,1.63%,0.84%
2020-01-01 00:13:20,9,4,7159,391,6768,10.92%,5.46%
2020-01-01 00:13:20,9,5,580,2,578,0.89%,0.34%
2020-01-01 00:13:20,9,6,8701,570,8131,13.28%,6.55%
2020-01-01 00:13:20,9,7,27767,5096,22671,42.37%,18.35%
2020-01-01 00:13:20,9,8,9965,683,9282,15.21%,6.85%
2020-01-01 00:13:20,9,9,245,0,245,0.37%,0.00%
2020-01-01 00:13:20,9,10,3530,98,3432,5.39%,2.78%
2020-01-01 00:13:20,9,11,9270,586,8684,14.14%,6.32%
2020-01-01 00:13:20,9,12,5355,221,5134,8.17%,4.13%
2020-01-01 00:13:20,10,1,1674,296,1378,2.55%,17.68%
2020-01-01 00:13:20,10,2,4920,440,4480,7.51%,8.94%
2020-01-01 00:13:20,10,3,3086,75,3011,4.71%,2.43%
2020-01-01 00:13:20,10,4,3766,1018,2748,5.75%,27.03%
2020-01-01 00:13:20,10,5,908,75,833,1.39%,8.26%
2020-01-01 00:13:20,10,6,6006,1212,4794,9.16%,20.18%
2020-01-01 00:13:20,10,7,12505,2232,10273,19.08%,17.85%
2020-01-01 00:13:20,10,8,32674,8758,23916,49.86%,26.80%
2020-01-01 00:13:20,10,9,537,1,536,0.82%,0.19%
2020-01-01 00:13:20,10,10,3063,68,2995,4.67%,2.22%
2020-01-01 00:13:20,10,11,15459,2101,13358,23.59%,13.59%
2020-01-01 00:13:20,10,12,11713,1417,10296,17.87%,12.10%
2020-01-01 00:13:20,11,1,2548,55,2493,3.89%,2.16%
2020-01-01 00:13:20,11,2,3605,113,3492,5.50%,3.13%
2020-01-01 00:13:20,11,3,868,6,862,1.32%,0.69%
2020-01-01 00:13:20,11,4,6216,307,5909,9.48%,4.94%
2020-01-01 00:13:20,11,5,279,0,279,0.43%,0.00%
2020-01-01 00:13:20,11,6,7217,411,6806,11.01%,5.69%
2020-01-01 00:13:20,11,7,12524,1136,11388,19.11%,9.07%
2020-01-01 00:13:20,11,8,27344,5010,22334,41.72%,18.32%
2020-01-01 00:13:20,11,9,299,1,298,0.46%,0.33%
2020-01-01 00:13:20,11,10,3390,96,3294,5.17%,2.83%
2020-01-01 00:13:20,11,11,10300,766,9534,15.72%,7.44%
2020-01-01 00:13:20,11,12,6495,313,6182,9.91%,4.82%
2020-01-01 00:13:20,12,1,36,0,36,0.05%,0.00%
2020-01-01 00:13:20,12,2,499,126,373,0.76%,25.25%
2020-01-01 00:13:20,12,3,2973,190,2783,4.54%,6.39%
2020-01-01 00:13:20,12,4,2977,66,2911,4.54%,2.22%
2020-01-01 00:13:20,12,5,8149,605,7544,12.43%,7.42%
2020-01-01 00:13:20,12,6,4427,156,4271,6.76%,3.52%
2020-01-01 00:13:20,12,7,1336,12,1324,2.04%,0.90%
2020-01-01 00:13:20,12,8,1643,349,1294,2.51%,21.24%
2020-01-01 00:13:20,12,9,21503,4204,17299,32.81%,19.55%
2020-01-01 00:13:20,12,10,4977,471,4506,7.59%,9.46%
2020-01-01 00:13:20,12,11,1935,353,1582,2.95%,18.24%
2020-01-01 00:13:20,12,12,7751,1371,6380,11.83%,17.69%
2020-01-01 00:13:20,13,1,1864,25,1839,2.84%,1.34%
2020-01-01 00:13:20,13,2,2310,35,2275,3.52%,1.52%
2020-01-01 00:13:20,13,3,712,5,707,1.09%,0.70%
2020-01-01 00:13:20,13,4,4825,798,4027,7.36%,16.54%
2020-01-01 00:13:20,13,5,7156,1118,6038,10.92%,15.62%
2020-01-01 00:13:20,13,6,5417,827,4590,8.27%,15.27%
2020-01-01 00:13:20,13,7,4207,127,4080,6.42%,3.02%
2020-01-01 00:13:20,13,8,7655,419,7236,11.68%,5.47%
2020-01-01 00:13:20,13,9,7509,1148,6361,11.46%,15.29%
2020-01-01 00:13:20,13,10,30296,6608,23688,46.23%,21.81%
2020-01-01 00:13:20,13,11,18688,2546,16142,28.52%,13.62%
2020-01-01 00:13:20,13,12,10612,1015,9597,16.19%,9.56%
2020-01-01 00:13:20,14,1,235,1,234,0.36%,0.43%
2020-01-01 00:13:20,14,2,1173,13,1160,1.79%,1.11%
2020-01-01 00:13:20,14,3,728,1,727,1.11%,0.14%
2020-01-01 00:13:20,14,4,3275,89,3186,5.00%,2.72%
2020-01-01 00:13:20,14,5,1277,14,1263,1.95%,1.10%
2020-01-01 00:13:20,14,6,3694,111,3583,5.64%,3.00%
2020-01-01 00:13:20,14,7,11247,991,10256,17.16%,8.81%
2020-01-01 00:13:20,14,8,12951,1255,11696,19.76%,9.69%
2020-01-01 00:13:20,14,9,1493,19,1474,2.28%,1.27%
2020-01-01 00:13:20,14,10,4201,151,4050,6.41%,3.59%
2020-01-01 00:13:20,14,11,27342,5033,22309,41.72%,18.41%
2020-01-01 00:13:20,14,12,9733,679,9054,14.85%,6.98%
2020-01-01 00:13:20,15,1,508,1,507,0.78%,0.20%
2020-01-01 00:13:20,15,2,127,0,127,0.19%,0.00%
2020-01-01 00:13:20,15,3,4264,165,4099,6.51%,3.87%
2020-01-01 00:13:20,15,4,4737,220,4517,7.23%,4.64%
2020-01-01 00:13:20,15,5,9971,802,9169,15.21%,8.04%
2020-01-01 00:13:20,15,6,5103,279,4824,7.79%,5.47%
2020-01-01 00:13:20,15,7,3430,89,3341,5.23%,2.59%
2020-01-01 00:13:20,15,8,5780,238,5542,8.82%,4.12%
2020-01-01 00:13:20,15,9,10169,825,9344,15.52%,8.11%
2020-01-01 00:13:20,15,10,6155,568,5587,9.39%,9.23%
2020-01-01 00:13:20,15,11,12153,1309,10844,18.54%,10.77%
2020-01-01 00:13:20,15,12,27892,5704,22188,42.56%,20.45%
2020-01-01 00:13:20,16,1,503,1,502,0.77%,0.20%
2020-01-01 00:13:20,16,2,296,0,296,0.45%,0.00%
2020-01-01 00:13:20,16,3,1359,11,1348,2.07%,0.81%
2020-01-01 00:13:20,16,4,3722,108,3614,5.68%,2.90%
2020-01-01 00:13:20,16,5,7227,431,6796,11.03%,5.96%
2020-01-01 00:13:20,16,6,4711,190,4521,7.19%,4.03%
2020-01-01 00:13:20,16,7,3193,93,3100,4.87%,2.91%
2020-01-01 00:13:20,16,8,7525,531,6994,11.48%,7.06%
2020-01-01 00:13:20,16,9,7688,490,7198,11.73%,6.37%
2020-01-01 00:13:20,16,10,1952,25,1927,2.98%,1.28%
2020-01-01 00:13:20,16,11,9637,794,8843,14.70%,8.24%
2020-01-01 00:13:20,16,12,24899,4284,20615,37.99%,17.21%
2020-01-01 00:13:30,1,1,18337,2375,15962,27.98%,12.95%
2020-01-01 00:13:30,1,2,8276,529,7747,12.63%,6.39%
2020-01-01 00:13:30,1,3,776,3,773,1.18%,0.39%
2020-01-01 00:13:30,1,4,9692,727,8965,14.79%,7.50%
2020-01-01 00:13:30,1,5,9347,669,8678,14.26%,7.16%
2020-01-01 00:13:30,1,6,9290,666,8624,14.18%,7.17%
2020-01-01 00:13:30,1,7,7495,419,7076,11.44%,5.59%
2020-01-01 00:13:30,1,8,5911,254,5657,9.02%,4.30%
2020-01-01 00:13:30,1,9,9205,654,8551,14.05%,7.10%
2020-01-01 00:13:30,1,10,4936,176,4760,7.53%,3.57%
2020-01-01 00:13:30,1,11,5071,187,4884,7.74%,3.69%
2020-01-01 00:13:30,1,12,9161,646,8515,13.98%,7.05%
2020-01-01 00:13:30,2,1,656,2,654,1.00%,0.30%
2020-01-01 00:13:30,2,2,24391,4036,20355,37.22%,16.55%
2020-01-01 00:13:30,2,3,19782,2735,17047,30.18%,13.83%
2020-01-01 00:13:30,2,4,601,1,600,0.92%,0.17%
2020-01-01 00:13:30,2,5,11103,948,10155,16.94%,8.54%
2020-01-01 00:13:30,2,6,44,0,44,0.07%,0.00%
2020-01-01 00:13:30,2,7,3940,103,3837,6.01%,2.61%
2020-01-01 00:13:30,2,8,2920,62,2858,4.46%,2.12%
2020-01-01 00:13:30,2,9,10980,931,10049,16.75%,8.48%
2020-01-01 00:13:30,2,10,1985,27,1958,3.03%,1.36%
2020-01-01 00:13:30,2,11,2036,28,2008,3.11%,1.38%
2020-01-01 00:13:30,2,12,10783,895,9888,16.45%,8.30%
2020-01-01 00:13:30,3,1,1641,21,1620,2.50%,1.28%
2020-01-01 00:13:30,3,2,25510,4397,21113,38.93%,17.24%
2020-01-01 00:13:30,3,3,71128,27718,43410,108.53%,38.97%
2020-01-01 00:13:30,3,4,9811,700,9111,14.97%,7.13%
2020-01-01 00:13:30,3,5,44286,11977,32309,67.58%,27.04%
2020-01-01 00:13:30,3,6,11893,1009,10884,18.15%,8.48%
2020-01-01 00:13:30,3,7,22139,3346,18793,33.78%,15.11%
2020-01-01 00:13:30,3,8,17723,2202,15521,27.04%,12.42%
2020-01-01 00:13:30,3,9,32098,6657,25441,48.98%,20.74%
2020-01-01 00:13:30,3,10,7860,418,7442,11.99%,5.32%
2020-01-01 00:13:30,3,11,2135,38,2097,3.26%,1.78%
2020-01-01 00:13:30,3,12,21390,3127,18263,32.64%,14.62%
2020-01-01 00:13:30,4,1,665,2,663,1.01%,0.30%
2020-01-01 00:13:30,4,2,435,1,434,0.66%,0.23%
2020-01-01 00:13:30,4,3,918,10,908,1.40%,1.09%
2020-01-01 00:13:30,4,4,27636,5098,22538,42.17%,18.45%
2020-01-01 00:13:30,4,5,16856,2016,14840,25.72%,11.96%
2020-01-01 00:13:30,4,6,23731,3845,19886,36.21%,16.20%
2020-01-01 00:13:30,4,7,5572,267,5305,8.50%,4.79%
2020-01-01 00:13:30,4,8,3371,103,3268,5.14%,3.06%
2020-01-01 00:13:30,4,9,14739,1575,13164,22.49%,10.69%
2020-01-01 00:13:30,4,10,1876,19,1857,2.86%,1.01%
2020-01-01 00:13:30,4,11,228,0,228,0.35%,0.00%
2020-01-01 00:13:30,4,12,12005,1059,10946,18.32%,8.82%
2020-01-01 00:13:30,5,1,2965,63,2902,4.52%,2.12%
2020-01-01 00:13:30,5,2,735,3,732,1.12%,0.41%
2020-01-01 00:13:30,5,3,1182,16,1166,1.80%,1.35%
2020-01-01 00:13:30,5,4,24475,4025,20450,37.35%,16.45%
2020-01-01 00:13:30,5,5,9264,644,8620,14.14%,6.95%
2020-01-01 00:13:30,5,6,14236,1467,12769,21.72%,10.30%
2020-01-01 00:13:30,5,7,4615,182,4433,7.04%,3.94%
2020-01-01 00:13:30,5,8,3205,86,3119,4.89%,2.68%
2020-01-01 00:13:30,5,9,7941,464,7477,12.12%,5.84%
2020-01-01 00:13:30,5,10,888,8,880,1.35%,0.90%
2020-01-01 00:13:30,5,11,570,4,566,0.87%,0.70%
2020-01-01 00:13:30,5,12,6716,333,6383,10.25%,4.96%
2020-01-01 00:13:30,6,1,1062,6,1056,1.62%,0.56%
2020-01-01 00:13:30,6,2,1315,13,1302,2.01%,0.99%
2020-01-01 00:13:30,6,3,1812,23,1789,2.76%,1.27%
2020-01-01 00:13:30,6,4,1464,6,1458,2.23%,0.41%
2020-01-01 00:13:30,6,5,14521,1480,13041,22.16%,10.19%
2020-01-01 00:13:30,6,6,6001,275,5726,9.16%,4.58%
2020-01-01 00:13:30,6,7,3960,118,3842,6.04%,2.98%
2020-01-01 00:13:30,6,8,2996,77,2919,4.57%,2.57%
2020-01-01 00:13:30,6,9,6392,281,6111,9.75%,4.40%
2020-01-01 00:13:30,6,10,1788,20,1768,2.73%,1.12%
2020-01-01 00:13:30,6,11,422,2,420,0.64%,0.47%
2020-01-01 00:13:30,6,12,4538,142,4396,6.92%,3.13%
2020-01-01 00:13:30,7,1,353,0,353,0.54%,0.00%
2020-01-01 00:13:30,7,2,213,1,212,0.33%,0.47%
2020-01-01 00:13:30,7,3,849,4,845,1.30%,0.47%
2020-01-01 00:13:30,7,4,2369,39,2330,3.61%,1.65%
2020-01-01 00:13:30,7,5,7437,438,6999,11.35%,5.89%
2020-01-01 00:13:30,7,6,13339,1416,11923,20.35%,10.62%
2020-01-01 00:13:30,7,7,3504,99,3405,5.35%,2.83%
2020-01-01 00:13:30,7,8,1699,45,1654,2.59%,2.65%
2020-01-01 00:13:30,7,9,6192,297,5895,9.45%,4.80%
2020-01-01 00:13:30,7,10,932,7,925,1.42%,0.75%
2020-01-01 00:13:30,7,11,72,0,72,0.11%,0.00%
2020-01-01 00:13:30,7,12,5277,221,5056,8.05%,4.19%
2020-01-01 00:13:30,8,1,491,2,489,0.75%,0.41%
2020-01-01 00:13:30,8,2,79,0,79,0.12%,0.00%
2020-01-01 00:13:30,8,3,2506,54,2452,3.82%,2.15%
2020-01-01 00:13:30,8,4,2922,76,2846,4.46%,2.60%
2020-01-01 00:13:30,8,5,8997,652,8345,13.73%,7.25%
2020-01-01 00:13:30,8,6,16991,2119,14872,25.93%,12.47%
2020-01-01 00:13:30,8,7,4999,169,4830,7.63%,3.38%
2020-01-01 00:13:30,8,8,2071,28,2043,3.16%,1.35%
2020-01-01 00:13:30,8,9,6278,292,5986,9.58%,4.65%
2020-01-01 00:13:30,8,10,2014,31,1983,3.07%,1.54%
2020-01-01 00:13:30,8,11,115,0,115,0.18%,0.00%
2020-01-01 00:13:30,8,12,4237,144,4093,6.47%,3.40%
2020-01-01 00:13:30,9,1,495,1,494,0.76%,0.20%
2020-01-01 00:13:30,9,2,2421,37,2384,3.69%,1.53%
2020-01-01 00:13:30,9,3,1498,11,1487,2.29%,0.73%
2020-01-01 00:13:30,9,4,9064,653,8411,13.83%,7.20%
2020-01-01 00:13:30,9,5,182,1,181,0.28%,0.55%
2020-01-01 00:13:30,9,6,9718,745,8973,14.83%,7.67%
2020-01-01 00:13:30,9,7,30636,6200,24436,46.75%,20.24%
2020-01-01 00:13:30,9,8,9950,714,9236,15.18%,7.18%
2020-01-01 00:13:30,9,9,149,1,148,0.23%,0.67%
2020-01-01 00:13:30,9,10,3241,84,3157,4.95%,2.59%
2020-01-01 00:13:30,9,11,8544,526,8018,13.04%,6.16%
2020-01-01 00:13:30,9,12,4922,193,4729,7.51%,3.92%
2020-01-01 00:13:30,10,1,1538,295,1243,2.35%,19.18%
2020-01-01 00:13:30,10,2,2907,330,2577,4.44%,11.35%
2020-01-01 00:13:30,10,3,1207,11,1196,1.84%,0.91%
2020-01-01 00:13:30,10,4,3780,989,2791,5.77%,26.16%
2020-01-01 00:13:30,10,5,750,100,650,1.14%,13.33%
2020-01-01 00:13:30,10,6,5853,1200,4653,8.93%,20.50%
2020-01-01 00:13:30,10,7,10575,1906,8669,16.14%,18.02%
2020-01-01 00:13:30,10,8,30472,7900,22572,46.50%,25.93%
2020-01-01 00:13:30,10,9,579,5,574,0.88%,0.86%
2020-01-01 00:13:30,10,10,3053,76,2977,4.66%,2.49%
2020-01-01 00:13:30,10,11,15280,2088,13192,23.32%,13.66%
2020-01-01 00:13:30,10,12,11536,1405,10131,17.60%,12.18%
2020-01-01 00:13:30,11,1,2453,59,2394,3.74%,2.41%
2020-01-01 00:13:30,11,2,3457,115,3342,5.27%,3.33%
2020-01-01 00:13:30,11,3,778,13,765,1.19%,1.67%
2020-01-01 00:13:30,11,4,5267,216,5051,8.04%,4.10%
2020-01-01 00:13:30,11,5,172,1,171,0.26%,0.58%
2020-01-01 00:13:30,11,6,6182,301,5881,9.43%,4.87%
2020-01-01 00:13:30,11,7,11464,994,10470,17.49%,8.67%
2020-01-01 00:13:30,11,8,24771,4126,20645,37.80%,16.66%
2020-01-01 00:13:30,11,9,213,0,213,0.33%,0.00%
2020-01-01 00:13:30,11,10,3154,72,3082,4.81%,2.28%
2020-01-01 00:13:30,11,11,9995,796,9199,15.25%,7.96%
2020-01-01 00:13:30,11,12,6525,338,6187,9.96%,5.18%
2020-01-01 00:13:30,12,1,28,0,28,0.04%,0.00%
2020-01-01 00:13:30,12,2,625,172,453,0.95%,27.52%
2020-01-01 00:13:30,12,3,2413,207,2206,3.68%,8.58%
2020-01-01 00:13:30,12,4,2974,128,2846,4.54%,4.30%
2020-01-01 00:13:30,12,5,7983,744,7239,12.18%,9.32%
2020-01-01 00:13:30,12,6,4847,273,4574,7.40%,5.63%
2020-01-01 00:13:30,12,7,1764,26,1738,2.69%,1.47%
2020-01-01 00:13:30,12,8,1527,356,1171,2.33%,23.31%
2020-01-01 00:13:30,12,9,20455,4036,16419,31.21%,19.73%
2020-01-01 00:13:30,12,10,4739,502,4237,7.23%,10.59%
2020-01-01 00:13:30,12,11,1757,356,1401,2.68%,20.26%
2020-01-01 00:13:30,12,12,7137,1183,5954,10.89%,16.58%
2020-01-01 00:13:30,13,1,1927,25,1902,2.94%,1.30%
2020-01-01 00:13:30,13,2,2295,36,2259,3.50%,1.57%
2020-01-01 00:13:30,13,3,952,5,947,1.45%,0.53%
2020-01-01 00:13:30,13,4,4980,635,4345,7.60%,12.75%
2020-01-01 00:13:30,13,5,7873,980,6893,12.01%,12.45%
2020-01-01 00:13:30,13,6,6081,718,5363,9.28%,11.81%
2020-01-01 00:13:30,13,7,4217,125,4092,6.43%,2.96%
2020-01-01 00:13:30,13,8,7711,439,7272,11.77%,5.69%
2020-01-01 00:13:30,13,9,8212,1018,7194,12.53%,12.40%
2020-01-01 00:13:30,13,10,28477,6080,22397,43.45%,21.35%
2020-01-01 00:13:30,13,11,17322,2453,14869,26.43%,14.16%
2020-01-01 00:13:30,13,12,9290,1013,8277,14.18%,10.90%
2020-01-01 00:13:30,14,1,332,0,332,0.51%,0.00%
2020-01-01 00:13:30,14,2,1563,24,1539,2.38%,1.54%
2020-01-01 00:13:30,14,3,1089,10,1079,1.66%,0.92%
2020-01-01 00:13:30,14,4,3403,96,3307,5.19%,2.82%
2020-01-01 00:13:30,14,5,1108,12,1096,1.69%,1.08%
2020-01-01 00:13:30,14,6,3810,117,3693,5.81%,3.07%
2020-01-01 00:13:30,14,7,11407,893,10514,17.41%,7.83%
2020-01-01 00:13:30,14,8,13610,1232,12378,20.77%,9.05%
2020-01-01 00:13:30,14,9,1359,15,1344,2.07%,1.10%
2020-01-01 00:13:30,14,10,3655,89,3566,5.58%,2.44%
2020-01-01 00:13:30,14,11,26696,4708,21988,40.73%,17.64%
2020-01-01 00:13:30,14,12,9058,621,8437,13.82%,6.86%
2020-01-01 00:13:30,15,1,558,2,556,0.85%,0.36%
2020-01-01 00:13:30,15,2,132,0,132,0.20%,0.00%
2020-01-01 00:13:30,15,3,6108,279,5829,9.32%,4.57%
2020-01-01 00:13:30,15,4,4544,194,4350,6.93%,4.27%
2020-01-01 00:13:30,15,5,11646,1020,10626,17.77%,8.76%
2020-01-01 00:13:30,15,6,4828,212,4616,7.37%,4.39%
2020-01-01 00:13:30,15,7,3939,141,3798,6.01%,3.58%
2020-01-01 00:13:30,15,8,6745,404,6341,10.29%,5.99%
2020-01-01 00:13:30,15,9,11845,1047,10798,18.07%,8.84%
2020-01-01 00:13:30,15,10,7104,541,6563,10.84%,7.62%
2020-01-01 00:13:30,15,11,13924,1587,12337,21.25%,11.40%
2020-01-01 00:13:30,15,12,30775,6722,24053,46.96%,21.84%
2020-01-01 00:13:30,16,1,536,5,531,0.82%,0.93%
2020-01-01 00:13:30,16,2,237,4,233,0.36%,1.69%
2020-01-01 00:13:30,16,3,1250,18,1232,1.91%,1.44%
2020-01-01 00:13:30,16,4,4625,168,4457,7.06%,3.63%
2020-01-01 00:13:30,16,5,7874,543,7331,12.01%,6.90%
2020-01-01 00:13:30,16,6,5523,239,5284,8.43%,4.33%
2020-01-01 00:13:30,16,7,3540,105,3435,5.40%,2.97%
2020-01-01 00:13:30,16,8,8489,615,7874,12.95%,7.24%
2020-01-01 00:13:30,16,9,8446,609,7837,12.89%,7.21%
2020-01-01 00:13:30,16,10,1581,21,1560,2.41%,1.33%
2020-01-01 00:13:30,16,11,10290,839,9451,15.70%,8.15%
2020-01-01 00:13:30,16,12,26811,5010,21801,40.91%,18.69%
2020-01-01 00:13:40,1,1,18621,2416,16205,28.41%,12.97%
2020-01-01 00:13:40,1,2,6474,303,6171,9.88%,4.68%
2020-01-01 00:13:40,1,3,678,2,676,1.03%,0.29%
2020-01-01 00:13:40,1,4,11885,1063,10822,18.14%,8.94%
2020-01-01 00:13:40,1,5,11681,1031,10650,17.82%,8.83%
2020-01-01 00:13:40,1,6,11566,1012,10554,17.65%,8.75%
2020-01-01 00:13:40,1,7,5782,244,5538,8.82%,4.22%
2020-01-01 00:13:40,1,8,3391,70,3321,5.17%,2.06%
2020-01-01 00:13:40,1,9,11515,1001,10514,17.57%,8.69%
2020-01-01 00:13:40,1,10,2930,49,2881,4.47%,1.67%
2020-01-01 00:13:40,1,11,2996,51,2945,4.57%,1.70%
2020-01-01 00:13:40,1,12,11484,996,10488,17.52%,8.67%
2020-01-01 00:13:40,2,1,989,4,985,1.51%,0.40%
2020-01-01 00:13:40,2,2,27921,5180,22741,42.60%,18.55%
2020-01-01 00:13:40,2,3,22305,3378,18927,34.03%,15.14%
2020-01-01 00:13:40,2,4,937,3,934,1.43%,0.32%
2020-01-01 00:13:40,2,5,13298,1274,12024,20.29%,9.58%
2020-01-01 00:13:40,2,6,46,0,46,0.07%,0.00%
2020-01-01 00:13:40,2,7,4606,155,4451,7.03%,3.37%
2020-01-01 00:13:40,2,8,3759,102,3657,5.74%,2.71%
2020-01-01 00:13:40,2,9,13148,1245,11903,20.06%,9.47%
2020-01-01 00:13:40,2,10,2962,65,2897,4.52%,2.19%
2020-01-01 00:13:40,2,11,3008,66,2942,4.59%,2.19%
2020-01-01 00:13:40,2,12,12977,1213,11764,19.80%,9.35%
2020-01-01 00:13:40,3,1,1408,11,1397,2.15%,0.78%
2020-01-01 00:13:40,3,2,22300,3326,18974,34.03%,14.91%
2020-01-01 00:13:40,3,3,66996,24820,42176,102.23%,37.05%
2020-01-01 00:13:40,3,4,7441,370,7071,11.35%,4.97%
2020-01-01 00:13:40,3,5,43300,11516,31784,66.07%,26.60%
2020-01-01 00:13:40,3,6,8923,530,8393,13.62%,5.94%
2020-01-01 00:13:40,3,7,19159,2493,16666,29.23%,13.01%
2020-01-01 00:13:40,3,8,15609,1715,13894,23.82%,10.99%
2020-01-01 00:13:40,3,9,34027,7408,26619,51.92%,21.77%
2020-01-01 00:13:40,3,10,5062,177,4885,7.72%,3.50%
2020-01-01 00:13:40,3,11,1768,31,1737,2.70%,1.75%
2020-01-01 00:13:40,3,12,27385,4950,22435,41.79%,18.08%
2020-01-01 00:13:40,4,1,513,5,508,0.78%,0.97%
2020-01-01 00:13:40,4,2,314,1,313,0.48%,0.32%
2020-01-01 00:13:40,4,3,1059,5,1054,1.62%,0.47%
2020-01-01 00:13:40,4,4,28012,5177,22835,42.74%,18.48%
2020-01-01 00:13:40,4,5,17501,2138,15363,26.70%,12.22%
2020-01-01 00:13:40,4,6,23677,3829,19848,36.13%,16.17%
2020-01-01 00:13:40,4,7,5017,191,4826,7.66%,3.81%
2020-01-01 00:13:40,4,8,2897,60,2837,4.42%,2.07%
2020-01-01 00:13:40,4,9,15060,1610,13450,22.98%,10.69%
2020-01-01 00:13:40,4,10,1839,25,1814,2.81%,1.36%
2020-01-01 00:13:40,4,11,163,1,162,0.25%,0.61%
2020-01-01 00:13:40,4,12,12586,1126,11460,19.20%,8.95%
2020-01-01 00:13:40,5,1,2892,63,2829,4.41%,2.18%
2020-01-01 00:13:40,5,2,712,3,709,1.09%,0.42%
2020-01-01 00:13:40,5,3,560,1,559,0.85%,0.18%
2020-01-01 00:13:40,5,4,23857,3800,20057,36.40%,15.93%
2020-01-01 00:13:40,5,5,9417,635,8782,14.37%,6.74%
2020-01-01 00:13:40,5,6,15958,1797,14161,24.35%,11.26%
2020-01-01 00:13:40,5,7,6107,282,5825,9.32%,4.62%
2020-01-01 00:13:40,5,8,4559,153,4406,6.96%,3.36%
2020-01-01 00:13:40,5,9,8717,552,8165,13.30%,6.33%
2020-01-01 00:13:40,5,10,1054,10,1044,1.61%,0.95%
2020-01-01 00:13:40,5,11,904,11,893,1.38%,1.22%
2020-01-01 00:13:40,5,12,7336,384,6952,11.19%,5.23%
2020-01-01 00:13:40,6,1,1119,13,1106,1.71%,1.16%
2020-01-01 00:13:40,6,2,1222,14,1208,1.86%,1.15%
2020-01-01 00:13:40,6,3,1789,38,1751,2.73%,2.12%
2020-01-01 00:13:40,6,4,1260,8,1252,1.92%,0.63%
2020-01-01 00:13:40,6,5,16847,2024,14823,25.71%,12.01%
2020-01-01 00:13:40,6,6,4515,178,4337,6.89%,3.94%
2020-01-01 00:13:40,6,7,2737,87,2650,4.18%,3.18%
2020-01-01 00:13:40,6,8,2179,68,2111,3.32%,3.12%
2020-01-01 00:13:40,6,9,10198,778,9420,15.56%,7.63%
2020-01-01 00:13:40,6,10,2119,34,2085,3.23%,1.60%
2020-01-01 00:13:40,6,11,475,3,472,0.72%,0.63%
2020-01-01 00:13:40,6,12,7919,489,7430,12.08%,6.18%
2020-01-01 00:13:40,7,1,452,3,449,0.69%,0.66%
2020-01-01 00:13:40,7,2,170,1,169,0.26%,0.59%
2020-01-01 00:13:40,7,3,1298,18,1280,1.98%,1.39%
2020-01-01 00:13:40,7,4,1320,13,1307,2.01%,0.98%
2020-01-01 00:13:40,7,5,7454,428,7026,11.37%,5.74%
2020-01-01 00:13:40,7,6,12177,1084,11093,18.58%,8.90%
2020-01-01 00:13:40,7,7,3390,74,3316,5.17%,2.18%
2020-01-01 00:13:40,7,8,1263,12,1251,1.93%,0.95%
2020-01-01 00:13:40,7,9,6021,283,5738,9.19%,4.70%
2020-01-01 00:13:40,7,10,1475,12,1463,2.25%,0.81%
2020-01-01 00:13:40,7,11,116,0,116,0.18%,0.00%
2020-01-01 00:13:40,7,12,4529,158,4371,6.91%,3.49%
2020-01-01 00:13:40,8,1,455,4,451,0.69%,0.88%
2020-01-01 00:13:40,8,2,88,0,88,0.13%,0.00%
2020-01-01 00:13:40,8,3,1670,26,1644,2.55%,1.56%
2020-01-01 00:13:40,8,4,2527,50,2477,3.86%,1.98%
2020-01-01 00:13:40,8,5,8238,534,7704,12.57%,6.48%
2020-01-01 00:13:40,8,6,15492,1716,13776,23.64%,11.08%
2020-01-01 00:13:40,8,7,4641,172,4469,7.08%,3.71%
2020-01-01 00:13:40,8,8,1888,27,1861,2.88%,1.43%
2020-01-01 00:13:40,8,9,6343,340,6003,9.68%,5.36%
2020-01-01 00:13:40,8,10,1836,26,1810,2.80%,1.42%
2020-01-01 00:13:40,8,11,118,0,118,0.18%,0.00%
2020-01-01 00:13:40,8,12,4383,171,4212,6.69%,3.90%
2020-01-01 00:13:40,9,1,489,1,488,0.75%,0.20%
2020-01-01 00:13:40,9,2,2201,34,2167,3.36%,1.54%
2020-01-01 00:13:40,9,3,1155,17,1138,1.76%,1.47%
2020-01-01 00:13:40,9,4,14523,1474,13049,22.16%,10.15%
2020-01-01 00:13:40,9,5,307,1,306,0.47%,0.33%
2020-01-01 00:13:40,9,6,15022,1568,13454,22.92%,10.44%
2020-01-01 00:13:40,9,7,36316,8365,27951,55.41%,23.03%
2020-01-01 00:13:40,9,8,13118,1219,11899,20.02%,9.29%
2020-01-01 00:13:40,9,9,239,0,239,0.36%,0.00%
2020-01-01 00:13:40,9,10,5737,226,5511,8.75%,3.94%
2020-01-01 00:13:40,9,11,11948,1020,10928,18.23%,8.54%
2020-01-01 00:13:40,9,12,5894,275,5619,8.99%,4.67%
2020-01-01 00:13:40,10,1,1682,281,1401,2.57%,16.71%
2020-01-01 00:13:40,10,2,4078,374,3704,6.22%,9.17%
2020-01-01 00:13:40,10,3,2190,35,2155,3.34%,1.60%
2020-01-01 00:13:40,10,4,3633,950,2683,5.54%,26.15%
2020-01-01 00:13:40,10,5,563,7,556,0.86%,1.24%
2020-01-01 00:13:40,10,6,5301,1040,4261,8.09%,19.62%
2020-01-01 00:13:40,10,7,11099,1860,9239,16.94%,16.76%
2020-01-01 00:13:40,10,8,28130,6999,21131,42.92%,24.88%
2020-01-01 00:13:40,10,9,639,2,637,0.98%,0.31%
2020-01-01 00:13:40,10,10,2584,60,2524,3.94%,2.32%
2020-01-01 00:13:40,10,11,12526,1525,11001,19.11%,12.17%
2020-01-01 00:13:40,10,12,9116,1037,8079,13.91%,11.38%
2020-01-01 00:13:40,11,1,2063,38,2025,3.15%,1.84%
2020-01-01 00:13:40,11,2,3737,99,3638,5.70%,2.65%
2020-01-01 00:13:40,11,3,1456,11,1445,2.22%,0.76%
2020-01-01 00:13:40,11,4,3427,103,3324,5.23%,3.01%
2020-01-01 00:13:40,11,5,606,2,604,0.92%,0.33%
2020-01-01 00:13:40,11,6,4669,176,4493,7.12%,3.77%
2020-01-01 00:13:40,11,7,12951,1186,11765,19.76%,9.16%
2020-01-01 00:13:40,11,8,26648,4671,21977,40.66%,17.53%
2020-01-01 00:13:40,11,9,286,0,286,0.44%,0.00%
2020-01-01 00:13:40,11,10,3753,109,3644,5.73%,2.90%
2020-01-01 00:13:40,11,11,10701,866,9835,16.33%,8.09%
2020-01-01 00:13:40,11,12,6751,357,6394,10.30%,5.29%
2020-01-01 00:13:40,12,1,42,0,42,0.06%,0.00%
2020-01-01 00:13:40,12,2,626,217,409,0.96%,34.66%
2020-01-01 00:13:40,12,3,2463,265,2198,3.76%,10.76%
2020-01-01 00:13:40,12,4,2465,52,2413,3.76%,2.11%
2020-01-01 00:13:40,12,5,9339,924,8415,14.25%,9.89%
2020-01-01 00:13:40,12,6,6058,366,5692,9.24%,6.04%
2020-01-01 00:13:40,12,7,3467,172,3295,5.29%,4.96%
2020-01-01 00:13:40,12,8,1470,283,1187,2.24%,19.25%
2020-01-01 00:13:40,12,9,22205,4442,17763,33.88%,20.00%
2020-01-01 00:13:40,12,10,4707,397,4310,7.18%,8.43%
2020-01-01 00:13:40,12,11,1630,287,1343,2.49%,17.61%
2020-01-01 00:13:40,12,12,7412,992,6420,11.31%,13.38%
2020-01-01 00:13:40,13,1,2180,30,2150,3.33%,1.38%
2020-01-01 00:13:40,13,2,2635,46,2589,4.02%,1.75%
2020-01-01 00:13:40,13,3,803,1,802,1.23%,0.12%
2020-01-01 00:13:40,13,4,4315,628,3687,6.58%,14.55%
2020-01-01 00:13:40,13,5,7129,950,6179,10.88%,13.33%
2020-01-01 00:13:40,13,6,5396,701,4695,8.23%,12.99%
2020-01-01 00:13:40,13,7,5243,194,5049,8.00%,3.70%
2020-01-01 00:13:40,13,8,7635,403,7232,11.65%,5.28%
2020-01-01 00:13:40,13,9,7360,967,6393,11.23%,13.14%
2020-01-01 00:13:40,13,10,27299,5613,21686,41.65%,20.56%
2020-01-01 00:13:40,13,11,17251,2307,14944,26.32%,13.37%
2020-01-01 00:13:40,13,12,8923,914,8009,13.62%,10.24%
2020-01-01 00:13:40,14,1,451,4,447,0.69%,0.89%
2020-01-01 00:13:40,14,2,1644,33,1611,2.51%,2.01%
2020-01-01 00:13:40,14,3,1054,10,1044,1.61%,0.95%
2020-01-01 00:13:40,14,4,3715,104,3611,5.67%,2.80%
2020-01-01 00:13:40,14,5,1252,9,1243,1.91%,0.72%
2020-01-01 00:13:40,14,6,4240,138,4102,6.47%,3.25%
2020-01-01 00:13:40,14,7,11581,966,10615,17.67%,8.34%
2020-01-01 00:13:40,14,8,13247,1251,11996,20.21%,9.44%
2020-01-01 00:13:40,14,9,1607,19,1588,2.45%,1.18%
2020-01-01 00:13:40,14,10,3996,112,3884,6.10%,2.80%
2020-01-01 00:13:40,14,11,24068,3867,20201,36.72%,16.07%
2020-01-01 00:13:40,14,12,6592,304,6288,10.06%,4.61%
2020-01-01 00:13:40,15,1,531,7,524,0.81%,1.32%
2020-01-01 00:13:40,15,2,133,0,133,0.20%,0.00%
2020-01-01 00:13:40,15,3,3541,91,3450,5.40%,2.57%
2020-01-01 00:13:40,15,4,5747,275,5472,8.77%,4.79%
2020-01-01 00:13:40,15,5,11160,923,10237,17.03%,8.27%
2020-01-01 00:13:40,15,6,6003,302,5701,9.16%,5.03%
2020-01-01 00:13:40,15,7,3751,103,3648,5.72%,2.75%
2020-01-01 00:13:40,15,8,5454,212,5242,8.32%,3.89%
2020-01-01 00:13:40,15,9,11414,962,10452,17.42%,8.43%
2020-01-01 00:13:40,15,10,3807,159,3648,5.81%,4.18%
2020-01-01 00:13:40,15,11,9441,709,8732,14.41%,7.51%
2020-01-01 00:13:40,15,12,25812,4801,21011,39.39%,18.60%
2020-01-01 00:13:40,16,1,429,2,427,0.65%,0.47%
2020-01-01 00:13:40,16,2,284,0,284,0.43%,0.00%
2020-01-01 00:13:40,16,3,1254,21,1233,1.91%,1.67%
2020-01-01 00:13:40,16,4,5755,267,5488,8.78%,4.64%
2020-01-01 00:13:40,16,5,9188,747,8441,14.02%,8.13%
2020-01-01 00:13:40,16,6,6607,344,6263,10.08%,5.21%
2020-01-01 00:13:40,16,7,3597,98,3499,5.49%,2.72%
2020-01-01 00:13:40,16,8,9619,886,8733,14.68%,9.21%
2020-01-01 00:13:40,16,9,9599,803,8796,14.65%,8.37%
2020-01-01 00:13:40,16,10,1533,16,1517,2.34%,1.04%
2020-01-01 00:13:40,16,11,11453,1135,10318,17.48%,9.91%
2020-01-01 00:13:40,16,12,29529,6012,23517,45.06%,20.36%
2020-01-01 00:13:50,1,1,17596,2236,15360,26.85%,12.71%
2020-01-01 00:13:50,1,2,7055,378,6677,10.77%,5.36%
2020-01-01 00:13:50,1,3,487,2,485,0.74%,0.41%
2020-01-01 00:13:50,1,4,9991,784,9207,15.25%,7.85%
2020-01-01 00:13:50,1,5,9481,697,8784,14.47%,7.35%
2020-01-01 00:13:50,1,6,9449,693,8756,14.42%,7.33%
2020-01-01 00:13:50,1,7,6548,332,6216,9.99%,5.07%
2020-01-01 00:13:50,1,8,5420,238,5182,8.27%,4.39%
2020-01-01 00:13:50,1,9,9398,688,8710,14.34%,7.32%
2020-01-01 00:13:50,1,10,4758,192,4566,7.26%,4.04%
2020-01-01 00:13:50,1,11,4858,201,4657,7.41%,4.14%
2020-01-01 00:13:50,1,12,9373,688,8685,14.30%,7.34%
2020-01-01 00:13:50,2,1,677,2,675,1.03%,0.30%
2020-01-01 00:13:50,2,2,29932,5882,24050,45.67%,19.65%
2020-01-01 00:13:50,2,3,23573,3721,19852,35.97%,15.79%
2020-01-01 00:13:50,2,4,629,1,628,0.96%,0.16%
2020-01-01 00:13:50,2,5,11386,939,10447,17.37%,8.25%
2020-01-01 00:13:50,2,6,56,0,56,0.09%,0.00%
2020-01-01 00:13:50,2,7,5660,238,5422,8.64%,4.20%
2020-01-01 00:13:50,2,8,4331,142,4189,6.61%,3.28%
2020-01-01 00:13:50,2,9,11320,929,10391,17.27%,8.21%
2020-01-01 00:13:50,2,10,3169,81,3088,4.84%,2.56%
2020-01-01 00:13:50,2,11,3184,81,3103,4.86%,2.54%
2020-01-01 00:13:50,2,12,11184,907,10277,17.07%,8.11%
2020-01-01 00:13:50,3,1,1107,10,1097,1.69%,0.90%
2020-01-01 00:13:50,3,2,23723,3870,19853,36.20%,16.31%
2020-01-01 00:13:50,3,3,68877,26288,42589,105.10%,38.17%
2020-01-01 00:13:50,3,4,9734,690,9044,14.85%,7.09%
2020-01-01 00:13:50,3,5,39590,9815,29775,60.41%,24.79%
2020-01-01 00:13:50,3,6,11075,913,10162,16.90%,8.24%
2020-01-01 00:13:50,3,7,20788,3030,17758,31.72%,14.58%
2020-01-01 00:13:50,3,8,16151,1869,14282,24.64%,11.57%
2020-01-01 00:13:50,3,9,28192,5244,22948,43.02%,18.60%
2020-01-01 00:13:50,3,10,5861,254,5607,8.94%,4.33%
2020-01-01 00:13:50,3,11,1596,15,1581,2.44%,0.94%
2020-01-01 00:13:50,3,12,18837,2416,16421,28.74%,12.83%
2020-01-01 00:13:50,4,1,563,3,560,0.86%,0.53%
2020-01-01 00:13:50,4,2,373,1,372,0.57%,0.27%
2020-01-01 00:13:50,4,3,1056,19,1037,1.61%,1.80%
2020-01-01 00:13:50,4,4,27455,5052,22403,41.89%,18.40%
2020-01-01 00:13:50,4,5,16479,1933,14546,25.14%,11.73%
2020-01-01 00:13:50,4,6,23170,3710,19460,35.35%,16.01%
2020-01-01 00:13:50,4,7,5366,260,5106,8.19%,4.85%
2020-01-01 00:13:50,4,8,3187,89,3098,4.86%,2.79%
2020-01-01 00:13:50,4,9,14331,1487,12844,21.87%,10.38%
2020-01-01 00:13:50,4,10,1922,35,1887,2.93%,1.82%
2020-01-01 00:13:50,4,11,276,0,276,0.42%,0.00%
2020-01-01 00:13:50,4,12,11646,999,10647,17.77%,8.58%
2020-01-01 00:13:50,5,1,3161,87,3074,4.82%,2.75%
2020-01-01 00:13:50,5,2,753,5,748,1.15%,0.66%
2020-01-01 00:13:50,5,3,562,1,561,0.86%,0.18%
2020-01-01 00:13:50,5,4,22373,3444,18929,34.14%,15.39%
2020-01-01 00:13:50,5,5,9164,622,8542,13.98%,6.79%
2020-01-01 00:13:50,5,6,15385,1718,13667,23.48%,11.17%
2020-01-01 00:13:50,5,7,5737,268,5469,8.75%,4.67%
2020-01-01 00:13:50,5,8,4286,153,4133,6.54%,3.57%
2020-01-01 00:13:50,5,9,8489,538,7951,12.95%,6.34%
2020-01-01 00:13:50,5,10,1347,15,1332,2.06%,1.11%
2020-01-01 00:13:50,5,11,660,4,656,1.01%,0.61%
2020-01-01 00:13:50,5,12,6794,348,6446,10.37%,5.12%
2020-01-01 00:13:50,6,1,1052,11,1041,1.61%,1.05%
2020-01-01 00:13:50,6,2,1115,14,1101,1.70%,1.26%
2020-01-01 00:13:50,6,3,1580,29,1551,2.41%,1.84%
2020-01-01 00:13:50,6,4,1218,10,1208,1.86%,0.82%
2020-01-01 00:13:50,6,5,11664,992,10672,17.80%,8.50%
2020-01-01 00:13:50,6,6,3872,109,3763,5.91%,2.82%
2020-01-01 00:13:50,6,7,2319,51,2268,3.54%,2.20%
2020-01-01 00:13:50,6,8,1873,40,1833,2.86%,2.14%
2020-01-01 00:13:50,6,9,5961,281,5680,9.10%,4.71%
2020-01-01 00:13:50,6,10,1989,26,1963,3.03%,1.31%
2020-01-01 00:13:50,6,11,471,1,470,0.72%,0.21%
2020-01-01 00:13:50,6,12,3891,109,3782,5.94%,2.80%
2020-01-01 00:13:50,7,1,583,0,583,0.89%,0.00%
2020-01-01 00:13:50,7,2,147,0,147,0.22%,0.00%
2020-01-01 00:13:50,7,3,1310,11,1299,2.00%,0.84%
2020-01-01 00:13:50,7,4,2122,27,2095,3.24%,1.27%
2020-01-01 00:13:50,7,5,8420,519,7901,12.85%,6.16%
2020-01-01 00:13:50,7,6,14258,1412,12846,21.76%,9.90%
2020-01-01 00:13:50,7,7,3684,102,3582,5.62%,2.77%
2020-01-01 00:13:50,7,8,1117,11,1106,1.70%,0.98%
2020-01-01 00:13:50,7,9,7046,366,6680,10.75%,5.19%
2020-01-01 00:13:50,7,10,1485,19,1466,2.27%,1.28%
2020-01-01 00:13:50,7,11,77,0,77,0.12%,0.00%
2020-01-01 00:13:50,7,12,5462,213,5249,8.33%,3.90%
2020-01-01 00:13:50,8,1,542,1,541,0.83%,0.18%
2020-01-01 00:13:50,8,2,69,0,69,0.11%,0.00%
2020-01-01 00:13:50,8,3,2015,38,1977,3.07%,1.89%
2020-01-01 00:13:50,8,4,2876,76,2800,4.39%,2.64%
2020-01-01 00:13:50,8,5,7975,498,7477,12.17%,6.24%
2020-01-01 00:13:50,8,6,15179,1690,13489,23.16%,11.13%
2020-01-01 00:13:50,8,7,4277,151,4126,6.53%,3.53%
2020-01-01 00:13:50,8,8,1929,38,1891,2.94%,1.97%
2020-01-01 00:13:50,8,9,5748,245,5503,8.77%,4.26%
2020-01-01 00:13:50,8,10,1603,24,1579,2.45%,1.50%
2020-01-01 00:13:50,8,11,72,0,72,0.11%,0.00%
2020-01-01 00:13:50,8,12,4180,133,4047,6.38%,3.18%
2020-01-01 00:13:50,9,1,1098,3,1095,1.68%,0.27%
2020-01-01 00:13:50,9,2,4554,140,4414,6.95%,3.07%
2020-01-01 00:13:50,9,3,3118,68,3050,4.76%,2.18%
2020-01-01 00:13:50,9,4,7056,388,6668,10.77%,5.50%
2020-01-01 00:13:50,9,5,566,3,563,0.86%,0.53%
2020-01-01 00:13:50,9,6,8479,528,7951,12.94%,6.23%
2020-01-01 00:13:50,9,7,29186,5685,23501,44.53%,19.48%
2020-01-01 00:13:50,9,8,10317,776,9541,15.74%,7.52%
2020-01-01 00:13:50,9,9,284,0,284,0.43%,0.00%
2020-01-01 00:13:50,9,10,3795,105,3690,5.79%,2.77%
2020-01-01 00:13:50,9,11,9180,610,8570,14.01%,6.64%
2020-01-01 00:13:50,9,12,5066,176,4890,7.73%,3.47%
2020-01-01 00:13:50,10,1,1558,222,1336,2.38%,14.25%
2020-01-01 00:13:50,10,2,3119,271,2848,4.76%,8.69%
2020-01-01 00:13:50,10,3,1376,16,1360,2.10%,1.16%
2020-01-01 00:13:50,10,4,3889,1161,2728,5.93%,29.85%
2020-01-01 00:13:50,10,5,682,51,631,1.04%,7.48%
2020-01-01 00:13:50,10,6,5980,1317,4663,9.12%,22.02%
2020-01-01 00:13:50,10,7,10865,2006,8859,16.58%,18.46%
2020-01-01 00:13:50,10,8,28615,7241,21374,43.66%,25.30%
2020-01-01 00:13:50,10,9,561,2,559,0.86%,0.36%
2020-01-01 00:13:50,10,10,2224,31,2193,3.39%,1.39%
2020-01-01 00:13:50,10,11,13921,1899,12022,21.24%,13.64%
2020-01-01 00:13:50,10,12,11252,1444,9808,17.17%,12.83%
2020-01-01 00:13:50,11,1,2360,40,2320,3.60%,1.69%
2020-01-01 00:13:50,11,2,3388,85,3303,5.17%,2.51%
2020-01-01 00:13:50,11,3,754,5,749,1.15%,0.66%
2020-01-01 00:13:50,11,4,5587,253,5334,8.53%,4.53%
2020-01-01 00:13:50,11,5,143,0,143,0.22%,0.00%
2020-01-01 00:13:50,11,6,6334,310,6024,9.66%,4.89%
2020-01-01 00:13:50,11,7,31044,6288,24756,47.37%,20.26%
2020-01-01 00:13:50,11,8,43612,11825,31787,66.55%,27.11%
2020-01-01 00:13:50,11,9,328,1,327,0.50%,0.30%
2020-01-01 00:13:50,11,10,2854,59,2795,4.35%,2.07%
2020-01-01 00:13:50,11,11,9113,623,8490,13.91%,6.84%
2020-01-01 00:13:50,11,12,5861,255,5606,8.94%,4.35%
2020-01-01 00:13:50,12,1,199,0,199,0.30%,0.00%
2020-01-01 00:13:50,12,2,527,159,368,0.80%,30.17%
2020-01-01 00:13:50,12,3,2946,229,2717,4.50%,7.77%
2020-01-01 00:13:50,12,4,2951,54,2897,4.50%,1.83%
2020-01-01 00:13:50,12,5,8267,630,7637,12.61%,7.62%
2020-01-01 00:13:50,12,6,4599,155,4444,7.02%,3.37%
2020-01-01 00:13:50,12,7,1488,27,1461,2.27%,1.81%
2020-01-01 00:13:50,12,8,1513,320,1193,2.31%,21.15%
2020-01-01 00:13:50,12,9,23681,4762,18919,36.13%,20.11%
2020-01-01 00:13:50,12,10,4558,441,4117,6.95%,9.68%
2020-01-01 00:13:50,12,11,1622,326,1296,2.47%,20.10%
2020-01-01 00:13:50,12,12,9830,1414,8416,15.00%,14.38%
2020-01-01 00:13:50,13,1,2281,47,2234,3.48%,2.06%
2020-01-01 00:13:50,13,2,2571,60,2511,3.92%,2.33%
2020-01-01 00:13:50,13,3,1126,13,1113,1.72%,1.15%
2020-01-01 00:13:50,13,4,4767,430,4337,7.27%,9.02%
2020-01-01 00:13:50,13,5,8020,892,7128,12.24%,11.12%
2020-01-01 00:13:50,13,6,5927,502,5425,9.04%,8.47%
2020-01-01 00:13:50,13,7,5508,255,5253,8.40%,4.63%
2020-01-01 00:13:50,13,8,7566,428,7138,11.54%,5.66%
2020-01-01 00:13:50,13,9,8256,925,7331,12.60%,11.20%
2020-01-01 00:13:50,13,10,26101,5109,20992,39.83%,19.57%
2020-01-01 00:13:50,13,11,15498,1961,13537,23.65%,12.65%
2020-01-01 00:13:50,13,12,7531,734,6797,11.49%,9.75%
2020-01-01 00:13:50,14,1,699,1,698,1.07%,0.14%
2020-01-01 00:13:50,14,2,1541,10,1531,2.35%,0.65%
2020-01-01 00:13:50,14,3,590,2,588,0.90%,0.34%
2020-01-01 00:13:50,14,4,3261,83,3178,4.98%,2.55%
2020-01-01 00:13:50,14,5,1385,11,1374,2.11%,0.79%
2020-01-01 00:13:50,14,6,3651,102,3549,5.57%,2.79%
2020-01-01 00:13:50,14,7,11307,910,10397,17.25%,8.05%
2020-01-01 00:13:50,14,8,12599,1134,11465,19.22%,9.00%
2020-01-01 00:13:50,14,9,1486,14,1472,2.27%,0.94%
2020-01-01 00:13:50,14,10,3948,139,3809,6.02%,3.52%
2020-01-01 00:13:50,14,11,24741,4197,20544,37.75%,16.96%
2020-01-01 00:13:50,14,12,7940,504,7436,12.12%,6.35%
2020-01-01 00:13:50,15,1,474,0,474,0.72%,0.00%
2020-01-01 00:13:50,15,2,138,0,138,0.21%,0.00%
2020-01-01 00:13:50,15,3,4323,131,4192,6.60%,3.03%
2020-01-01 00:13:50,15,4,4329,173,4156,6.61%,4.00%
2020-01-01 00:13:50,15,5,9618,660,8958,14.68%,6.86%
2020-01-01 00:13:50,15,6,4539,176,4363,6.93%,3.88%
2020-01-01 00:13:50,15,7,3086,86,3000,4.71%,2.79%
2020-01-01 00:13:50,15,8,4720,209,4511,7.20%,4.43%
2020-01-01 00:13:50,15,9,9883,689,9194,15.08%,6.97%
2020-01-01 00:13:50,15,10,3536,322,3214,5.40%,9.11%
2020-01-01 00:13:50,15,11,8326,760,7566,12.70%,9.13%
2020-01-01 00:13:50,15,12,23022,4060,18962,35.13%,17.64%
2020-01-01 00:13:50,16,1,378,1,377,0.58%,0.26%
2020-01-01 00:13:50,16,2,224,0,224,0.34%,0.00%
2020-01-01 00:13:50,16,3,1327,15,1312,2.02%,1.13%
2020-01-01 00:13:50,16,4,4010,130,3880,6.12%,3.24%
2020-01-01 00:13:50,16,5,6927,383,6544,10.57%,5.53%
2020-01-01 00:13:50,16,6,4804,178,4626,7.33%,3.71%
2020-01-01 00:13:50,16,7,3285,77,3208,5.01%,2.34%
2020-01-01 00:13:50,16,8,7197,459,6738,10.98%,6.38%
2020-01-01 00:13:50,16,9,7380,423,6957,11.26%,5.73%
2020-01-01 00:13:50,16,10,1206,3,1203,1.84%,0.25%
2020-01-01 00:13:50,16,11,8609,619,7990,13.14%,7.19%
2020-01-01 00:13:50,16,12,23596,3790,19806,36.00%,16.06%
2020-01-01 00:14:00,1,1,22985,3654,19331,35.07%,15.90%
2020-01-01 00:14:00,1,2,13880,1363,12517,21.18%,9.82%
2020-01-01 00:14:00,1,3,796,3,793,1.21%,0.38%
2020-01-01 00:14:00,1,4,8739,611,8128,13.33%,6.99%
2020-01-01 00:14:00,1,5,8424,565,7859,12.85%,6.71%
2020-01-01 00:14:00,1,6,8332,553,7779,12.71%,6.64%
2020-01-01 00:14:00,1,7,13069,1222,11847,19.94%,9.35%
2020-01-01 00:14:00,1,8,10587,764,9823,16.15%,7.22%
2020-01-01 00:14:00,1,9,8297,548,7749,12.66%,6.60%
2020-01-01 00:14:00,1,10,10063,680,9383,15.35%,6.76%
2020-01-01 00:14:00,1,11,10099,686,9413,15.41%,6.79%
2020-01-01 00:14:00,1,12,8261,542,7719,12.61%,6.56%
2020-01-01 00:14:00,2,1,1302,6,1296,1.99%,0.46%
2020-01-01 00:14:00,2,2,32516,6761,25755,49.62%,20.79%
2020-01-01 00:14:00,2,3,23203,3617,19586,35.40%,15.59%
2020-01-01 00:14:00,2,4,1254,6,1248,1.91%,0.48%
2020-01-01 00:14:00,2,5,15664,1709,13955,23.90%,10.91%
2020-01-01 00:14:00,2,6,15,0,15,0.02%,0.00%
2020-01-01 00:14:00,2,7,7996,396,7600,12.20%,4.95%
2020-01-01 00:14:00,2,8,6842,281,6561,10.44%,4.11%
2020-01-01 00:14:00,2,9,15599,1695,13904,23.80%,10.87%
2020-01-01 00:14:00,2,10,5880,215,5665,8.97%,3.66%
2020-01-01 00:14:00,2,11,5885,216,5669,8.98%,3.67%
2020-01-01 00:14:00,2,12,15413,1645,13768,23.52%,10.67%
2020-01-01 00:14:00,3,1,1774,30,1744,2.71%,1.69%
2020-01-01 00:14:00,3,2,22745,3611,19134,34.71%,15.88%
2020-01-01 00:14:00,3,3,64501,23647,40854,98.42%,36.66%
2020-01-01 00:14:00,3,4,4339,127,4212,6.62%,2.93%
2020-01-01 00:14:00,3,5,40487,10436,30051,61.78%,25.78%
2020-01-01 00:14:00,3,6,6172,266,5906,9.42%,4.31%
2020-01-01 00:14:00,3,7,18913,2559,16354,28.86%,13.53%
2020-01-01 00:14:00,3,8,15092,1657,13435,23.03%,10.98%
2020-01-01 00:14:00,3,9,33961,7591,26370,51.82%,22.35%
2020-01-01 00:14:00,3,10,6499,332,6167,9.92%,5.11%
2020-01-01 00:14:00,3,11,1893,22,1871,2.89%,1.16%
2020-01-01 00:14:00,3,12,24408,4118,20290,37.24%,16.87%
2020-01-01 00:14:00,4,1,518,0,518,0.79%,0.00%
2020-01-01 00:14:00,4,2,305,0,305,0.47%,0.00%
2020-01-01 00:14:00,4,3,856,1,855,1.31%,0.12%
2020-01-01 00:14:00,4,4,27906,5095,22811,42.58%,18.26%
2020-01-01 00:14:00,4,5,17460,2042,15418,26.64%,11.70%
2020-01-01 00:14:00,4,6,24314,3883,20431,37.10%,15.97%
2020-01-01 00:14:00,4,7,5461,213,5248,8.33%,3.90%
2020-01-01 00:14:00,4,8,2972,68,2904,4.53%,2.29%
2020-01-01 00:14:00,4,9,15238,1629,13609,23.25%,10.69%
2020-01-01 00:14:00,4,10,2179,25,2154,3.32%,1.15%
2020-01-01 00:14:00,4,11,176,0,176,0.27%,0.00%
2020-01-01 00:14:00,4,12,12252,1042,11210,18.70%,8.50%
2020-01-01 00:14:00,5,1,2918,64,2854,4.45%,2.19%
2020-01-01 00:14:00,5,2,1359,11,1348,2.07%,0.81%
2020-01-01 00:14:00,5,3,611,3,608,0.93%,0.49%
2020-01-01 00:14:00,5,4,22407,3389,19018,34.19%,15.12%
2020-01-01 00:14:00,5,5,9887,708,9179,15.09%,7.16%
2020-01-01 00:14:00,5,6,14308,1448,12860,21.83%,10.12%
2020-01-01 00:14:00,5,7,4017,128,3889,6.13%,3.19%
2020-01-01 00:14:00,5,8,3230,87,3143,4.93%,2.69%
2020-01-01 00:14:00,5,9,9058,588,8470,13.82%,6.49%
2020-01-01 00:14:00,5,10,902,12,890,1.38%,1.33%
2020-01-01 00:14:00,5,11,722,9,713,1.10%,1.25%
2020-01-01 00:14:00,5,12,7980,460,7520,12.18%,5.76%
2020-01-01 00:14:00,6,1,1092,13,1079,1.67%,1.19%
2020-01-01 00:14:00,6,2,1160,14,1146,1.77%,1.21%
2020-01-01 00:14:00,6,3,1757,24,1733,2.68%,1.37%
2020-01-01 00:14:00,6,4,1756,13,1743,2.68%,0.74%
2020-01-01 00:14:00,6,5,14019,1383,12636,21.39%,9.87%
2020-01-01 00:14:00,6,6,4760,177,4583,7.26%,3.72%
2020-01-01 00:14:00,6,7,2544,70,2474,3.88%,2.75%
2020-01-01 00:14:00,6,8,2036,53,1983,3.11%,2.60%
2020-01-01 00:14:00,6,9,7208,360,6848,11.00%,4.99%
2020-01-01 00:14:00,6,10,2707,49,2658,4.13%,1.81%
2020-01-01 00:14:00,6,11,445,2,443,0.68%,0.45%
2020-01-01 00:14:00,6,12,4435,133,4302,6.77%,3.00%
2020-01-01 00:14:00,7,1,409,5,404,0.62%,1.22%
2020-01-01 00:14:00,7,2,143,0,143,0.22%,0.00%
2020-01-01 00:14:00,7,3,785,3,782,1.20%,0.38%
2020-01-01 00:14:00,7,4,1508,24,1484,2.30%,1.59%
2020-01-01 00:14:00,7,5,7145,375,6770,10.90%,5.25%
2020-01-01 00:14:00,7,6,12079,1084,10995,18.43%,8.97%
2020-01-01 00:14:00,7,7,3409,101,3308,5.20%,2.96%
2020-01-01 00:14:00,7,8,1302,13,1289,1.99%,1.00%
2020-01-01 00:14:00,7,9,6300,313,5987,9.61%,4.97%
2020-01-01 00:14:00,7,10,1218,22,1196,1.86%,1.81%
2020-01-01 00:14:00,7,11,123,1,122,0.19%,0.81%
2020-01-01 00:14:00,7,12,5068,218,4850,7.73%,4.30%
2020-01-01 00:14:00,8,1,433,1,432,0.66%,0.23%
2020-01-01 00:14:00,8,2,119,0,119,0.18%,0.00%
2020-01-01 00:14:00,8,3,1570,17,1553,2.40%,1.08%
2020-01-01 00:14:00,8,4,3010,62,2948,4.59%,2.06%
2020-01-01 00:14:00,8,5,8552,546,8006,13.05%,6.38%
2020-01-01 00:14:00,8,6,18133,2288,15845,27.67%,12.62%
2020-01-01 00:14:00,8,7,6505,311,6194,9.93%,4.78%
2020-01-01 00:14:00,8,8,3423,86,3337,5.22%,2.51%
2020-01-01 00:14:00,8,9,6747,345,6402,10.30%,5.11%
2020-01-01 00:14:00,8,10,1654,17,1637,2.52%,1.03%
2020-01-01 00:14:00,8,11,182,0,182,0.28%,0.00%
2020-01-01 00:14:00,8,12,5113,213,4900,7.80%,4.17%
2020-01-01 00:14:00,9,1,429,2,427,0.65%,0.47%
2020-01-01 00:14:00,9,2,6902,365,6537,10.53%,5.29%
2020-01-01 00:14:00,9,3,6147,289,5858,9.38%,4.70%
2020-01-01 00:14:00,9,4,2821,89,2732,4.30%,3.15%
2020-01-01 00:14:00,9,5,300,1,299,0.46%,0.33%
2020-01-01 00:14:00,9,6,3620,126,3494,5.52%,3.48%
2020-01-01 00:14:00,9,7,29898,6057,23841,45.62%,20.26%
2020-01-01 00:14:00,9,8,13335,1480,11855,20.35%,11.10%
2020-01-01 00:14:00,9,9,197,1,196,0.30%,0.51%
2020-01-01 00:14:00,9,10,6281,408,5873,9.58%,6.50%
2020-01-01 00:14:00,9,11,11882,1124,10758,18.13%,9.46%
2020-01-01 00:14:00,9,12,5323,191,5132,8.12%,3.59%
2020-01-01 00:14:00,10,1,1384,183,1201,2.11%,13.22%
2020-01-01 00:14:00,10,2,3023,246,2777,4.61%,8.14%
2020-01-01 00:14:00,10,3,1496,33,1463,2.28%,2.21%
2020-01-01 00:14:00,10,4,4123,791,3332,6.29%,19.19%
2020-01-01 00:14:00,10,5,571,1,570,0.87%,0.18%
2020-01-01 00:14:00,10,6,5741,888,4853,8.76%,15.47%
2020-01-01 00:14:00,10,7,10652,1579,9073,16.25%,14.82%
2020-01-01 00:14:00,10,8,28055,6764,21291,42.81%,24.11%
2020-01-01 00:14:00,10,9,519,0,519,0.79%,0.00%
2020-01-01 00:14:00,10,10,2234,36,2198,3.41%,1.61%
2020-01-01 00:14:00,10,11,13736,1813,11923,20.96%,13.20%
2020-01-01 00:14:00,10,12,10772,1348,9424,16.44%,12.51%
2020-01-01 00:14:00,11,1,2371,64,2307,3.62%,2.70%
2020-01-01 00:14:00,11,2,3471,106,3365,5.30%,3.05%
2020-01-01 00:14:00,11,3,924,3,921,1.41%,0.32%
2020-01-01 00:14:00,11,4,6755,419,6336,10.31%,6.20%
2020-01-01 00:14:00,11,5,209,0,209,0.32%,0.00%
2020-01-01 00:14:00,11,6,7448,485,6963,11.36%,6.51%
2020-01-01 00:14:00,11,7,13028,1265,11763,19.88%,9.71%
2020-01-01 00:14:00,11,8,26334,4707,21627,40.18%,17.87%
2020-01-01 00:14:00,11,9,142,0,142,0.22%,0.00%
2020-01-01 00:14:00,11,10,2781,60,2721,4.24%,2.16%
2020-01-01 00:14:00,11,11,9447,721,8726,14.41%,7.63%
2020-01-01 00:14:00,11,12,6365,350,6015,9.71%,5.50%
2020-01-01 00:14:00,12,1,77,0,77,0.12%,0.00%
2020-01-01 00:14:00,12,2,558,218,340,0.85%,39.07%
2020-01-01 00:14:00,12,3,2270,259,2011,3.46%,11.41%
2020-01-01 00:14:00,12,4,2707,71,2636,4.13%,2.62%
2020-01-01 00:14:00,12,5,8590,721,7869,13.11%,8.39%
2020-01-01 00:14:00,12,6,5454,216,5238,8.32%,3.96%
2020-01-01 00:14:00,12,7,2540,41,2499,3.88%,1.61%
2020-01-01 00:14:00,12,8,1356,315,1041,2.07%,23.23%
2020-01-01 00:14:00,12,9,21082,4058,17024,32.17%,19.25%
2020-01-01 00:14:00,12,10,3982,405,3577,6.08%,10.17%
2020-01-01 00:14:00,12,11,1516,318,1198,2.31%,20.98%
2020-01-01 00:14:00,12,12,8018,1100,6918,12.23%,13.72%
2020-01-01 00:14:00,13,1,2256,41,2215,3.44%,1.82%
2020-01-01 00:14:00,13,2,2552,55,2497,3.89%,2.16%
2020-01-01 00:14:00,13,3,873,3,870,1.33%,0.34%
2020-01-01 00:14:00,13,4,5787,409,5378,8.83%,7.07%
2020-01-01 00:14:00,13,5,7861,717,7144,11.99%,9.12%
2020-01-01 00:14:00,13,6,6346,444,5902,9.68%,7.00%
2020-01-01 00:14:00,13,7,5278,212,5066,8.05%,4.02%
2020-01-01 00:14:00,13,8,7581,428,7153,11.57%,5.65%
2020-01-01 00:14:00,13,9,8148,757,7391,12.43%,9.29%
2020-01-01 00:14:00,13,10,28029,5763,22266,42.77%,20.56%
2020-01-01 00:14:00,13,11,17243,2459,14784,26.31%,14.26%
2020-01-01 00:14:00,13,12,9274,1032,8242,14.15%,11.13%
2020-01-01 00:14:00,14,1,353,1,352,0.54%,0.28%
2020-01-01 00:14:00,14,2,1472,17,1455,2.25%,1.15%
2020-01-01 00:14:00,14,3,913,6,907,1.39%,0.66%
2020-01-01 00:14:00,14,4,4438,129,4309,6.77%,2.91%
2020-01-01 00:14:00,14,5,1394,11,1383,2.13%,0.79%
2020-01-01 00:14:00,14,6,4765,155,4610,7.27%,3.25%
2020-01-01 00:14:00,14,7,11833,985,10848,18.06%,8.32%
2020-01-01 00:14:00,14,8,13150,1209,11941,20.07%,9.19%
2020-01-01 00:14:00,14,9,1558,16,1542,2.38%,1.03%
2020-01-01 00:14:00,14,10,3875,185,3690,5.91%,4.77%
2020-01-01 00:14:00,14,11,25067,4339,20728,38.25%,17.31%
2020-01-01 00:14:00,14,12,7832,478,7354,11.95%,6.10%
2020-01-01 00:14:00,15,1,590,5,585,0.90%,0.85%
2020-01-01 00:14:00,15,2,211,0,211,0.32%,0.00%
2020-01-01 00:14:00,15,3,4309,152,4157,6.58%,3.53%
2020-01-01 00:14:00,15,4,8235,507,7728,12.57%,6.16%
2020-01-01 00:14:00,15,5,13708,1352,12356,20.92%,9.86%
2020-01-01 00:14:00,15,6,8481,540,7941,12.94%,6.37%
2020-01-01 00:14:00,15,7,4080,134,3946,6.23%,3.28%
2020-01-01 00:14:00,15,8,5718,259,5459,8.72%,4.53%
2020-01-01 00:14:00,15,9,13888,1385,12503,21.19%,9.97%
2020-01-01 00:14:00,15,10,4249,130,4119,6.48%,3.06%
2020-01-01 00:14:00,15,11,10065,750,9315,15.36%,7.45%
2020-01-01 00:14:00,15,12,29618,5975,23643,45.19%,20.17%
2020-01-01 00:14:00,16,1,397,2,395,0.61%,0.50%
2020-01-01 00:14:00,16,2,214,2,212,0.33%,0.93%
2020-01-01 00:14:00,16,3,3231,88,3143,4.93%,2.72%
2020-01-01 00:14:00,16,4,4163,154,4009,6.35%,3.70%
2020-01-01 00:14:00,16,5,9469,683,8786,14.45%,7.21%
2020-01-01 00:14:00,16,6,4946,194,4752,7.55%,3.92%
2020-01-01 00:14:00,16,7,3412,127,3285,5.21%,3.72%
2020-01-01 00:14:00,16,8,7817,563,7254,11.93%,7.20%
2020-01-01 00:14:00,16,9,9809,736,9073,14.97%,7.50%
2020-01-01 00:14:00,16,10,1884,30,1854,2.87%,1.59%
2020-01-01 00:14:00,16,11,9859,855,9004,15.04%,8.67%
2020-01-01 00:14:00,16,12,27306,5111,22195,41.67%,18.72%
2020-01-01 00:14:10,1,1,30083,5994,24089,45.90%,19.92%
2020-01-01 00:14:10,1,2,16621,1957,14664,25.36%,11.77%
2020-01-01 00:14:10,1,3,763,3,760,1.16%,0.39%
2020-01-01 00:14:10,1,4,13198,1360,11838,20.14%,10.30%
2020-01-01 00:14:10,1,5,12765,1266,11499,19.48%,9.92%
2020-01-01 00:14:10,1,6,12699,1249,11450,19.38%,9.84%
2020-01-01 00:14:10,1,7,15831,1796,14035,24.16%,11.34%
2020-01-01 00:14:10,1,8,14998,1627,13371,22.89%,10.85%
2020-01-01 00:14:10,1,9,12670,1244,11426,19.33%,9.82%
2020-01-01 00:14:10,1,10,14366,1504,12862,21.92%,10.47%
2020-01-01 00:14:10,1,11,14447,1516,12931,22.04%,10.49%
2020-01-01 00:14:10,1,12,12607,1235,11372,19.24%,9.80%
2020-01-01 00:14:10,2,1,835,5,830,1.27%,0.60%
2020-01-01 00:14:10,2,2,23944,3827,20117,36.54%,15.98%
2020-01-01 00:14:10,2,3,17708,2177,15531,27.02%,12.29%
2020-01-01 00:14:10,2,4,783,5,778,1.19%,0.64%
2020-01-01 00:14:10,2,5,11400,975,10425,17.40%,8.55%
2020-01-01 00:14:10,2,6,31,0,31,0.05%,0.00%
2020-01-01 00:14:10,2,7,5389,182,5207,8.22%,3.38%
2020-01-01 00:14:10,2,8,4323,122,4201,6.60%,2.82%
2020-01-01 00:14:10,2,9,11260,958,10302,17.18%,8.51%
2020-01-01 00:14:10,2,10,3524,75,3449,5.38%,2.13%
2020-01-01 00:14:10,2,11,3528,75,3453,5.38%,2.13%
2020-01-01 00:14:10,2,12,11090,938,10152,16.92%,8.46%
2020-01-01 00:14:10,3,1,1666,21,1645,2.54%,1.26%
2020-01-01 00:14:10,3,2,24311,4022,20289,37.10%,16.54%
2020-01-01 00:14:10,3,3,78067,32473,45594,119.12%,41.60%
2020-01-01 00:14:10,3,4,8831,580,8251,13.48%,6.57%
2020-01-01 00:14:10,3,5,51532,15903,35629,78.63%,30.86%
2020-01-01 00:14:10,3,6,10067,769,9298,15.36%,7.64%
2020-01-01 00:14:10,3,7,20864,2988,17876,31.84%,14.32%
2020-01-01 00:14:10,3,8,17205,2039,15166,26.25%,11.85%
2020-01-01 00:14:10,3,9,41106,10557,30549,62.72%,25.68%
2020-01-01 00:14:10,3,10,4667,158,4509,7.12%,3.39%
2020-01-01 00:14:10,3,11,2194,42,2152,3.35%,1.91%
2020-01-01 00:14:10,3,12,35056,7964,27092,53.49%,22.72%
2020-01-01 00:14:10,4,1,398,2,396,0.61%,0.50%
2020-01-01 00:14:10,4,2,215,2,213,0.33%,0.93%
2020-01-01 00:14:10,4,3,1127,7,1120,1.72%,0.62%
2020-01-01 00:14:10,4,4,27107,4875,22232,41.36%,17.98%
2020-01-01 00:14:10,4,5,17406,2133,15273,26.56%,12.25%
2020-01-01 00:14:10,4,6,23430,3684,19746,35.75%,15.72%
2020-01-01 00:14:10,4,7,4776,185,4591,7.29%,3.87%
2020-01-01 00:14:10,4,8,3253,92,3161,4.96%,2.83%
2020-01-01 00:14:10,4,9,15142,1621,13521,23.10%,10.71%
2020-01-01 00:14:10,4,10,1748,20,1728,2.67%,1.14%
2020-01-01 00:14:10,4,11,143,0,143,0.22%,0.00%
2020-01-01 00:14:10,4,12,12710,1161,11549,19.39%,9.13%
2020-01-01 00:14:10,5,1,2893,60,2833,4.41%,2.07%
2020-01-01 00:14:10,5,2,790,7,783,1.21%,0.89%
2020-01-01 00:14:10,5,3,437,1,436,0.67%,0.23%
2020-01-01 00:14:10,5,4,23266,3656,19610,35.50%,15.71%
2020-01-01 00:14:10,5,5,10366,798,9568,15.82%,7.70%
2020-01-01 00:14:10,5,6,15552,1736,13816,23.73%,11.16%
2020-01-01 00:14:10,5,7,4617,180,4437,7.04%,3.90%
2020-01-01 00:14:10,5,8,3601,120,3481,5.49%,3.33%
2020-01-01 00:14:10,5,9,9733,697,9036,14.85%,7.16%
2020-01-01 00:14:10,5,10,1172,7,1165,1.79%,0.60%
2020-01-01 00:14:10,5,11,1044,15,1029,1.59%,1.44%
2020-01-01 00:14:10,5,12,7897,445,7452,12.05%,5.64%
2020-01-01 00:14:10,6,1,1032,11,1021,1.57%,1.07%
2020-01-01 00:14:10,6,2,1181,13,1168,1.80%,1.10%
2020-01-01 00:14:10,6,3,1568,16,1552,2.39%,1.02%
2020-01-01 00:14:10,6,4,1042,27,1015,1.59%,2.59%
2020-01-01 00:14:10,6,5,15986,1792,14194,24.39%,11.21%
2020-01-01 00:14:10,6,6,3698,123,3575,5.64%,3.33%
2020-01-01 00:14:10,6,7,2141,29,2112,3.27%,1.35%
2020-01-01 00:14:10,6,8,1495,21,1474,2.28%,1.40%
2020-01-01 00:14:10,6,9,10414,822,9592,15.89%,7.89%
2020-01-01 00:14:10,6,10,2948,71,2877,4.50%,2.41%
2020-01-01 00:14:10,6,11,426,1,425,0.65%,0.23%
2020-01-01 00:14:10,6,12,7388,411,6977,11.27%,5.56%
2020-01-01 00:14:10,7,1,339,2,337,0.52%,0.59%
2020-01-01 00:14:10,7,2,72,0,72,0.11%,0.00%
2020-01-01 00:14:10,7,3,1379,9,1370,2.10%,0.65%
2020-01-01 00:14:10,7,4,1666,23,1643,2.54%,1.38%
2020-01-01 00:14:10,7,5,6809,425,6384,10.39%,6.24%
2020-01-01 00:14:10,7,6,12130,1094,11036,18.51%,9.02%
2020-01-01 00:14:10,7,7,3629,102,3527,5.54%,2.81%
2020-01-01 00:14:10,7,8,1442,18,1424,2.20%,1.25%
2020-01-01 00:14:10,7,9,5387,310,5077,8.22%,5.75%
2020-01-01 00:14:10,7,10,1530,20,1510,2.33%,1.31%
2020-01-01 00:14:10,7,11,136,2,134,0.21%,1.47%
2020-01-01 00:14:10,7,12,3859,123,3736,5.89%,3.19%
2020-01-01 00:14:10,8,1,387,6,381,0.59%,1.55%
2020-01-01 00:14:10,8,2,59,0,59,0.09%,0.00%
2020-01-01 00:14:10,8,3,1423,15,1408,2.17%,1.05%
2020-01-01 00:14:10,8,4,2502,44,2458,3.82%,1.76%
2020-01-01 00:14:10,8,5,7950,481,7469,12.13%,6.05%
2020-01-01 00:14:10,8,6,16339,1850,14489,24.93%,11.32%
2020-01-01 00:14:10,8,7,5703,238,5465,8.70%,4.17%
2020-01-01 00:14:10,8,8,2440,38,2402,3.72%,1.56%
2020-01-01 00:14:10,8,9,6162,287,5875,9.40%,4.66%
2020-01-01 00:14:10,8,10,1825,20,1805,2.78%,1.10%
2020-01-01 00:14:10,8,11,372,1,371,0.57%,0.27%
2020-01-01 00:14:10,8,12,4289,143,4146,6.54%,3.33%
2020-01-01 00:14:10,9,1,215,0,215,0.33%,0.00%
2020-01-01 00:14:10,9,2,2129,29,2100,3.25%,1.36%
2020-01-01 00:14:10,9,3,1450,10,1440,2.21%,0.69%
2020-01-01 00:14:10,9,4,4622,164,4458,7.05%,3.55%
2020-01-01 00:14:10,9,5,194,1,193,0.30%,0.52%
2020-01-01 00:14:10,9,6,5533,224,5309,8.44%,4.05%
2020-01-01 00:14:10,9,7,22756,3635,19121,34.72%,15.97%
2020-01-01 00:14:10,9,8,9787,762,9025,14.93%,7.79%
2020-01-01 00:14:10,9,9,165,0,165,0.25%,0.00%
2020-01-01 00:14:10,9,10,2874,126,2748,4.39%,4.38%
2020-01-01 00:14:10,9,11,8798,621,8177,13.42%,7.06%
2020-01-01 00:14:10,9,12,5631,240,5391,8.59%,4.26%
2020-01-01 00:14:10,10,1,1258,329,929,1.92%,26.15%
2020-01-01 00:14:10,10,2,2991,385,2606,4.56%,12.87%
2020-01-01 00:14:10,10,3,1593,28,1565,2.43%,1.76%
2020-01-01 00:14:10,10,4,4631,1066,3565,7.07%,23.02%
2020-01-01 00:14:10,10,5,641,2,639,0.98%,0.31%
2020-01-01 00:14:10,10,6,6277,1162,5115,9.58%,18.51%
2020-01-01 00:14:10,10,7,10988,1979,9009,16.77%,18.01%
2020-01-01 00:14:10,10,8,28355,6895,21460,43.27%,24.32%
2020-01-01 00:14:10,10,9,1376,17,1359,2.10%,1.24%
2020-01-01 00:14:10,10,10,3227,81,3146,4.92%,2.51%
2020-01-01 00:14:10,10,11,13963,1813,12150,21.31%,12.98%
2020-01-01 00:14:10,10,12,10298,1207,9091,15.71%,11.72%
2020-01-01 00:14:10,11,1,2568,68,2500,3.92%,2.65%
2020-01-01 00:14:10,11,2,3691,123,3568,5.63%,3.33%
2020-01-01 00:14:10,11,3,968,9,959,1.48%,0.93%
2020-01-01 00:14:10,11,4,3476,123,3353,5.30%,3.54%
2020-01-01 00:14:10,11,5,209,0,209,0.32%,0.00%
2020-01-01 00:14:10,11,6,4374,174,4200,6.67%,3.98%
2020-01-01 00:14:10,11,7,10176,821,9355,15.53%,8.07%
2020-01-01 00:14:10,11,8,23332,3792,19540,35.60%,16.25%
2020-01-01 00:14:10,11,9,181,0,181,0.28%,0.00%
2020-01-01 00:14:10,11,10,3183,63,3120,4.86%,1.98%
2020-01-01 00:14:10,11,11,9593,657,8936,14.64%,6.85%
2020-01-01 00:14:10,11,12,6182,308,5874,9.43%,4.98%
2020-01-01 00:14:10,12,1,77,0,77,0.12%,0.00%
2020-01-01 00:14:10,12,2,725,268,457,1.11%,36.97%
2020-01-01 00:14:10,12,3,3560,350,3210,5.43%,9.83%
2020-01-01 00:14:10,12,4,3554,83,3471,5.42%,2.34%
2020-01-01 00:14:10,12,5,10153,974,9179,15.49%,9.59%
2020-01-01 00:14:10,12,6,5960,270,5690,9.09%,4.53%
2020-01-01 00:14:10,12,7,2303,44,2259,3.51%,1.91%
2020-01-01 00:14:10,12,8,1056,290,766,1.61%,27.46%
2020-01-01 00:14:10,12,9,22601,4575,18026,34.49%,20.24%
2020-01-01 00:14:10,12,10,3906,381,3525,5.96%,9.75%
2020-01-01 00:14:10,12,11,1461,294,1167,2.23%,20.12%
2020-01-01 00:14:10,12,12,7428,1074,6354,11.33%,14.46%
2020-01-01 00:14:10,13,1,1987,34,1953,3.03%,1.71%
2020-01-01 00:14:10,13,2,2570,47,2523,3.92%,1.83%
2020-01-01 00:14:10,13,3,832,6,826,1.27%,0.72%
2020-01-01 00:14:10,13,4,4738,548,4190,7.23%,11.57%
2020-01-01 00:14:10,13,5,6947,865,6082,10.60%,12.45%
2020-01-01 00:14:10,13,6,5379,599,4780,8.21%,11.14%
2020-01-01 00:14:10,13,7,5092,183,4909,7.77%,3.59%
2020-01-01 00:14:10,13,8,6773,339,6434,10.33%,5.01%
2020-01-01 00:14:10,13,9,7174,884,6290,10.95%,12.32%
2020-01-01 00:14:10,13,10,25950,5152,20798,39.60%,19.85%
2020-01-01 00:14:10,13,11,16370,2139,14231,24.98%,13.07%
2020-01-01 00:14:10,13,12,9145,879,8266,13.95%,9.61%
2020-01-01 00:14:10,14,1,499,1,498,0.76%,0.20%
2020-01-01 00:14:10,14,2,2266,48,2218,3.46%,2.12%
2020-01-01 00:14:10,14,3,1185,18,1167,1.81%,1.52%
2020-01-01 00:14:10,14,4,4525,167,4358,6.90%,3.69%
2020-01-01 00:14:10,14,5,1220,11,1209,1.86%,0.90%
2020-01-01 00:14:10,14,6,4910,191,4719,7.49%,3.89%
2020-01-01 00:14:10,14,7,12350,1106,11244,18.84%,8.96%
2020-01-01 00:14:10,14,8,13949,1414,12535,21.28%,10.14%
2020-01-01 00:14:10,14,9,1681,18,1663,2.57%,1.07%
2020-01-01 00:14:10,14,10,4194,142,4052,6.40%,3.39%
2020-01-01 00:14:10,14,11,25446,4342,21104,38.83%,17.06%
2020-01-01 00:14:10,14,12,7112,362,6750,10.85%,5.09%
2020-01-01 00:14:10,15,1,421,4,417,0.64%,0.95%
2020-01-01 00:14:10,15,2,130,0,130,0.20%,0.00%
2020-01-01 00:14:10,15,3,3963,133,3830,6.05%,3.36%
2020-01-01 00:14:10,15,4,6279,277,6002,9.58%,4.41%
2020-01-01 00:14:10,15,5,10965,873,10092,16.73%,7.96%
2020-01-01 00:14:10,15,6,6423,291,6132,9.80%,4.53%
2020-01-01 00:14:10,15,7,3709,111,3598,5.66%,2.99%
2020-01-01 00:14:10,15,8,6609,332,6277,10.08%,5.02%
2020-01-01 00:14:10,15,9,11096,895,10201,16.93%,8.07%
2020-01-01 00:14:10,15,10,3835,122,3713,5.85%,3.18%
2020-01-01 00:14:10,15,11,10691,863,9828,16.31%,8.07%
2020-01-01 00:14:10,15,12,26588,4989,21599,40.57%,18.76%
2020-01-01 00:14:10,16,1,456,2,454,0.70%,0.44%
2020-01-01 00:14:10,16,2,291,0,291,0.44%,0.00%
2020-01-01 00:14:10,16,3,3983,116,3867,6.08%,2.91%
2020-01-01 00:14:10,16,4,3983,107,3876,6.08%,2.69%
2020-01-01 00:14:10,16,5,10134,821,9313,15.46%,8.10%
2020-01-01 00:14:10,16,6,4767,160,4607,7.27%,3.36%
2020-01-01 00:14:10,16,7,2979,73,2906,4.55%,2.45%
2020-01-01 00:14:10,16,8,6832,374,6458,10.42%,5.47%
2020-01-01 00:14:10,16,9,10605,883,9722,16.18%,8.33%
2020-01-01 00:14:10,16,10,1371,16,1355,2.09%,1.17%
2020-01-01 00:14:10,16,11,8599,590,8009,13.12%,6.86%
2020-01-01 00:14:10,16,12,28004,5372,22632,42.73%,19.18%
2020-01-01 00:14:20,1,1,22239,3432,18807,33.93%,15.43%
2020-01-01 00:14:20,1,2,7031,392,6639,10.73%,5.58%
2020-01-01 00:14:20,1,3,902,2,900,1.38%,0.22%
2020-01-01 00:14:20,1,4,14857,1614,13243,22.67%,10.86%
2020-01-01 00:14:20,1,5,14364,1495,12869,21.92%,10.41%
2020-01-01 00:14:20,1,6,14375,1499,12876,21.93%,10.43%
2020-01-01 00:14:20,1,7,6118,308,5810,9.34%,5.03%
2020-01-01 00:14:20,1,8,4652,178,4474,7.10%,3.83%
2020-01-01 00:14:20,1,9,14319,1485,12834,21.85%,10.37%
2020-01-01 00:14:20,1,10,3720,98,3622,5.68%,2.63%
2020-01-01 00:14:20,1,11,3834,110,3724,5.85%,2.87%
2020-01-01 00:14:20,1,12,14302,1482,12820,21.82%,10.36%
2020-01-01 00:14:20,2,1,1686,16,1670,2.57%,0.95%
2020-01-01 00:14:20,2,2,27376,5040,22336,41.77%,18.41%
2020-01-01 00:14:20,2,3,21727,3304,18423,33.15%,15.21%
2020-01-01 00:14:20,2,4,1586,9,1577,2.42%,0.57%
2020-01-01 00:14:20,2,5,13506,1281,12225,20.61%,9.48%
2020-01-01 00:14:20,2,6,17,1,16,0.03%,5.88%
2020-01-01 00:14:20,2,7,3942,106,3836,6.02%,2.69%
2020-01-01 00:14:20,2,8,2876,56,2820,4.39%,1.95%
2020-01-01 00:14:20,2,9,13104,1208,11896,20.00%,9.22%
2020-01-01 00:14:20,2,10,2199,35,2164,3.36%,1.59%
2020-01-01 00:14:20,2,11,2212,35,2177,3.38%,1.58%
2020-01-01 00:14:20,2,12,12863,1180,11683,19.63%,9.17%
2020-01-01 00:14:20,3,1,1448,19,1429,2.21%,1.31%
2020-01-01 00:14:20,3,2,23481,3751,19730,35.83%,15.97%
2020-01-01 00:14:20,3,3,71275,27960,43315,108.76%,39.23%
2020-01-01 00:14:20,3,4,6126,249,5877,9.35%,4.06%
2020-01-01 00:14:20,3,5,46028,12949,33079,70.23%,28.13%
2020-01-01 00:14:20,3,6,7355,376,6979,11.22%,5.11%
2020-01-01 00:14:20,3,7,20373,2841,17532,31.09%,13.94%
2020-01-01 00:14:20,3,8,17613,2126,15487,26.88%,12.07%
2020-01-01 00:14:20,3,9,38395,9372,29023,58.59%,24.41%
2020-01-01 00:14:20,3,10,5485,206,5279,8.37%,3.76%
2020-01-01 00:14:20,3,11,2556,36,2520,3.90%,1.41%
2020-01-01 00:14:20,3,12,30660,6211,24449,46.78%,20.26%
2020-01-01 00:14:20,4,1,409,0,409,0.62%,0.00%
2020-01-01 00:14:20,4,2,186,0,186,0.28%,0.00%
2020-01-01 00:14:20,4,3,960,8,952,1.46%,0.83%
2020-01-01 00:14:20,4,4,27832,5095,22737,42.47%,18.31%
2020-01-01 00:14:20,4,5,18140,2192,15948,27.68%,12.08%
2020-01-01 00:14:20,4,6,23661,3690,19971,36.10%,15.60%
2020-01-01 00:14:20,4,7,4248,124,4124,6.48%,2.92%
2020-01-01 00:14:20,4,8,2792,56,2736,4.26%,2.01%
2020-01-01 00:14:20,4,9,15955,1716,14239,24.35%,10.76%
2020-01-01 00:14:20,4,10,1992,25,1967,3.04%,1.26%
2020-01-01 00:14:20,4,11,146,0,146,0.22%,0.00%
2020-01-01 00:14:20,4,12,13213,1186,12027,20.16%,8.98%
2020-01-01 00:14:20,5,1,2494,48,2446,3.81%,1.92%
2020-01-01 00:14:20,5,2,937,9,928,1.43%,0.96%
2020-01-01 00:14:20,5,3,568,3,565,0.87%,0.53%
2020-01-01 00:14:20,5,4,31963,6617,25346,48.77%,20.70%
2020-01-01 00:14:20,5,5,9567,695,8872,14.60%,7.26%
2020-01-01 00:14:20,5,6,24531,4046,20485,37.43%,16.49%
2020-01-01 00:14:20,5,7,14295,1505,12790,21.81%,10.53%
2020-01-01 00:14:20,5,8,3758,120,3638,5.73%,3.19%
2020-01-01 00:14:20,5,9,8861,608,8253,13.52%,6.86%
2020-01-01 00:14:20,5,10,1100,13,1087,1.68%,1.18%
2020-01-01 00:14:20,5,11,1010,12,998,1.54%,1.19%
2020-01-01 00:14:20,5,12,7377,429,6948,11.26%,5.82%
2020-01-01 00:14:20,6,1,949,10,939,1.45%,1.05%
2020-01-01 00:14:20,6,2,1066,12,1054,1.63%,1.13%
2020-01-01 00:14:20,6,3,1425,16,1409,2.17%,1.12%
2020-01-01 00:14:20,6,4,1418,25,1393,2.16%,1.76%
2020-01-01 00:14:20,6,5,16992,1950,15042,25.93%,11.48%
2020-01-01 00:14:20,6,6,4815,168,4647,7.35%,3.49%
2020-01-01 00:14:20,6,7,2863,61,2802,4.37%,2.13%
2020-01-01 00:14:20,6,8,2036,27,2009,3.11%,1.33%
2020-01-01 00:14:20,6,9,10413,782,9631,15.89%,7.51%
2020-01-01 00:14:20,6,10,2092,34,2058,3.19%,1.63%
2020-01-01 00:14:20,6,11,399,0,399,0.61%,0.00%
2020-01-01 00:14:20,6,12,8244,497,7747,12.58%,6.03%
2020-01-01 00:14:20,7,1,525,2,523,0.80%,0.38%
2020-01-01 00:14:20,7,2,96,0,96,0.15%,0.00%
2020-01-01 00:14:20,7,3,1032,9,1023,1.57%,0.87%
2020-01-01 00:14:20,7,4,2509,53,2456,3.83%,2.11%
2020-01-01 00:14:20,7,5,6611,269,6342,10.09%,4.07%
2020-01-01 00:14:20,7,6,12469,1039,11430,19.03%,8.33%
2020-01-01 00:14:20,7,7,3319,82,3237,5.06%,2.47%
2020-01-01 00:14:20,7,8,1140,13,1127,1.74%,1.14%
2020-01-01 00:14:20,7,9,5488,186,5302,8.37%,3.39%
2020-01-01 00:14:20,7,10,841,0,841,1.28%,0.00%
2020-01-01 00:14:20,7,11,140,0,140,0.21%,0.00%
2020-01-01 00:14:20,7,12,4665,138,4527,7.12%,2.96%
2020-01-01 00:14:20,8,1,417,2,415,0.64%,0.48%
2020-01-01 00:14:20,8,2,69,0,69,0.11%,0.00%
2020-01-01 00:14:20,8,3,1430,21,1409,2.18%,1.47%
2020-01-01 00:14:20,8,4,3003,68,2935,4.58%,2.26%
2020-01-01 00:14:20,8,5,8069,497,7572,12.31%,6.16%
2020-01-01 00:14:20,8,6,15854,1822,14032,24.19%,11.49%
2020-01-01 00:14:20,8,7,4717,174,4543,7.20%,3.69%
2020-01-01 00:14:20,8,8,1946,46,1900,2.97%,2.36%
2020-01-01 00:14:20,8,9,6350,300,6050,9.69%,4.72%
2020-01-01 00:14:20,8,10,1736,23,1713,2.65%,1.32%
2020-01-01 00:14:20,8,11,343,0,343,0.52%,0.00%
2020-01-01 00:14:20,8,12,4565,145,4420,6.97%,3.18%
2020-01-01 00:14:20,9,1,220,3,217,0.34%,1.36%
2020-01-01 00:14:20,9,2,3327,100,3227,5.08%,3.01%
2020-01-01 00:14:20,9,3,2589,58,2531,3.95%,2.24%
2020-01-01 00:14:20,9,4,8130,485,7645,12.41%,5.97%
2020-01-01 00:14:20,9,5,171,1,170,0.26%,0.58%
2020-01-01 00:14:20,9,6,8581,541,8040,13.09%,6.30%
2020-01-01 00:14:20,9,7,28955,5671,23284,44.18%,19.59%
2020-01-01 00:14:20,9,8,11439,999,10440,17.45%,8.73%
2020-01-01 00:14:20,9,9,135,1,134,0.21%,0.74%
2020-01-01 00:14:20,9,10,3855,143,3712,5.88%,3.71%
2020-01-01 00:14:20,9,11,9249,649,8600,14.11%,7.02%
2020-01-01 00:14:20,9,12,5120,197,4923,7.81%,3.85%
2020-01-01 00:14:20,10,1,1172,434,738,1.79%,37.03%
2020-01-01 00:14:20,10,2,2463,456,2007,3.76%,18.51%
2020-01-01 00:14:20,10,3,1147,9,1138,1.75%,0.78%
2020-01-01 00:14:20,10,4,4454,993,3461,6.80%,22.29%
2020-01-01 00:14:20,10,5,552,4,548,0.84%,0.72%
2020-01-01 00:14:20,10,6,6287,1109,5178,9.59%,17.64%
2020-01-01 00:14:20,10,7,10483,1932,8551,16.00%,18.43%
2020-01-01 00:14:20,10,8,25724,6349,19375,39.25%,24.68%
2020-01-01 00:14:20,10,9,644,4,640,0.98%,0.62%
2020-01-01 00:14:20,10,10,2378,60,2318,3.63%,2.52%
2020-01-01 00:14:20,10,11,11980,1433,10547,18.28%,11.96%
2020-01-01 00:14:20,10,12,9082,992,8090,13.86%,10.92%
2020-01-01 00:14:20,11,1,2684,64,2620,4.10%,2.38%
2020-01-01 00:14:20,11,2,5637,229,5408,8.60%,4.06%
2020-01-01 00:14:20,11,3,2843,45,2798,4.34%,1.58%
2020-01-01 00:14:20,11,4,3313,91,3222,5.06%,2.75%
2020-01-01 00:14:20,11,5,579,4,575,0.88%,0.69%
2020-01-01 00:14:20,11,6,4526,184,4342,6.91%,4.07%
2020-01-01 00:14:20,11,7,12421,1148,11273,18.95%,9.24%
2020-01-01 00:14:20,11,8,27525,5080,22445,42.00%,18.46%
2020-01-01 00:14:20,11,9,290,3,287,0.44%,1.03%
2020-01-01 00:14:20,11,10,3473,93,3380,5.30%,2.68%
2020-01-01 00:14:20,11,11,11004,932,10072,16.79%,8.47%
2020-01-01 00:14:20,11,12,7355,422,6933,11.22%,5.74%
2020-01-01 00:14:20,12,1,27,0,27,0.04%,0.00%
2020-01-01 00:14:20,12,2,725,267,458,1.11%,36.83%
2020-01-01 00:14:20,12,3,2909,316,2593,4.44%,10.86%
2020-01-01 00:14:20,12,4,3283,109,3174,5.01%,3.32%
2020-01-01 00:14:20,12,5,9568,953,8615,14.60%,9.96%
2020-01-01 00:14:20,12,6,5801,256,5545,8.85%,4.41%
2020-01-01 00:14:20,12,7,2393,37,2356,3.65%,1.55%
2020-01-01 00:14:20,12,8,945,197,748,1.44%,20.85%
2020-01-01 00:14:20,12,9,21017,3951,17066,32.07%,18.80%
2020-01-01 00:14:20,12,10,3736,279,3457,5.70%,7.47%
2020-01-01 00:14:20,12,11,1195,198,997,1.82%,16.57%
2020-01-01 00:14:20,12,12,7128,790,6338,10.88%,11.08%
2020-01-01 00:14:20,13,1,1973,35,1938,3.01%,1.77%
2020-01-01 00:14:20,13,2,2222,45,2177,3.39%,2.03%
2020-01-01 00:14:20,13,3,1053,5,1048,1.61%,0.47%
2020-01-01 00:14:20,13,4,5054,429,4625,7.71%,8.49%
2020-01-01 00:14:20,13,5,7617,766,6851,11.62%,10.06%
2020-01-01 00:14:20,13,6,5592,465,5127,8.53%,8.32%
2020-01-01 00:14:20,13,7,4282,138,4144,6.53%,3.22%
2020-01-01 00:14:20,13,8,5827,258,5569,8.89%,4.43%
2020-01-01 00:14:20,13,9,7852,784,7068,11.98%,9.98%
2020-01-01 00:14:20,13,10,24968,4771,20197,38.10%,19.11%
2020-01-01 00:14:20,13,11,14568,1873,12695,22.23%,12.86%
2020-01-01 00:14:20,13,12,8265,860,7405,12.61%,10.41%
2020-01-01 00:14:20,14,1,651,1,650,0.99%,0.15%
2020-01-01 00:14:20,14,2,2439,42,2397,3.72%,1.72%
2020-01-01 00:14:20,14,3,1592,23,1569,2.43%,1.44%
2020-01-01 00:14:20,14,4,4248,165,4083,6.48%,3.88%
2020-01-01 00:14:20,14,5,1388,17,1371,2.12%,1.22%
2020-01-01 00:14:20,14,6,4649,185,4464,7.09%,3.98%
2020-01-01 00:14:20,14,7,12278,1102,11176,18.73%,8.98%
2020-01-01 00:14:20,14,8,13509,1328,12181,20.61%,9.83%
2020-01-01 00:14:20,14,9,1677,23,1654,2.56%,1.37%
2020-01-01 00:14:20,14,10,4323,137,4186,6.60%,3.17%
2020-01-01 00:14:20,14,11,24318,4007,20311,37.11%,16.48%
2020-01-01 00:14:20,14,12,6264,288,5976,9.56%,4.60%
2020-01-01 00:14:20,15,1,412,1,411,0.63%,0.24%
2020-01-01 00:14:20,15,2,165,2,163,0.25%,1.21%
2020-01-01 00:14:20,15,3,3707,127,3580,5.66%,3.43%
2020-01-01 00:14:20,15,4,4372,126,4246,6.67%,2.88%
2020-01-01 00:14:20,15,5,9227,630,8597,14.08%,6.83%
2020-01-01 00:14:20,15,6,4578,135,4443,6.99%,2.95%
2020-01-01 00:14:20,15,7,3556,110,3446,5.43%,3.09%
2020-01-01 00:14:20,15,8,5176,221,4955,7.90%,4.27%
2020-01-01 00:14:20,15,9,9394,655,8739,14.33%,6.97%
2020-01-01 00:14:20,15,10,4011,134,3877,6.12%,3.34%
2020-01-01 00:14:20,15,11,9287,661,8626,14.17%,7.12%
2020-01-01 00:14:20,15,12,24486,4315,20171,37.36%,17.62%
2020-01-01 00:14:20,16,1,386,0,386,0.59%,0.00%
2020-01-01 00:14:20,16,2,199,1,198,0.30%,0.50%
2020-01-01 00:14:20,16,3,1365,15,1350,2.08%,1.10%
2020-01-01 00:14:20,16,4,4577,159,4418,6.98%,3.47%
2020-01-01 00:14:20,16,5,7962,573,7389,12.15%,7.20%
2020-01-01 00:14:20,16,6,5315,212,5103,8.11%,3.99%
2020-01-01 00:14:20,16,7,2952,55,2897,4.50%,1.86%
2020-01-01 00:14:20,16,8,6625,296,6329,10.11%,4.47%
2020-01-01 00:14:20,16,9,8400,627,7773,12.82%,7.46%
2020-01-01 00:14:20,16,10,2976,59,2917,4.54%,1.98%
2020-01-01 00:14:20,16,11,9760,637,9123,14.89%,6.53%
2020-01-01 00:14:20,16,12,26946,5008,21938,41.12%,18.59%
2020-01-01 00:14:30,1,1,16765,2064,14701,25.58%,12.31%
2020-01-01 00:14:30,1,2,5306,240,5066,8.10%,4.52%
2020-01-01 00:14:30,1,3,514,4,510,0.78%,0.78%
2020-01-01 00:14:30,1,4,11130,938,10192,16.98%,8.43%
2020-01-01 00:14:30,1,5,10871,901,9970,16.59%,8.29%
2020-01-01 00:14:30,1,6,10809,887,9922,16.49%,8.21%
2020-01-01 00:14:30,1,7,4784,191,4593,7.30%,3.99%
2020-01-01 00:14:30,1,8,3957,122,3835,6.04%,3.08%
2020-01-01 00:14:30,1,9,10782,884,9898,16.45%,8.20%
2020-01-01 00:14:30,1,10,3449,92,3357,5.26%,2.67%
2020-01-01 00:14:30,1,11,3490,94,3396,5.33%,2.69%
2020-01-01 00:14:30,1,12,10763,881,9882,16.42%,8.19%
2020-01-01 00:14:30,2,1,1019,7,1012,1.55%,0.69%
2020-01-01 00:14:30,2,2,26137,4585,21552,39.88%,17.54%
2020-01-01 00:14:30,2,3,20369,2860,17509,31.08%,14.04%
2020-01-01 00:14:30,2,4,903,6,897,1.38%,0.66%
2020-01-01 00:14:30,2,5,13620,1324,12296,20.78%,9.72%
2020-01-01 00:14:30,2,6,26,0,26,0.04%,0.00%
2020-01-01 00:14:30,2,7,4734,184,4550,7.22%,3.89%
2020-01-01 00:14:30,2,8,3576,103,3473,5.46%,2.88%
2020-01-01 00:14:30,2,9,13515,1301,12214,20.62%,9.63%
2020-01-01 00:14:30,2,10,2707,59,2648,4.13%,2.18%
2020-01-01 00:14:30,2,11,2730,60,2670,4.17%,2.20%
2020-01-01 00:14:30,2,12,13330,1269,12061,20.34%,9.52%
2020-01-01 00:14:30,3,1,1341,5,1336,2.05%,0.37%
2020-01-01 00:14:30,3,2,21271,3144,18127,32.46%,14.78%
2020-01-01 00:14:30,3,3,70917,27638,43279,108.21%,38.97%
2020-01-01 00:14:30,3,4,13984,1423,12561,21.34%,10.18%
2020-01-01 00:14:30,3,5,46319,13123,33196,70.68%,28.33%
2020-01-01 00:14:30,3,6,16036,1838,14198,24.47%,11.46%
2020-01-01 00:14:30,3,7,17640,2208,15432,26.92%,12.52%
2020-01-01 00:14:30,3,8,14876,1577,13299,22.70%,10.60%
2020-01-01 00:14:30,3,9,29916,5881,24035,45.65%,19.66%
2020-01-01 00:14:30,3,10,5332,216,5116,8.14%,4.05%
2020-01-01 00:14:30,3,11,1914,24,1890,2.92%,1.25%
2020-01-01 00:14:30,3,12,21037,3000,18037,32.10%,14.26%
2020-01-01 00:14:30,4,1,558,1,557,0.85%,0.18%
2020-01-01 00:14:30,4,2,327,1,326,0.50%,0.31%
2020-01-01 00:14:30,4,3,829,6,823,1.26%,0.72%
2020-01-01 00:14:30,4,4,28174,5332,22842,42.99%,18.93%
2020-01-01 00:14:30,4,5,17914,2224,15690,27.33%,12.41%
2020-01-01 00:14:30,4,6,23970,3899,20071,36.58%,16.27%
2020-01-01 00:14:30,4,7,4817,153,4664,7.35%,3.18%
2020-01-01 00:14:30,4,8,2631,45,2586,4.01%,1.71%
2020-01-01 00:14:30,4,9,15703,1697,14006,23.96%,10.81%
2020-01-01 00:14:30,4,10,2335,57,2278,3.56%,2.44%
2020-01-01 00:14:30,4,11,138,0,138,0.21%,0.00%
2020-01-01 00:14:30,4,12,12642,1121,11521,19.29%,8.87%
2020-01-01 00:14:30,5,1,3006,69,2937,4.59%,2.30%
2020-01-01 00:14:30,5,2,1427,18,1409,2.18%,1.26%
2020-01-01 00:14:30,5,3,650,3,647,0.99%,0.46%
2020-01-01 00:14:30,5,4,25909,4545,21364,39.53%,17.54%
2020-01-01 00:14:30,5,5,9757,723,9034,14.89%,7.41%
2020-01-01 00:14:30,5,6,16231,1895,14336,24.77%,11.68%
2020-01-01 00:14:30,5,7,6052,281,5771,9.23%,4.64%
2020-01-01 00:14:30,5,8,4327,127,4200,6.60%,2.94%
2020-01-01 00:14:30,5,9,8985,617,8368,13.71%,6.87%
2020-01-01 00:14:30,5,10,792,10,782,1.21%,1.26%
2020-01-01 00:14:30,5,11,701,8,693,1.07%,1.14%
2020-01-01 00:14:30,5,12,7964,472,7492,12.15%,5.93%
2020-01-01 00:14:30,6,1,1103,10,1093,1.68%,0.91%
2020-01-01 00:14:30,6,2,1172,10,1162,1.79%,0.85%
2020-01-01 00:14:30,6,3,1650,18,1632,2.52%,1.09%
2020-01-01 00:14:30,6,4,1597,15,1582,2.44%,0.94%
2020-01-01 00:14:30,6,5,14467,1499,12968,22.07%,10.36%
2020-01-01 00:14:30,6,6,4625,149,4476,7.06%,3.22%
2020-01-01 00:14:30,6,7,2558,53,2505,3.90%,2.07%
2020-01-01 00:14:30,6,8,2029,34,1995,3.10%,1.68%
2020-01-01 00:14:30,6,9,7930,495,7435,12.10%,6.24%
2020-01-01 00:14:30,6,10,2538,63,2475,3.87%,2.48%
2020-01-01 00:14:30,6,11,525,2,523,0.80%,0.38%
2020-01-01 00:14:30,6,12,5315,213,5102,8.11%,4.01%
2020-01-01 00:14:30,7,1,289,10,279,0.44%,3.46%
2020-01-01 00:14:30,7,2,118,0,118,0.18%,0.00%
2020-01-01 00:14:30,7,3,1706,14,1692,2.60%,0.82%
2020-01-01 00:14:30,7,4,1645,26,1619,2.51%,1.58%
2020-01-01 00:14:30,7,5,8348,534,7814,12.74%,6.40%
2020-01-01 00:14:30,7,6,13225,1273,11952,20.18%,9.63%
2020-01-01 00:14:30,7,7,3206,79,3127,4.89%,2.46%
2020-01-01 00:14:30,7,8,1247,18,1229,1.90%,1.44%
2020-01-01 00:14:30,7,9,6597,333,6264,10.07%,5.05%
2020-01-01 00:14:30,7,10,1318,13,1305,2.01%,0.99%
2020-01-01 00:14:30,7,11,106,0,106,0.16%,0.00%
2020-01-01 00:14:30,7,12,5234,205,5029,7.99%,3.92%
2020-01-01 00:14:30,8,1,361,1,360,0.55%,0.28%
2020-01-01 00:14:30,8,2,145,0,145,0.22%,0.00%
2020-01-01 00:14:30,8,3,1474,22,1452,2.25%,1.49%
2020-01-01 00:14:30,8,4,2676,41,2635,4.08%,1.53%
2020-01-01 00:14:30,8,5,8081,460,7621,12.33%,5.69%
2020-01-01 00:14:30,8,6,16298,1865,14433,24.87%,11.44%
2020-01-01 00:14:30,8,7,5479,214,5265,8.36%,3.91%
2020-01-01 00:14:30,8,8,2018,29,1989,3.08%,1.44%
2020-01-01 00:14:30,8,9,6409,275,6134,9.78%,4.29%
2020-01-01 00:14:30,8,10,1743,22,1721,2.66%,1.26%
2020-01-01 00:14:30,8,11,181,0,181,0.28%,0.00%
2020-01-01 00:14:30,8,12,4680,142,4538,7.14%,3.03%
2020-01-01 00:14:30,9,1,2227,18,2209,3.40%,0.81%
2020-01-01 00:14:30,9,2,4451,167,4284,6.79%,3.75%
2020-01-01 00:14:30,9,3,1861,26,1835,2.84%,1.40%
2020-01-01 00:14:30,9,4,6692,324,6368,10.21%,4.84%
2020-01-01 00:14:30,9,5,127,0,127,0.19%,0.00%
2020-01-01 00:14:30,9,6,7398,398,7000,11.29%,5.38%
2020-01-01 00:14:30,9,7,30176,6035,24141,46.04%,20.00%
2020-01-01 00:14:30,9,8,10975,855,10120,16.75%,7.79%
2020-01-01 00:14:30,9,9,112,0,112,0.17%,0.00%
2020-01-01 00:14:30,9,10,1827,25,1802,2.79%,1.37%
2020-01-01 00:14:30,9,11,9351,642,8709,14.27%,6.87%
2020-01-01 00:14:30,9,12,7303,392,6911,11.14%,5.37%
2020-01-01 00:14:30,10,1,1146,181,965,1.75%,15.79%
2020-01-01 00:14:30,10,2,2820,236,2584,4.30%,8.37%
2020-01-01 00:14:30,10,3,1465,29,1436,2.24%,1.98%
2020-01-01 00:14:30,10,4,3963,781,3182,6.05%,19.71%
2020-01-01 00:14:30,10,5,560,2,558,0.85%,0.36%
2020-01-01 00:14:30,10,6,5581,868,4713,8.52%,15.55%
2020-01-01 00:14:30,10,7,10421,1529,8892,15.90%,14.67%
2020-01-01 00:14:30,10,8,28732,7040,21692,43.84%,24.50%
2020-01-01 00:14:30,10,9,422,2,420,0.64%,0.47%
2020-01-01 00:14:30,10,10,2507,48,2459,3.83%,1.91%
2020-01-01 00:14:30,10,11,14597,2077,12520,22.27%,14.23%
2020-01-01 00:14:30,10,12,11497,1520,9977,17.54%,13.22%
2020-01-01 00:14:30,11,1,2109,47,2062,3.22%,2.23%
2020-01-01 00:14:30,11,2,3322,95,3227,5.07%,2.86%
2020-01-01 00:14:30,11,3,1031,8,1023,1.57%,0.78%
2020-01-01 00:14:30,11,4,5934,362,5572,9.05%,6.10%
2020-01-01 00:14:30,11,5,221,2,219,0.34%,0.90%
2020-01-01 00:14:30,11,6,6747,434,6313,10.30%,6.43%
2020-01-01 00:14:30,11,7,12188,1145,11043,18.60%,9.39%
2020-01-01 00:14:30,11,8,25618,4490,21128,39.09%,17.53%
2020-01-01 00:14:30,11,9,284,0,284,0.43%,0.00%
2020-01-01 00:14:30,11,10,3056,60,2996,4.66%,1.96%
2020-01-01 00:14:30,11,11,9490,642,8848,14.48%,6.77%
2020-01-01 00:14:30,11,12,6018,277,5741,9.18%,4.60%
2020-01-01 00:14:30,12,1,99,0,99,0.15%,0.00%
2020-01-01 00:14:30,12,2,543,220,323,0.83%,40.52%
2020-01-01 00:14:30,12,3,2577,276,2301,3.93%,10.71%
2020-01-01 00:14:30,12,4,3272,68,3204,4.99%,2.08%
2020-01-01 00:14:30,12,5,9613,941,8672,14.67%,9.79%
2020-01-01 00:14:30,12,6,6166,342,5824,9.41%,5.55%
2020-01-01 00:14:30,12,7,2640,134,2506,4.03%,5.08%
2020-01-01 00:14:30,12,8,1718,271,1447,2.62%,15.77%
2020-01-01 00:14:30,12,9,22448,4611,17837,34.25%,20.54%
2020-01-01 00:14:30,12,10,4284,390,3894,6.54%,9.10%
2020-01-01 00:14:30,12,11,1932,274,1658,2.95%,14.18%
2020-01-01 00:14:30,12,12,8037,1233,6804,12.26%,15.34%
2020-01-01 00:14:30,13,1,2835,54,2781,4.33%,1.90%
2020-01-01 00:14:30,13,2,3070,62,3008,4.68%,2.02%
2020-01-01 00:14:30,13,3,755,5,750,1.15%,0.66%
2020-01-01 00:14:30,13,4,5399,412,4987,8.24%,7.63%
2020-01-01 00:14:30,13,5,7552,700,6852,11.52%,9.27%
2020-01-01 00:14:30,13,6,5947,451,5496,9.07%,7.58%
2020-01-01 00:14:30,13,7,5448,238,5210,8.31%,4.37%
2020-01-01 00:14:30,13,8,8016,512,7504,12.23%,6.39%
2020-01-01 00:14:30,13,9,7956,738,7218,12.14%,9.28%
2020-01-01 00:14:30,13,10,29528,6303,23225,45.06%,21.35%
2020-01-01 00:14:30,13,11,18076,2645,15431,27.58%,14.63%
2020-01-01 00:14:30,13,12,9700,1055,8645,14.80%,10.88%
2020-01-01 00:14:30,14,1,288,0,288,0.44%,0.00%
2020-01-01 00:14:30,14,2,1654,11,1643,2.52%,0.67%
2020-01-01 00:14:30,14,3,1029,2,1027,1.57%,0.19%
2020-01-01 00:14:30,14,4,5892,242,5650,8.99%,4.11%
2020-01-01 00:14:30,14,5,1795,24,1771,2.74%,1.34%
2020-01-01 00:14:30,14,6,6210,271,5939,9.48%,4.36%
2020-01-01 00:14:30,14,7,13495,1263,12232,20.59%,9.36%
2020-01-01 00:14:30,14,8,15160,1591,13569,23.13%,10.49%
2020-01-01 00:14:30,14,9,1999,31,1968,3.05%,1.55%
2020-01-01 00:14:30,14,10,4716,206,4510,7.20%,4.37%
2020-01-01 00:14:30,14,11,28289,5366,22923,43.17%,18.97%
2020-01-01 00:14:30,14,12,8296,529,7767,12.66%,6.38%
2020-01-01 00:14:30,15,1,685,3,682,1.05%,0.44%
2020-01-01 00:14:30,15,2,190,2,188,0.29%,1.05%
2020-01-01 00:14:30,15,3,4317,132,4185,6.59%,3.06%
2020-01-01 00:14:30,15,4,5351,241,5110,8.16%,4.50%
2020-01-01 00:14:30,15,5,11423,948,10475,17.43%,8.30%
2020-01-01 00:14:30,15,6,5681,264,5417,8.67%,4.65%
2020-01-01 00:14:30,15,7,4462,154,4308,6.81%,3.45%
2020-01-01 00:14:30,15,8,6182,296,5886,9.43%,4.79%
2020-01-01 00:14:30,15,9,11616,982,10634,17.72%,8.45%
2020-01-01 00:14:30,15,10,3855,120,3735,5.88%,3.11%
2020-01-01 00:14:30,15,11,10132,750,9382,15.46%,7.40%
2020-01-01 00:14:30,15,12,27828,5430,22398,42.46%,19.51%
2020-01-01 00:14:30,16,1,400,0,400,0.61%,0.00%
2020-01-01 00:14:30,16,2,213,0,213,0.33%,0.00%
2020-01-01 00:14:30,16,3,1648,26,1622,2.51%,1.58%
2020-01-01 00:14:30,16,4,3946,120,3826,6.02%,3.04%
2020-01-01 00:14:30,16,5,8095,564,7531,12.35%,6.97%
2020-01-01 00:14:30,16,6,4953,194,4759,7.56%,3.92%
2020-01-01 00:14:30,16,7,3335,105,3230,5.09%,3.15%
2020-01-01 00:14:30,16,8,7426,534,6892,11.33%,7.19%
2020-01-01 00:14:30,16,9,8424,597,7827,12.85%,7.09%
2020-01-01 00:14:30,16,10,1777,21,1756,2.71%,1.18%
2020-01-01 00:14:30,16,11,9383,766,8617,14.32%,8.16%
2020-01-01 00:14:30,16,12,25423,4459,20964,38.79%,17.54%
2020-01-01 00:14:40,1,1,28048,5369,22679,42.80%,19.14%
2020-01-01 00:14:40,1,2,13637,1372,12265,20.81%,10.06%
2020-01-01 00:14:40,1,3,301,2,299,0.46%,0.66%
2020-01-01 00:14:40,1,4,13826,1402,12424,21.10%,10.14%
2020-01-01 00:14:40,1,5,13379,1315,12064,20.41%,9.83%
2020-01-01 00:14:40,1,6,13372,1315,12057,20.40%,9.83%
2020-01-01 00:14:40,1,7,13326,1309,12017,20.33%,9.82%
2020-01-01 00:14:40,1,8,6806,325,6481,10.39%,4.78%
2020-01-01 00:14:40,1,9,13334,1306,12028,20.35%,9.79%
2020-01-01 00:14:40,1,10,5564,228,5336,8.49%,4.10%
2020-01-01 00:14:40,1,11,5725,243,5482,8.74%,4.24%
2020-01-01 00:14:40,1,12,13297,1301,11996,20.29%,9.78%
2020-01-01 00:14:40,2,1,603,1,602,0.92%,0.17%
2020-01-01 00:14:40,2,2,24970,4237,20733,38.10%,16.97%
2020-01-01 00:14:40,2,3,19901,2816,17085,30.37%,14.15%
2020-01-01 00:14:40,2,4,542,0,542,0.83%,0.00%
2020-01-01 00:14:40,2,5,11089,901,10188,16.92%,8.13%
2020-01-01 00:14:40,2,6,62,0,62,0.09%,0.00%
2020-01-01 00:14:40,2,7,4448,167,4281,6.79%,3.75%
2020-01-01 00:14:40,2,8,3031,67,2964,4.62%,2.21%
2020-01-01 00:14:40,2,9,10951,885,10066,16.71%,8.08%
2020-01-01 00:14:40,2,10,2016,32,1984,3.08%,1.59%
2020-01-01 00:14:40,2,11,2036,33,2003,3.11%,1.62%
2020-01-01 00:14:40,2,12,10786,865,9921,16.46%,8.02%
2020-01-01 00:14:40,3,1,2702,50,2652,4.12%,1.85%
2020-01-01 00:14:40,3,2,23172,3654,19518,35.36%,15.77%
2020-01-01 00:14:40,3,3,75406,30525,44881,115.06%,40.48%
2020-01-01 00:14:40,3,4,12843,1181,11662,19.60%,9.20%
2020-01-01 00:14:40,3,5,51245,15681,35564,78.19%,30.60%
2020-01-01 00:14:40,3,6,13449,1280,12169,20.52%,9.52%
2020-01-01 00:14:40,3,7,18978,2525,16453,28.96%,13.30%
2020-01-01 00:14:40,3,8,14034,1396,12638,21.41%,9.95%
2020-01-01 00:14:40,3,9,37344,8820,28524,56.98%,23.62%
2020-01-01 00:14:40,3,10,5389,210,5179,8.22%,3.90%
2020-01-01 00:14:40,3,11,1056,8,1048,1.61%,0.76%
2020-01-01 00:14:40,3,12,27183,4902,22281,41.48%,18.03%
2020-01-01 00:14:40,4,1,571,2,569,0.87%,0.35%
2020-01-01 00:14:40,4,2,393,1,392,0.60%,0.25%
2020-01-01 00:14:40,4,3,741,1,740,1.13%,0.13%
2020-01-01 00:14:40,4,4,27991,5212,22779,42.71%,18.62%
2020-01-01 00:14:40,4,5,18049,2345,15704,27.54%,12.99%
2020-01-01 00:14:40,4,6,24481,4068,20413,37.36%,16.62%
2020-01-01 00:14:40,4,7,5104,204,4900,7.79%,4.00%
2020-01-01 00:14:40,4,8,2597,54,2543,3.96%,2.08%
2020-01-01 00:14:40,4,9,16159,1894,14265,24.66%,11.72%
2020-01-01 00:14:40,4,10,2007,51,1956,3.06%,2.54%
2020-01-01 00:14:40,4,11,157,1,156,0.24%,0.64%
2020-01-01 00:14:40,4,12,12827,1223,11604,19.57%,9.53%
2020-01-01 00:14:40,5,1,2848,68,2780,4.35%,2.39%
2020-01-01 00:14:40,5,2,718,6,712,1.10%,0.84%
2020-01-01 00:14:40,5,3,527,3,524,0.80%,0.57%
2020-01-01 00:14:40,5,4,21831,3252,18579,33.31%,14.90%
2020-01-01 00:14:40,5,5,8637,510,8127,13.18%,5.90%
2020-01-01 00:14:40,5,6,15606,1683,13923,23.81%,10.78%
2020-01-01 00:14:40,5,7,6585,348,6237,10.05%,5.28%
2020-01-01 00:14:40,5,8,3320,99,3221,5.07%,2.98%
2020-01-01 00:14:40,5,9,7989,423,7566,12.19%,5.29%
2020-01-01 00:14:40,5,10,967,13,954,1.48%,1.34%
2020-01-01 00:14:40,5,11,449,5,444,0.69%,1.11%
2020-01-01 00:14:40,5,12,6886,311,6575,10.51%,4.52%
2020-01-01 00:14:40,6,1,948,8,940,1.45%,0.84%
2020-01-01 00:14:40,6,2,996,8,988,1.52%,0.80%
2020-01-01 00:14:40,6,3,1724,15,1709,2.63%,0.87%
2020-01-01 00:14:40,6,4,1481,24,1457,2.26%,1.62%
2020-01-01 00:14:40,6,5,12848,1198,11650,19.60%,9.32%
2020-01-01 00:14:40,6,6,4857,205,4652,7.41%,4.22%
2020-01-01 00:14:40,6,7,2797,64,2733,4.27%,2.29%
2020-01-01 00:14:40,6,8,2203,47,2156,3.36%,2.13%
2020-01-01 00:14:40,6,9,6034,261,5773,9.21%,4.33%
2020-01-01 00:14:40,6,10,1952,23,1929,2.98%,1.18%
2020-01-01 00:14:40,6,11,379,0,379,0.58%,0.00%
2020-01-01 00:14:40,6,12,3990,115,3875,6.09%,2.88%
2020-01-01 00:14:40,7,1,419,4,415,0.64%,0.95%
2020-01-01 00:14:40,7,2,180,0,180,0.27%,0.00%
2020-01-01 00:14:40,7,3,545,0,545,0.83%,0.00%
2020-01-01 00:14:40,7,4,1391,11,1380,2.12%,0.79%
2020-01-01 00:14:40,7,5,8146,465,7681,12.43%,5.71%
2020-01-01 00:14:40,7,6,12977,1170,11807,19.80%,9.02%
2020-01-01 00:14:40,7,7,3373,92,3281,5.15%,2.73%
2020-01-01 00:14:40,7,8,1396,12,1384,2.13%,0.86%
2020-01-01 00:14:40,7,9,7548,386,7162,11.52%,5.11%
2020-01-01 00:14:40,7,10,2524,42,2482,3.85%,1.66%
2020-01-01 00:14:40,7,11,241,1,240,0.37%,0.41%
2020-01-01 00:14:40,7,12,4943,169,4774,7.54%,3.42%
2020-01-01 00:14:40,8,1,522,1,521,0.80%,0.19%
2020-01-01 00:14:40,8,2,106,0,106,0.16%,0.00%
2020-01-01 00:14:40,8,3,1587,20,1567,2.42%,1.26%
2020-01-01 00:14:40,8,4,3022,77,2945,4.61%,2.55%
2020-01-01 00:14:40,8,5,7811,471,7340,11.92%,6.03%
2020-01-01 00:14:40,8,6,15900,1794,14106,24.26%,11.28%
2020-01-01 00:14:40,8,7,4692,151,4541,7.16%,3.22%
2020-01-01 00:14:40,8,8,2035,28,2007,3.11%,1.38%
2020-01-01 00:14:40,8,9,5970,283,5687,9.11%,4.74%
2020-01-01 00:14:40,8,10,1510,19,1491,2.30%,1.26%
2020-01-01 00:14:40,8,11,251,0,251,0.38%,0.00%
2020-01-01 00:14:40,8,12,4441,155,4286,6.78%,3.49%
2020-01-01 00:14:40,9,1,1904,10,1894,2.91%,0.53%
2020-01-01 00:14:40,9,2,4419,118,4301,6.74%,2.67%
2020-01-01 00:14:40,9,3,2070,34,2036,3.16%,1.64%
2020-01-01 00:14:40,9,4,4992,207,4785,7.62%,4.15%
2020-01-01 00:14:40,9,5,238,1,237,0.36%,0.42%
2020-01-01 00:14:40,9,6,5713,264,5449,8.72%,4.62%
2020-01-01 00:14:40,9,7,28378,5397,22981,43.30%,19.02%
2020-01-01 00:14:40,9,8,11463,965,10498,17.49%,8.42%
2020-01-01 00:14:40,9,9,126,0,126,0.19%,0.00%
2020-01-01 00:14:40,9,10,4087,125,3962,6.24%,3.06%
2020-01-01 00:14:40,9,11,10535,824,9711,16.08%,7.82%
2020-01-01 00:14:40,9,12,6093,317,5776,9.30%,5.20%
2020-01-01 00:14:40,10,1,1190,172,1018,1.82%,14.45%
2020-01-01 00:14:40,10,2,4138,290,3848,6.31%,7.01%
2020-01-01 00:14:40,10,3,2771,66,2705,4.23%,2.38%
2020-01-01 00:14:40,10,4,3751,905,2846,5.72%,24.13%
2020-01-01 00:14:40,10,5,730,52,678,1.11%,7.12%
2020-01-01 00:14:40,10,6,5278,1037,4241,8.05%,19.65%
2020-01-01 00:14:40,10,7,10965,1801,9164,16.73%,16.42%
2020-01-01 00:14:40,10,8,29904,7514,22390,45.63%,25.13%
2020-01-01 00:14:40,10,9,1176,14,1162,1.79%,1.19%
2020-01-01 00:14:40,10,10,2915,74,2841,4.45%,2.54%
2020-01-01 00:14:40,10,11,14716,2029,12687,22.45%,13.79%
2020-01-01 00:14:40,10,12,10952,1399,9553,16.71%,12.77%
2020-01-01 00:14:40,11,1,2739,56,2683,4.18%,2.04%
2020-01-01 00:14:40,11,2,3579,94,3485,5.46%,2.63%
2020-01-01 00:14:40,11,3,649,4,645,0.99%,0.62%
2020-01-01 00:14:40,11,4,4889,175,4714,7.46%,3.58%
2020-01-01 00:14:40,11,5,1077,6,1071,1.64%,0.56%
2020-01-01 00:14:40,11,6,6679,327,6352,10.19%,4.90%
2020-01-01 00:14:40,11,7,12045,998,11047,18.38%,8.29%
2020-01-01 00:14:40,11,8,25531,4445,21086,38.96%,17.41%
2020-01-01 00:14:40,11,9,149,0,149,0.23%,0.00%
2020-01-01 00:14:40,11,10,2765,57,2708,4.22%,2.06%
2020-01-01 00:14:40,11,11,9464,739,8725,14.44%,7.81%
2020-01-01 00:14:40,11,12,6380,342,6038,9.74%,5.36%
2020-01-01 00:14:40,12,1,42,0,42,0.06%,0.00%
2020-01-01 00:14:40,12,2,589,166,423,0.90%,28.18%
2020-01-01 00:14:40,12,3,2741,239,2502,4.18%,8.72%
2020-01-01 00:14:40,12,4,3389,72,3317,5.17%,2.12%
2020-01-01 00:14:40,12,5,9753,792,8961,14.88%,8.12%
2020-01-01 00:14:40,12,6,6142,236,5906,9.37%,3.84%
2020-01-01 00:14:40,12,7,2547,37,2510,3.89%,1.45%
2020-01-01 00:14:40,12,8,1237,284,953,1.89%,22.96%
2020-01-01 00:14:40,12,9,22439,4200,18239,34.24%,18.72%
2020-01-01 00:14:40,12,10,3829,398,3431,5.84%,10.39%
2020-01-01 00:14:40,12,11,1383,284,1099,2.11%,20.54%
2020-01-01 00:14:40,12,12,8397,1061,7336,12.81%,12.64%
2020-01-01 00:14:40,13,1,2080,22,2058,3.17%,1.06%
2020-01-01 00:14:40,13,2,2447,69,2378,3.73%,2.82%
2020-01-01 00:14:40,13,3,828,5,823,1.26%,0.60%
2020-01-01 00:14:40,13,4,4996,536,4460,7.62%,10.73%
2020-01-01 00:14:40,13,5,7120,772,6348,10.86%,10.84%
2020-01-01 00:14:40,13,6,5627,588,5039,8.59%,10.45%
2020-01-01 00:14:40,13,7,4329,145,4184,6.61%,3.35%
2020-01-01 00:14:40,13,8,6391,297,6094,9.75%,4.65%
2020-01-01 00:14:40,13,9,7428,802,6626,11.33%,10.80%
2020-01-01 00:14:40,13,10,26810,5411,21399,40.91%,20.18%
2020-01-01 00:14:40,13,11,16156,2178,13978,24.65%,13.48%
2020-01-01 00:14:40,13,12,9267,1018,8249,14.14%,10.99%
2020-01-01 00:14:40,14,1,229,1,228,0.35%,0.44%
2020-01-01 00:14:40,14,2,1301,20,1281,1.99%,1.54%
2020-01-01 00:14:40,14,3,885,7,878,1.35%,0.79%
2020-01-01 00:14:40,14,4,4027,115,3912,6.14%,2.86%
2020-01-01 00:14:40,14,5,1296,10,1286,1.98%,0.77%
2020-01-01 00:14:40,14,6,4249,123,4126,6.48%,2.89%
2020-01-01 00:14:40,14,7,12182,1087,11095,18.59%,8.92%
2020-01-01 00:14:40,14,8,13299,1275,12024,20.29%,9.59%
2020-01-01 00:14:40,14,9,1431,13,1418,2.18%,0.91%
2020-01-01 00:14:40,14,10,4128,124,4004,6.30%,3.00%
2020-01-01 00:14:40,14,11,25833,4427,21406,39.42%,17.14%
2020-01-01 00:14:40,14,12,8156,473,7683,12.45%,5.80%
2020-01-01 00:14:40,15,1,494,3,491,0.75%,0.61%
2020-01-01 00:14:40,15,2,196,0,196,0.30%,0.00%
2020-01-01 00:14:40,15,3,3702,81,3621,5.65%,2.19%
2020-01-01 00:14:40,15,4,4794,152,4642,7.32%,3.17%
2020-01-01 00:14:40,15,5,9147,573,8574,13.96%,6.26%
2020-01-01 00:14:40,15,6,4985,164,4821,7.61%,3.29%
2020-01-01 00:14:40,15,7,3462,107,3355,5.28%,3.09%
2020-01-01 00:14:40,15,8,5411,238,5173,8.26%,4.40%
2020-01-01 00:14:40,15,9,9306,602,8704,14.20%,6.47%
2020-01-01 00:14:40,15,10,3847,113,3734,5.87%,2.94%
2020-01-01 00:14:40,15,11,9451,665,8786,14.42%,7.04%
2020-01-01 00:14:40,15,12,25019,4625,20394,38.18%,18.49%
2020-01-01 00:14:40,16,1,539,1,538,0.82%,0.19%
2020-01-01 00:14:40,16,2,217,0,217,0.33%,0.00%
2020-01-01 00:14:40,16,3,2613,55,2558,3.99%,2.10%
2020-01-01 00:14:40,16,4,4511,152,4359,6.88%,3.37%
2020-01-01 00:14:40,16,5,9395,690,8705,14.34%,7.34%
2020-01-01 00:14:40,16,6,5140,185,4955,7.84%,3.60%
2020-01-01 00:14:40,16,7,3421,88,3333,5.22%,2.57%
2020-01-01 00:14:40,16,8,6856,445,6411,10.46%,6.49%
2020-01-01 00:14:40,16,9,9807,756,9051,14.96%,7.71%
2020-01-01 00:14:40,16,10,1491,16,1475,2.28%,1.07%
2020-01-01 00:14:40,16,11,8611,627,7984,13.14%,7.28%
2020-01-01 00:14:40,16,12,26063,4643,21420,39.77%,17.81%
2020-01-01 00:14:50,1,1,22360,3433,18927,34.12%,15.35%
2020-01-01 00:14:50,1,2,10151,727,9424,15.49%,7.16%
2020-01-01 00:14:50,1,3,486,1,485,0.74%,0.21%
2020-01-01 00:14:50,1,4,11615,989,10626,17.72%,8.51%
2020-01-01 00:14:50,1,5,10824,862,9962,16.52%,7.96%
2020-01-01 00:14:50,1,6,10723,846,9877,16.36%,7.89%
2020-01-01 00:14:50,1,7,9649,659,8990,14.72%,6.83%
2020-01-01 00:14:50,1,8,8478,508,7970,12.94%,5.99%
2020-01-01 00:14:50,1,9,10698,844,9854,16.32%,7.89%
2020-01-01 00:14:50,1,10,7877,438,7439,12.02%,5.56%
2020-01-01 00:14:50,1,11,7968,447,7521,12.16%,5.61%
2020-01-01 00:14:50,1,12,10676,839,9837,16.29%,7.86%
2020-01-01 00:14:50,2,1,700,2,698,1.07%,0.29%
2020-01-01 00:14:50,2,2,28219,5244,22975,43.06%,18.58%
2020-01-01 00:14:50,2,3,22520,3388,19132,34.36%,15.04%
2020-01-01 00:14:50,2,4,658,1,657,1.00%,0.15%
2020-01-01 00:14:50,2,5,14244,1431,12813,21.73%,10.05%
2020-01-01 00:14:50,2,6,58,0,58,0.09%,0.00%
2020-01-01 00:14:50,2,7,4986,190,4796,7.61%,3.81%
2020-01-01 00:14:50,2,8,4062,126,3936,6.20%,3.10%
2020-01-01 00:14:50,2,9,14169,1420,12749,21.62%,10.02%
2020-01-01 00:14:50,2,10,2966,67,2899,4.53%,2.26%
2020-01-01 00:14:50,2,11,2979,67,2912,4.55%,2.25%
2020-01-01 00:14:50,2,12,13986,1382,12604,21.34%,9.88%
2020-01-01 00:14:50,3,1,2027,37,1990,3.09%,1.83%
2020-01-01 00:14:50,3,2,22964,3603,19361,35.04%,15.69%
2020-01-01 00:14:50,3,3,69658,26924,42734,106.29%,38.65%
2020-01-01 00:14:50,3,4,10219,779,9440,15.59%,7.62%
2020-01-01 00:14:50,3,5,45161,12578,32583,68.91%,27.85%
2020-01-01 00:14:50,3,6,11566,1007,10559,17.65%,8.71%
2020-01-01 00:14:50,3,7,19299,2600,16699,29.45%,13.47%
2020-01-01 00:14:50,3,8,14645,1518,13127,22.35%,10.37%
2020-01-01 00:14:50,3,9,33268,7168,26100,50.76%,21.55%
2020-01-01 00:14:50,3,10,3171,79,3092,4.84%,2.49%
2020-01-01 00:14:50,3,11,1742,25,1717,2.66%,1.44%
2020-01-01 00:14:50,3,12,26002,4537,21465,39.68%,17.45%
2020-01-01 00:14:50,4,1,540,0,540,0.82%,0.00%
2020-01-01 00:14:50,4,2,401,0,401,0.61%,0.00%
2020-01-01 00:14:50,4,3,1704,14,1690,2.60%,0.82%
2020-01-01 00:14:50,4,4,27827,5119,22708,42.46%,18.40%
2020-01-01 00:14:50,4,5,17286,2099,15187,26.38%,12.14%
2020-01-01 00:14:50,4,6,23879,3855,20024,36.44%,16.14%
2020-01-01 00:14:50,4,7,5252,189,5063,8.01%,3.60%
2020-01-01 00:14:50,4,8,2946,78,2868,4.50%,2.65%
2020-01-01 00:14:50,4,9,14406,1524,12882,21.98%,10.58%
2020-01-01 00:14:50,4,10,1859,38,1821,2.84%,2.04%
2020-01-01 00:14:50,4,11,237,2,235,0.36%,0.84%
2020-01-01 00:14:50,4,12,11765,1036,10729,17.95%,8.81%
2020-01-01 00:14:50,5,1,2777,81,2696,4.24%,2.92%
2020-01-01 00:14:50,5,2,659,3,656,1.01%,0.46%
2020-01-01 00:14:50,5,3,1164,13,1151,1.78%,1.12%
2020-01-01 00:14:50,5,4,23550,3863,19687,35.93%,16.40%
2020-01-01 00:14:50,5,5,9479,700,8779,14.46%,7.38%
2020-01-01 00:14:50,5,6,15056,1661,13395,22.97%,11.03%
2020-01-01 00:14:50,5,7,4960,200,4760,7.57%,4.03%
2020-01-01 00:14:50,5,8,3285,77,3208,5.01%,2.34%
2020-01-01 00:14:50,5,9,8159,532,7627,12.45%,6.52%
2020-01-01 00:14:50,5,10,1052,6,1046,1.61%,0.57%
2020-01-01 00:14:50,5,11,687,11,676,1.05%,1.60%
2020-01-01 00:14:50,5,12,6807,404,6403,10.39%,5.94%
2020-01-01 00:14:50,6,1,1196,9,1187,1.82%,0.75%
2020-01-01 00:14:50,6,2,1279,9,1270,1.95%,0.70%
2020-01-01 00:14:50,6,3,1823,25,1798,2.78%,1.37%
2020-01-01 00:14:50,6,4,1305,8,1297,1.99%,0.61%
2020-01-01 00:14:50,6,5,15676,1645,14031,23.92%,10.49%
2020-01-01 00:14:50,6,6,6389,299,6090,9.75%,4.68%
2020-01-01 00:14:50,6,7,4535,150,4385,6.92%,3.31%
2020-01-01 00:14:50,6,8,3901,119,3782,5.95%,3.05%
2020-01-01 00:14:50,6,9,7238,349,6889,11.04%,4.82%
2020-01-01 00:14:50,6,10,2176,26,2150,3.32%,1.19%
2020-01-01 00:14:50,6,11,394,1,393,0.60%,0.25%
2020-01-01 00:14:50,6,12,5006,181,4825,7.64%,3.62%
2020-01-01 00:14:50,7,1,486,1,485,0.74%,0.21%
2020-01-01 00:14:50,7,2,143,0,143,0.22%,0.00%
2020-01-01 00:14:50,7,3,690,1,689,1.05%,0.14%
2020-01-01 00:14:50,7,4,2292,45,2247,3.50%,1.96%
2020-01-01 00:14:50,7,5,8866,558,8308,13.53%,6.29%
2020-01-01 00:14:50,7,6,15270,1652,13618,23.30%,10.82%
2020-01-01 00:14:50,7,7,4049,161,3888,6.18%,3.98%
2020-01-01 00:14:50,7,8,1587,17,1570,2.42%,1.07%
2020-01-01 00:14:50,7,9,7865,449,7416,12.00%,5.71%
2020-01-01 00:14:50,7,10,1987,21,1966,3.03%,1.06%
2020-01-01 00:14:50,7,11,90,0,90,0.14%,0.00%
2020-01-01 00:14:50,7,12,5861,268,5593,8.94%,4.57%
2020-01-01 00:14:50,8,1,334,0,334,0.51%,0.00%
2020-01-01 00:14:50,8,2,83,0,83,0.13%,0.00%
2020-01-01 00:14:50,8,3,1930,32,1898,2.94%,1.66%
2020-01-01 00:14:50,8,4,2552,43,2509,3.89%,1.68%
2020-01-01 00:14:50,8,5,8115,492,7623,12.38%,6.06%
2020-01-01 00:14:50,8,6,15380,1689,13691,23.47%,10.98%
2020-01-01 00:14:50,8,7,4571,174,4397,6.97%,3.81%
2020-01-01 00:14:50,8,8,1985,34,1951,3.03%,1.71%
2020-01-01 00:14:50,8,9,6002,270,5732,9.16%,4.50%
2020-01-01 00:14:50,8,10,1714,23,1691,2.62%,1.34%
2020-01-01 00:14:50,8,11,71,0,71,0.11%,0.00%
2020-01-01 00:14:50,8,12,4271,137,4134,6.52%,3.21%
2020-01-01 00:14:50,9,1,507,3,504,0.77%,0.59%
2020-01-01 00:14:50,9,2,4304,133,4171,6.57%,3.09%
2020-01-01 00:14:50,9,3,3405,75,3330,5.20%,2.20%
2020-01-01 00:14:50,9,4,9053,576,8477,13.81%,6.36%
2020-01-01 00:14:50,9,5,403,0,403,0.61%,0.00%
2020-01-01 00:14:50,9,6,10041,703,9338,15.32%,7.00%
2020-01-01 00:14:50,9,7,32536,6801,25735,49.65%,20.90%
2020-01-01 00:14:50,9,8,10834,915,9919,16.53%,8.45%
2020-01-01 00:14:50,9,9,130,0,130,0.20%,0.00%
2020-01-01 00:14:50,9,10,3989,134,3855,6.09%,3.36%
2020-01-01 00:14:50,9,11,10033,794,9239,15.31%,7.91%
2020-01-01 00:14:50,9,12,5756,247,5509,8.78%,4.29%
2020-01-01 00:14:50,10,1,1276,213,1063,1.95%,16.69%
2020-01-01 00:14:50,10,2,3231,267,2964,4.93%,8.26%
2020-01-01 00:14:50,10,3,1800,19,1781,2.75%,1.06%
2020-01-01 00:14:50,10,4,4020,1376,2644,6.13%,34.23%
2020-01-01 00:14:50,10,5,699,55,644,1.07%,7.87%
2020-01-01 00:14:50,10,6,6096,1534,4562,9.30%,25.16%
2020-01-01 00:14:50,10,7,11050,2203,8847,16.86%,19.94%
2020-01-01 00:14:50,10,8,28192,7111,21081,43.02%,25.22%
2020-01-01 00:14:50,10,9,813,4,809,1.24%,0.49%
2020-01-01 00:14:50,10,10,2472,41,2431,3.77%,1.66%
2020-01-01 00:14:50,10,11,13625,1824,11801,20.79%,13.39%
2020-01-01 00:14:50,10,12,10536,1323,9213,16.08%,12.56%
2020-01-01 00:14:50,11,1,2228,37,2191,3.40%,1.66%
2020-01-01 00:14:50,11,2,4205,131,4074,6.42%,3.12%
2020-01-01 00:14:50,11,3,1707,24,1683,2.60%,1.41%
2020-01-01 00:14:50,11,4,4315,114,4201,6.58%,2.64%
2020-01-01 00:14:50,11,5,340,2,338,0.52%,0.59%
2020-01-01 00:14:50,11,6,5460,205,5255,8.33%,3.75%
2020-01-01 00:14:50,11,7,11251,887,10364,17.17%,7.88%
2020-01-01 00:14:50,11,8,24568,4043,20525,37.49%,16.46%
2020-01-01 00:14:50,11,9,245,0,245,0.37%,0.00%
2020-01-01 00:14:50,11,10,2857,67,2790,4.36%,2.35%
2020-01-01 00:14:50,11,11,9346,688,8658,14.26%,7.36%
2020-01-01 00:14:50,11,12,6112,315,5797,9.33%,5.15%
2020-01-01 00:14:50,12,1,132,1,131,0.20%,0.76%
2020-01-01 00:14:50,12,2,487,160,327,0.74%,32.85%
2020-01-01 00:14:50,12,3,2647,202,2445,4.04%,7.63%
2020-01-01 00:14:50,12,4,3186,86,3100,4.86%,2.70%
2020-01-01 00:14:50,12,5,8362,665,7697,12.76%,7.95%
2020-01-01 00:14:50,12,6,4952,188,4764,7.56%,3.80%
2020-01-01 00:14:50,12,7,1581,22,1559,2.41%,1.39%
2020-01-01 00:14:50,12,8,1790,368,1422,2.73%,20.56%
2020-01-01 00:14:50,12,9,22819,4578,18241,34.82%,20.06%
2020-01-01 00:14:50,12,10,4623,519,4104,7.05%,11.23%
2020-01-01 00:14:50,12,11,1909,372,1537,2.91%,19.49%
2020-01-01 00:14:50,12,12,8864,1336,7528,13.53%,15.07%
2020-01-01 00:14:50,13,1,2025,29,1996,3.09%,1.43%
2020-01-01 00:14:50,13,2,2400,41,2359,3.66%,1.71%
2020-01-01 00:14:50,13,3,1278,7,1271,1.95%,0.55%
2020-01-01 00:14:50,13,4,5019,438,4581,7.66%,8.73%
2020-01-01 00:14:50,13,5,8207,878,7329,12.52%,10.70%
2020-01-01 00:14:50,13,6,6087,523,5564,9.29%,8.59%
2020-01-01 00:14:50,13,7,4321,145,4176,6.59%,3.36%
2020-01-01 00:14:50,13,8,6387,321,6066,9.75%,5.03%
2020-01-01 00:14:50,13,9,8456,900,7556,12.90%,10.64%
2020-01-01 00:14:50,13,10,26300,5140,21160,40.13%,19.54%
2020-01-01 00:14:50,13,11,14986,1865,13121,22.87%,12.44%
2020-01-01 00:14:50,13,12,8242,839,7403,12.58%,10.18%
2020-01-01 00:14:50,14,1,260,0,260,0.40%,0.00%
2020-01-01 00:14:50,14,2,953,9,944,1.45%,0.94%
2020-01-01 00:14:50,14,3,479,2,477,0.73%,0.42%
2020-01-01 00:14:50,14,4,3890,144,3746,5.94%,3.70%
2020-01-01 00:14:50,14,5,1420,20,1400,2.17%,1.41%
2020-01-01 00:14:50,14,6,4286,166,4120,6.54%,3.87%
2020-01-01 00:14:50,14,7,11719,1153,10566,17.88%,9.84%
2020-01-01 00:14:50,14,8,13241,1448,11793,20.20%,10.94%
2020-01-01 00:14:50,14,9,1679,32,1647,2.56%,1.91%
2020-01-01 00:14:50,14,10,4110,120,3990,6.27%,2.92%
2020-01-01 00:14:50,14,11,25851,4620,21231,39.45%,17.87%
2020-01-01 00:14:50,14,12,8193,486,7707,12.50%,5.93%
2020-01-01 00:14:50,15,1,585,1,584,0.89%,0.17%
2020-01-01 00:14:50,15,2,145,1,144,0.22%,0.69%
2020-01-01 00:14:50,15,3,4163,124,4039,6.35%,2.98%
2020-01-01 00:14:50,15,4,5131,284,4847,7.83%,5.53%
2020-01-01 00:14:50,15,5,10152,793,9359,15.49%,7.81%
2020-01-01 00:14:50,15,6,5493,310,5183,8.38%,5.64%
2020-01-01 00:14:50,15,7,3165,88,3077,4.83%,2.78%
2020-01-01 00:14:50,15,8,5553,245,5308,8.47%,4.41%
2020-01-01 00:14:50,15,9,10373,819,9554,15.83%,7.90%
2020-01-01 00:14:50,15,10,3848,221,3627,5.87%,5.74%
2020-01-01 00:14:50,15,11,9669,783,8886,14.75%,8.10%
2020-01-01 00:14:50,15,12,25531,4780,20751,38.96%,18.72%
2020-01-01 00:14:50,16,1,456,1,455,0.70%,0.22%
2020-01-01 00:14:50,16,2,185,0,185,0.28%,0.00%
2020-01-01 00:14:50,16,3,1876,30,1846,2.86%,1.60%
2020-01-01 00:14:50,16,4,3886,128,3758,5.93%,3.29%
2020-01-01 00:14:50,16,5,7423,485,6938,11.33%,6.53%
2020-01-01 00:14:50,16,6,4561,184,4377,6.96%,4.03%
2020-01-01 00:14:50,16,7,3361,95,3266,5.13%,2.83%
2020-01-01 00:14:50,16,8,8428,625,7803,12.86%,7.42%
2020-01-01 00:14:50,16,9,7903,533,7370,12.06%,6.74%
2020-01-01 00:14:50,16,10,1829,23,1806,2.79%,1.26%
2020-01-01 00:14:50,16,11,10467,871,9596,15.97%,8.32%
2020-01-01 00:14:50,16,12,26192,4722,21470,39.97%,18.03%
2020-01-01 00:15:00,1,1,16403,1898,14505,25.03%,11.57%
2020-01-01 00:15:00,1,2,6492,307,6185,9.91%,4.73%
2020-01-01 00:15:00,1,3,586,4,582,0.89%,0.68%
2020-01-01 00:15:00,1,4,9597,685,8912,14.64%,7.14%
2020-01-01 00:15:00,1,5,9256,637,8619,14.12%,6.88%
2020-01-01 00:15:00,1,6,9189,626,8563,14.02%,6.81%
2020-01-01 00:15:00,1,7,5891,255,5636,8.99%,4.33%
2020-01-01 00:15:00,1,8,4004,114,3890,6.11%,2.85%
2020-01-01 00:15:00,1,9,9135,620,8515,13.94%,6.79%
2020-01-01 00:15:00,1,10,3226,70,3156,4.92%,2.17%
2020-01-01 00:15:00,1,11,3296,77,3219,5.03%,2.34%
2020-01-01 00:15:00,1,12,9109,615,8494,13.90%,6.75%
2020-01-01 00:15:00,2,1,884,4,880,1.35%,0.45%
2020-01-01 00:15:00,2,2,28761,5447,23314,43.89%,18.94%
2020-01-01 00:15:00,2,3,20880,2953,17927,31.86%,14.14%
2020-01-01 00:15:00,2,4,747,2,745,1.14%,0.27%
2020-01-01 00:15:00,2,5,12163,1068,11095,18.56%,8.78%
2020-01-01 00:15:00,2,6,24,0,24,0.04%,0.00%
2020-01-01 00:15:00,2,7,6980,335,6645,10.65%,4.80%
2020-01-01 00:15:00,2,8,5726,223,5503,8.74%,3.89%
2020-01-01 00:15:00,2,9,11980,1032,10948,18.28%,8.61%
2020-01-01 00:15:00,2,10,4796,157,4639,7.32%,3.27%
2020-01-01 00:15:00,2,11,4837,158,4679,7.38%,3.27%
2020-01-01 00:15:00,2,12,11763,994,10769,17.95%,8.45%
2020-01-01 00:15:00,3,1,1448,8,1440,2.21%,0.55%
2020-01-01 00:15:00,3,2,25417,4254,21163,38.78%,16.74%
2020-01-01 00:15:00,3,3,67434,25230,42204,102.90%,37.41%
2020-01-01 00:15:00,3,4,5347,225,5122,8.16%,4.21%
2020-01-01 00:15:00,3,5,40668,10242,30426,62.05%,25.18%
2020-01-01 00:15:00,3,6,6274,312,5962,9.57%,4.97%
2020-01-01 00:15:00,3,7,21945,3220,18725,33.49%,14.67%
2020-01-01 00:15:00,3,8,18437,2321,16116,28.13%,12.59%
2020-01-01 00:15:00,3,9,34002,7383,26619,51.88%,21.71%
2020-01-01 00:15:00,3,10,4076,117,3959,6.22%,2.87%
2020-01-01 00:15:00,3,11,1858,20,1838,2.84%,1.08%
2020-01-01 00:15:00,3,12,27226,4881,22345,41.54%,17.93%
2020-01-01 00:15:00,4,1,545,2,543,0.83%,0.37%
2020-01-01 00:15:00,4,2,351,1,350,0.54%,0.28%
2020-01-01 00:15:00,4,3,1307,12,1295,1.99%,0.92%
2020-01-01 00:15:00,4,4,29434,5844,23590,44.91%,19.85%
2020-01-01 00:15:00,4,5,18348,2358,15990,28.00%,12.85%
2020-01-01 00:15:00,4,6,25257,4355,20902,38.54%,17.24%
2020-01-01 00:15:00,4,7,5629,261,5368,8.59%,4.64%
2020-01-01 00:15:00,4,8,3311,74,3237,5.05%,2.23%
2020-01-01 00:15:00,4,9,15812,1787,14025,24.13%,11.30%
2020-01-01 00:15:00,4,10,2079,42,2037,3.17%,2.02%
2020-01-01 00:15:00,4,11,173,0,173,0.26%,0.00%
2020-01-01 00:15:00,4,12,12957,1192,11765,19.77%,9.20%
2020-01-01 00:15:00,5,1,2951,64,2887,4.50%,2.17%
2020-01-01 00:15:00,5,2,821,4,817,1.25%,0.49%
2020-01-01 00:15:00,5,3,339,0,339,0.52%,0.00%
2020-01-01 00:15:00,5,4,23121,3629,19492,35.28%,15.70%
2020-01-01 00:15:00,5,5,10361,747,9614,15.81%,7.21%
2020-01-01 00:15:00,5,6,16634,1930,14704,25.38%,11.60%
2020-01-01 00:15:00,5,7,5750,255,5495,8.77%,4.43%
2020-01-01 00:15:00,5,8,4819,162,4657,7.35%,3.36%
2020-01-01 00:15:00,5,9,9830,678,9152,15.00%,6.90%
2020-01-01 00:15:00,5,10,1009,7,1002,1.54%,0.69%
2020-01-01 00:15:00,5,11,961,8,953,1.47%,0.83%
2020-01-01 00:15:00,5,12,7820,427,7393,11.93%,5.46%
2020-01-01 00:15:00,6,1,1093,18,1075,1.67%,1.65%
2020-01-01 00:15:00,6,2,1220,23,1197,1.86%,1.89%
2020-01-01 00:15:00,6,3,1931,35,1896,2.95%,1.81%
2020-01-01 00:15:00,6,4,2168,16,2152,3.31%,0.74%
2020-01-01 00:15:00,6,5,19043,2503,16540,29.06%,13.14%
2020-01-01 00:15:00,6,6,4900,172,4728,7.48%,3.51%
2020-01-01 00:15:00,6,7,2254,43,2211,3.44%,1.91%
2020-01-01 00:15:00,6,8,1727,29,1698,2.64%,1.68%
2020-01-01 00:15:00,6,9,11853,998,10855,18.09%,8.42%
2020-01-01 00:15:00,6,10,4171,133,4038,6.36%,3.19%
2020-01-01 00:15:00,6,11,273,0,273,0.42%,0.00%
2020-01-01 00:15:00,6,12,7627,419,7208,11.64%,5.49%
2020-01-01 00:15:00,7,1,404,0,404,0.62%,0.00%
2020-01-01 00:15:00,7,2,188,0,188,0.29%,0.00%
2020-01-01 00:15:00,7,3,1515,16,1499,2.31%,1.06%
2020-01-01 00:15:00,7,4,1581,13,1568,2.41%,0.82%
2020-01-01 00:15:00,7,5,8650,557,8093,13.20%,6.44%
2020-01-01 00:15:00,7,6,13824,1346,12478,21.09%,9.74%
2020-01-01 00:15:00,7,7,3558,99,3459,5.43%,2.78%
2020-01-01 00:15:00,7,8,1423,13,1410,2.17%,0.91%
2020-01-01 00:15:00,7,9,6869,362,6507,10.48%,5.27%
2020-01-01 00:15:00,7,10,1543,27,1516,2.35%,1.75%
2020-01-01 00:15:00,7,11,115,0,115,0.18%,0.00%
2020-01-01 00:15:00,7,12,5370,215,5155,8.19%,4.00%
2020-01-01 00:15:00,8,1,394,1,393,0.60%,0.25%
2020-01-01 00:15:00,8,2,86,0,86,0.13%,0.00%
2020-01-01 00:15:00,8,3,2179,29,2150,3.32%,1.33%
2020-01-01 00:15:00,8,4,2602,63,2539,3.97%,2.42%
2020-01-01 00:15:00,8,5,8836,579,8257,13.48%,6.55%
2020-01-01 00:15:00,8,6,16381,1862,14519,25.00%,11.37%
2020-01-01 00:15:00,8,7,4872,167,4705,7.43%,3.43%
2020-01-01 00:15:00,8,8,1561,23,1538,2.38%,1.47%
2020-01-01 00:15:00,8,9,6431,303,6128,9.81%,4.71%
2020-01-01 00:15:00,8,10,1872,27,1845,2.86%,1.44%
2020-01-01 00:15:00,8,11,311,0,311,0.47%,0.00%
2020-01-01 00:15:00,8,12,4557,170,4387,6.95%,3.73%
2020-01-01 00:15:00,9,1,919,1,918,1.40%,0.11%
2020-01-01 00:15:00,9,2,2720,42,2678,4.15%,1.54%
2020-01-01 00:15:00,9,3,1438,11,1427,2.19%,0.76%
2020-01-01 00:15:00,9,4,5250,203,5047,8.01%,3.87%
2020-01-01 00:15:00,9,5,367,0,367,0.56%,0.00%
2020-01-01 00:15:00,9,6,5926,268,5658,9.04%,4.52%
2020-01-01 00:15:00,9,7,26948,4732,22216,41.12%,17.56%
2020-01-01 00:15:00,9,8,11991,1025,10966,18.30%,8.55%
2020-01-01 00:15:00,9,9,287,0,287,0.44%,0.00%
2020-01-01 00:15:00,9,10,4513,143,4370,6.89%,3.17%
2020-01-01 00:15:00,9,11,10576,794,9782,16.14%,7.51%
2020-01-01 00:15:00,9,12,5729,251,5478,8.74%,4.38%
2020-01-01 00:15:00,10,1,1530,340,1190,2.33%,22.22%
2020-01-01 00:15:00,10,2,4594,473,4121,7.01%,10.30%
2020-01-01 00:15:00,10,3,2926,71,2855,4.46%,2.43%
2020-01-01 00:15:00,10,4,4305,1093,3212,6.57%,25.39%
2020-01-01 00:15:00,10,5,558,9,549,0.85%,1.61%
2020-01-01 00:15:00,10,6,6207,1208,4999,9.47%,19.46%
2020-01-01 00:15:00,10,7,13282,2372,10910,20.27%,17.86%
2020-01-01 00:15:00,10,8,30981,7927,23054,47.27%,25.59%
2020-01-01 00:15:00,10,9,729,1,728,1.11%,0.14%
2020-01-01 00:15:00,10,10,2759,55,2704,4.21%,1.99%
2020-01-01 00:15:00,10,11,13570,1606,11964,20.71%,11.83%
2020-01-01 00:15:00,10,12,10313,1101,9212,15.74%,10.68%
2020-01-01 00:15:00,11,1,2128,35,2093,3.25%,1.64%
2020-01-01 00:15:00,11,2,3526,86,3440,5.38%,2.44%
2020-01-01 00:15:00,11,3,1176,8,1168,1.79%,0.68%
2020-01-01 00:15:00,11,4,3770,106,3664,5.75%,2.81%
2020-01-01 00:15:00,11,5,170,0,170,0.26%,0.00%
2020-01-01 00:15:00,11,6,4728,170,4558,7.21%,3.60%
2020-01-01 00:15:00,11,7,10168,738,9430,15.52%,7.26%
2020-01-01 00:15:00,11,8,24587,4140,20447,37.52%,16.84%
2020-01-01 00:15:00,11,9,214,1,213,0.33%,0.47%
2020-01-01 00:15:00,11,10,3696,120,3576,5.64%,3.25%
2020-01-01 00:15:00,11,11,10664,870,9794,16.27%,8.16%
2020-01-01 00:15:00,11,12,6761,351,6410,10.32%,5.19%
2020-01-01 00:15:00,12,1,75,0,75,0.11%,0.00%
2020-01-01 00:15:00,12,2,616,220,396,0.94%,35.71%
2020-01-01 00:15:00,12,3,2566,251,2315,3.92%,9.78%
2020-01-01 00:15:00,12,4,3295,77,3218,5.03%,2.34%
2020-01-01 00:15:00,12,5,9870,901,8969,15.06%,9.13%
2020-01-01 00:15:00,12,6,6352,303,6049,9.69%,4.77%
2020-01-01 00:15:00,12,7,2911,57,2854,4.44%,1.96%
2020-01-01 00:15:00,12,8,1286,278,1008,1.96%,21.62%
2020-01-01 00:15:00,12,9,22942,4607,18335,35.01%,20.08%
2020-01-01 00:15:00,12,10,3687,346,3341,5.63%,9.38%
2020-01-01 00:15:00,12,11,1392,278,1114,2.12%,19.97%
2020-01-01 00:15:00,12,12,7854,1151,6703,11.98%,14.65%
2020-01-01 00:15:00,13,1,2267,50,2217,3.46%,2.21%
2020-01-01 00:15:00,13,2,2559,63,2496,3.90%,2.46%
2020-01-01 00:15:00,13,3,864,5,859,1.32%,0.58%
2020-01-01 00:15:00,13,4,5665,536,5129,8.64%,9.46%
2020-01-01 00:15:00,13,5,8562,921,7641,13.06%,10.76%
2020-01-01 00:15:00,13,6,6836,634,6202,10.43%,9.27%
2020-01-01 00:15:00,13,7,5077,208,4869,7.75%,4.10%
2020-01-01 00:15:00,13,8,7024,346,6678,10.72%,4.93%
2020-01-01 00:15:00,13,9,8957,962,7995,13.67%,10.74%
2020-01-01 00:15:00,13,10,28796,5947,22849,43.94%,20.65%
2020-01-01 00:15:00,13,11,16572,2150,14422,25.29%,12.97%
2020-01-01 00:15:00,13,12,8993,902,8091,13.72%,10.03%
2020-01-01 00:15:00,14,1,293,0,293,0.45%,0.00%
2020-01-01 00:15:00,14,2,1553,18,1535,2.37%,1.16%
2020-01-01 00:15:00,14,3,994,5,989,1.52%,0.50%
2020-01-01 00:15:00,14,4,4907,302,4605,7.49%,6.15%
2020-01-01 00:15:00,14,5,1371,14,1357,2.09%,1.02%
2020-01-01 00:15:00,14,6,5055,314,4741,7.71%,6.21%
2020-01-01 00:15:00,14,7,12123,1181,10942,18.50%,9.74%
2020-01-01 00:15:00,14,8,13820,1481,12339,21.09%,10.72%
2020-01-01 00:15:00,14,9,1645,18,1627,2.51%,1.09%
2020-01-01 00:15:00,14,10,4656,160,4496,7.10%,3.44%
2020-01-01 00:15:00,14,11,27001,4990,22011,41.20%,18.48%
2020-01-01 00:15:00,14,12,8236,561,7675,12.57%,6.81%
2020-01-01 00:15:00,15,1,440,1,439,0.67%,0.23%
2020-01-01 00:15:00,15,2,117,0,117,0.18%,0.00%
2020-01-01 00:15:00,15,3,3935,113,3822,6.00%,2.87%
2020-01-01 00:15:00,15,4,5187,288,4899,7.91%,5.55%
2020-01-01 00:15:00,15,5,10813,911,9902,16.50%,8.43%
2020-01-01 00:15:00,15,6,5411,305,5106,8.26%,5.64%
2020-01-01 00:15:00,15,7,3843,135,3708,5.86%,3.51%
2020-01-01 00:15:00,15,8,5693,282,5411,8.69%,4.95%
2020-01-01 00:15:00,15,9,11048,949,10099,16.86%,8.59%
2020-01-01 00:15:00,15,10,3972,128,3844,6.06%,3.22%
2020-01-01 00:15:00,15,11,9884,745,9139,15.08%,7.54%
2020-01-01 00:15:00,15,12,27530,5363,22167,42.01%,19.48%
2020-01-01 00:15:00,16,1,410,2,408,0.63%,0.49%
2020-01-01 00:15:00,16,2,254,1,253,0.39%,0.39%
2020-01-01 00:15:00,16,3,1415,24,1391,2.16%,1.70%
2020-01-01 00:15:00,16,4,4170,102,4068,6.36%,2.45%
2020-01-01 00:15:00,16,5,7410,428,6982,11.31%,5.78%
2020-01-01 00:15:00,16,6,5032,156,4876,7.68%,3.10%
2020-01-01 00:15:00,16,7,3884,136,3748,5.93%,3.50%
2020-01-01 00:15:00,16,8,8025,511,7514,12.25%,6.37%
2020-01-01 00:15:00,16,9,7841,473,7368,11.96%,6.03%
2020-01-01 00:15:00,16,10,2008,21,1987,3.06%,1.05%
2020-01-01 00:15:00,16,11,10304,767,9537,15.72%,7.44%
2020-01-01 00:15:00,16,12,26682,4705,21977,40.71%,17.63%
2020-01-01 00:15:10,1,1,15440,1733,13707,23.56%,11.22%
2020-01-01 00:15:10,1,2,4979,217,4762,7.60%,4.36%
2020-01-01 00:15:10,1,3,741,5,736,1.13%,0.67%
2020-01-01 00:15:10,1,4,9980,716,9264,15.23%,7.17%
2020-01-01 00:15:10,1,5,9608,670,8938,14.66%,6.97%
2020-01-01 00:15:10,1,6,9565,658,8907,14.60%,6.88%
2020-01-01 00:15:10,1,7,4217,164,4053,6.43%,3.89%
2020-01-01 00:15:10,1,8,3445,104,3341,5.26%,3.02%
2020-01-01 00:15:10,1,9,9510,654,8856,14.51%,6.88%
2020-01-01 00:15:10,1,10,2744,60,2684,4.19%,2.19%
2020-01-01 00:15:10,1,11,2856,63,2793,4.36%,2.21%
2020-01-01 00:15:10,1,12,9483,650,8833,14.47%,6.85%
2020-01-01 00:15:10,2,1,718,5,713,1.10%,0.70%
2020-01-01 00:15:10,2,2,25848,4513,21335,39.44%,17.46%
2020-01-01 00:15:10,2,3,19929,2771,17158,30.41%,13.90%
2020-01-01 00:15:10,2,4,644,5,639,0.98%,0.78%
2020-01-01 00:15:10,2,5,12963,1217,11746,19.78%,9.39%
2020-01-01 00:15:10,2,6,58,0,58,0.09%,0.00%
2020-01-01 00:15:10,2,7,5173,204,4969,7.89%,3.94%
2020-01-01 00:15:10,2,8,3470,86,3384,5.29%,2.48%
2020-01-01 00:15:10,2,9,12865,1191,11674,19.63%,9.26%
2020-01-01 00:15:10,2,10,2706,51,2655,4.13%,1.88%
2020-01-01 00:15:10,2,11,2740,52,2688,4.18%,1.90%
2020-01-01 00:15:10,2,12,12713,1160,11553,19.40%,9.12%
2020-01-01 00:15:10,3,1,1570,18,1552,2.40%,1.15%
2020-01-01 00:15:10,3,2,24171,3949,20222,36.88%,16.34%
2020-01-01 00:15:10,3,3,71465,27882,43583,109.05%,39.01%
2020-01-01 00:15:10,3,4,10632,782,9850,16.22%,7.36%
2020-01-01 00:15:10,3,5,46277,13018,33259,70.61%,28.13%
2020-01-01 00:15:10,3,6,11718,953,10765,17.88%,8.13%
2020-01-01 00:15:10,3,7,20876,2983,17893,31.85%,14.29%
2020-01-01 00:15:10,3,8,18295,2331,15964,27.92%,12.74%
2020-01-01 00:15:10,3,9,34014,7487,26527,51.90%,22.01%
2020-01-01 00:15:10,3,10,6597,337,6260,10.07%,5.11%
2020-01-01 00:15:10,3,11,2265,35,2230,3.46%,1.55%
2020-01-01 00:15:10,3,12,24644,4070,20574,37.60%,16.52%
2020-01-01 00:15:10,4,1,537,3,534,0.82%,0.56%
2020-01-01 00:15:10,4,2,361,0,361,0.55%,0.00%
2020-01-01 00:15:10,4,3,932,22,910,1.42%,2.36%
2020-01-01 00:15:10,4,4,28227,5262,22965,43.07%,18.64%
2020-01-01 00:15:10,4,5,17033,2046,14987,25.99%,12.01%
2020-01-01 00:15:10,4,6,23653,3809,19844,36.09%,16.10%
2020-01-01 00:15:10,4,7,5273,210,5063,8.05%,3.98%
2020-01-01 00:15:10,4,8,3193,84,3109,4.87%,2.63%
2020-01-01 00:15:10,4,9,14994,1614,13380,22.88%,10.76%
2020-01-01 00:15:10,4,10,1766,35,1731,2.69%,1.98%
2020-01-01 00:15:10,4,11,253,2,251,0.39%,0.79%
2020-01-01 00:15:10,4,12,12644,1151,11493,19.29%,9.10%
2020-01-01 00:15:10,5,1,3406,97,3309,5.20%,2.85%
2020-01-01 00:15:10,5,2,817,8,809,1.25%,0.98%
2020-01-01 00:15:10,5,3,2020,29,1991,3.08%,1.44%
2020-01-01 00:15:10,5,4,23931,3942,19989,36.52%,16.47%
2020-01-01 00:15:10,5,5,12284,1080,11204,18.74%,8.79%
2020-01-01 00:15:10,5,6,17213,2092,15121,26.26%,12.15%
2020-01-01 00:15:10,5,7,4533,172,4361,6.92%,3.79%
2020-01-01 00:15:10,5,8,3679,110,3569,5.61%,2.99%
2020-01-01 00:15:10,5,9,10135,749,9386,15.46%,7.39%
2020-01-01 00:15:10,5,10,1598,29,1569,2.44%,1.81%
2020-01-01 00:15:10,5,11,620,5,615,0.95%,0.81%
2020-01-01 00:15:10,5,12,8265,495,7770,12.61%,5.99%
2020-01-01 00:15:10,6,1,984,7,977,1.50%,0.71%
2020-01-01 00:15:10,6,2,1052,9,1043,1.61%,0.86%
2020-01-01 00:15:10,6,3,1494,22,1472,2.28%,1.47%
2020-01-01 00:15:10,6,4,1322,19,1303,2.02%,1.44%
2020-01-01 00:15:10,6,5,17827,2226,15601,27.20%,12.49%
2020-01-01 00:15:10,6,6,4742,191,4551,7.24%,4.03%
2020-01-01 00:15:10,6,7,3092,87,3005,4.72%,2.81%
2020-01-01 00:15:10,6,8,2616,65,2551,3.99%,2.48%
2020-01-01 00:15:10,6,9,11259,900,10359,17.18%,7.99%
2020-01-01 00:15:10,6,10,2567,38,2529,3.92%,1.48%
2020-01-01 00:15:10,6,11,426,0,426,0.65%,0.00%
2020-01-01 00:15:10,6,12,8645,568,8077,13.19%,6.57%
2020-01-01 00:15:10,7,1,464,0,464,0.71%,0.00%
2020-01-01 00:15:10,7,2,223,0,223,0.34%,0.00%
2020-01-01 00:15:10,7,3,988,6,982,1.51%,0.61%
2020-01-01 00:15:10,7,4,2251,39,2212,3.43%,1.73%
2020-01-01 00:15:10,7,5,7421,404,7017,11.32%,5.44%
2020-01-01 00:15:10,7,6,14448,1484,12964,22.05%,10.27%
2020-01-01 00:15:10,7,7,4727,199,4528,7.21%,4.21%
2020-01-01 00:15:10,7,8,2266,35,2231,3.46%,1.54%
2020-01-01 00:15:10,7,9,6256,305,5951,9.55%,4.88%
2020-01-01 00:15:10,7,10,1220,11,1209,1.86%,0.90%
2020-01-01 00:15:10,7,11,477,1,476,0.73%,0.21%
2020-01-01 00:15:10,7,12,5028,186,4842,7.67%,3.70%
2020-01-01 00:15:10,8,1,777,4,773,1.19%,0.51%
2020-01-01 00:15:10,8,2,115,0,115,0.18%,0.00%
2020-01-01 00:15:10,8,3,2048,39,2009,3.12%,1.90%
2020-01-01 00:15:10,8,4,3154,69,3085,4.81%,2.19%
2020-01-01 00:15:10,8,5,9195,660,8535,14.03%,7.18%
2020-01-01 00:15:10,8,6,17646,2262,15384,26.93%,12.82%
2020-01-01 00:15:10,8,7,5166,217,4949,7.88%,4.20%
2020-01-01 00:15:10,8,8,1953,35,1918,2.98%,1.79%
2020-01-01 00:15:10,8,9,6920,366,6554,10.56%,5.29%
2020-01-01 00:15:10,8,10,1778,21,1757,2.71%,1.18%
2020-01-01 00:15:10,8,11,114,0,114,0.17%,0.00%
2020-01-01 00:15:10,8,12,5144,201,4943,7.85%,3.91%
2020-01-01 00:15:10,9,1,1129,2,1127,1.72%,0.18%
2020-01-01 00:15:10,9,2,3489,62,3427,5.32%,1.78%
2020-01-01 00:15:10,9,3,2007,28,1979,3.06%,1.40%
2020-01-01 00:15:10,9,4,4919,152,4767,7.51%,3.09%
2020-01-01 00:15:10,9,5,398,1,397,0.61%,0.25%
2020-01-01 00:15:10,9,6,6073,265,5808,9.27%,4.36%
2020-01-01 00:15:10,9,7,26818,4867,21951,40.92%,18.15%
2020-01-01 00:15:10,9,8,10578,811,9767,16.14%,7.67%
2020-01-01 00:15:10,9,9,149,1,148,0.23%,0.67%
2020-01-01 00:15:10,9,10,3613,96,3517,5.51%,2.66%
2020-01-01 00:15:10,9,11,9419,664,8755,14.37%,7.05%
2020-01-01 00:15:10,9,12,5363,221,5142,8.18%,4.12%
2020-01-01 00:15:10,10,1,1638,297,1341,2.50%,18.13%
2020-01-01 00:15:10,10,2,3494,356,3138,5.33%,10.19%
2020-01-01 00:15:10,10,3,1657,18,1639,2.53%,1.09%
2020-01-01 00:15:10,10,4,3595,1004,2591,5.49%,27.93%
2020-01-01 00:15:10,10,5,940,92,848,1.43%,9.79%
2020-01-01 00:15:10,10,6,5880,1222,4658,8.97%,20.78%
2020-01-01 00:15:10,10,7,11699,2058,9641,17.85%,17.59%
2020-01-01 00:15:10,10,8,29824,7521,22303,45.51%,25.22%
2020-01-01 00:15:10,10,9,394,2,392,0.60%,0.51%
2020-01-01 00:15:10,10,10,2353,50,2303,3.59%,2.12%
2020-01-01 00:15:10,10,11,14295,1827,12468,21.81%,12.78%
2020-01-01 00:15:10,10,12,11312,1318,9994,17.26%,11.65%
2020-01-01 00:15:10,11,1,2206,40,2166,3.37%,1.81%
2020-01-01 00:15:10,11,2,3505,99,3406,5.35%,2.82%
2020-01-01 00:15:10,11,3,1006,6,1000,1.54%,0.60%
2020-01-01 00:15:10,11,4,4766,161,4605,7.27%,3.38%
2020-01-01 00:15:10,11,5,336,0,336,0.51%,0.00%
2020-01-01 00:15:10,11,6,6041,257,5784,9.22%,4.25%
2020-01-01 00:15:10,11,7,11481,986,10495,17.52%,8.59%
2020-01-01 00:15:10,11,8,26602,4745,21857,40.59%,17.84%
2020-01-01 00:15:10,11,9,180,1,179,0.27%,0.56%
2020-01-01 00:15:10,11,10,3237,77,3160,4.94%,2.38%
2020-01-01 00:15:10,11,11,10394,790,9604,15.86%,7.60%
2020-01-01 00:15:10,11,12,6859,368,6491,10.47%,5.37%
2020-01-01 00:15:10,12,1,27,0,27,0.04%,0.00%
2020-01-01 00:15:10,12,2,596,133,463,0.91%,22.32%
2020-01-01 00:15:10,12,3,3030,192,2838,4.62%,6.34%
2020-01-01 00:15:10,12,4,3072,70,3002,4.69%,2.28%
2020-01-01 00:15:10,12,5,8911,674,8237,13.60%,7.56%
2020-01-01 00:15:10,12,6,5138,191,4947,7.84%,3.72%
2020-01-01 00:15:10,12,7,1963,36,1927,3.00%,1.83%
2020-01-01 00:15:10,12,8,1401,298,1103,2.14%,21.27%
2020-01-01 00:15:10,12,9,22080,4400,17680,33.69%,19.93%
2020-01-01 00:15:10,12,10,4490,423,4067,6.85%,9.42%
2020-01-01 00:15:10,12,11,1586,304,1282,2.42%,19.17%
2020-01-01 00:15:10,12,12,8087,1484,6603,12.34%,18.35%
2020-01-01 00:15:10,13,1,1780,21,1759,2.72%,1.18%
2020-01-01 00:15:10,13,2,2115,37,2078,3.23%,1.75%
2020-01-01 00:15:10,13,3,814,5,809,1.24%,0.61%
2020-01-01 00:15:10,13,4,5541,944,4597,8.45%,17.04%
2020-01-01 00:15:10,13,5,7800,1281,6519,11.90%,16.42%
2020-01-01 00:15:10,13,6,6087,982,5105,9.29%,16.13%
2020-01-01 00:15:10,13,7,4059,134,3925,6.19%,3.30%
2020-01-01 00:15:10,13,8,6914,363,6551,10.55%,5.25%
2020-01-01 00:15:10,13,9,8222,1332,6890,12.55%,16.20%
2020-01-01 00:15:10,13,10,28731,6339,22392,43.84%,22.06%
2020-01-01 00:15:10,13,11,18117,2608,15509,27.64%,14.40%
2020-01-01 00:15:10,13,12,10681,1150,9531,16.30%,10.77%
2020-01-01 00:15:10,14,1,297,0,297,0.45%,0.00%
2020-01-01 00:15:10,14,2,1377,10,1367,2.10%,0.73%
2020-01-01 00:15:10,14,3,890,3,887,1.36%,0.34%
2020-01-01 00:15:10,14,4,3477,90,3387,5.31%,2.59%
2020-01-01 00:15:10,14,5,1240,13,1227,1.89%,1.05%
2020-01-01 00:15:10,14,6,3743,104,3639,5.71%,2.78%
2020-01-01 00:15:10,14,7,11488,972,10516,17.53%,8.46%
2020-01-01 00:15:10,14,8,13121,1268,11853,20.02%,9.66%
2020-01-01 00:15:10,14,9,1438,18,1420,2.19%,1.25%
2020-01-01 00:15:10,14,10,4791,176,4615,7.31%,3.67%
2020-01-01 00:15:10,14,11,27644,5142,22502,42.18%,18.60%
2020-01-01 00:15:10,14,12,9350,632,8718,14.27%,6.76%
2020-01-01 00:15:10,15,1,468,1,467,0.71%,0.21%
2020-01-01 00:15:10,15,2,178,1,177,0.27%,0.56%
2020-01-01 00:15:10,15,3,3833,104,3729,5.85%,2.71%
2020-01-01 00:15:10,15,4,4453,186,4267,6.79%,4.18%
2020-01-01 00:15:10,15,5,9214,653,8561,14.06%,7.09%
2020-01-01 00:15:10,15,6,4816,252,4564,7.35%,5.23%
2020-01-01 00:15:10,15,7,3763,119,3644,5.74%,3.16%
2020-01-01 00:15:10,15,8,5998,287,5711,9.15%,4.78%
2020-01-01 00:15:10,15,9,9431,690,8741,14.39%,7.32%
2020-01-01 00:15:10,15,10,5347,535,4812,8.16%,10.01%
2020-01-01 00:15:10,15,11,11574,1237,10337,17.66%,10.69%
2020-01-01 00:15:10,15,12,26806,5408,21398,40.90%,20.17%
2020-01-01 00:15:10,16,1,398,0,398,0.61%,0.00%
2020-01-01 00:15:10,16,2,287,0,287,0.44%,0.00%
2020-01-01 00:15:10,16,3,3129,59,3070,4.77%,1.89%
2020-01-01 00:15:10,16,4,4115,128,3987,6.28%,3.11%
2020-01-01 00:15:10,16,5,9361,675,8686,14.28%,7.21%
2020-01-01 00:15:10,16,6,5099,197,4902,7.78%,3.86%
2020-01-01 00:15:10,16,7,3631,110,3521,5.54%,3.03%
2020-01-01 00:15:10,16,8,7533,467,7066,11.49%,6.20%
2020-01-01 00:15:10,16,9,9781,736,9045,14.92%,7.52%
2020-01-01 00:15:10,16,10,1665,20,1645,2.54%,1.20%
2020-01-01 00:15:10,16,11,9412,688,8724,14.36%,7.31%
2020-01-01 00:15:10,16,12,26566,4747,21819,40.54%,17.87%
2020-01-01 00:15:20,1,1,17408,2111,15297,26.56%,12.13%
2020-01-01 00:15:20,1,2,7295,397,6898,11.13%,5.44%
2020-01-01 00:15:20,1,3,1498,13,1485,2.29%,0.87%
2020-01-01 00:15:20,1,4,9726,712,9014,14.84%,7.32%
2020-01-01 00:15:20,1,5,9097,639,8458,13.88%,7.02%
2020-01-01 00:15:20,1,6,9052,631,8421,13.81%,6.97%
2020-01-01 00:15:20,1,7,5770,249,5521,8.80%,4.32%
2020-01-01 00:15:20,1,8,5289,207,5082,8.07%,3.91%
2020-01-01 00:15:20,1,9,9011,628,8383,13.75%,6.97%
2020-01-01 00:15:20,1,10,4552,145,4407,6.95%,3.19%
2020-01-01 00:15:20,1,11,4635,153,4482,7.07%,3.30%
2020-01-01 00:15:20,1,12,8980,626,8354,13.70%,6.97%
2020-01-01 00:15:20,2,1,527,2,525,0.80%,0.38%
2020-01-01 00:15:20,2,2,28978,5557,23421,44.22%,19.18%
2020-01-01 00:15:20,2,3,24120,3939,20181,36.80%,16.33%
2020-01-01 00:15:20,2,4,411,1,410,0.63%,0.24%
2020-01-01 00:15:20,2,5,15652,1667,13985,23.88%,10.65%
2020-01-01 00:15:20,2,6,226,0,226,0.34%,0.00%
2020-01-01 00:15:20,2,7,4302,150,4152,6.56%,3.49%
2020-01-01 00:15:20,2,8,2794,66,2728,4.26%,2.36%
2020-01-01 00:15:20,2,9,15571,1657,13914,23.76%,10.64%
2020-01-01 00:15:20,2,10,2018,40,1978,3.08%,1.98%
2020-01-01 00:15:20,2,11,2031,42,1989,3.10%,2.07%
2020-01-01 00:15:20,2,12,15441,1630,13811,23.56%,10.56%
2020-01-01 00:15:20,3,1,1571,12,1559,2.40%,0.76%
2020-01-01 00:15:20,3,2,24094,3855,20239,36.76%,16.00%
2020-01-01 00:15:20,3,3,65882,24325,41557,100.53%,36.92%
2020-01-01 00:15:20,3,4,4699,171,4528,7.17%,3.64%
2020-01-01 00:15:20,3,5,40864,10479,30385,62.35%,25.64%
2020-01-01 00:15:20,3,6,5972,261,5711,9.11%,4.37%
2020-01-01 00:15:20,3,7,20601,2919,17682,31.43%,14.17%
2020-01-01 00:15:20,3,8,16971,2016,14955,25.90%,11.88%
2020-01-01 00:15:20,3,9,34492,7712,26780,52.63%,22.36%
2020-01-01 00:15:20,3,10,6139,290,5849,9.37%,4.72%
2020-01-01 00:15:20,3,11,1834,22,1812,2.80%,1.20%
2020-01-01 00:15:20,3,12,25148,4301,20847,38.37%,17.10%
2020-01-01 00:15:20,4,1,494,3,491,0.75%,0.61%
2020-01-01 00:15:20,4,2,298,2,296,0.45%,0.67%
2020-01-01 00:15:20,4,3,958,6,952,1.46%,0.63%
2020-01-01 00:15:20,4,4,28163,5269,22894,42.97%,18.71%
2020-01-01 00:15:20,4,5,17438,2120,15318,26.61%,12.16%
2020-01-01 00:15:20,4,6,24224,3992,20232,36.96%,16.48%
2020-01-01 00:15:20,4,7,5522,234,5288,8.43%,4.24%
2020-01-01 00:15:20,4,8,3136,79,3057,4.79%,2.52%
2020-01-01 00:15:20,4,9,15222,1618,13604,23.23%,10.63%
2020-01-01 00:15:20,4,10,1976,30,1946,3.02%,1.52%
2020-01-01 00:15:20,4,11,161,0,161,0.25%,0.00%
2020-01-01 00:15:20,4,12,12633,1132,11501,19.28%,8.96%
2020-01-01 00:15:20,5,1,3254,73,3181,4.97%,2.24%
2020-01-01 00:15:20,5,2,736,4,732,1.12%,0.54%
2020-01-01 00:15:20,5,3,895,8,887,1.37%,0.89%
2020-01-01 00:15:20,5,4,24953,4251,20702,38.08%,17.04%
2020-01-01 00:15:20,5,5,10045,724,9321,15.33%,7.21%
2020-01-01 00:15:20,5,6,15300,1674,13626,23.35%,10.94%
2020-01-01 00:15:20,5,7,4776,168,4608,7.29%,3.52%
2020-01-01 00:15:20,5,8,3468,92,3376,5.29%,2.65%
2020-01-01 00:15:20,5,9,8955,576,8379,13.66%,6.43%
2020-01-01 00:15:20,5,10,1089,7,1082,1.66%,0.64%
2020-01-01 00:15:20,5,11,663,5,658,1.01%,0.75%
2020-01-01 00:15:20,5,12,7418,395,7023,11.32%,5.32%
2020-01-01 00:15:20,6,1,1136,9,1127,1.73%,0.79%
2020-01-01 00:15:20,6,2,1267,13,1254,1.93%,1.03%
2020-01-01 00:15:20,6,3,1809,23,1786,2.76%,1.27%
2020-01-01 00:15:20,6,4,1375,16,1359,2.10%,1.16%
2020-01-01 00:15:20,6,5,17009,1967,15042,25.95%,11.56%
2020-01-01 00:15:20,6,6,5808,231,5577,8.86%,3.98%
2020-01-01 00:15:20,6,7,4013,105,3908,6.12%,2.62%
2020-01-01 00:15:20,6,8,3410,81,3329,5.20%,2.38%
2020-01-01 00:15:20,6,9,9034,539,8495,13.78%,5.97%
2020-01-01 00:15:20,6,10,1971,30,1941,3.01%,1.52%
2020-01-01 00:15:20,6,11,396,1,395,0.60%,0.25%
2020-01-01 00:15:20,6,12,6980,320,6660,10.65%,4.58%
2020-01-01 00:15:20,7,1,522,2,520,0.80%,0.38%
2020-01-01 00:15:20,7,2,107,0,107,0.16%,0.00%
2020-01-01 00:15:20,7,3,934,6,928,1.43%,0.64%
2020-01-01 00:15:20,7,4,1868,34,1834,2.85%,1.82%
2020-01-01 00:15:20,7,5,7209,370,6839,11.00%,5.13%
2020-01-01 00:15:20,7,6,13015,1207,11808,19.86%,9.27%
2020-01-01 00:15:20,7,7,3904,131,3773,5.96%,3.36%
2020-01-01 00:15:20,7,8,1680,21,1659,2.56%,1.25%
2020-01-01 00:15:20,7,9,6106,262,5844,9.32%,4.29%
2020-01-01 00:15:20,7,10,1084,3,1081,1.65%,0.28%
2020-01-01 00:15:20,7,11,240,0,240,0.37%,0.00%
2020-01-01 00:15:20,7,12,4987,181,4806,7.61%,3.63%
2020-01-01 00:15:20,8,1,568,2,566,0.87%,0.35%
2020-01-01 00:15:20,8,2,149,0,149,0.23%,0.00%
2020-01-01 00:15:20,8,3,1736,21,1715,2.65%,1.21%
2020-01-01 00:15:20,8,4,2702,55,2647,4.12%,2.04%
2020-01-01 00:15:20,8,5,8177,472,7705,12.48%,5.77%
2020-01-01 00:15:20,8,6,17240,2063,15177,26.31%,11.97%
2020-01-01 00:15:20,8,7,6308,279,6029,9.63%,4.42%
2020-01-01 00:15:20,8,8,2591,53,2538,3.95%,2.05%
2020-01-01 00:15:20,8,9,6233,293,5940,9.51%,4.70%
2020-01-01 00:15:20,8,10,1636,29,1607,2.50%,1.77%
2020-01-01 00:15:20,8,11,392,1,391,0.60%,0.26%
2020-01-01 00:15:20,8,12,4565,148,4417,6.97%,3.24%
2020-01-01 00:15:20,9,1,749,0,749,1.14%,0.00%
2020-01-01 00:15:20,9,2,5043,187,4856,7.70%,3.71%
2020-01-01 00:15:20,9,3,3957,113,3844,6.04%,2.86%
2020-01-01 00:15:20,9,4,5805,265,5540,8.86%,4.57%
2020-01-01 00:15:20,9,5,299,0,299,0.46%,0.00%
2020-01-01 00:15:20,9,6,6665,346,6319,10.17%,5.19%
2020-01-01 00:15:20,9,7,29167,5694,23473,44.51%,19.52%
2020-01-01 00:15:20,9,8,11350,916,10434,17.32%,8.07%
2020-01-01 00:15:20,9,9,201,0,201,0.31%,0.00%
2020-01-01 00:15:20,9,10,4834,146,4688,7.38%,3.02%
2020-01-01 00:15:20,9,11,10278,703,9575,15.68%,6.84%
2020-01-01 00:15:20,9,12,4993,179,4814,7.62%,3.59%
2020-01-01 00:15:20,10,1,1421,281,1140,2.17%,19.77%
2020-01-01 00:15:20,10,2,3095,356,2739,4.72%,11.50%
2020-01-01 00:15:20,10,3,1478,19,1459,2.26%,1.29%
2020-01-01 00:15:20,10,4,4027,802,3225,6.14%,19.92%
2020-01-01 00:15:20,10,5,715,31,684,1.09%,4.34%
2020-01-01 00:15:20,10,6,6351,1008,5343,9.69%,15.87%
2020-01-01 00:15:20,10,7,11435,1843,9592,17.45%,16.12%
2020-01-01 00:15:20,10,8,29113,7172,21941,44.42%,24.64%
2020-01-01 00:15:20,10,9,655,2,653,1.00%,0.31%
2020-01-01 00:15:20,10,10,2797,56,2741,4.27%,2.00%
2020-01-01 00:15:20,10,11,13667,1659,12008,20.85%,12.14%
2020-01-01 00:15:20,10,12,10209,1123,9086,15.58%,11.00%
2020-01-01 00:15:20,11,1,2611,53,2558,3.98%,2.03%
2020-01-01 00:15:20,11,2,4154,136,4018,6.34%,3.27%
2020-01-01 00:15:20,11,3,1391,10,1381,2.12%,0.72%
2020-01-01 00:15:20,11,4,5245,184,5061,8.00%,3.51%
2020-01-01 00:15:20,11,5,174,0,174,0.27%,0.00%
2020-01-01 00:15:20,11,6,6308,244,6064,9.63%,3.87%
2020-01-01 00:15:20,11,7,12584,1100,11484,19.20%,8.74%
2020-01-01 00:15:20,11,8,28523,5425,23098,43.52%,19.02%
2020-01-01 00:15:20,11,9,279,1,278,0.43%,0.36%
2020-01-01 00:15:20,11,10,4130,124,4006,6.30%,3.00%
2020-01-01 00:15:20,11,11,11124,928,10196,16.97%,8.34%
2020-01-01 00:15:20,11,12,6708,344,6364,10.24%,5.13%
2020-01-01 00:15:20,12,1,36,0,36,0.05%,0.00%
2020-01-01 00:15:20,12,2,666,195,471,1.02%,29.28%
2020-01-01 00:15:20,12,3,2831,246,2585,4.32%,8.69%
2020-01-01 00:15:20,12,4,3394,87,3307,5.18%,2.56%
2020-01-01 00:15:20,12,5,10421,921,9500,15.90%,8.84%
2020-01-01 00:15:20,12,6,6591,321,6270,10.06%,4.87%
2020-01-01 00:15:20,12,7,3080,87,2993,4.70%,2.82%
2020-01-01 00:15:20,12,8,1257,228,1029,1.92%,18.14%
2020-01-01 00:15:20,12,9,23460,4797,18663,35.80%,20.45%
2020-01-01 00:15:20,12,10,4624,369,4255,7.06%,7.98%
2020-01-01 00:15:20,12,11,1573,234,1339,2.40%,14.88%
2020-01-01 00:15:20,12,12,7603,1246,6357,11.60%,16.39%
2020-01-01 00:15:20,13,1,2029,33,1996,3.10%,1.63%
2020-01-01 00:15:20,13,2,2375,41,2334,3.62%,1.73%
2020-01-01 00:15:20,13,3,782,6,776,1.19%,0.77%
2020-01-01 00:15:20,13,4,6166,637,5529,9.41%,10.33%
2020-01-01 00:15:20,13,5,9058,1049,8009,13.82%,11.58%
2020-01-01 00:15:20,13,6,7239,729,6510,11.05%,10.07%
2020-01-01 00:15:20,13,7,4819,181,4638,7.35%,3.76%
2020-01-01 00:15:20,13,8,6807,361,6446,10.39%,5.30%
2020-01-01 00:15:20,13,9,9322,1079,8243,14.22%,11.57%
2020-01-01 00:15:20,13,10,27971,5825,22146,42.68%,20.83%
2020-01-01 00:15:20,13,11,16101,2160,13941,24.57%,13.42%
2020-01-01 00:15:20,13,12,8747,868,7879,13.35%,9.92%
2020-01-01 00:15:20,14,1,339,0,339,0.52%,0.00%
2020-01-01 00:15:20,14,2,1493,16,1477,2.28%,1.07%
2020-01-01 00:15:20,14,3,953,8,945,1.45%,0.84%
2020-01-01 00:15:20,14,4,4014,99,3915,6.12%,2.47%
2020-01-01 00:15:20,14,5,1398,15,1383,2.13%,1.07%
2020-01-01 00:15:20,14,6,4252,114,4138,6.49%,2.68%
2020-01-01 00:15:20,14,7,11740,940,10800,17.91%,8.01%
2020-01-01 00:15:20,14,8,13666,1279,12387,20.85%,9.36%
2020-01-01 00:15:20,14,9,1611,19,1592,2.46%,1.18%
2020-01-01 00:15:20,14,10,4692,191,4501,7.16%,4.07%
2020-01-01 00:15:20,14,11,26123,4538,21585,39.86%,17.37%
2020-01-01 00:15:20,14,12,7529,384,7145,11.49%,5.10%
2020-01-01 00:15:20,15,1,436,1,435,0.67%,0.23%
2020-01-01 00:15:20,15,2,308,1,307,0.47%,0.32%
2020-01-01 00:15:20,15,3,3739,115,3624,5.71%,3.08%
2020-01-01 00:15:20,15,4,4940,194,4746,7.54%,3.93%
2020-01-01 00:15:20,15,5,9511,679,8832,14.51%,7.14%
2020-01-01 00:15:20,15,6,5346,232,5114,8.16%,4.34%
2020-01-01 00:15:20,15,7,4048,161,3887,6.18%,3.98%
2020-01-01 00:15:20,15,8,5992,321,5671,9.14%,5.36%
2020-01-01 00:15:20,15,9,9765,716,9049,14.90%,7.33%
2020-01-01 00:15:20,15,10,4067,214,3853,6.21%,5.26%
2020-01-01 00:15:20,15,11,10428,895,9533,15.91%,8.58%
2020-01-01 00:15:20,15,12,26071,5137,20934,39.78%,19.70%
2020-01-01 00:15:20,16,1,388,2,386,0.59%,0.52%
2020-01-01 00:15:20,16,2,321,0,321,0.49%,0.00%
2020-01-01 00:15:20,16,3,2831,66,2765,4.32%,2.33%
2020-01-01 00:15:20,16,4,3934,114,3820,6.00%,2.90%
2020-01-01 00:15:20,16,5,8852,621,8231,13.51%,7.02%
2020-01-01 00:15:20,16,6,4765,174,4591,7.27%,3.65%
2020-01-01 00:15:20,16,7,3383,84,3299,5.16%,2.48%
2020-01-01 00:15:20,16,8,7269,377,6892,11.09%,5.19%
2020-01-01 00:15:20,16,9,9270,665,8605,14.14%,7.17%
2020-01-01 00:15:20,16,10,1750,33,1717,2.67%,1.89%
2020-01-01 00:15:20,16,11,9291,663,8628,14.18%,7.14%
2020-01-01 00:15:20,16,12,26848,4836,22012,40.97%,18.01%
2020-01-01 00:15:30,1,1,16458,1953,14505,25.11%,11.87%
2020-01-01 00:15:30,1,2,5576,252,5324,8.51%,4.52%
2020-01-01 00:15:30,1,3,451,0,451,0.69%,0.00%
2020-01-01 00:15:30,1,4,10593,828,9765,16.16%,7.82%
2020-01-01 00:15:30,1,5,10323,785,9538,15.75%,7.60%
2020-01-01 00:15:30,1,6,10274,777,9497,15.68%,7.56%
2020-01-01 00:15:30,1,7,5095,217,4878,7.77%,4.26%
2020-01-01 00:15:30,1,8,4364,155,4209,6.66%,3.55%
2020-01-01 00:15:30,1,9,10214,774,9440,15.59%,7.58%
2020-01-01 00:15:30,1,10,3664,104,3560,5.59%,2.84%
2020-01-01 00:15:30,1,11,3764,111,3653,5.74%,2.95%
2020-01-01 00:15:30,1,12,10190,767,9423,15.55%,7.53%
2020-01-01 00:15:30,2,1,568,1,567,0.87%,0.18%
2020-01-01 00:15:30,2,2,24388,4066,20322,37.21%,16.67%
2020-01-01 00:15:30,2,3,19813,2740,17073,30.23%,13.83%
2020-01-01 00:15:30,2,4,481,0,481,0.73%,0.00%
2020-01-01 00:15:30,2,5,11352,966,10386,17.32%,8.51%
2020-01-01 00:15:30,2,6,119,0,119,0.18%,0.00%
2020-01-01 00:15:30,2,7,3991,132,3859,6.09%,3.31%
2020-01-01 00:15:30,2,8,2919,61,2858,4.45%,2.09%
2020-01-01 00:15:30,2,9,11232,943,10289,17.14%,8.40%
2020-01-01 00:15:30,2,10,2065,28,2037,3.15%,1.36%
2020-01-01 00:15:30,2,11,2105,28,2077,3.21%,1.33%
2020-01-01 00:15:30,2,12,11101,926,10175,16.94%,8.34%
2020-01-01 00:15:30,3,1,1632,20,1612,2.49%,1.23%
2020-01-01 00:15:30,3,2,26901,4767,22134,41.05%,17.72%
2020-01-01 00:15:30,3,3,75406,30635,44771,115.06%,40.63%
2020-01-01 00:15:30,3,4,9497,629,8868,14.49%,6.62%
2020-01-01 00:15:30,3,5,47249,13644,33605,72.10%,28.88%
2020-01-01 00:15:30,3,6,11086,869,10217,16.92%,7.84%
2020-01-01 00:15:30,3,7,23308,3606,19702,35.57%,15.47%
2020-01-01 00:15:30,3,8,19208,2497,16711,29.31%,13.00%
2020-01-01 00:15:30,3,9,35759,8266,27493,54.56%,23.12%
2020-01-01 00:15:30,3,10,4170,134,4036,6.36%,3.21%
2020-01-01 00:15:30,3,11,2774,45,2729,4.23%,1.62%
2020-01-01 00:15:30,3,12,28356,5337,23019,43.27%,18.82%
2020-01-01 00:15:30,4,1,539,4,535,0.82%,0.74%
2020-01-01 00:15:30,4,2,354,1,353,0.54%,0.28%
2020-01-01 00:15:30,4,3,1158,3,1155,1.77%,0.26%
2020-01-01 00:15:30,4,4,28010,5290,22720,42.74%,18.89%
2020-01-01 00:15:30,4,5,17607,2204,15403,26.87%,12.52%
2020-01-01 00:15:30,4,6,23938,3937,20001,36.53%,16.45%
2020-01-01 00:15:30,4,7,5068,215,4853,7.73%,4.24%
2020-01-01 00:15:30,4,8,2821,66,2755,4.30%,2.34%
2020-01-01 00:15:30,4,9,15007,1614,13393,22.90%,10.75%
2020-01-01 00:15:30,4,10,1897,35,1862,2.89%,1.85%
2020-01-01 00:15:30,4,11,152,0,152,0.23%,0.00%
2020-01-01 00:15:30,4,12,12495,1106,11389,19.07%,8.85%
2020-01-01 00:15:30,5,1,2952,67,2885,4.50%,2.27%
2020-01-01 00:15:30,5,2,772,6,766,1.18%,0.78%
2020-01-01 00:15:30,5,3,421,0,421,0.64%,0.00%
2020-01-01 00:15:30,5,4,25289,4298,20991,38.59%,17.00%
2020-01-01 00:15:30,5,5,10073,712,9361,15.37%,7.07%
2020-01-01 00:15:30,5,6,15384,1634,13750,23.47%,10.62%
2020-01-01 00:15:30,5,7,4707,175,4532,7.18%,3.72%
2020-01-01 00:15:30,5,8,3677,104,3573,5.61%,2.83%
2020-01-01 00:15:30,5,9,9462,633,8829,14.44%,6.69%
2020-01-01 00:15:30,5,10,1052,7,1045,1.61%,0.67%
2020-01-01 00:15:30,5,11,815,8,807,1.24%,0.98%
2020-01-01 00:15:30,5,12,7802,437,7365,11.90%,5.60%
2020-01-01 00:15:30,6,1,1014,14,1000,1.55%,1.38%
2020-01-01 00:15:30,6,2,1141,14,1127,1.74%,1.23%
2020-01-01 00:15:30,6,3,1772,27,1745,2.70%,1.52%
2020-01-01 00:15:30,6,4,1332,20,1312,2.03%,1.50%
2020-01-01 00:15:30,6,5,17483,2101,15382,26.68%,12.02%
2020-01-01 00:15:30,6,6,4941,185,4756,7.54%,3.74%
2020-01-01 00:15:30,6,7,3120,77,3043,4.76%,2.47%
2020-01-01 00:15:30,6,8,2553,59,2494,3.90%,2.31%
2020-01-01 00:15:30,6,9,10441,763,9678,15.93%,7.31%
2020-01-01 00:15:30,6,10,2205,39,2166,3.36%,1.77%
2020-01-01 00:15:30,6,11,425,2,423,0.65%,0.47%
2020-01-01 00:15:30,6,12,8141,466,7675,12.42%,5.72%
2020-01-01 00:15:30,7,1,472,2,470,0.72%,0.42%
2020-01-01 00:15:30,7,2,154,0,154,0.23%,0.00%
2020-01-01 00:15:30,7,3,1133,5,1128,1.73%,0.44%
2020-01-01 00:15:30,7,4,2000,49,1951,3.05%,2.45%
2020-01-01 00:15:30,7,5,7116,335,6781,10.86%,4.71%
2020-01-01 00:15:30,7,6,12024,1100,10924,18.35%,9.15%
2020-01-01 00:15:30,7,7,2866,83,2783,4.37%,2.90%
2020-01-01 00:15:30,7,8,1013,27,986,1.55%,2.67%
2020-01-01 00:15:30,7,9,5900,243,5657,9.00%,4.12%
2020-01-01 00:15:30,7,10,1227,14,1213,1.87%,1.14%
2020-01-01 00:15:30,7,11,112,0,112,0.17%,0.00%
2020-01-01 00:15:30,7,12,4702,141,4561,7.17%,3.00%
2020-01-01 00:15:30,8,1,542,2,540,0.83%,0.37%
2020-01-01 00:15:30,8,2,121,0,121,0.18%,0.00%
2020-01-01 00:15:30,8,3,2009,24,1985,3.07%,1.19%
2020-01-01 00:15:30,8,4,2740,56,2684,4.18%,2.04%
2020-01-01 00:15:30,8,5,8357,515,7842,12.75%,6.16%
2020-01-01 00:15:30,8,6,19111,2545,16566,29.16%,13.32%
2020-01-01 00:15:30,8,7,7983,477,7506,12.18%,5.98%
2020-01-01 00:15:30,8,8,4727,177,4550,7.21%,3.74%
2020-01-01 00:15:30,8,9,6155,284,5871,9.39%,4.61%
2020-01-01 00:15:30,8,10,1604,16,1588,2.45%,1.00%
2020-01-01 00:15:30,8,11,310,1,309,0.47%,0.32%
2020-01-01 00:15:30,8,12,4441,158,4283,6.78%,3.56%
2020-01-01 00:15:30,9,1,235,0,235,0.36%,0.00%
2020-01-01 00:15:30,9,2,2186,40,2146,3.34%,1.83%
2020-01-01 00:15:30,9,3,1634,25,1609,2.49%,1.53%
2020-01-01 00:15:30,9,4,8471,534,7937,12.93%,6.30%
2020-01-01 00:15:30,9,5,513,3,510,0.78%,0.58%
2020-01-01 00:15:30,9,6,9667,693,8974,14.75%,7.17%
2020-01-01 00:15:30,9,7,27135,5064,22071,41.40%,18.66%
2020-01-01 00:15:30,9,8,10134,800,9334,15.46%,7.89%
2020-01-01 00:15:30,9,9,487,3,484,0.74%,0.62%
2020-01-01 00:15:30,9,10,3567,94,3473,5.44%,2.64%
2020-01-01 00:15:30,9,11,8582,584,7998,13.10%,6.80%
2020-01-01 00:15:30,9,12,4694,183,4511,7.16%,3.90%
2020-01-01 00:15:30,10,1,1211,287,924,1.85%,23.70%
2020-01-01 00:15:30,10,2,2781,329,2452,4.24%,11.83%
2020-01-01 00:15:30,10,3,1366,18,1348,2.08%,1.32%
2020-01-01 00:15:30,10,4,4564,984,3580,6.96%,21.56%
2020-01-01 00:15:30,10,5,601,1,600,0.92%,0.17%
2020-01-01 00:15:30,10,6,6590,1109,5481,10.06%,16.83%
2020-01-01 00:15:30,10,7,11171,1901,9270,17.05%,17.02%
2020-01-01 00:15:30,10,8,26913,6590,20323,41.07%,24.49%
2020-01-01 00:15:30,10,9,679,3,676,1.04%,0.44%
2020-01-01 00:15:30,10,10,2539,61,2478,3.87%,2.40%
2020-01-01 00:15:30,10,11,11930,1391,10539,18.20%,11.66%
2020-01-01 00:15:30,10,12,8740,934,7806,13.34%,10.69%
2020-01-01 00:15:30,11,1,2244,41,2203,3.42%,1.83%
2020-01-01 00:15:30,11,2,3417,97,3320,5.21%,2.84%
2020-01-01 00:15:30,11,3,984,11,973,1.50%,1.12%
2020-01-01 00:15:30,11,4,4735,172,4563,7.23%,3.63%
2020-01-01 00:15:30,11,5,726,3,723,1.11%,0.41%
2020-01-01 00:15:30,11,6,6131,270,5861,9.36%,4.40%
2020-01-01 00:15:30,11,7,12072,1120,10952,18.42%,9.28%
2020-01-01 00:15:30,11,8,25527,4469,21058,38.95%,17.51%
2020-01-01 00:15:30,11,9,190,1,189,0.29%,0.53%
2020-01-01 00:15:30,11,10,3380,72,3308,5.16%,2.13%
2020-01-01 00:15:30,11,11,10012,734,9278,15.28%,7.33%
2020-01-01 00:15:30,11,12,6417,313,6104,9.79%,4.88%
2020-01-01 00:15:30,12,1,23,0,23,0.04%,0.00%
2020-01-01 00:15:30,12,2,787,220,567,1.20%,27.95%
2020-01-01 00:15:30,12,3,2650,264,2386,4.04%,9.96%
2020-01-01 00:15:30,12,4,3139,58,3081,4.79%,1.85%
2020-01-01 00:15:30,12,5,11022,1033,9989,16.82%,9.37%
2020-01-01 00:15:30,12,6,6340,270,6070,9.67%,4.26%
2020-01-01 00:15:30,12,7,3077,68,3009,4.70%,2.21%
2020-01-01 00:15:30,12,8,1413,202,1211,2.16%,14.30%
2020-01-01 00:15:30,12,9,24011,4913,19098,36.64%,20.46%
2020-01-01 00:15:30,12,10,4262,308,3954,6.50%,7.23%
2020-01-01 00:15:30,12,11,1611,207,1404,2.46%,12.85%
2020-01-01 00:15:30,12,12,7730,1115,6615,11.80%,14.42%
2020-01-01 00:15:30,13,1,2256,38,2218,3.44%,1.68%
2020-01-01 00:15:30,13,2,2571,47,2524,3.92%,1.83%
2020-01-01 00:15:30,13,3,605,5,600,0.92%,0.83%
2020-01-01 00:15:30,13,4,4840,441,4399,7.39%,9.11%
2020-01-01 00:15:30,13,5,7236,786,6450,11.04%,10.86%
2020-01-01 00:15:30,13,6,5830,524,5306,8.90%,8.99%
2020-01-01 00:15:30,13,7,5197,208,4989,7.93%,4.00%
2020-01-01 00:15:30,13,8,7060,418,6642,10.77%,5.92%
2020-01-01 00:15:30,13,9,7551,827,6724,11.52%,10.95%
2020-01-01 00:15:30,13,10,27948,5799,22149,42.65%,20.75%
2020-01-01 00:15:30,13,11,17794,2596,15198,27.15%,14.59%
2020-01-01 00:15:30,13,12,10034,1142,8892,15.31%,11.38%
2020-01-01 00:15:30,14,1,338,0,338,0.52%,0.00%
2020-01-01 00:15:30,14,2,1658,18,1640,2.53%,1.09%
2020-01-01 00:15:30,14,3,1159,8,1151,1.77%,0.69%
2020-01-01 00:15:30,14,4,4096,143,3953,6.25%,3.49%
2020-01-01 00:15:30,14,5,1349,12,1337,2.06%,0.89%
2020-01-01 00:15:30,14,6,4296,153,4143,6.56%,3.56%
2020-01-01 00:15:30,14,7,11499,957,10542,17.55%,8.32%
2020-01-01 00:15:30,14,8,13444,1321,12123,20.51%,9.83%
2020-01-01 00:15:30,14,9,1609,14,1595,2.46%,0.87%
2020-01-01 00:15:30,14,10,4201,137,4064,6.41%,3.26%
2020-01-01 00:15:30,14,11,25308,4344,20964,38.62%,17.16%
2020-01-01 00:15:30,14,12,7388,379,7009,11.27%,5.13%
2020-01-01 00:15:30,15,1,473,4,469,0.72%,0.85%
2020-01-01 00:15:30,15,2,257,0,257,0.39%,0.00%
2020-01-01 00:15:30,15,3,4417,134,4283,6.74%,3.03%
2020-01-01 00:15:30,15,4,6120,319,5801,9.34%,5.21%
2020-01-01 00:15:30,15,5,12063,1058,11005,18.41%,8.77%
2020-01-01 00:15:30,15,6,6356,345,6011,9.70%,5.43%
2020-01-01 00:15:30,15,7,3857,131,3726,5.89%,3.40%
2020-01-01 00:15:30,15,8,5463,215,5248,8.34%,3.94%
2020-01-01 00:15:30,15,9,12303,1097,11206,18.77%,8.92%
2020-01-01 00:15:30,15,10,4511,141,4370,6.88%,3.13%
2020-01-01 00:15:30,15,11,10148,740,9408,15.48%,7.29%
2020-01-01 00:15:30,15,12,29277,6017,23260,44.67%,20.55%
2020-01-01 00:15:30,16,1,457,1,456,0.70%,0.22%
2020-01-01 00:15:30,16,2,214,0,214,0.33%,0.00%
2020-01-01 00:15:30,16,3,1315,15,1300,2.01%,1.14%
2020-01-01 00:15:30,16,4,4663,176,4487,7.12%,3.77%
2020-01-01 00:15:30,16,5,7934,531,7403,12.11%,6.69%
2020-01-01 00:15:30,16,6,5387,229,5158,8.22%,4.25%
2020-01-01 00:15:30,16,7,3715,106,3609,5.67%,2.85%
2020-01-01 00:15:30,16,8,7733,423,7310,11.80%,5.47%
2020-01-01 00:15:30,16,9,8322,578,7744,12.70%,6.95%
2020-01-01 00:15:30,16,10,1430,26,1404,2.18%,1.82%
2020-01-01 00:15:30,16,11,9355,628,8727,14.27%,6.71%
2020-01-01 00:15:30,16,12,25625,4545,21080,39.10%,17.74%
2020-01-01 00:15:40,1,1,18233,2334,15899,27.82%,12.80%
2020-01-01 00:15:40,1,2,8765,544,8221,13.37%,6.21%
2020-01-01 00:15:40,1,3,547,1,546,0.83%,0.18%
2020-01-01 00:15:40,1,4,9149,616,8533,13.96%,6.73%
2020-01-01 00:15:40,1,5,8814,582,8232,13.45%,6.60%
2020-01-01 00:15:40,1,6,8750,567,8183,13.35%,6.48%
2020-01-01 00:15:40,1,7,8196,486,7710,12.51%,5.93%
2020-01-01 00:15:40,1,8,7454,376,7078,11.37%,5.04%
2020-01-01 00:15:40,1,9,8685,561,8124,13.25%,6.46%
2020-01-01 00:15:40,1,10,6806,318,6488,10.39%,4.67%
2020-01-01 00:15:40,1,11,6886,328,6558,10.51%,4.76%
2020-01-01 00:15:40,1,12,8662,557,8105,13.22%,6.43%
2020-01-01 00:15:40,2,1,948,3,945,1.45%,0.32%
2020-01-01 00:15:40,2,2,27294,4926,22368,41.65%,18.05%
2020-01-01 00:15:40,2,3,20696,2933,17763,31.58%,14.17%
2020-01-01 00:15:40,2,4,835,2,833,1.27%,0.24%
2020-01-01 00:15:40,2,5,13032,1226,11806,19.89%,9.41%
2020-01-01 00:15:40,2,6,53,0,53,0.08%,0.00%
2020-01-01 00:15:40,2,7,5626,229,5397,8.58%,4.07%
2020-01-01 00:15:40,2,8,4227,124,4103,6.45%,2.93%
2020-01-01 00:15:40,2,9,12952,1214,11738,19.76%,9.37%
2020-01-01 00:15:40,2,10,3260,73,3187,4.97%,2.24%
2020-01-01 00:15:40,2,11,3289,75,3214,5.02%,2.28%
2020-01-01 00:15:40,2,12,12769,1176,11593,19.48%,9.21%
2020-01-01 00:15:40,3,1,2008,34,1974,3.06%,1.69%
2020-01-01 00:15:40,3,2,25327,4352,20975,38.65%,17.18%
2020-01-01 00:15:40,3,3,72008,28311,43697,109.88%,39.32%
2020-01-01 00:15:40,3,4,10893,872,10021,16.62%,8.01%
2020-01-01 00:15:40,3,5,45632,12743,32889,69.63%,27.93%
2020-01-01 00:15:40,3,6,11709,995,10714,17.87%,8.50%
2020-01-01 00:15:40,3,7,21546,3219,18327,32.88%,14.94%
2020-01-01 00:15:40,3,8,16638,1940,14698,25.39%,11.66%
2020-01-01 00:15:40,3,9,33350,7194,26156,50.89%,21.57%
2020-01-01 00:15:40,3,10,3831,112,3719,5.85%,2.92%
2020-01-01 00:15:40,3,11,2405,46,2359,3.67%,1.91%
2020-01-01 00:15:40,3,12,25877,4497,21380,39.49%,17.38%
2020-01-01 00:15:40,4,1,478,1,477,0.73%,0.21%
2020-01-01 00:15:40,4,2,325,0,325,0.50%,0.00%
2020-01-01 00:15:40,4,3,808,8,800,1.23%,0.99%
2020-01-01 00:15:40,4,4,27356,4980,22376,41.74%,18.20%
2020-01-01 00:15:40,4,5,17327,2135,15192,26.44%,12.32%
2020-01-01 00:15:40,4,6,23740,3788,19952,36.22%,15.96%
2020-01-01 00:15:40,4,7,5096,195,4901,7.78%,3.83%
2020-01-01 00:15:40,4,8,2939,58,2881,4.48%,1.97%
2020-01-01 00:15:40,4,9,15560,1741,13819,23.74%,11.19%
2020-01-01 00:15:40,4,10,1830,21,1809,2.79%,1.15%
2020-01-01 00:15:40,4,11,151,0,151,0.23%,0.00%
2020-01-01 00:15:40,4,12,12752,1197,11555,19.46%,9.39%
2020-01-01 00:15:40,5,1,3284,70,3214,5.01%,2.13%
2020-01-01 00:15:40,5,2,873,2,871,1.33%,0.23%
2020-01-01 00:15:40,5,3,393,1,392,0.60%,0.25%
2020-01-01 00:15:40,5,4,25033,4157,20876,38.20%,16.61%
2020-01-01 00:15:40,5,5,10070,721,9349,15.37%,7.16%
2020-01-01 00:15:40,5,6,15312,1645,13667,23.36%,10.74%
2020-01-01 00:15:40,5,7,4708,178,4530,7.18%,3.78%
2020-01-01 00:15:40,5,8,3620,111,3509,5.52%,3.07%
2020-01-01 00:15:40,5,9,9558,647,8911,14.58%,6.77%
2020-01-01 00:15:40,5,10,1330,17,1313,2.03%,1.28%
2020-01-01 00:15:40,5,11,644,5,639,0.98%,0.78%
2020-01-01 00:15:40,5,12,7873,420,7453,12.01%,5.33%
2020-01-01 00:15:40,6,1,1114,12,1102,1.70%,1.08%
2020-01-01 00:15:40,6,2,1283,13,1270,1.96%,1.01%
2020-01-01 00:15:40,6,3,2003,27,1976,3.06%,1.35%
2020-01-01 00:15:40,6,4,1135,11,1124,1.73%,0.97%
2020-01-01 00:15:40,6,5,13811,1368,12443,21.07%,9.91%
2020-01-01 00:15:40,6,6,3689,105,3584,5.63%,2.85%
2020-01-01 00:15:40,6,7,2057,37,2020,3.14%,1.80%
2020-01-01 00:15:40,6,8,1597,28,1569,2.44%,1.75%
2020-01-01 00:15:40,6,9,7897,456,7441,12.05%,5.77%
2020-01-01 00:15:40,6,10,2805,44,2761,4.28%,1.57%
2020-01-01 00:15:40,6,11,439,0,439,0.67%,0.00%
2020-01-01 00:15:40,6,12,4976,168,4808,7.59%,3.38%
2020-01-01 00:15:40,7,1,435,1,434,0.66%,0.23%
2020-01-01 00:15:40,7,2,149,0,149,0.23%,0.00%
2020-01-01 00:15:40,7,3,749,5,744,1.14%,0.67%
2020-01-01 00:15:40,7,4,1603,39,1564,2.45%,2.43%
2020-01-01 00:15:40,7,5,8818,573,8245,13.46%,6.50%
2020-01-01 00:15:40,7,6,14220,1434,12786,21.70%,10.08%
2020-01-01 00:15:40,7,7,3775,88,3687,5.76%,2.33%
2020-01-01 00:15:40,7,8,1846,23,1823,2.82%,1.25%
2020-01-01 00:15:40,7,9,7997,485,7512,12.20%,6.06%
2020-01-01 00:15:40,7,10,1793,19,1774,2.74%,1.06%
2020-01-01 00:15:40,7,11,103,0,103,0.16%,0.00%
2020-01-01 00:15:40,7,12,6202,297,5905,9.46%,4.79%
2020-01-01 00:15:40,8,1,334,0,334,0.51%,0.00%
2020-01-01 00:15:40,8,2,123,0,123,0.19%,0.00%
2020-01-01 00:15:40,8,3,1710,23,1687,2.61%,1.35%
2020-01-01 00:15:40,8,4,2983,61,2922,4.55%,2.04%
2020-01-01 00:15:40,8,5,9456,703,8753,14.43%,7.43%
2020-01-01 00:15:40,8,6,18264,2444,15820,27.87%,13.38%
2020-01-01 00:15:40,8,7,5786,246,5540,8.83%,4.25%
2020-01-01 00:15:40,8,8,2366,49,2317,3.61%,2.07%
2020-01-01 00:15:40,8,9,7412,429,6983,11.31%,5.79%
2020-01-01 00:15:40,8,10,1550,26,1524,2.37%,1.68%
2020-01-01 00:15:40,8,11,210,1,209,0.32%,0.48%
2020-01-01 00:15:40,8,12,5798,245,5553,8.85%,4.23%
2020-01-01 00:15:40,9,1,448,0,448,0.68%,0.00%
2020-01-01 00:15:40,9,2,4205,127,4078,6.42%,3.02%
2020-01-01 00:15:40,9,3,3174,70,3104,4.84%,2.21%
2020-01-01 00:15:40,9,4,4332,127,4205,6.61%,2.93%
2020-01-01 00:15:40,9,5,279,1,278,0.43%,0.36%
2020-01-01 00:15:40,9,6,5280,189,5091,8.06%,3.58%
2020-01-01 00:15:40,9,7,27433,5078,22355,41.86%,18.51%
2020-01-01 00:15:40,9,8,12022,1025,10997,18.34%,8.53%
2020-01-01 00:15:40,9,9,235,0,235,0.36%,0.00%
2020-01-01 00:15:40,9,10,4046,102,3944,6.17%,2.52%
2020-01-01 00:15:40,9,11,10505,756,9749,16.03%,7.20%
2020-01-01 00:15:40,9,12,6217,298,5919,9.49%,4.79%
2020-01-01 00:15:40,10,1,1104,211,893,1.68%,19.11%
2020-01-01 00:15:40,10,2,6239,482,5757,9.52%,7.73%
2020-01-01 00:15:40,10,3,4935,178,4757,7.53%,3.61%
2020-01-01 00:15:40,10,4,3929,789,3140,6.00%,20.08%
2020-01-01 00:15:40,10,5,709,2,707,1.08%,0.28%
2020-01-01 00:15:40,10,6,5659,899,4760,8.63%,15.89%
2020-01-01 00:15:40,10,7,14040,2145,11895,21.42%,15.28%
2020-01-01 00:15:40,10,8,33467,8742,24725,51.07%,26.12%
2020-01-01 00:15:40,10,9,1194,9,1185,1.82%,0.75%
2020-01-01 00:15:40,10,10,2914,71,2843,4.45%,2.44%
2020-01-01 00:15:40,10,11,13666,1704,11962,20.85%,12.47%
2020-01-01 00:15:40,10,12,9967,1171,8796,15.21%,11.75%
2020-01-01 00:15:40,11,1,2274,72,2202,3.47%,3.17%
2020-01-01 00:15:40,11,2,3409,110,3299,5.20%,3.23%
2020-01-01 00:15:40,11,3,969,11,958,1.48%,1.14%
2020-01-01 00:15:40,11,4,3194,78,3116,4.87%,2.44%
2020-01-01 00:15:40,11,5,188,0,188,0.29%,0.00%
2020-01-01 00:15:40,11,6,3875,97,3778,5.91%,2.50%
2020-01-01 00:15:40,11,7,9929,714,9215,15.15%,7.19%
2020-01-01 00:15:40,11,8,24652,4231,20421,37.62%,17.16%
2020-01-01 00:15:40,11,9,232,0,232,0.35%,0.00%
2020-01-01 00:15:40,11,10,3793,115,3678,5.79%,3.03%
2020-01-01 00:15:40,11,11,10958,900,10058,16.72%,8.21%
2020-01-01 00:15:40,11,12,6811,356,6455,10.39%,5.23%
2020-01-01 00:15:40,12,1,50,0,50,0.08%,0.00%
2020-01-01 00:15:40,12,2,663,184,479,1.01%,27.75%
2020-01-01 00:15:40,12,3,2769,230,2539,4.23%,8.31%
2020-01-01 00:15:40,12,4,2315,44,2271,3.53%,1.90%
2020-01-01 00:15:40,12,5,9136,724,8412,13.94%,7.92%
2020-01-01 00:15:40,12,6,5020,180,4840,7.66%,3.59%
2020-01-01 00:15:40,12,7,2548,56,2492,3.89%,2.20%
2020-01-01 00:15:40,12,8,1200,219,981,1.83%,18.25%
2020-01-01 00:15:40,12,9,21940,4233,17707,33.48%,19.29%
2020-01-01 00:15:40,12,10,3665,286,3379,5.59%,7.80%
2020-01-01 00:15:40,12,11,1369,222,1147,2.09%,16.22%
2020-01-01 00:15:40,12,12,8458,1219,7239,12.91%,14.41%
2020-01-01 00:15:40,13,1,2128,39,2089,3.25%,1.83%
2020-01-01 00:15:40,13,2,2589,56,2533,3.95%,2.16%
2020-01-01 00:15:40,13,3,701,2,699,1.07%,0.29%
2020-01-01 00:15:40,13,4,4745,565,4180,7.24%,11.91%
2020-01-01 00:15:40,13,5,7277,835,6442,11.10%,11.47%
2020-01-01 00:15:40,13,6,5785,649,5136,8.83%,11.22%
2020-01-01 00:15:40,13,7,4924,196,4728,7.51%,3.98%
2020-01-01 00:15:40,13,8,6889,383,6506,10.51%,5.56%
2020-01-01 00:15:40,13,9,7570,867,6703,11.55%,11.45%
2020-01-01 00:15:40,13,10,26859,5412,21447,40.98%,20.15%
2020-01-01 00:15:40,13,11,16560,2195,14365,25.27%,13.25%
2020-01-01 00:15:40,13,12,9167,941,8226,13.99%,10.27%
2020-01-01 00:15:40,14,1,343,2,341,0.52%,0.58%
2020-01-01 00:15:40,14,2,1513,29,1484,2.31%,1.92%
2020-01-01 00:15:40,14,3,1020,11,1009,1.56%,1.08%
2020-01-01 00:15:40,14,4,4201,129,4072,6.41%,3.07%
2020-01-01 00:15:40,14,5,1466,12,1454,2.24%,0.82%
2020-01-01 00:15:40,14,6,4556,156,4400,6.95%,3.42%
2020-01-01 00:15:40,14,7,12712,1196,11516,19.40%,9.41%
2020-01-01 00:15:40,14,8,14641,1583,13058,22.34%,10.81%
2020-01-01 00:15:40,14,9,1762,24,1738,2.69%,1.36%
2020-01-01 00:15:40,14,10,4545,154,4391,6.94%,3.39%
2020-01-01 00:15:40,14,11,27203,4980,22223,41.51%,18.31%
2020-01-01 00:15:40,14,12,7773,429,7344,11.86%,5.52%
2020-01-01 00:15:40,15,1,593,3,590,0.90%,0.51%
2020-01-01 00:15:40,15,2,175,0,175,0.27%,0.00%
2020-01-01 00:15:40,15,3,4531,159,4372,6.91%,3.51%
2020-01-01 00:15:40,15,4,5391,249,5142,8.23%,4.62%
2020-01-01 00:15:40,15,5,10839,899,9940,16.54%,8.29%
2020-01-01 00:15:40,15,6,5656,273,5383,8.63%,4.83%
2020-01-01 00:15:40,15,7,4091,139,3952,6.24%,3.40%
2020-01-01 00:15:40,15,8,6056,286,5770,9.24%,4.72%
2020-01-01 00:15:40,15,9,11041,934,10107,16.85%,8.46%
2020-01-01 00:15:40,15,10,3890,191,3699,5.94%,4.91%
2020-01-01 00:15:40,15,11,10115,824,9291,15.43%,8.15%
2020-01-01 00:15:40,15,12,27528,5424,22104,42.00%,19.70%
2020-01-01 00:15:40,16,1,445,5,440,0.68%,1.12%
2020-01-01 00:15:40,16,2,265,0,265,0.40%,0.00%
2020-01-01 00:15:40,16,3,1413,11,1402,2.16%,0.78%
2020-01-01 00:15:40,16,4,3962,128,3834,6.05%,3.23%
2020-01-01 00:15:40,16,5,7596,489,7107,11.59%,6.44%
2020-01-01 00:15:40,16,6,4625,162,4463,7.06%,3.50%
2020-01-01 00:15:40,16,7,3544,103,3441,5.41%,2.91%
2020-01-01 00:15:40,16,8,7253,439,6814,11.07%,6.05%
2020-01-01 00:15:40,16,9,7927,538,7389,12.10%,6.79%
2020-01-01 00:15:40,16,10,1553,15,1538,2.37%,0.97%
2020-01-01 00:15:40,16,11,8996,643,8353,13.73%,7.15%
2020-01-01 00:15:40,16,12,24628,4191,20437,37.58%,17.02%
2020-01-01 00:15:50,1,1,20233,2802,17431,30.87%,13.85%
2020-01-01 00:15:50,1,2,7307,386,6921,11.15%,5.28%
2020-01-01 00:15:50,1,3,713,2,711,1.09%,0.28%
2020-01-01 00:15:50,1,4,12590,1151,11439,19.21%,9.14%
2020-01-01 00:15:50,1,5,12266,1095,11171,18.72%,8.93%
2020-01-01 00:15:50,1,6,12186,1088,11098,18.59%,8.93%
2020-01-01 00:15:50,1,7,6576,330,6246,10.03%,5.02%
2020-01-01 00:15:50,1,8,5791,265,5526,8.84%,4.58%
2020-01-01 00:15:50,1,9,12140,1075,11065,18.52%,8.86%
2020-01-01 00:15:50,1,10,5015,204,4811,7.65%,4.07%
2020-01-01 00:15:50,1,11,5110,209,4901,7.80%,4.09%
2020-01-01 00:15:50,1,12,12114,1068,11046,18.48%,8.82%
2020-01-01 00:15:50,2,1,891,3,888,1.36%,0.34%
2020-01-01 00:15:50,2,2,25010,4266,20744,38.16%,17.06%
2020-01-01 00:15:50,2,3,20045,2841,17204,30.59%,14.17%
2020-01-01 00:15:50,2,4,830,2,828,1.27%,0.24%
2020-01-01 00:15:50,2,5,12877,1222,11655,19.65%,9.49%
2020-01-01 00:15:50,2,6,36,0,36,0.05%,0.00%
2020-01-01 00:15:50,2,7,4063,128,3935,6.20%,3.15%
2020-01-01 00:15:50,2,8,2880,53,2827,4.39%,1.84%
2020-01-01 00:15:50,2,9,12764,1193,11571,19.48%,9.35%
2020-01-01 00:15:50,2,10,2387,36,2351,3.64%,1.51%
2020-01-01 00:15:50,2,11,2392,36,2356,3.65%,1.51%
2020-01-01 00:15:50,2,12,12610,1172,11438,19.24%,9.29%
2020-01-01 00:15:50,3,1,1944,24,1920,2.97%,1.23%
2020-01-01 00:15:50,3,2,22306,3429,18877,34.04%,15.37%
2020-01-01 00:15:50,3,3,71601,27990,43611,109.25%,39.09%
2020-01-01 00:15:50,3,4,8164,489,7675,12.46%,5.99%
2020-01-01 00:15:50,3,5,48296,13999,34297,73.69%,28.99%
2020-01-01 00:15:50,3,6,9547,667,8880,14.57%,6.99%
2020-01-01 00:15:50,3,7,18756,2479,16277,28.62%,13.22%
2020-01-01 00:15:50,3,8,15082,1642,13440,23.01%,10.89%
2020-01-01 00:15:50,3,9,38345,9216,29129,58.51%,24.03%
2020-01-01 00:15:50,3,10,7740,438,7302,11.81%,5.66%
2020-01-01 00:15:50,3,11,2201,46,2155,3.36%,2.09%
2020-01-01 00:15:50,3,12,27991,5145,22846,42.71%,18.38%
2020-01-01 00:15:50,4,1,421,4,417,0.64%,0.95%
2020-01-01 00:15:50,4,2,246,0,246,0.38%,0.00%
2020-01-01 00:15:50,4,3,967,12,955,1.48%,1.24%
2020-01-01 00:15:50,4,4,27823,5265,22558,42.45%,18.92%
2020-01-01 00:15:50,4,5,17811,2304,15507,27.18%,12.94%
2020-01-01 00:15:50,4,6,24283,4070,20213,37.05%,16.76%
2020-01-01 00:15:50,4,7,5140,196,4944,7.84%,3.81%
2020-01-01 00:15:50,4,8,3304,86,3218,5.04%,2.60%
2020-01-01 00:15:50,4,9,15810,1853,13957,24.12%,11.72%
2020-01-01 00:15:50,4,10,1796,35,1761,2.74%,1.95%
2020-01-01 00:15:50,4,11,119,0,119,0.18%,0.00%
2020-01-01 00:15:50,4,12,12981,1274,11707,19.81%,9.81%
2020-01-01 00:15:50,5,1,3016,72,2944,4.60%,2.39%
2020-01-01 00:15:50,5,2,812,1,811,1.24%,0.12%
2020-01-01 00:15:50,5,3,972,3,969,1.48%,0.31%
2020-01-01 00:15:50,5,4,24173,3962,20211,36.89%,16.39%
2020-01-01 00:15:50,5,5,10771,845,9926,16.44%,7.85%
2020-01-01 00:15:50,5,6,15772,1735,14037,24.07%,11.00%
2020-01-01 00:15:50,5,7,4513,152,4361,6.89%,3.37%
2020-01-01 00:15:50,5,8,3671,96,3575,5.60%,2.62%
2020-01-01 00:15:50,5,9,9680,694,8986,14.77%,7.17%
2020-01-01 00:15:50,5,10,1746,18,1728,2.66%,1.03%
2020-01-01 00:15:50,5,11,911,5,906,1.39%,0.55%
2020-01-01 00:15:50,5,12,7574,425,7149,11.56%,5.61%
2020-01-01 00:15:50,6,1,1164,9,1155,1.78%,0.77%
2020-01-01 00:15:50,6,2,1264,11,1253,1.93%,0.87%
2020-01-01 00:15:50,6,3,1650,20,1630,2.52%,1.21%
2020-01-01 00:15:50,6,4,1524,19,1505,2.33%,1.25%
2020-01-01 00:15:50,6,5,15292,1757,13535,23.33%,11.49%
2020-01-01 00:15:50,6,6,4282,163,4119,6.53%,3.81%
2020-01-01 00:15:50,6,7,2141,45,2096,3.27%,2.10%
2020-01-01 00:15:50,6,8,1550,22,1528,2.37%,1.42%
2020-01-01 00:15:50,6,9,9063,634,8429,13.83%,7.00%
2020-01-01 00:15:50,6,10,2362,33,2329,3.60%,1.40%
2020-01-01 00:15:50,6,11,375,2,373,0.57%,0.53%
2020-01-01 00:15:50,6,12,6592,342,6250,10.06%,5.19%
2020-01-01 00:15:50,7,1,524,4,520,0.80%,0.76%
2020-01-01 00:15:50,7,2,88,0,88,0.13%,0.00%
2020-01-01 00:15:50,7,3,1177,8,1169,1.80%,0.68%
2020-01-01 00:15:50,7,4,1456,22,1434,2.22%,1.51%
2020-01-01 00:15:50,7,5,7633,421,7212,11.65%,5.52%
2020-01-01 00:15:50,7,6,13190,1206,11984,20.13%,9.14%
2020-01-01 00:15:50,7,7,4043,140,3903,6.17%,3.46%
2020-01-01 00:15:50,7,8,1569,16,1553,2.39%,1.02%
2020-01-01 00:15:50,7,9,6356,289,6067,9.70%,4.55%
2020-01-01 00:15:50,7,10,1334,13,1321,2.04%,0.97%
2020-01-01 00:15:50,7,11,155,0,155,0.24%,0.00%
2020-01-01 00:15:50,7,12,5009,194,4815,7.64%,3.87%
2020-01-01 00:15:50,8,1,289,0,289,0.44%,0.00%
2020-01-01 00:15:50,8,2,57,0,57,0.09%,0.00%
2020-01-01 00:15:50,8,3,1476,16,1460,2.25%,1.08%
2020-01-01 00:15:50,8,4,2666,66,2600,4.07%,2.48%
2020-01-01 00:15:50,8,5,8054,471,7583,12.29%,5.85%
2020-01-01 00:15:50,8,6,15682,1694,13988,23.93%,10.80%
2020-01-01 00:15:50,8,7,4865,196,4669,7.42%,4.03%
2020-01-01 00:15:50,8,8,1721,35,1686,2.63%,2.03%
2020-01-01 00:15:50,8,9,6422,308,6114,9.80%,4.80%
2020-01-01 00:15:50,8,10,1879,25,1854,2.87%,1.33%
2020-01-01 00:15:50,8,11,292,1,291,0.45%,0.34%
2020-01-01 00:15:50,8,12,4454,148,4306,6.80%,3.32%
2020-01-01 00:15:50,9,1,1485,4,1481,2.27%,0.27%
2020-01-01 00:15:50,9,2,4860,163,4697,7.42%,3.35%
2020-01-01 00:15:50,9,3,2948,68,2880,4.50%,2.31%
2020-01-01 00:15:50,9,4,7080,357,6723,10.80%,5.04%
2020-01-01 00:15:50,9,5,281,0,281,0.43%,0.00%
2020-01-01 00:15:50,9,6,8002,471,7531,12.21%,5.89%
2020-01-01 00:15:50,9,7,32737,7023,25714,49.95%,21.45%
2020-01-01 00:15:50,9,8,10137,749,9388,15.47%,7.39%
2020-01-01 00:15:50,9,9,259,0,259,0.40%,0.00%
2020-01-01 00:15:50,9,10,3531,90,3441,5.39%,2.55%
2020-01-01 00:15:50,9,11,8704,568,8136,13.28%,6.53%
2020-01-01 00:15:50,9,12,4901,174,4727,7.48%,3.55%
2020-01-01 00:15:50,10,1,1399,275,1124,2.13%,19.66%
2020-01-01 00:15:50,10,2,3804,368,3436,5.80%,9.67%
2020-01-01 00:15:50,10,3,2140,38,2102,3.27%,1.78%
2020-01-01 00:15:50,10,4,3863,894,2969,5.89%,23.14%
2020-01-01 00:15:50,10,5,868,11,857,1.32%,1.27%
2020-01-01 00:15:50,10,6,5831,1007,4824,8.90%,17.27%
2020-01-01 00:15:50,10,7,11502,1919,9583,17.55%,16.68%
2020-01-01 00:15:50,10,8,28368,6856,21512,43.29%,24.17%
2020-01-01 00:15:50,10,9,1043,9,1034,1.59%,0.86%
2020-01-01 00:15:50,10,10,3416,81,3335,5.21%,2.37%
2020-01-01 00:15:50,10,11,13271,1647,11624,20.25%,12.41%
2020-01-01 00:15:50,10,12,9101,1056,8045,13.89%,11.60%
2020-01-01 00:15:50,11,1,2680,47,2633,4.09%,1.75%
2020-01-01 00:15:50,11,2,3690,98,3592,5.63%,2.66%
2020-01-01 00:15:50,11,3,828,5,823,1.26%,0.60%
2020-01-01 00:15:50,11,4,6457,316,6141,9.85%,4.89%
2020-01-01 00:15:50,11,5,219,0,219,0.33%,0.00%
2020-01-01 00:15:50,11,6,7305,411,6894,11.15%,5.63%
2020-01-01 00:15:50,11,7,12821,1197,11624,19.56%,9.34%
2020-01-01 00:15:50,11,8,27022,4912,22110,41.23%,18.18%
2020-01-01 00:15:50,11,9,335,0,335,0.51%,0.00%
2020-01-01 00:15:50,11,10,3151,92,3059,4.81%,2.92%
2020-01-01 00:15:50,11,11,9888,696,9192,15.09%,7.04%
2020-01-01 00:15:50,11,12,6339,291,6048,9.67%,4.59%
2020-01-01 00:15:50,12,1,39,0,39,0.06%,0.00%
2020-01-01 00:15:50,12,2,659,233,426,1.01%,35.36%
2020-01-01 00:15:50,12,3,3026,291,2735,4.62%,9.62%
2020-01-01 00:15:50,12,4,2988,89,2899,4.56%,2.98%
2020-01-01 00:15:50,12,5,9830,953,8877,15.00%,9.69%
2020-01-01 00:15:50,12,6,5737,275,5462,8.75%,4.79%
2020-01-01 00:15:50,12,7,2610,39,2571,3.98%,1.49%
2020-01-01 00:15:50,12,8,1257,286,971,1.92%,22.75%
2020-01-01 00:15:50,12,9,22474,4475,17999,34.29%,19.91%
2020-01-01 00:15:50,12,10,3709,376,3333,5.66%,10.14%
2020-01-01 00:15:50,12,11,1532,298,1234,2.34%,19.45%
2020-01-01 00:15:50,12,12,7873,1092,6781,12.01%,13.87%
2020-01-01 00:15:50,13,1,2535,50,2485,3.87%,1.97%
2020-01-01 00:15:50,13,2,3036,72,2964,4.63%,2.37%
2020-01-01 00:15:50,13,3,792,1,791,1.21%,0.13%
2020-01-01 00:15:50,13,4,4184,434,3750,6.38%,10.37%
2020-01-01 00:15:50,13,5,6896,735,6161,10.52%,10.66%
2020-01-01 00:15:50,13,6,4966,479,4487,7.58%,9.65%
2020-01-01 00:15:50,13,7,5652,256,5396,8.62%,4.53%
2020-01-01 00:15:50,13,8,7700,472,7228,11.75%,6.13%
2020-01-01 00:15:50,13,9,7233,762,6471,11.04%,10.54%
2020-01-01 00:15:50,13,10,27336,5455,21881,41.71%,19.96%
2020-01-01 00:15:50,13,11,17435,2363,15072,26.60%,13.55%
2020-01-01 00:15:50,13,12,9318,943,8375,14.22%,10.12%
2020-01-01 00:15:50,14,1,361,0,361,0.55%,0.00%
2020-01-01 00:15:50,14,2,1684,15,1669,2.57%,0.89%
2020-01-01 00:15:50,14,3,1059,5,1054,1.62%,0.47%
2020-01-01 00:15:50,14,4,4549,162,4387,6.94%,3.56%
2020-01-01 00:15:50,14,5,1761,27,1734,2.69%,1.53%
2020-01-01 00:15:50,14,6,4899,188,4711,7.48%,3.84%
2020-01-01 00:15:50,14,7,12313,1138,11175,18.79%,9.24%
2020-01-01 00:15:50,14,8,14043,1467,12576,21.43%,10.45%
2020-01-01 00:15:50,14,9,1922,29,1893,2.93%,1.51%
2020-01-01 00:15:50,14,10,4427,142,4285,6.76%,3.21%
2020-01-01 00:15:50,14,11,26024,4515,21509,39.71%,17.35%
2020-01-01 00:15:50,14,12,7384,375,7009,11.27%,5.08%
2020-01-01 00:15:50,15,1,440,2,438,0.67%,0.45%
2020-01-01 00:15:50,15,2,143,0,143,0.22%,0.00%
2020-01-01 00:15:50,15,3,3898,116,3782,5.95%,2.98%
2020-01-01 00:15:50,15,4,6890,352,6538,10.51%,5.11%
2020-01-01 00:15:50,15,5,11495,1051,10444,17.54%,9.14%
2020-01-01 00:15:50,15,6,7098,379,6719,10.83%,5.34%
2020-01-01 00:15:50,15,7,3651,137,3514,5.57%,3.75%
2020-01-01 00:15:50,15,8,5625,289,5336,8.58%,5.14%
2020-01-01 00:15:50,15,9,11688,1084,10604,17.83%,9.27%
2020-01-01 00:15:50,15,10,4554,180,4374,6.95%,3.95%
2020-01-01 00:15:50,15,11,10313,851,9462,15.74%,8.25%
2020-01-01 00:15:50,15,12,27168,5243,21925,41.46%,19.30%
2020-01-01 00:15:50,16,1,482,0,482,0.74%,0.00%
2020-01-01 00:15:50,16,2,305,1,304,0.47%,0.33%
2020-01-01 00:15:50,16,3,1357,12,1345,2.07%,0.88%
2020-01-01 00:15:50,16,4,4942,204,4738,7.54%,4.13%
2020-01-01 00:15:50,16,5,8560,643,7917,13.06%,7.51%
2020-01-01 00:15:50,16,6,5787,283,5504,8.83%,4.89%
2020-01-01 00:15:50,16,7,3380,106,3274,5.16%,3.14%
2020-01-01 00:15:50,16,8,7273,481,6792,11.10%,6.61%
2020-01-01 00:15:50,16,9,8933,675,8258,13.63%,7.56%
2020-01-01 00:15:50,16,10,1310,13,1297,2.00%,0.99%
2020-01-01 00:15:50,16,11,8783,672,8111,13.40%,7.65%
2020-01-01 00:15:50,16,12,25816,4640,21176,39.39%,17.97%
2020-01-01 00:16:00,1,1,19777,2755,17022,30.18%,13.93%
2020-01-01 00:16:00,1,2,7419,415,7004,11.32%,5.59%
2020-01-01 00:16:00,1,3,1966,22,1944,3.00%,1.12%
2020-01-01 00:16:00,1,4,11974,1077,10897,18.27%,8.99%
2020-01-01 00:16:00,1,5,11640,1030,10610,17.76%,8.85%
2020-01-01 00:16:00,1,6,11576,1017,10559,17.66%,8.79%
2020-01-01 00:16:00,1,7,5445,252,5193,8.31%,4.63%
2020-01-01 00:16:00,1,8,3854,127,3727,5.88%,3.30%
2020-01-01 00:16:00,1,9,11525,1009,10516,17.59%,8.75%
2020-01-01 00:16:00,1,10,2989,73,2916,4.56%,2.44%
2020-01-01 00:16:00,1,11,3097,81,3016,4.73%,2.62%
2020-01-01 00:16:00,1,12,11494,1004,10490,17.54%,8.73%
2020-01-01 00:16:00,2,1,660,1,659,1.01%,0.15%
2020-01-01 00:16:00,2,2,22767,3512,19255,34.74%,15.43%
2020-01-01 00:16:00,2,3,18485,2393,16092,28.21%,12.95%
2020-01-01 00:16:00,2,4,604,1,603,0.92%,0.17%
2020-01-01 00:16:00,2,5,11667,1040,10627,17.80%,8.91%
2020-01-01 00:16:00,2,6,39,0,39,0.06%,0.00%
2020-01-01 00:16:00,2,7,3612,105,3507,5.51%,2.91%
2020-01-01 00:16:00,2,8,2636,63,2573,4.02%,2.39%
2020-01-01 00:16:00,2,9,11537,1023,10514,17.60%,8.87%
2020-01-01 00:16:00,2,10,2025,36,1989,3.09%,1.78%
2020-01-01 00:16:00,2,11,2035,37,1998,3.11%,1.82%
2020-01-01 00:16:00,2,12,11344,984,10360,17.31%,8.67%
2020-01-01 00:16:00,3,1,1284,16,1268,1.96%,1.25%
2020-01-01 00:16:00,3,2,23568,3765,19803,35.96%,15.98%
2020-01-01 00:16:00,3,3,73532,29457,44075,112.20%,40.06%
2020-01-01 00:16:00,3,4,10848,853,9995,16.55%,7.86%
2020-01-01 00:16:00,3,5,47456,13769,33687,72.41%,29.01%
2020-01-01 00:16:00,3,6,11906,1020,10886,18.17%,8.57%
2020-01-01 00:16:00,3,7,19952,2758,17194,30.44%,13.82%
2020-01-01 00:16:00,3,8,16729,1944,14785,25.53%,11.62%
2020-01-01 00:16:00,3,9,35059,7982,27077,53.50%,22.77%
2020-01-01 00:16:00,3,10,5423,206,5217,8.27%,3.80%
2020-01-01 00:16:00,3,11,1931,25,1906,2.95%,1.29%
2020-01-01 00:16:00,3,12,25150,4294,20856,38.38%,17.07%
2020-01-01 00:16:00,4,1,563,0,563,0.86%,0.00%
2020-01-01 00:16:00,4,2,340,0,340,0.52%,0.00%
2020-01-01 00:16:00,4,3,791,9,782,1.21%,1.14%
2020-01-01 00:16:00,4,4,28846,5544,23302,44.02%,19.22%
2020-01-01 00:16:00,4,5,18064,2333,15731,27.56%,12.92%
2020-01-01 00:16:00,4,6,25121,4318,20803,38.33%,17.19%
2020-01-01 00:16:00,4,7,5688,239,5449,8.68%,4.20%
2020-01-01 00:16:00,4,8,3628,98,3530,5.54%,2.70%
2020-01-01 00:16:00,4,9,16048,1829,14219,24.49%,11.40%
2020-01-01 00:16:00,4,10,2053,38,2015,3.13%,1.85%
2020-01-01 00:16:00,4,11,146,0,146,0.22%,0.00%
2020-01-01 00:16:00,4,12,12926,1197,11729,19.72%,9.26%
2020-01-01 00:16:00,5,1,3138,79,3059,4.79%,2.52%
2020-01-01 00:16:00,5,2,762,5,757,1.16%,0.66%
2020-01-01 00:16:00,5,3,1035,4,1031,1.58%,0.39%
2020-01-01 00:16:00,5,4,26028,4622,21406,39.72%,17.76%
2020-01-01 00:16:00,5,5,9944,728,9216,15.17%,7.32%
2020-01-01 00:16:00,5,6,16089,1887,14202,24.55%,11.73%
2020-01-01 00:16:00,5,7,5593,267,5326,8.53%,4.77%
2020-01-01 00:16:00,5,8,4616,188,4428,7.04%,4.07%
2020-01-01 00:16:00,5,9,8742,545,8197,13.34%,6.23%
2020-01-01 00:16:00,5,10,1414,14,1400,2.16%,0.99%
2020-01-01 00:16:00,5,11,689,6,683,1.05%,0.87%
2020-01-01 00:16:00,5,12,7141,365,6776,10.90%,5.11%
2020-01-01 00:16:00,6,1,1140,9,1131,1.74%,0.79%
2020-01-01 00:16:00,6,2,1291,14,1277,1.97%,1.08%
2020-01-01 00:16:00,6,3,2000,29,1971,3.05%,1.45%
2020-01-01 00:16:00,6,4,1348,11,1337,2.06%,0.82%
2020-01-01 00:16:00,6,5,15095,1647,13448,23.03%,10.91%
2020-01-01 00:16:00,6,6,4805,168,4637,7.33%,3.50%
2020-01-01 00:16:00,6,7,2897,65,2832,4.42%,2.24%
2020-01-01 00:16:00,6,8,2335,41,2294,3.56%,1.76%
2020-01-01 00:16:00,6,9,7927,465,7462,12.10%,5.87%
2020-01-01 00:16:00,6,10,2021,34,1987,3.08%,1.68%
2020-01-01 00:16:00,6,11,361,4,357,0.55%,1.11%
2020-01-01 00:16:00,6,12,5840,258,5582,8.91%,4.42%
2020-01-01 00:16:00,7,1,509,1,508,0.78%,0.20%
2020-01-01 00:16:00,7,2,182,0,182,0.28%,0.00%
2020-01-01 00:16:00,7,3,1792,16,1776,2.73%,0.89%
2020-01-01 00:16:00,7,4,1989,31,1958,3.03%,1.56%
2020-01-01 00:16:00,7,5,8519,544,7975,13.00%,6.39%
2020-01-01 00:16:00,7,6,14547,1505,13042,22.20%,10.35%
2020-01-01 00:16:00,7,7,4002,143,3859,6.11%,3.57%
2020-01-01 00:16:00,7,8,1510,11,1499,2.30%,0.73%
2020-01-01 00:16:00,7,9,6648,335,6313,10.14%,5.04%
2020-01-01 00:16:00,7,10,1467,27,1440,2.24%,1.84%
2020-01-01 00:16:00,7,11,163,0,163,0.25%,0.00%
2020-01-01 00:16:00,7,12,5183,194,4989,7.91%,3.74%
2020-01-01 00:16:00,8,1,460,1,459,0.70%,0.22%
2020-01-01 00:16:00,8,2,66,0,66,0.10%,0.00%
2020-01-01 00:16:00,8,3,1640,16,1624,2.50%,0.98%
2020-01-01 00:16:00,8,4,3087,73,3014,4.71%,2.36%
2020-01-01 00:16:00,8,5,7724,423,7301,11.79%,5.48%
2020-01-01 00:16:00,8,6,16285,1905,14380,24.85%,11.70%
2020-01-01 00:16:00,8,7,5281,200,5081,8.06%,3.79%
2020-01-01 00:16:00,8,8,2029,33,1996,3.10%,1.63%
2020-01-01 00:16:00,8,9,5857,278,5579,8.94%,4.75%
2020-01-01 00:16:00,8,10,1774,26,1748,2.71%,1.47%
2020-01-01 00:16:00,8,11,313,0,313,0.48%,0.00%
2020-01-01 00:16:00,8,12,4079,141,3938,6.22%,3.46%
2020-01-01 00:16:00,9,1,750,1,749,1.14%,0.13%
2020-01-01 00:16:00,9,2,2789,43,2746,4.26%,1.54%
2020-01-01 00:16:00,9,3,1699,18,1681,2.59%,1.06%
2020-01-01 00:16:00,9,4,4240,103,4137,6.47%,2.43%
2020-01-01 00:16:00,9,5,284,1,283,0.43%,0.35%
2020-01-01 00:16:00,9,6,5516,205,5311,8.42%,3.72%
2020-01-01 00:16:00,9,7,27100,4909,22191,41.35%,18.11%
2020-01-01 00:16:00,9,8,11351,930,10421,17.32%,8.19%
2020-01-01 00:16:00,9,9,199,1,198,0.30%,0.50%
2020-01-01 00:16:00,9,10,2996,54,2942,4.57%,1.80%
2020-01-01 00:16:00,9,11,10317,770,9547,15.74%,7.46%
2020-01-01 00:16:00,9,12,6937,341,6596,10.59%,4.92%
2020-01-01 00:16:00,10,1,1289,280,1009,1.97%,21.72%
2020-01-01 00:16:00,10,2,4328,407,3921,6.60%,9.40%
2020-01-01 00:16:00,10,3,2875,48,2827,4.39%,1.67%
2020-01-01 00:16:00,10,4,4389,1093,3296,6.70%,24.90%
2020-01-01 00:16:00,10,5,749,37,712,1.14%,4.94%
2020-01-01 00:16:00,10,6,6360,1242,5118,9.70%,19.53%
2020-01-01 00:16:00,10,7,13003,2333,10670,19.84%,17.94%
2020-01-01 00:16:00,10,8,29752,7576,22176,45.40%,25.46%
2020-01-01 00:16:00,10,9,980,10,970,1.50%,1.02%
2020-01-01 00:16:00,10,10,3036,80,2956,4.63%,2.64%
2020-01-01 00:16:00,10,11,13511,1693,11818,20.62%,12.53%
2020-01-01 00:16:00,10,12,9649,1056,8593,14.72%,10.94%
2020-01-01 00:16:00,11,1,2530,44,2486,3.86%,1.74%
2020-01-01 00:16:00,11,2,3509,97,3412,5.35%,2.76%
2020-01-01 00:16:00,11,3,818,6,812,1.25%,0.73%
2020-01-01 00:16:00,11,4,4209,138,4071,6.42%,3.28%
2020-01-01 00:16:00,11,5,316,2,314,0.48%,0.63%
2020-01-01 00:16:00,11,6,5322,213,5109,8.12%,4.00%
2020-01-01 00:16:00,11,7,10646,820,9826,16.24%,7.70%
2020-01-01 00:16:00,11,8,25211,4261,20950,38.47%,16.90%
2020-01-01 00:16:00,11,9,217,0,217,0.33%,0.00%
2020-01-01 00:16:00,11,10,3364,87,3277,5.13%,2.59%
2020-01-01 00:16:00,11,11,10207,759,9448,15.57%,7.44%
2020-01-01 00:16:00,11,12,6467,335,6132,9.87%,5.18%
2020-01-01 00:16:00,12,1,95,0,95,0.14%,0.00%
2020-01-01 00:16:00,12,2,698,212,486,1.07%,30.37%
2020-01-01 00:16:00,12,3,3533,273,3260,5.39%,7.73%
2020-01-01 00:16:00,12,4,3177,101,3076,4.85%,3.18%
2020-01-01 00:16:00,12,5,10117,936,9181,15.44%,9.25%
2020-01-01 00:16:00,12,6,5686,259,5427,8.68%,4.56%
2020-01-01 00:16:00,12,7,2339,41,2298,3.57%,1.75%
2020-01-01 00:16:00,12,8,1434,306,1128,2.19%,21.34%
2020-01-01 00:16:00,12,9,23282,4569,18713,35.53%,19.62%
2020-01-01 00:16:00,12,10,4423,423,4000,6.75%,9.56%
2020-01-01 00:16:00,12,11,1578,310,1268,2.41%,19.65%
2020-01-01 00:16:00,12,12,8175,1059,7116,12.47%,12.95%
2020-01-01 00:16:00,13,1,2309,47,2262,3.52%,2.04%
2020-01-01 00:16:00,13,2,2684,59,2625,4.10%,2.20%
2020-01-01 00:16:00,13,3,767,4,763,1.17%,0.52%
2020-01-01 00:16:00,13,4,5150,475,4675,7.86%,9.22%
2020-01-01 00:16:00,13,5,7833,860,6973,11.95%,10.98%
2020-01-01 00:16:00,13,6,6042,551,5491,9.22%,9.12%
2020-01-01 00:16:00,13,7,4834,182,4652,7.38%,3.76%
2020-01-01 00:16:00,13,8,6873,374,6499,10.49%,5.44%
2020-01-01 00:16:00,13,9,8305,908,7397,12.67%,10.93%
2020-01-01 00:16:00,13,10,27031,5546,21485,41.25%,20.52%
2020-01-01 00:16:00,13,11,16188,2323,13865,24.70%,14.35%
2020-01-01 00:16:00,13,12,8865,1105,7760,13.53%,12.46%
2020-01-01 00:16:00,14,1,329,0,329,0.50%,0.00%
2020-01-01 00:16:00,14,2,1585,19,1566,2.42%,1.20%
2020-01-01 00:16:00,14,3,954,8,946,1.46%,0.84%
2020-01-01 00:16:00,14,4,4148,119,4029,6.33%,2.87%
2020-01-01 00:16:00,14,5,1337,16,1321,2.04%,1.20%
2020-01-01 00:16:00,14,6,4551,147,4404,6.94%,3.23%
2020-01-01 00:16:00,14,7,12355,1020,11335,18.85%,8.26%
2020-01-01 00:16:00,14,8,13789,1294,12495,21.04%,9.38%
2020-01-01 00:16:00,14,9,1528,19,1509,2.33%,1.24%
2020-01-01 00:16:00,14,10,4045,114,3931,6.17%,2.82%
2020-01-01 00:16:00,14,11,25924,4460,21464,39.56%,17.20%
2020-01-01 00:16:00,14,12,7765,448,7317,11.85%,5.77%
2020-01-01 00:16:00,15,1,501,1,500,0.76%,0.20%
2020-01-01 00:16:00,15,2,139,0,139,0.21%,0.00%
2020-01-01 00:16:00,15,3,4283,141,4142,6.54%,3.29%
2020-01-01 00:16:00,15,4,6045,213,5832,9.22%,3.52%
2020-01-01 00:16:00,15,5,11107,924,10183,16.95%,8.32%
2020-01-01 00:16:00,15,6,6238,226,6012,9.52%,3.62%
2020-01-01 00:16:00,15,7,3555,96,3459,5.42%,2.70%
2020-01-01 00:16:00,15,8,5925,289,5636,9.04%,4.88%
2020-01-01 00:16:00,15,9,11272,950,10322,17.20%,8.43%
2020-01-01 00:16:00,15,10,5849,264,5585,8.92%,4.51%
2020-01-01 00:16:00,15,11,11899,1061,10838,18.16%,8.92%
2020-01-01 00:16:00,15,12,28796,5677,23119,43.94%,19.71%
2020-01-01 00:16:00,16,1,420,3,417,0.64%,0.71%
2020-01-01 00:16:00,16,2,301,0,301,0.46%,0.00%
2020-01-01 00:16:00,16,3,1438,23,1415,2.19%,1.60%
2020-01-01 00:16:00,16,4,4729,166,4563,7.22%,3.51%
2020-01-01 00:16:00,16,5,8179,547,7632,12.48%,6.69%
2020-01-01 00:16:00,16,6,5590,226,5364,8.53%,4.04%
2020-01-01 00:16:00,16,7,3350,94,3256,5.11%,2.81%
2020-01-01 00:16:00,16,8,7241,498,6743,11.05%,6.88%
2020-01-01 00:16:00,16,9,8644,612,8032,13.19%,7.08%
2020-01-01 00:16:00,16,10,1541,13,1528,2.35%,0.84%
2020-01-01 00:16:00,16,11,9011,694,8317,13.75%,7.70%
2020-01-01 00:16:00,16,12,25948,4640,21308,39.59%,17.88%
2020-01-01 00:16:10,1,1,16912,2058,14854,25.81%,12.17%
2020-01-01 00:16:10,1,2,6506,330,6176,9.93%,5.07%
2020-01-01 00:16:10,1,3,434,2,432,0.66%,0.46%
2020-01-01 00:16:10,1,4,9925,744,9181,15.14%,7.50%
2020-01-01 00:16:10,1,5,9616,703,8913,14.67%,7.31%
2020-01-01 00:16:10,1,6,9526,693,8833,14.54%,7.27%
2020-01-01 00:16:10,1,7,6055,291,5764,9.24%,4.81%
2020-01-01 00:16:10,1,8,4545,164,4381,6.94%,3.61%
2020-01-01 00:16:10,1,9,9480,685,8795,14.47%,7.23%
2020-01-01 00:16:10,1,10,4058,126,3932,6.19%,3.10%
2020-01-01 00:16:10,1,11,4162,137,4025,6.35%,3.29%
2020-01-01 00:16:10,1,12,9451,680,8771,14.42%,7.20%
2020-01-01 00:16:10,2,1,1430,11,1419,2.18%,0.77%
2020-01-01 00:16:10,2,2,28075,5325,22750,42.84%,18.97%
2020-01-01 00:16:10,2,3,21747,3305,18442,33.18%,15.20%
2020-01-01 00:16:10,2,4,1372,11,1361,2.09%,0.80%
2020-01-01 00:16:10,2,5,13484,1345,12139,20.57%,9.97%
2020-01-01 00:16:10,2,6,31,0,31,0.05%,0.00%
2020-01-01 00:16:10,2,7,4884,161,4723,7.45%,3.30%
2020-01-01 00:16:10,2,8,3740,98,3642,5.71%,2.62%
2020-01-01 00:16:10,2,9,13432,1337,12095,20.50%,9.95%
2020-01-01 00:16:10,2,10,2928,55,2873,4.47%,1.88%
2020-01-01 00:16:10,2,11,2943,55,2888,4.49%,1.87%
2020-01-01 00:16:10,2,12,13269,1310,11959,20.25%,9.87%
2020-01-01 00:16:10,3,1,1566,11,1555,2.39%,0.70%
2020-01-01 00:16:10,3,2,25213,4330,20883,38.47%,17.17%
2020-01-01 00:16:10,3,3,71782,28115,43667,109.53%,39.17%
2020-01-01 00:16:10,3,4,12099,1094,11005,18.46%,9.04%
2020-01-01 00:16:10,3,5,43297,11719,31578,66.07%,27.07%
2020-01-01 00:16:10,3,6,13203,1292,11911,20.15%,9.79%
2020-01-01 00:16:10,3,7,21578,3222,18356,32.93%,14.93%
2020-01-01 00:16:10,3,8,17768,2277,15491,27.11%,12.82%
2020-01-01 00:16:10,3,9,29597,5857,23740,45.16%,19.79%
2020-01-01 00:16:10,3,10,5478,239,5239,8.36%,4.36%
2020-01-01 00:16:10,3,11,2010,41,1969,3.07%,2.04%
2020-01-01 00:16:10,3,12,21303,3147,18156,32.51%,14.77%
2020-01-01 00:16:10,4,1,595,4,591,0.91%,0.67%
2020-01-01 00:16:10,4,2,369,3,366,0.56%,0.81%
2020-01-01 00:16:10,4,3,666,4,662,1.02%,0.60%
2020-01-01 00:16:10,4,4,28899,5533,23366,44.10%,19.15%
2020-01-01 00:16:10,4,5,17870,2233,15637,27.27%,12.50%
2020-01-01 00:16:10,4,6,24728,4155,20573,37.73%,16.80%
2020-01-01 00:16:10,4,7,5289,227,5062,8.07%,4.29%
2020-01-01 00:16:10,4,8,3053,84,2969,4.66%,2.75%
2020-01-01 00:16:10,4,9,15958,1805,14153,24.35%,11.31%
2020-01-01 00:16:10,4,10,2250,34,2216,3.43%,1.51%
2020-01-01 00:16:10,4,11,221,0,221,0.34%,0.00%
2020-01-01 00:16:10,4,12,12714,1189,11525,19.40%,9.35%
2020-01-01 00:16:10,5,1,3135,77,3058,4.78%,2.46%
2020-01-01 00:16:10,5,2,820,7,813,1.25%,0.85%
2020-01-01 00:16:10,5,3,515,2,513,0.79%,0.39%
2020-01-01 00:16:10,5,4,26278,4618,21660,40.10%,17.57%
2020-01-01 00:16:10,5,5,8183,488,7695,12.49%,5.96%
2020-01-01 00:16:10,5,6,16942,2017,14925,25.85%,11.91%
2020-01-01 00:16:10,5,7,8104,483,7621,12.37%,5.96%
2020-01-01 00:16:10,5,8,3628,103,3525,5.54%,2.84%
2020-01-01 00:16:10,5,9,7514,409,7105,11.47%,5.44%
2020-01-01 00:16:10,5,10,797,2,795,1.22%,0.25%
2020-01-01 00:16:10,5,11,465,7,458,0.71%,1.51%
2020-01-01 00:16:10,5,12,6450,313,6137,9.84%,4.85%
2020-01-01 00:16:10,6,1,1005,11,994,1.53%,1.09%
2020-01-01 00:16:10,6,2,1110,11,1099,1.69%,0.99%
2020-01-01 00:16:10,6,3,1762,36,1726,2.69%,2.04%
2020-01-01 00:16:10,6,4,1417,40,1377,2.16%,2.82%
2020-01-01 00:16:10,6,5,13620,1380,12240,20.78%,10.13%
2020-01-01 00:16:10,6,6,5073,268,4805,7.74%,5.28%
2020-01-01 00:16:10,6,7,3099,125,2974,4.73%,4.03%
2020-01-01 00:16:10,6,8,2405,95,2310,3.67%,3.95%
2020-01-01 00:16:10,6,9,6577,314,6263,10.04%,4.77%
2020-01-01 00:16:10,6,10,2127,32,2095,3.25%,1.50%
2020-01-01 00:16:10,6,11,413,1,412,0.63%,0.24%
2020-01-01 00:16:10,6,12,4394,151,4243,6.70%,3.44%
2020-01-01 00:16:10,7,1,424,1,423,0.65%,0.24%
2020-01-01 00:16:10,7,2,164,0,164,0.25%,0.00%
2020-01-01 00:16:10,7,3,970,4,966,1.48%,0.41%
2020-01-01 00:16:10,7,4,2126,39,2087,3.24%,1.83%
2020-01-01 00:16:10,7,5,7857,436,7421,11.99%,5.55%
2020-01-01 00:16:10,7,6,13652,1315,12337,20.83%,9.63%
2020-01-01 00:16:10,7,7,3639,123,3516,5.55%,3.38%
2020-01-01 00:16:10,7,8,1556,36,1520,2.37%,2.31%
2020-01-01 00:16:10,7,9,6665,312,6353,10.17%,4.68%
2020-01-01 00:16:10,7,10,1205,11,1194,1.84%,0.91%
2020-01-01 00:16:10,7,11,78,0,78,0.12%,0.00%
2020-01-01 00:16:10,7,12,5455,216,5239,8.32%,3.96%
2020-01-01 00:16:10,8,1,437,2,435,0.67%,0.46%
2020-01-01 00:16:10,8,2,63,0,63,0.10%,0.00%
2020-01-01 00:16:10,8,3,2050,41,2009,3.13%,2.00%
2020-01-01 00:16:10,8,4,2918,63,2855,4.45%,2.16%
2020-01-01 00:16:10,8,5,8118,467,7651,12.39%,5.75%
2020-01-01 00:16:10,8,6,17380,2145,15235,26.52%,12.34%
2020-01-01 00:16:10,8,7,6259,264,5995,9.55%,4.22%
2020-01-01 00:16:10,8,8,3066,57,3009,4.68%,1.86%
2020-01-01 00:16:10,8,9,5858,238,5620,8.94%,4.06%
2020-01-01 00:16:10,8,10,1673,21,1652,2.55%,1.26%
2020-01-01 00:16:10,8,11,198,0,198,0.30%,0.00%
2020-01-01 00:16:10,8,12,4219,128,4091,6.44%,3.03%
2020-01-01 00:16:10,9,1,464,1,463,0.71%,0.22%
2020-01-01 00:16:10,9,2,2347,39,2308,3.58%,1.66%
2020-01-01 00:16:10,9,3,1486,12,1474,2.27%,0.81%
2020-01-01 00:16:10,9,4,7807,464,7343,11.91%,5.94%
2020-01-01 00:16:10,9,5,419,1,418,0.64%,0.24%
2020-01-01 00:16:10,9,6,9264,660,8604,14.14%,7.12%
2020-01-01 00:16:10,9,7,29032,5616,23416,44.30%,19.34%
2020-01-01 00:16:10,9,8,11880,1050,10830,18.13%,8.84%
2020-01-01 00:16:10,9,9,300,0,300,0.46%,0.00%
2020-01-01 00:16:10,9,10,4710,181,4529,7.19%,3.84%
2020-01-01 00:16:10,9,11,10647,868,9779,16.25%,8.15%
2020-01-01 00:16:10,9,12,5524,214,5310,8.43%,3.87%
2020-01-01 00:16:10,10,1,1323,260,1063,2.02%,19.65%
2020-01-01 00:16:10,10,2,3341,323,3018,5.10%,9.67%
2020-01-01 00:16:10,10,3,1887,29,1858,2.88%,1.54%
2020-01-01 00:16:10,10,4,4194,1113,3081,6.40%,26.54%
2020-01-01 00:16:10,10,5,1127,87,1040,1.72%,7.72%
2020-01-01 00:16:10,10,6,6454,1326,5128,9.85%,20.55%
2020-01-01 00:16:10,10,7,11433,2118,9315,17.45%,18.53%
2020-01-01 00:16:10,10,8,29791,7837,21954,45.46%,26.31%
2020-01-01 00:16:10,10,9,765,2,763,1.17%,0.26%
2020-01-01 00:16:10,10,10,2890,53,2837,4.41%,1.83%
2020-01-01 00:16:10,10,11,14438,1927,12511,22.03%,13.35%
2020-01-01 00:16:10,10,12,10562,1239,9323,16.12%,11.73%
2020-01-01 00:16:10,11,1,2623,60,2563,4.00%,2.29%
2020-01-01 00:16:10,11,2,3544,97,3447,5.41%,2.74%
2020-01-01 00:16:10,11,3,751,5,746,1.15%,0.67%
2020-01-01 00:16:10,11,4,3032,74,2958,4.63%,2.44%
2020-01-01 00:16:10,11,5,273,2,271,0.42%,0.73%
2020-01-01 00:16:10,11,6,4120,142,3978,6.29%,3.45%
2020-01-01 00:16:10,11,7,9497,670,8827,14.49%,7.05%
2020-01-01 00:16:10,11,8,23747,3843,19904,36.24%,16.18%
2020-01-01 00:16:10,11,9,215,0,215,0.33%,0.00%
2020-01-01 00:16:10,11,10,2891,51,2840,4.41%,1.76%
2020-01-01 00:16:10,11,11,10291,789,9502,15.70%,7.67%
2020-01-01 00:16:10,11,12,6906,394,6512,10.54%,5.71%
2020-01-01 00:16:10,12,1,44,0,44,0.07%,0.00%
2020-01-01 00:16:10,12,2,657,164,493,1.00%,24.96%
2020-01-01 00:16:10,12,3,3196,218,2978,4.88%,6.82%
2020-01-01 00:16:10,12,4,2842,87,2755,4.34%,3.06%
2020-01-01 00:16:10,12,5,8674,722,7952,13.24%,8.32%
2020-01-01 00:16:10,12,6,4712,206,4506,7.19%,4.37%
2020-01-01 00:16:10,12,7,1662,24,1638,2.54%,1.44%
2020-01-01 00:16:10,12,8,1454,309,1145,2.22%,21.25%
2020-01-01 00:16:10,12,9,22668,4472,18196,34.59%,19.73%
2020-01-01 00:16:10,12,10,5135,477,4658,7.84%,9.29%
2020-01-01 00:16:10,12,11,1693,314,1379,2.58%,18.55%
2020-01-01 00:16:10,12,12,8150,1173,6977,12.44%,14.39%
2020-01-01 00:16:10,13,1,2363,50,2313,3.61%,2.12%
2020-01-01 00:16:10,13,2,2709,65,2644,4.13%,2.40%
2020-01-01 00:16:10,13,3,927,7,920,1.41%,0.76%
2020-01-01 00:16:10,13,4,5706,503,5203,8.71%,8.82%
2020-01-01 00:16:10,13,5,8160,813,7347,12.45%,9.96%
2020-01-01 00:16:10,13,6,6488,569,5919,9.90%,8.77%
2020-01-01 00:16:10,13,7,4895,196,4699,7.47%,4.00%
2020-01-01 00:16:10,13,8,7756,507,7249,11.83%,6.54%
2020-01-01 00:16:10,13,9,8645,881,7764,13.19%,10.19%
2020-01-01 00:16:10,13,10,29036,6215,22821,44.31%,21.40%
2020-01-01 00:16:10,13,11,17399,2695,14704,26.55%,15.49%
2020-01-01 00:16:10,13,12,9251,1135,8116,14.12%,12.27%
2020-01-01 00:16:10,14,1,369,0,369,0.56%,0.00%
2020-01-01 00:16:10,14,2,1524,15,1509,2.33%,0.98%
2020-01-01 00:16:10,14,3,923,9,914,1.41%,0.98%
2020-01-01 00:16:10,14,4,4586,194,4392,7.00%,4.23%
2020-01-01 00:16:10,14,5,1412,12,1400,2.15%,0.85%
2020-01-01 00:16:10,14,6,4824,212,4612,7.36%,4.39%
2020-01-01 00:16:10,14,7,12954,1169,11785,19.77%,9.02%
2020-01-01 00:16:10,14,8,14705,1484,13221,22.44%,10.09%
2020-01-01 00:16:10,14,9,1593,18,1575,2.43%,1.13%
2020-01-01 00:16:10,14,10,3740,103,3637,5.71%,2.75%
2020-01-01 00:16:10,14,11,26719,4763,21956,40.77%,17.83%
2020-01-01 00:16:10,14,12,7939,450,7489,12.11%,5.67%
2020-01-01 00:16:10,15,1,540,5,535,0.82%,0.93%
2020-01-01 00:16:10,15,2,110,0,110,0.17%,0.00%
2020-01-01 00:16:10,15,3,3665,114,3551,5.59%,3.11%
2020-01-01 00:16:10,15,4,5044,229,4815,7.70%,4.54%
2020-01-01 00:16:10,15,5,9469,706,8763,14.45%,7.46%
2020-01-01 00:16:10,15,6,5238,243,4995,7.99%,4.64%
2020-01-01 00:16:10,15,7,3747,111,3636,5.72%,2.96%
2020-01-01 00:16:10,15,8,5728,266,5462,8.74%,4.64%
2020-01-01 00:16:10,15,9,9637,730,8907,14.70%,7.57%
2020-01-01 00:16:10,15,10,4331,266,4065,6.61%,6.14%
2020-01-01 00:16:10,15,11,10181,897,9284,15.53%,8.81%
2020-01-01 00:16:10,15,12,26025,5150,20875,39.71%,19.79%
2020-01-01 00:16:10,16,1,526,4,522,0.80%,0.76%
2020-01-01 00:16:10,16,2,237,1,236,0.36%,0.42%
2020-01-01 00:16:10,16,3,1821,19,1802,2.78%,1.04%
2020-01-01 00:16:10,16,4,4579,124,4455,6.99%,2.71%
2020-01-01 00:16:10,16,5,8399,558,7841,12.82%,6.64%
2020-01-01 00:16:10,16,6,5555,210,5345,8.48%,3.78%
2020-01-01 00:16:10,16,7,3945,124,3821,6.02%,3.14%
2020-01-01 00:16:10,16,8,7490,514,6976,11.43%,6.86%
2020-01-01 00:16:10,16,9,8939,629,8310,13.64%,7.04%
2020-01-01 00:16:10,16,10,1715,22,1693,2.62%,1.28%
2020-01-01 00:16:10,16,11,9423,758,8665,14.38%,8.04%
2020-01-01 00:16:10,16,12,26279,4732,21547,40.10%,18.01%
2020-01-01 00:16:20,1,1,17202,2050,15152,26.25%,11.92%
2020-01-01 00:16:20,1,2,6430,323,6107,9.81%,5.02%
2020-01-01 00:16:20,1,3,318,1,317,0.49%,0.31%
2020-01-01 00:16:20,1,4,10141,750,9391,15.47%,7.40%
2020-01-01 00:16:20,1,5,6996,371,6625,10.68%,5.30%
2020-01-01 00:16:20,1,6,6937,361,6576,10.59%,5.20%
2020-01-01 00:16:20,1,7,6094,291,5803,9.30%,4.78%
2020-01-01 00:16:20,1,8,3999,136,3863,6.10%,3.40%
2020-01-01 00:16:20,1,9,6889,361,6528,10.51%,5.24%
2020-01-01 00:16:20,1,10,3269,87,3182,4.99%,2.66%
2020-01-01 00:16:20,1,11,3384,97,3287,5.16%,2.87%
2020-01-01 00:16:20,1,12,6867,357,6510,10.48%,5.20%
2020-01-01 00:16:20,2,1,1737,30,1707,2.65%,1.73%
2020-01-01 00:16:20,2,2,27543,5100,22443,42.03%,18.52%
2020-01-01 00:16:20,2,3,21104,3095,18009,32.20%,14.67%
2020-01-01 00:16:20,2,4,1643,25,1618,2.51%,1.52%
2020-01-01 00:16:20,2,5,11031,915,10116,16.83%,8.29%
2020-01-01 00:16:20,2,6,23,0,23,0.04%,0.00%
2020-01-01 00:16:20,2,7,4686,147,4539,7.15%,3.14%
2020-01-01 00:16:20,2,8,3481,85,3396,5.31%,2.44%
2020-01-01 00:16:20,2,9,10989,910,10079,16.77%,8.28%
2020-01-01 00:16:20,2,10,2678,38,2640,4.09%,1.42%
2020-01-01 00:16:20,2,11,2703,38,2665,4.12%,1.41%
2020-01-01 00:16:20,2,12,10844,890,9954,16.55%,8.21%
2020-01-01 00:16:20,3,1,1788,27,1761,2.73%,1.51%
2020-01-01 00:16:20,3,2,22778,3520,19258,34.76%,15.45%
2020-01-01 00:16:20,3,3,78116,32465,45651,119.20%,41.56%
2020-01-01 00:16:20,3,4,10932,869,10063,16.68%,7.95%
2020-01-01 00:16:20,3,5,54248,17325,36923,82.78%,31.94%
2020-01-01 00:16:20,3,6,12573,1122,11451,19.18%,8.92%
2020-01-01 00:16:20,3,7,19393,2596,16797,29.59%,13.39%
2020-01-01 00:16:20,3,8,16532,1914,14618,25.23%,11.58%
2020-01-01 00:16:20,3,9,41298,10634,30664,63.02%,25.75%
2020-01-01 00:16:20,3,10,8441,518,7923,12.88%,6.14%
2020-01-01 00:16:20,3,11,1982,39,1943,3.02%,1.97%
2020-01-01 00:16:20,3,12,30471,6119,24352,46.50%,20.08%
2020-01-01 00:16:20,4,1,631,3,628,0.96%,0.48%
2020-01-01 00:16:20,4,2,394,1,393,0.60%,0.25%
2020-01-01 00:16:20,4,3,689,3,686,1.05%,0.44%
2020-01-01 00:16:20,4,4,27675,5109,22566,42.23%,18.46%
2020-01-01 00:16:20,4,5,17321,2133,15188,26.43%,12.31%
2020-01-01 00:16:20,4,6,23970,3891,20079,36.58%,16.23%
2020-01-01 00:16:20,4,7,5252,171,5081,8.01%,3.26%
2020-01-01 00:16:20,4,8,3176,65,3111,4.85%,2.05%
2020-01-01 00:16:20,4,9,15408,1729,13679,23.51%,11.22%
2020-01-01 00:16:20,4,10,2147,34,2113,3.28%,1.58%
2020-01-01 00:16:20,4,11,236,0,236,0.36%,0.00%
2020-01-01 00:16:20,4,12,12366,1140,11226,18.87%,9.22%
2020-01-01 00:16:20,5,1,2671,54,2617,4.08%,2.02%
2020-01-01 00:16:20,5,2,644,1,643,0.98%,0.16%
2020-01-01 00:16:20,5,3,1989,31,1958,3.03%,1.56%
2020-01-01 00:16:20,5,4,24317,4073,20244,37.10%,16.75%
2020-01-01 00:16:20,5,5,10715,855,9860,16.35%,7.98%
2020-01-01 00:16:20,5,6,15889,1832,14057,24.24%,11.53%
2020-01-01 00:16:20,5,7,4701,169,4532,7.17%,3.59%
2020-01-01 00:16:20,5,8,3265,84,3181,4.98%,2.57%
2020-01-01 00:16:20,5,9,8594,557,8037,13.11%,6.48%
2020-01-01 00:16:20,5,10,935,10,925,1.43%,1.07%
2020-01-01 00:16:20,5,11,326,4,322,0.50%,1.23%
2020-01-01 00:16:20,5,12,7153,397,6756,10.91%,5.55%
2020-01-01 00:16:20,6,1,1198,14,1184,1.83%,1.17%
2020-01-01 00:16:20,6,2,1255,15,1240,1.91%,1.20%
2020-01-01 00:16:20,6,3,1744,23,1721,2.66%,1.32%
2020-01-01 00:16:20,6,4,1093,26,1067,1.67%,2.38%
2020-01-01 00:16:20,6,5,14084,1410,12674,21.49%,10.01%
2020-01-01 00:16:20,6,6,5925,302,5623,9.04%,5.10%
2020-01-01 00:16:20,6,7,4395,165,4230,6.71%,3.75%
2020-01-01 00:16:20,6,8,3450,84,3366,5.26%,2.43%
2020-01-01 00:16:20,6,9,6172,271,5901,9.42%,4.39%
2020-01-01 00:16:20,6,10,2203,41,2162,3.36%,1.86%
2020-01-01 00:16:20,6,11,471,0,471,0.72%,0.00%
2020-01-01 00:16:20,6,12,3944,107,3837,6.02%,2.71%
2020-01-01 00:16:20,7,1,564,3,561,0.86%,0.53%
2020-01-01 00:16:20,7,2,137,0,137,0.21%,0.00%
2020-01-01 00:16:20,7,3,634,3,631,0.97%,0.47%
2020-01-01 00:16:20,7,4,2628,56,2572,4.01%,2.13%
2020-01-01 00:16:20,7,5,7959,464,7495,12.14%,5.83%
2020-01-01 00:16:20,7,6,13823,1397,12426,21.09%,10.11%
2020-01-01 00:16:20,7,7,3200,90,3110,4.88%,2.81%
2020-01-01 00:16:20,7,8,1453,17,1436,2.22%,1.17%
2020-01-01 00:16:20,7,9,6900,355,6545,10.53%,5.14%
2020-01-01 00:16:20,7,10,1477,13,1464,2.25%,0.88%
2020-01-01 00:16:20,7,11,98,0,98,0.15%,0.00%
2020-01-01 00:16:20,7,12,5413,235,5178,8.26%,4.34%
2020-01-01 00:16:20,8,1,355,1,354,0.54%,0.28%
2020-01-01 00:16:20,8,2,96,0,96,0.15%,0.00%
2020-01-01 00:16:20,8,3,2507,44,2463,3.83%,1.76%
2020-01-01 00:16:20,8,4,2803,79,2724,4.28%,2.82%
2020-01-01 00:16:20,8,5,9833,661,9172,15.00%,6.72%
2020-01-01 00:16:20,8,6,17318,2085,15233,26.43%,12.04%
2020-01-01 00:16:20,8,7,4622,170,4452,7.05%,3.68%
2020-01-01 00:16:20,8,8,1970,40,1930,3.01%,2.03%
2020-01-01 00:16:20,8,9,7100,366,6734,10.83%,5.15%
2020-01-01 00:16:20,8,10,2898,45,2853,4.42%,1.55%
2020-01-01 00:16:20,8,11,157,0,157,0.24%,0.00%
2020-01-01 00:16:20,8,12,4199,142,4057,6.41%,3.38%
2020-01-01 00:16:20,9,1,293,0,293,0.45%,0.00%
2020-01-01 00:16:20,9,2,2012,30,1982,3.07%,1.49%
2020-01-01 00:16:20,9,3,1385,17,1368,2.11%,1.23%
2020-01-01 00:16:20,9,4,5020,168,4852,7.66%,3.35%
2020-01-01 00:16:20,9,5,456,3,453,0.70%,0.66%
2020-01-01 00:16:20,9,6,6172,245,5927,9.42%,3.97%
2020-01-01 00:16:20,9,7,28948,5642,23306,44.17%,19.49%
2020-01-01 00:16:20,9,8,12001,1106,10895,18.31%,9.22%
2020-01-01 00:16:20,9,9,335,2,333,0.51%,0.60%
2020-01-01 00:16:20,9,10,4490,194,4296,6.85%,4.32%
2020-01-01 00:16:20,9,11,10819,923,9896,16.51%,8.53%
2020-01-01 00:16:20,9,12,6020,330,5690,9.19%,5.48%
2020-01-01 00:16:20,10,1,1506,295,1211,2.30%,19.59%
2020-01-01 00:16:20,10,2,3349,392,2957,5.11%,11.70%
2020-01-01 00:16:20,10,3,1730,38,1692,2.64%,2.20%
2020-01-01 00:16:20,10,4,3853,1044,2809,5.88%,27.10%
2020-01-01 00:16:20,10,5,893,113,780,1.36%,12.65%
2020-01-01 00:16:20,10,6,6059,1284,4775,9.25%,21.19%
2020-01-01 00:16:20,10,7,11093,2126,8967,16.93%,19.17%
2020-01-01 00:16:20,10,8,30824,8169,22655,47.03%,26.50%
2020-01-01 00:16:20,10,9,518,3,515,0.79%,0.58%
2020-01-01 00:16:20,10,10,2838,59,2779,4.33%,2.08%
2020-01-01 00:16:20,10,11,14732,2053,12679,22.48%,13.94%
2020-01-01 00:16:20,10,12,11089,1423,9666,16.92%,12.83%
2020-01-01 00:16:20,11,1,2758,68,2690,4.21%,2.47%
2020-01-01 00:16:20,11,2,3681,116,3565,5.62%,3.15%
2020-01-01 00:16:20,11,3,719,5,714,1.10%,0.70%
2020-01-01 00:16:20,11,4,3091,88,3003,4.72%,2.85%
2020-01-01 00:16:20,11,5,198,0,198,0.30%,0.00%
2020-01-01 00:16:20,11,6,3981,135,3846,6.07%,3.39%
2020-01-01 00:16:20,11,7,9330,673,8657,14.24%,7.21%
2020-01-01 00:16:20,11,8,23284,3789,19495,35.53%,16.27%
2020-01-01 00:16:20,11,9,296,0,296,0.45%,0.00%
2020-01-01 00:16:20,11,10,3061,80,2981,4.67%,2.61%
2020-01-01 00:16:20,11,11,10328,807,9521,15.76%,7.81%
2020-01-01 00:16:20,11,12,6695,349,6346,10.22%,5.21%
2020-01-01 00:16:20,12,1,49,0,49,0.07%,0.00%
2020-01-01 00:16:20,12,2,582,165,417,0.89%,28.35%
2020-01-01 00:16:20,12,3,2223,191,2032,3.39%,8.59%
2020-01-01 00:16:20,12,4,2741,119,2622,4.18%,4.34%
2020-01-01 00:16:20,12,5,7216,585,6631,11.01%,8.11%
2020-01-01 00:16:20,12,6,4353,203,4150,6.64%,4.66%
2020-01-01 00:16:20,12,7,1456,19,1437,2.22%,1.30%
2020-01-01 00:16:20,12,8,1484,340,1144,2.26%,22.91%
2020-01-01 00:16:20,12,9,20503,4023,16480,31.29%,19.62%
2020-01-01 00:16:20,12,10,4961,477,4484,7.57%,9.61%
2020-01-01 00:16:20,12,11,1746,342,1404,2.66%,19.59%
2020-01-01 00:16:20,12,12,7272,1231,6041,11.10%,16.93%
2020-01-01 00:16:20,13,1,2002,30,1972,3.05%,1.50%
2020-01-01 00:16:20,13,2,2427,44,2383,3.70%,1.81%
2020-01-01 00:16:20,13,3,882,6,876,1.35%,0.68%
2020-01-01 00:16:20,13,4,4358,468,3890,6.65%,10.74%
2020-01-01 00:16:20,13,5,6647,734,5913,10.14%,11.04%
2020-01-01 00:16:20,13,6,5037,508,4529,7.69%,10.09%
2020-01-01 00:16:20,13,7,4558,147,4411,6.95%,3.23%
2020-01-01 00:16:20,13,8,8251,507,7744,12.59%,6.14%
2020-01-01 00:16:20,13,9,6938,769,6169,10.59%,11.08%
2020-01-01 00:16:20,13,10,27741,5760,21981,42.33%,20.76%
2020-01-01 00:16:20,13,11,17485,2466,15019,26.68%,14.10%
2020-01-01 00:16:20,13,12,8902,950,7952,13.58%,10.67%
2020-01-01 00:16:20,14,1,208,0,208,0.32%,0.00%
2020-01-01 00:16:20,14,2,1556,17,1539,2.37%,1.09%
2020-01-01 00:16:20,14,3,1170,8,1162,1.79%,0.68%
2020-01-01 00:16:20,14,4,3892,137,3755,5.94%,3.52%
2020-01-01 00:16:20,14,5,1303,18,1285,1.99%,1.38%
2020-01-01 00:16:20,14,6,4102,151,3951,6.26%,3.68%
2020-01-01 00:16:20,14,7,11929,1079,10850,18.20%,9.05%
2020-01-01 00:16:20,14,8,13439,1346,12093,20.51%,10.02%
2020-01-01 00:16:20,14,9,1471,22,1449,2.24%,1.50%
2020-01-01 00:16:20,14,10,3955,131,3824,6.03%,3.31%
2020-01-01 00:16:20,14,11,26222,4606,21616,40.01%,17.57%
2020-01-01 00:16:20,14,12,8450,525,7925,12.89%,6.21%
2020-01-01 00:16:20,15,1,616,2,614,0.94%,0.32%
2020-01-01 00:16:20,15,2,115,0,115,0.18%,0.00%
2020-01-01 00:16:20,15,3,3215,89,3126,4.91%,2.77%
2020-01-01 00:16:20,15,4,4734,187,4547,7.22%,3.95%
2020-01-01 00:16:20,15,5,8898,579,8319,13.58%,6.51%
2020-01-01 00:16:20,15,6,4965,205,4760,7.58%,4.13%
2020-01-01 00:16:20,15,7,3633,96,3537,5.54%,2.64%
2020-01-01 00:16:20,15,8,5511,200,5311,8.41%,3.63%
2020-01-01 00:16:20,15,9,9089,611,8478,13.87%,6.72%
2020-01-01 00:16:20,15,10,5217,422,4795,7.96%,8.09%
2020-01-01 00:16:20,15,11,10853,1039,9814,16.56%,9.57%
2020-01-01 00:16:20,15,12,25391,4835,20556,38.74%,19.04%
2020-01-01 00:16:20,16,1,467,7,460,0.71%,1.50%
2020-01-01 00:16:20,16,2,295,0,295,0.45%,0.00%
2020-01-01 00:16:20,16,3,1711,34,1677,2.61%,1.99%
2020-01-01 00:16:20,16,4,5659,232,5427,8.63%,4.10%
2020-01-01 00:16:20,16,5,9200,708,8492,14.04%,7.70%
2020-01-01 00:16:20,16,6,6584,323,6261,10.05%,4.91%
2020-01-01 00:16:20,16,7,3491,109,3382,5.33%,3.12%
2020-01-01 00:16:20,16,8,7476,473,7003,11.41%,6.33%
2020-01-01 00:16:20,16,9,9724,782,8942,14.84%,8.04%
2020-01-01 00:16:20,16,10,1498,15,1483,2.29%,1.00%
2020-01-01 00:16:20,16,11,9169,644,8525,13.99%,7.02%
2020-01-01 00:16:20,16,12,26902,4962,21940,41.05%,18.44%
2020-01-01 00:16:30,1,1,19755,2751,17004,30.14%,13.93%
2020-01-01 00:16:30,1,2,5529,225,5304,8.44%,4.07%
2020-01-01 00:16:30,1,3,622,1,621,0.95%,0.16%
2020-01-01 00:16:30,1,4,13672,1388,12284,20.86%,10.15%
2020-01-01 00:16:30,1,5,10828,866,9962,16.52%,8.00%
2020-01-01 00:16:30,1,6,10795,866,9929,16.47%,8.02%
2020-01-01 00:16:30,1,7,4890,183,4707,7.46%,3.74%
2020-01-01 00:16:30,1,8,4216,134,4082,6.43%,3.18%
2020-01-01 00:16:30,1,9,10749,855,9894,16.40%,7.95%
2020-01-01 00:16:30,1,10,3527,98,3429,5.38%,2.78%
2020-01-01 00:16:30,1,11,3639,102,3537,5.55%,2.80%
2020-01-01 00:16:30,1,12,10714,852,9862,16.35%,7.95%
2020-01-01 00:16:30,2,1,481,6,475,0.73%,1.25%
2020-01-01 00:16:30,2,2,28539,5464,23075,43.55%,19.15%
2020-01-01 00:16:30,2,3,22547,3534,19013,34.40%,15.67%
2020-01-01 00:16:30,2,4,350,2,348,0.53%,0.57%
2020-01-01 00:16:30,2,5,13489,1343,12146,20.58%,9.96%
2020-01-01 00:16:30,2,6,24,0,24,0.04%,0.00%
2020-01-01 00:16:30,2,7,5491,223,5268,8.38%,4.06%
2020-01-01 00:16:30,2,8,4369,143,4226,6.67%,3.27%
2020-01-01 00:16:30,2,9,13403,1326,12077,20.45%,9.89%
2020-01-01 00:16:30,2,10,3452,85,3367,5.27%,2.46%
2020-01-01 00:16:30,2,11,3481,86,3395,5.31%,2.47%
2020-01-01 00:16:30,2,12,13242,1299,11943,20.21%,9.81%
2020-01-01 00:16:30,3,1,1944,27,1917,2.97%,1.39%
2020-01-01 00:16:30,3,2,23936,3936,20000,36.52%,16.44%
2020-01-01 00:16:30,3,3,73188,29253,43935,111.68%,39.97%
2020-01-01 00:16:30,3,4,11663,1020,10643,17.80%,8.75%
2020-01-01 00:16:30,3,5,48246,14148,34098,73.62%,29.32%
2020-01-01 00:16:30,3,6,13415,1323,12092,20.47%,9.86%
2020-01-01 00:16:30,3,7,20163,2840,17323,30.77%,14.09%
2020-01-01 00:16:30,3,8,15903,1823,14080,24.27%,11.46%
2020-01-01 00:16:30,3,9,34351,7700,26651,52.42%,22.42%
2020-01-01 00:16:30,3,10,3646,111,3535,5.56%,3.04%
2020-01-01 00:16:30,3,11,1704,23,1681,2.60%,1.35%
2020-01-01 00:16:30,3,12,27141,4945,22196,41.41%,18.22%
2020-01-01 00:16:30,4,1,553,6,547,0.84%,1.08%
2020-01-01 00:16:30,4,2,344,1,343,0.52%,0.29%
2020-01-01 00:16:30,4,3,925,4,921,1.41%,0.43%
2020-01-01 00:16:30,4,4,27400,5062,22338,41.81%,18.47%
2020-01-01 00:16:30,4,5,17369,2085,15284,26.50%,12.00%
2020-01-01 00:16:30,4,6,24059,3932,20127,36.71%,16.34%
2020-01-01 00:16:30,4,7,5433,206,5227,8.29%,3.79%
2020-01-01 00:16:30,4,8,2978,63,2915,4.54%,2.12%
2020-01-01 00:16:30,4,9,15117,1585,13532,23.07%,10.48%
2020-01-01 00:16:30,4,10,2071,51,2020,3.16%,2.46%
2020-01-01 00:16:30,4,11,184,1,183,0.28%,0.54%
2020-01-01 00:16:30,4,12,12230,1020,11210,18.66%,8.34%
2020-01-01 00:16:30,5,1,2596,47,2549,3.96%,1.81%
2020-01-01 00:16:30,5,2,572,1,571,0.87%,0.17%
2020-01-01 00:16:30,5,3,2302,40,2262,3.51%,1.74%
2020-01-01 00:16:30,5,4,27725,5085,22640,42.30%,18.34%
2020-01-01 00:16:30,5,5,11760,952,10808,17.94%,8.10%
2020-01-01 00:16:30,5,6,17486,2054,15432,26.68%,11.75%
2020-01-01 00:16:30,5,7,5319,196,5123,8.12%,3.68%
2020-01-01 00:16:30,5,8,4100,120,3980,6.26%,2.93%
2020-01-01 00:16:30,5,9,9303,597,8706,14.20%,6.42%
2020-01-01 00:16:30,5,10,1253,8,1245,1.91%,0.64%
2020-01-01 00:16:30,5,11,575,4,571,0.88%,0.70%
2020-01-01 00:16:30,5,12,7598,395,7203,11.59%,5.20%
2020-01-01 00:16:30,6,1,1118,8,1110,1.71%,0.72%
2020-01-01 00:16:30,6,2,1203,9,1194,1.84%,0.75%
2020-01-01 00:16:30,6,3,1887,22,1865,2.88%,1.17%
2020-01-01 00:16:30,6,4,1596,17,1579,2.44%,1.07%
2020-01-01 00:16:30,6,5,12981,1166,11815,19.81%,8.98%
2020-01-01 00:16:30,6,6,5018,187,4831,7.66%,3.73%
2020-01-01 00:16:30,6,7,2960,65,2895,4.52%,2.20%
2020-01-01 00:16:30,6,8,2011,24,1987,3.07%,1.19%
2020-01-01 00:16:30,6,9,5735,233,5502,8.75%,4.06%
2020-01-01 00:16:30,6,10,2070,25,2045,3.16%,1.21%
2020-01-01 00:16:30,6,11,517,5,512,0.79%,0.97%
2020-01-01 00:16:30,6,12,3607,98,3509,5.50%,2.72%
2020-01-01 00:16:30,7,1,474,1,473,0.72%,0.21%
2020-01-01 00:16:30,7,2,136,0,136,0.21%,0.00%
2020-01-01 00:16:30,7,3,611,5,606,0.93%,0.82%
2020-01-01 00:16:30,7,4,1824,21,1803,2.78%,1.15%
2020-01-01 00:16:30,7,5,7130,395,6735,10.88%,5.54%
2020-01-01 00:16:30,7,6,12294,1089,11205,18.76%,8.86%
2020-01-01 00:16:30,7,7,3283,89,3194,5.01%,2.71%
2020-01-01 00:16:30,7,8,1313,10,1303,2.00%,0.76%
2020-01-01 00:16:30,7,9,6260,312,5948,9.55%,4.98%
2020-01-01 00:16:30,7,10,927,4,923,1.41%,0.43%
2020-01-01 00:16:30,7,11,92,0,92,0.14%,0.00%
2020-01-01 00:16:30,7,12,5372,234,5138,8.20%,4.36%
2020-01-01 00:16:30,8,1,514,2,512,0.78%,0.39%
2020-01-01 00:16:30,8,2,81,1,80,0.12%,1.23%
2020-01-01 00:16:30,8,3,1975,57,1918,3.01%,2.89%
2020-01-01 00:16:30,8,4,2832,51,2781,4.32%,1.80%
2020-01-01 00:16:30,8,5,10604,793,9811,16.18%,7.48%
2020-01-01 00:16:30,8,6,18738,2419,16319,28.59%,12.91%
2020-01-01 00:16:30,8,7,5222,208,5014,7.97%,3.98%
2020-01-01 00:16:30,8,8,2035,36,1999,3.11%,1.77%
2020-01-01 00:16:30,8,9,8389,490,7899,12.80%,5.84%
2020-01-01 00:16:30,8,10,4378,143,4235,6.68%,3.27%
2020-01-01 00:16:30,8,11,156,1,155,0.24%,0.64%
2020-01-01 00:16:30,8,12,3992,123,3869,6.09%,3.08%
2020-01-01 00:16:30,9,1,1055,18,1037,1.61%,1.71%
2020-01-01 00:16:30,9,2,3798,105,3693,5.80%,2.76%
2020-01-01 00:16:30,9,3,2446,44,2402,3.73%,1.80%
2020-01-01 00:16:30,9,4,4625,144,4481,7.06%,3.11%
2020-01-01 00:16:30,9,5,202,0,202,0.31%,0.00%
2020-01-01 00:16:30,9,6,5754,222,5532,8.78%,3.86%
2020-01-01 00:16:30,9,7,27179,4877,22302,41.47%,17.94%
2020-01-01 00:16:30,9,8,11545,944,10601,17.62%,8.18%
2020-01-01 00:16:30,9,9,185,0,185,0.28%,0.00%
2020-01-01 00:16:30,9,10,3284,77,3207,5.01%,2.34%
2020-01-01 00:16:30,9,11,9583,669,8914,14.62%,6.98%
2020-01-01 00:16:30,9,12,5929,265,5664,9.05%,4.47%
2020-01-01 00:16:30,10,1,1411,226,1185,2.15%,16.02%
2020-01-01 00:16:30,10,2,3205,267,2938,4.89%,8.33%
2020-01-01 00:16:30,10,3,1665,19,1646,2.54%,1.14%
2020-01-01 00:16:30,10,4,3712,918,2794,5.66%,24.73%
2020-01-01 00:16:30,10,5,817,59,758,1.25%,7.22%
2020-01-01 00:16:30,10,6,5709,1082,4627,8.71%,18.95%
2020-01-01 00:16:30,10,7,10680,1739,8941,16.30%,16.28%
2020-01-01 00:16:30,10,8,29600,7372,22228,45.17%,24.91%
2020-01-01 00:16:30,10,9,666,4,662,1.02%,0.60%
2020-01-01 00:16:30,10,10,2444,49,2395,3.73%,2.00%
2020-01-01 00:16:30,10,11,14500,1944,12556,22.13%,13.41%
2020-01-01 00:16:30,10,12,11358,1440,9918,17.33%,12.68%
2020-01-01 00:16:30,11,1,2908,64,2844,4.44%,2.20%
2020-01-01 00:16:30,11,2,3850,113,3737,5.87%,2.94%
2020-01-01 00:16:30,11,3,709,4,705,1.08%,0.56%
2020-01-01 00:16:30,11,4,4515,157,4358,6.89%,3.48%
2020-01-01 00:16:30,11,5,262,2,260,0.40%,0.76%
2020-01-01 00:16:30,11,6,5487,222,5265,8.37%,4.05%
2020-01-01 00:16:30,11,7,11313,931,10382,17.26%,8.23%
2020-01-01 00:16:30,11,8,25519,4424,21095,38.94%,17.34%
2020-01-01 00:16:30,11,9,185,0,185,0.28%,0.00%
2020-01-01 00:16:30,11,10,2623,59,2564,4.00%,2.25%
2020-01-01 00:16:30,11,11,10288,836,9452,15.70%,8.13%
2020-01-01 00:16:30,11,12,6980,373,6607,10.65%,5.34%
2020-01-01 00:16:30,12,1,57,0,57,0.09%,0.00%
2020-01-01 00:16:30,12,2,691,189,502,1.05%,27.35%
2020-01-01 00:16:30,12,3,2709,251,2458,4.13%,9.27%
2020-01-01 00:16:30,12,4,2610,79,2531,3.98%,3.03%
2020-01-01 00:16:30,12,5,8064,706,7358,12.30%,8.75%
2020-01-01 00:16:30,12,6,4584,204,4380,6.99%,4.45%
2020-01-01 00:16:30,12,7,1799,22,1777,2.75%,1.22%
2020-01-01 00:16:30,12,8,1442,366,1076,2.20%,25.38%
2020-01-01 00:16:30,12,9,21394,4171,17223,32.64%,19.50%
2020-01-01 00:16:30,12,10,4438,469,3969,6.77%,10.57%
2020-01-01 00:16:30,12,11,1642,367,1275,2.51%,22.35%
2020-01-01 00:16:30,12,12,7922,1235,6687,12.09%,15.59%
2020-01-01 00:16:30,13,1,2161,40,2121,3.30%,1.85%
2020-01-01 00:16:30,13,2,2585,48,2537,3.94%,1.86%
2020-01-01 00:16:30,13,3,767,22,745,1.17%,2.87%
2020-01-01 00:16:30,13,4,5198,473,4725,7.93%,9.10%
2020-01-01 00:16:30,13,5,7460,770,6690,11.38%,10.32%
2020-01-01 00:16:30,13,6,5869,510,5359,8.96%,8.69%
2020-01-01 00:16:30,13,7,4975,176,4799,7.59%,3.54%
2020-01-01 00:16:30,13,8,7556,421,7135,11.53%,5.57%
2020-01-01 00:16:30,13,9,7717,801,6916,11.78%,10.38%
2020-01-01 00:16:30,13,10,27711,5765,21946,42.28%,20.80%
2020-01-01 00:16:30,13,11,17042,2470,14572,26.00%,14.49%
2020-01-01 00:16:30,13,12,8957,1061,7896,13.67%,11.85%
2020-01-01 00:16:30,14,1,241,0,241,0.37%,0.00%
2020-01-01 00:16:30,14,2,1355,7,1348,2.07%,0.52%
2020-01-01 00:16:30,14,3,869,4,865,1.33%,0.46%
2020-01-01 00:16:30,14,4,4193,108,4085,6.40%,2.58%
2020-01-01 00:16:30,14,5,1137,16,1121,1.73%,1.41%
2020-01-01 00:16:30,14,6,4443,128,4315,6.78%,2.88%
2020-01-01 00:16:30,14,7,11510,905,10605,17.56%,7.86%
2020-01-01 00:16:30,14,8,13296,1219,12077,20.29%,9.17%
2020-01-01 00:16:30,14,9,1278,18,1260,1.95%,1.41%
2020-01-01 00:16:30,14,10,3620,85,3535,5.52%,2.35%
2020-01-01 00:16:30,14,11,25904,4427,21477,39.53%,17.09%
2020-01-01 00:16:30,14,12,8574,536,8038,13.08%,6.25%
2020-01-01 00:16:30,15,1,517,1,516,0.79%,0.19%
2020-01-01 00:16:30,15,2,126,0,126,0.19%,0.00%
2020-01-01 00:16:30,15,3,3457,100,3357,5.27%,2.89%
2020-01-01 00:16:30,15,4,5218,207,5011,7.96%,3.97%
2020-01-01 00:16:30,15,5,10108,757,9351,15.42%,7.49%
2020-01-01 00:16:30,15,6,5482,230,5252,8.36%,4.20%
2020-01-01 00:16:30,15,7,3674,98,3576,5.61%,2.67%
2020-01-01 00:16:30,15,8,5987,257,5730,9.14%,4.29%
2020-01-01 00:16:30,15,9,10319,784,9535,15.75%,7.60%
2020-01-01 00:16:30,15,10,4268,305,3963,6.51%,7.15%
2020-01-01 00:16:30,15,11,10369,947,9422,15.82%,9.13%
2020-01-01 00:16:30,15,12,26401,5166,21235,40.28%,19.57%
2020-01-01 00:16:30,16,1,420,3,417,0.64%,0.71%
2020-01-01 00:16:30,16,2,227,0,227,0.35%,0.00%
2020-01-01 00:16:30,16,3,1359,15,1344,2.07%,1.10%
2020-01-01 00:16:30,16,4,4816,162,4654,7.35%,3.36%
2020-01-01 00:16:30,16,5,8240,576,7664,12.57%,6.99%
2020-01-01 00:16:30,16,6,5590,232,5358,8.53%,4.15%
2020-01-01 00:16:30,16,7,3563,81,3482,5.44%,2.27%
2020-01-01 00:16:30,16,8,7501,470,7031,11.45%,6.27%
2020-01-01 00:16:30,16,9,8770,643,8127,13.38%,7.33%
2020-01-01 00:16:30,16,10,1458,17,1441,2.22%,1.17%
2020-01-01 00:16:30,16,11,9181,663,8518,14.01%,7.22%
2020-01-01 00:16:30,16,12,25579,4487,21092,39.03%,17.54%
2020-01-01 00:16:40,1,1,19224,2676,16548,29.33%,13.92%
2020-01-01 00:16:40,1,2,6084,260,5824,9.28%,4.27%
2020-01-01 00:16:40,1,3,726,2,724,1.11%,0.28%
2020-01-01 00:16:40,1,4,12798,1285,11513,19.53%,10.04%
2020-01-01 00:16:40,1,5,12268,1177,11091,18.72%,9.59%
2020-01-01 00:16:40,1,6,12188,1165,11023,18.60%,9.56%
2020-01-01 00:16:40,1,7,5347,201,5146,8.16%,3.76%
2020-01-01 00:16:40,1,8,3854,100,3754,5.88%,2.59%
2020-01-01 00:16:40,1,9,12177,1165,11012,18.58%,9.57%
2020-01-01 00:16:40,1,10,3025,69,2956,4.62%,2.28%
2020-01-01 00:16:40,1,11,3127,71,3056,4.77%,2.27%
2020-01-01 00:16:40,1,12,12147,1162,10985,18.53%,9.57%
2020-01-01 00:16:40,2,1,471,6,465,0.72%,1.27%
2020-01-01 00:16:40,2,2,31328,6391,24937,47.80%,20.40%
2020-01-01 00:16:40,2,3,22893,3554,19339,34.93%,15.52%
2020-01-01 00:16:40,2,4,382,1,381,0.58%,0.26%
2020-01-01 00:16:40,2,5,16788,1946,14842,25.62%,11.59%
2020-01-01 00:16:40,2,6,15,0,15,0.02%,0.00%
2020-01-01 00:16:40,2,7,7942,450,7492,12.12%,5.67%
2020-01-01 00:16:40,2,8,6996,372,6624,10.68%,5.32%
2020-01-01 00:16:40,2,9,16679,1921,14758,25.45%,11.52%
2020-01-01 00:16:40,2,10,6305,303,6002,9.62%,4.81%
2020-01-01 00:16:40,2,11,6314,303,6011,9.63%,4.80%
2020-01-01 00:16:40,2,12,16505,1886,14619,25.18%,11.43%
2020-01-01 00:16:40,3,1,1399,9,1390,2.13%,0.64%
2020-01-01 00:16:40,3,2,23691,3791,19900,36.15%,16.00%
2020-01-01 00:16:40,3,3,66383,24599,41784,101.29%,37.06%
2020-01-01 00:16:40,3,4,8843,554,8289,13.49%,6.26%
2020-01-01 00:16:40,3,5,41176,10547,30629,62.83%,25.61%
2020-01-01 00:16:40,3,6,10102,724,9378,15.41%,7.17%
2020-01-01 00:16:40,3,7,20536,2933,17603,31.34%,14.28%
2020-01-01 00:16:40,3,8,17327,2124,15203,26.44%,12.26%
2020-01-01 00:16:40,3,9,30756,6128,24628,46.93%,19.92%
2020-01-01 00:16:40,3,10,3601,96,3505,5.49%,2.67%
2020-01-01 00:16:40,3,11,1933,26,1907,2.95%,1.35%
2020-01-01 00:16:40,3,12,24034,3880,20154,36.67%,16.14%
2020-01-01 00:16:40,4,1,481,3,478,0.73%,0.62%
2020-01-01 00:16:40,4,2,274,1,273,0.42%,0.36%
2020-01-01 00:16:40,4,3,942,7,935,1.44%,0.74%
2020-01-01 00:16:40,4,4,26940,4860,22080,41.11%,18.04%
2020-01-01 00:16:40,4,5,17379,2080,15299,26.52%,11.97%
2020-01-01 00:16:40,4,6,23611,3797,19814,36.03%,16.08%
2020-01-01 00:16:40,4,7,5087,194,4893,7.76%,3.81%
2020-01-01 00:16:40,4,8,2671,50,2621,4.08%,1.87%
2020-01-01 00:16:40,4,9,15321,1607,13714,23.38%,10.49%
2020-01-01 00:16:40,4,10,1820,24,1796,2.78%,1.32%
2020-01-01 00:16:40,4,11,153,0,153,0.23%,0.00%
2020-01-01 00:16:40,4,12,12731,1107,11624,19.43%,8.70%
2020-01-01 00:16:40,5,1,2974,53,2921,4.54%,1.78%
2020-01-01 00:16:40,5,2,770,4,766,1.17%,0.52%
2020-01-01 00:16:40,5,3,2154,28,2126,3.29%,1.30%
2020-01-01 00:16:40,5,4,29623,5782,23841,45.20%,19.52%
2020-01-01 00:16:40,5,5,12570,1131,11439,19.18%,9.00%
2020-01-01 00:16:40,5,6,18194,2331,15863,27.76%,12.81%
2020-01-01 00:16:40,5,7,5130,201,4929,7.83%,3.92%
2020-01-01 00:16:40,5,8,3771,112,3659,5.75%,2.97%
2020-01-01 00:16:40,5,9,10187,768,9419,15.54%,7.54%
2020-01-01 00:16:40,5,10,1434,20,1414,2.19%,1.39%
2020-01-01 00:16:40,5,11,837,9,828,1.28%,1.08%
2020-01-01 00:16:40,5,12,8116,486,7630,12.38%,5.99%
2020-01-01 00:16:40,6,1,1130,7,1123,1.72%,0.62%
2020-01-01 00:16:40,6,2,1236,7,1229,1.89%,0.57%
2020-01-01 00:16:40,6,3,1673,14,1659,2.55%,0.84%
2020-01-01 00:16:40,6,4,1204,9,1195,1.84%,0.75%
2020-01-01 00:16:40,6,5,15053,1591,13462,22.97%,10.57%
2020-01-01 00:16:40,6,6,4779,174,4605,7.29%,3.64%
2020-01-01 00:16:40,6,7,3106,72,3034,4.74%,2.32%
2020-01-01 00:16:40,6,8,2170,39,2131,3.31%,1.80%
2020-01-01 00:16:40,6,9,8194,483,7711,12.50%,5.89%
2020-01-01 00:16:40,6,10,2201,37,2164,3.36%,1.68%
2020-01-01 00:16:40,6,11,481,2,479,0.73%,0.42%
2020-01-01 00:16:40,6,12,5922,244,5678,9.04%,4.12%
2020-01-01 00:16:40,7,1,457,2,455,0.70%,0.44%
2020-01-01 00:16:40,7,2,76,0,76,0.12%,0.00%
2020-01-01 00:16:40,7,3,810,3,807,1.24%,0.37%
2020-01-01 00:16:40,7,4,1376,18,1358,2.10%,1.31%
2020-01-01 00:16:40,7,5,7352,391,6961,11.22%,5.32%
2020-01-01 00:16:40,7,6,12154,1100,11054,18.55%,9.05%
2020-01-01 00:16:40,7,7,3375,67,3308,5.15%,1.99%
2020-01-01 00:16:40,7,8,1212,12,1200,1.85%,0.99%
2020-01-01 00:16:40,7,9,6506,312,6194,9.93%,4.80%
2020-01-01 00:16:40,7,10,1881,15,1866,2.87%,0.80%
2020-01-01 00:16:40,7,11,84,0,84,0.13%,0.00%
2020-01-01 00:16:40,7,12,4651,164,4487,7.10%,3.53%
2020-01-01 00:16:40,8,1,389,1,388,0.59%,0.26%
2020-01-01 00:16:40,8,2,87,0,87,0.13%,0.00%
2020-01-01 00:16:40,8,3,1291,10,1281,1.97%,0.77%
2020-01-01 00:16:40,8,4,3272,73,3199,4.99%,2.23%
2020-01-01 00:16:40,8,5,8335,517,7818,12.72%,6.20%
2020-01-01 00:16:40,8,6,17045,2069,14976,26.01%,12.14%
2020-01-01 00:16:40,8,7,5327,208,5119,8.13%,3.90%
2020-01-01 00:16:40,8,8,1763,26,1737,2.69%,1.47%
2020-01-01 00:16:40,8,9,6741,330,6411,10.29%,4.90%
2020-01-01 00:16:40,8,10,2710,41,2669,4.14%,1.51%
2020-01-01 00:16:40,8,11,294,0,294,0.45%,0.00%
2020-01-01 00:16:40,8,12,3979,126,3853,6.07%,3.17%
2020-01-01 00:16:40,9,1,2569,376,2193,3.92%,14.64%
2020-01-01 00:16:40,9,2,5773,563,5210,8.81%,9.75%
2020-01-01 00:16:40,9,3,2734,55,2679,4.17%,2.01%
2020-01-01 00:16:40,9,4,3611,94,3517,5.51%,2.60%
2020-01-01 00:16:40,9,5,256,1,255,0.39%,0.39%
2020-01-01 00:16:40,9,6,4376,135,4241,6.68%,3.09%
2020-01-01 00:16:40,9,7,29869,6051,23818,45.58%,20.26%
2020-01-01 00:16:40,9,8,14225,1418,12807,21.71%,9.97%
2020-01-01 00:16:40,9,9,163,1,162,0.25%,0.61%
2020-01-01 00:16:40,9,10,5830,257,5573,8.90%,4.41%
2020-01-01 00:16:40,9,11,12297,1080,11217,18.76%,8.78%
2020-01-01 00:16:40,9,12,6087,306,5781,9.29%,5.03%
2020-01-01 00:16:40,10,1,1433,265,1168,2.19%,18.49%
2020-01-01 00:16:40,10,2,3179,318,2861,4.85%,10.00%
2020-01-01 00:16:40,10,3,1478,27,1451,2.26%,1.83%
2020-01-01 00:16:40,10,4,3810,913,2897,5.81%,23.96%
2020-01-01 00:16:40,10,5,746,4,742,1.14%,0.54%
2020-01-01 00:16:40,10,6,5943,1019,4924,9.07%,17.15%
2020-01-01 00:16:40,10,7,10833,1783,9050,16.53%,16.46%
2020-01-01 00:16:40,10,8,29245,7245,22000,44.62%,24.77%
2020-01-01 00:16:40,10,9,780,5,775,1.19%,0.64%
2020-01-01 00:16:40,10,10,2859,67,2792,4.36%,2.34%
2020-01-01 00:16:40,10,11,14246,2016,12230,21.74%,14.15%
2020-01-01 00:16:40,10,12,10939,1456,9483,16.69%,13.31%
2020-01-01 00:16:40,11,1,2645,59,2586,4.04%,2.23%
2020-01-01 00:16:40,11,2,3466,99,3367,5.29%,2.86%
2020-01-01 00:16:40,11,3,701,7,694,1.07%,1.00%
2020-01-01 00:16:40,11,4,2947,62,2885,4.50%,2.10%
2020-01-01 00:16:40,11,5,473,2,471,0.72%,0.42%
2020-01-01 00:16:40,11,6,4038,121,3917,6.16%,3.00%
2020-01-01 00:16:40,11,7,9393,654,8739,14.33%,6.96%
2020-01-01 00:16:40,11,8,23241,3642,19599,35.46%,15.67%
2020-01-01 00:16:40,11,9,227,0,227,0.35%,0.00%
2020-01-01 00:16:40,11,10,2882,67,2815,4.40%,2.32%
2020-01-01 00:16:40,11,11,9993,702,9291,15.25%,7.02%
2020-01-01 00:16:40,11,12,6797,325,6472,10.37%,4.78%
2020-01-01 00:16:40,12,1,88,1,87,0.13%,1.14%
2020-01-01 00:16:40,12,2,834,242,592,1.27%,29.02%
2020-01-01 00:16:40,12,3,3279,309,2970,5.00%,9.42%
2020-01-01 00:16:40,12,4,2981,84,2897,4.55%,2.82%
2020-01-01 00:16:40,12,5,9676,931,8745,14.76%,9.62%
2020-01-01 00:16:40,12,6,5631,291,5340,8.59%,5.17%
2020-01-01 00:16:40,12,7,2513,47,2466,3.83%,1.87%
2020-01-01 00:16:40,12,8,1231,294,937,1.88%,23.88%
2020-01-01 00:16:40,12,9,21734,4383,17351,33.16%,20.17%
2020-01-01 00:16:40,12,10,3721,389,3332,5.68%,10.45%
2020-01-01 00:16:40,12,11,1491,296,1195,2.28%,19.85%
2020-01-01 00:16:40,12,12,7285,1090,6195,11.12%,14.96%
2020-01-01 00:16:40,13,1,2216,44,2172,3.38%,1.99%
2020-01-01 00:16:40,13,2,2566,58,2508,3.92%,2.26%
2020-01-01 00:16:40,13,3,732,20,712,1.12%,2.73%
2020-01-01 00:16:40,13,4,4932,438,4494,7.53%,8.88%
2020-01-01 00:16:40,13,5,7313,761,6552,11.16%,10.41%
2020-01-01 00:16:40,13,6,5697,496,5201,8.69%,8.71%
2020-01-01 00:16:40,13,7,5064,199,4865,7.73%,3.93%
2020-01-01 00:16:40,13,8,6669,344,6325,10.18%,5.16%
2020-01-01 00:16:40,13,9,7591,781,6810,11.58%,10.29%
2020-01-01 00:16:40,13,10,28510,5980,22530,43.50%,20.98%
2020-01-01 00:16:40,13,11,17818,2638,15180,27.19%,14.81%
2020-01-01 00:16:40,13,12,10587,1290,9297,16.15%,12.18%
2020-01-01 00:16:40,14,1,417,0,417,0.64%,0.00%
2020-01-01 00:16:40,14,2,1661,14,1647,2.53%,0.84%
2020-01-01 00:16:40,14,3,1054,3,1051,1.61%,0.28%
2020-01-01 00:16:40,14,4,6116,317,5799,9.33%,5.18%
2020-01-01 00:16:40,14,5,1496,19,1477,2.28%,1.27%
2020-01-01 00:16:40,14,6,6430,348,6082,9.81%,5.41%
2020-01-01 00:16:40,14,7,13452,1289,12163,20.53%,9.58%
2020-01-01 00:16:40,14,8,15443,1669,13774,23.56%,10.81%
2020-01-01 00:16:40,14,9,1707,24,1683,2.60%,1.41%
2020-01-01 00:16:40,14,10,4452,147,4305,6.79%,3.30%
2020-01-01 00:16:40,14,11,27728,5090,22638,42.31%,18.36%
2020-01-01 00:16:40,14,12,7545,428,7117,11.51%,5.67%
2020-01-01 00:16:40,15,1,516,2,514,0.79%,0.39%
2020-01-01 00:16:40,15,2,106,0,106,0.16%,0.00%
2020-01-01 00:16:40,15,3,3876,110,3766,5.91%,2.84%
2020-01-01 00:16:40,15,4,4402,157,4245,6.72%,3.57%
2020-01-01 00:16:40,15,5,9371,629,8742,14.30%,6.71%
2020-01-01 00:16:40,15,6,4645,182,4463,7.09%,3.92%
2020-01-01 00:16:40,15,7,3792,111,3681,5.79%,2.93%
2020-01-01 00:16:40,15,8,5785,250,5535,8.83%,4.32%
2020-01-01 00:16:40,15,9,9548,646,8902,14.57%,6.77%
2020-01-01 00:16:40,15,10,3711,163,3548,5.66%,4.39%
2020-01-01 00:16:40,15,11,9629,760,8869,14.69%,7.89%
2020-01-01 00:16:40,15,12,24933,4420,20513,38.04%,17.73%
2020-01-01 00:16:40,16,1,379,2,377,0.58%,0.53%
2020-01-01 00:16:40,16,2,310,1,309,0.47%,0.32%
2020-01-01 00:16:40,16,3,1526,23,1503,2.33%,1.51%
2020-01-01 00:16:40,16,4,4976,162,4814,7.59%,3.26%
2020-01-01 00:16:40,16,5,8664,616,8048,13.22%,7.11%
2020-01-01 00:16:40,16,6,5720,220,5500,8.73%,3.85%
2020-01-01 00:16:40,16,7,3436,90,3346,5.24%,2.62%
2020-01-01 00:16:40,16,8,7724,458,7266,11.79%,5.93%
2020-01-01 00:16:40,16,9,9172,678,8494,14.00%,7.39%
2020-01-01 00:16:40,16,10,1593,21,1572,2.43%,1.32%
2020-01-01 00:16:40,16,11,9593,746,8847,14.64%,7.78%
2020-01-01 00:16:40,16,12,26936,4960,21976,41.10%,18.41%
2020-01-01 00:16:50,1,1,22738,3500,19238,34.70%,15.39%
2020-01-01 00:16:50,1,2,6697,329,6368,10.22%,4.91%
2020-01-01 00:16:50,1,3,775,2,773,1.18%,0.26%
2020-01-01 00:16:50,1,4,15694,1746,13948,23.95%,11.13%
2020-01-01 00:16:50,1,5,15480,1707,13773,23.62%,11.03%
2020-01-01 00:16:50,1,6,15426,1691,13735,23.54%,10.96%
2020-01-01 00:16:50,1,7,5910,262,5648,9.02%,4.43%
2020-01-01 00:16:50,1,8,4934,177,4757,7.53%,3.59%
2020-01-01 00:16:50,1,9,15387,1682,13705,23.48%,10.93%
2020-01-01 00:16:50,1,10,4142,115,4027,6.32%,2.78%
2020-01-01 00:16:50,1,11,4236,124,4112,6.46%,2.93%
2020-01-01 00:16:50,1,12,15366,1678,13688,23.45%,10.92%
2020-01-01 00:16:50,2,1,574,3,571,0.88%,0.52%
2020-01-01 00:16:50,2,2,22843,3624,19219,34.86%,15.86%
2020-01-01 00:16:50,2,3,18585,2486,16099,28.36%,13.38%
2020-01-01 00:16:50,2,4,535,2,533,0.82%,0.37%
2020-01-01 00:16:50,2,5,12143,1068,11075,18.53%,8.80%
2020-01-01 00:16:50,2,6,48,0,48,0.07%,0.00%
2020-01-01 00:16:50,2,7,3670,124,3546,5.60%,3.38%
2020-01-01 00:16:50,2,8,2119,33,2086,3.23%,1.56%
2020-01-01 00:16:50,2,9,12047,1053,10994,18.38%,8.74%
2020-01-01 00:16:50,2,10,1362,18,1344,2.08%,1.32%
2020-01-01 00:16:50,2,11,1371,18,1353,2.09%,1.31%
2020-01-01 00:16:50,2,12,11852,1027,10825,18.08%,8.67%
2020-01-01 00:16:50,3,1,1565,14,1551,2.39%,0.89%
2020-01-01 00:16:50,3,2,22046,3264,18782,33.64%,14.81%
2020-01-01 00:16:50,3,3,73675,29532,44143,112.42%,40.08%
2020-01-01 00:16:50,3,4,8419,544,7875,12.85%,6.46%
2020-01-01 00:16:50,3,5,46679,13322,33357,71.23%,28.54%
2020-01-01 00:16:50,3,6,9525,676,8849,14.53%,7.10%
2020-01-01 00:16:50,3,7,18664,2358,16306,28.48%,12.63%
2020-01-01 00:16:50,3,8,15797,1712,14085,24.10%,10.84%
2020-01-01 00:16:50,3,9,36760,8639,28121,56.09%,23.50%
2020-01-01 00:16:50,3,10,8642,553,8089,13.19%,6.40%
2020-01-01 00:16:50,3,11,2397,44,2353,3.66%,1.84%
2020-01-01 00:16:50,3,12,26178,4640,21538,39.94%,17.72%
2020-01-01 00:16:50,4,1,578,2,576,0.88%,0.35%
2020-01-01 00:16:50,4,2,362,0,362,0.55%,0.00%
2020-01-01 00:16:50,4,3,918,16,902,1.40%,1.74%
2020-01-01 00:16:50,4,4,27456,5040,22416,41.89%,18.36%
2020-01-01 00:16:50,4,5,17397,2183,15214,26.55%,12.55%
2020-01-01 00:16:50,4,6,23168,3667,19501,35.35%,15.83%
2020-01-01 00:16:50,4,7,4681,163,4518,7.14%,3.48%
2020-01-01 00:16:50,4,8,3017,71,2946,4.60%,2.35%
2020-01-01 00:16:50,4,9,15321,1681,13640,23.38%,10.97%
2020-01-01 00:16:50,4,10,2033,40,1993,3.10%,1.97%
2020-01-01 00:16:50,4,11,191,0,191,0.29%,0.00%
2020-01-01 00:16:50,4,12,12567,1130,11437,19.18%,8.99%
2020-01-01 00:16:50,5,1,2601,56,2545,3.97%,2.15%
2020-01-01 00:16:50,5,2,1004,5,999,1.53%,0.50%
2020-01-01 00:16:50,5,3,1609,8,1601,2.46%,0.50%
2020-01-01 00:16:50,5,4,24485,4028,20457,37.36%,16.45%
2020-01-01 00:16:50,5,5,9988,726,9262,15.24%,7.27%
2020-01-01 00:16:50,5,6,14983,1581,13402,22.86%,10.55%
2020-01-01 00:16:50,5,7,4538,157,4381,6.92%,3.46%
2020-01-01 00:16:50,5,8,3298,81,3217,5.03%,2.46%
2020-01-01 00:16:50,5,9,8173,514,7659,12.47%,6.29%
2020-01-01 00:16:50,5,10,1074,10,1064,1.64%,0.93%
2020-01-01 00:16:50,5,11,675,10,665,1.03%,1.48%
2020-01-01 00:16:50,5,12,6751,365,6386,10.30%,5.41%
2020-01-01 00:16:50,6,1,1079,6,1073,1.65%,0.56%
2020-01-01 00:16:50,6,2,1223,9,1214,1.87%,0.74%
2020-01-01 00:16:50,6,3,1632,10,1622,2.49%,0.61%
2020-01-01 00:16:50,6,4,1564,8,1556,2.39%,0.51%
2020-01-01 00:16:50,6,5,15192,1590,13602,23.18%,10.47%
2020-01-01 00:16:50,6,6,4478,138,4340,6.83%,3.08%
2020-01-01 00:16:50,6,7,2310,34,2276,3.52%,1.47%
2020-01-01 00:16:50,6,8,1844,26,1818,2.81%,1.41%
2020-01-01 00:16:50,6,9,8846,563,8283,13.50%,6.36%
2020-01-01 00:16:50,6,10,2573,39,2534,3.93%,1.52%
2020-01-01 00:16:50,6,11,447,0,447,0.68%,0.00%
2020-01-01 00:16:50,6,12,6218,312,5906,9.49%,5.02%
2020-01-01 00:16:50,7,1,329,1,328,0.50%,0.30%
2020-01-01 00:16:50,7,2,150,0,150,0.23%,0.00%
2020-01-01 00:16:50,7,3,725,2,723,1.11%,0.28%
2020-01-01 00:16:50,7,4,2069,30,2039,3.16%,1.45%
2020-01-01 00:16:50,7,5,7176,408,6768,10.95%,5.69%
2020-01-01 00:16:50,7,6,13175,1266,11909,20.10%,9.61%
2020-01-01 00:16:50,7,7,3887,121,3766,5.93%,3.11%
2020-01-01 00:16:50,7,8,1548,17,1531,2.36%,1.10%
2020-01-01 00:16:50,7,9,5512,237,5275,8.41%,4.30%
2020-01-01 00:16:50,7,10,1050,4,1046,1.60%,0.38%
2020-01-01 00:16:50,7,11,157,0,157,0.24%,0.00%
2020-01-01 00:16:50,7,12,4484,157,4327,6.84%,3.50%
2020-01-01 00:16:50,8,1,538,0,538,0.82%,0.00%
2020-01-01 00:16:50,8,2,76,2,74,0.12%,2.63%
2020-01-01 00:16:50,8,3,3879,117,3762,5.92%,3.02%
2020-01-01 00:16:50,8,4,3557,72,3485,5.43%,2.02%
2020-01-01 00:16:50,8,5,10733,808,9925,16.38%,7.53%
2020-01-01 00:16:50,8,6,19081,2533,16548,29.12%,13.27%
2020-01-01 00:16:50,8,7,4665,161,4504,7.12%,3.45%
2020-01-01 00:16:50,8,8,1561,16,1545,2.38%,1.02%
2020-01-01 00:16:50,8,9,6521,289,6232,9.95%,4.43%
2020-01-01 00:16:50,8,10,1833,27,1806,2.80%,1.47%
2020-01-01 00:16:50,8,11,326,1,325,0.50%,0.31%
2020-01-01 00:16:50,8,12,4597,145,4452,7.01%,3.15%
2020-01-01 00:16:50,9,1,528,6,522,0.81%,1.14%
2020-01-01 00:16:50,9,2,2214,46,2168,3.38%,2.08%
2020-01-01 00:16:50,9,3,1281,17,1264,1.95%,1.33%
2020-01-01 00:16:50,9,4,7453,389,7064,11.37%,5.22%
2020-01-01 00:16:50,9,5,435,1,434,0.66%,0.23%
2020-01-01 00:16:50,9,6,8430,498,7932,12.86%,5.91%
2020-01-01 00:16:50,9,7,28744,5465,23279,43.86%,19.01%
2020-01-01 00:16:50,9,8,11307,885,10422,17.25%,7.83%
2020-01-01 00:16:50,9,9,225,0,225,0.34%,0.00%
2020-01-01 00:16:50,9,10,4354,123,4231,6.64%,2.82%
2020-01-01 00:16:50,9,11,10544,770,9774,16.09%,7.30%
2020-01-01 00:16:50,9,12,5886,250,5636,8.98%,4.25%
2020-01-01 00:16:50,10,1,1355,339,1016,2.07%,25.02%
2020-01-01 00:16:50,10,2,2991,389,2602,4.56%,13.01%
2020-01-01 00:16:50,10,3,1475,20,1455,2.25%,1.36%
2020-01-01 00:16:50,10,4,3892,969,2923,5.94%,24.90%
2020-01-01 00:16:50,10,5,797,25,772,1.22%,3.14%
2020-01-01 00:16:50,10,6,6102,1134,4968,9.31%,18.58%
2020-01-01 00:16:50,10,7,10793,1913,8880,16.47%,17.72%
2020-01-01 00:16:50,10,8,28939,7138,21801,44.16%,24.67%
2020-01-01 00:16:50,10,9,626,2,624,0.96%,0.32%
2020-01-01 00:16:50,10,10,2574,45,2529,3.93%,1.75%
2020-01-01 00:16:50,10,11,14344,1840,12504,21.89%,12.83%
2020-01-01 00:16:50,10,12,11129,1313,9816,16.98%,11.80%
2020-01-01 00:16:50,11,1,2347,31,2316,3.58%,1.32%
2020-01-01 00:16:50,11,2,3343,74,3269,5.10%,2.21%
2020-01-01 00:16:50,11,3,872,5,867,1.33%,0.57%
2020-01-01 00:16:50,11,4,3397,88,3309,5.18%,2.59%
2020-01-01 00:16:50,11,5,171,0,171,0.26%,0.00%
2020-01-01 00:16:50,11,6,4328,137,4191,6.60%,3.17%
2020-01-01 00:16:50,11,7,9595,713,8882,14.64%,7.43%
2020-01-01 00:16:50,11,8,23725,3857,19868,36.20%,16.26%
2020-01-01 00:16:50,11,9,213,1,212,0.33%,0.47%
2020-01-01 00:16:50,11,10,3218,72,3146,4.91%,2.24%
2020-01-01 00:16:50,11,11,9872,709,9163,15.06%,7.18%
2020-01-01 00:16:50,11,12,6311,301,6010,9.63%,4.77%
2020-01-01 00:16:50,12,1,107,0,107,0.16%,0.00%
2020-01-01 00:16:50,12,2,707,202,505,1.08%,28.57%
2020-01-01 00:16:50,12,3,3878,316,3562,5.92%,8.15%
2020-01-01 00:16:50,12,4,3066,61,3005,4.68%,1.99%
2020-01-01 00:16:50,12,5,9674,847,8827,14.76%,8.76%
2020-01-01 00:16:50,12,6,5087,189,4898,7.76%,3.72%
2020-01-01 00:16:50,12,7,1915,35,1880,2.92%,1.83%
2020-01-01 00:16:50,12,8,1663,250,1413,2.54%,15.03%
2020-01-01 00:16:50,12,9,22088,4355,17733,33.70%,19.72%
2020-01-01 00:16:50,12,10,4488,381,4107,6.85%,8.49%
2020-01-01 00:16:50,12,11,1983,261,1722,3.03%,13.16%
2020-01-01 00:16:50,12,12,7092,1100,5992,10.82%,15.51%
2020-01-01 00:16:50,13,1,1930,25,1905,2.94%,1.30%
2020-01-01 00:16:50,13,2,2312,36,2276,3.53%,1.56%
2020-01-01 00:16:50,13,3,866,4,862,1.32%,0.46%
2020-01-01 00:16:50,13,4,4909,602,4307,7.49%,12.26%
2020-01-01 00:16:50,13,5,7459,950,6509,11.38%,12.74%
2020-01-01 00:16:50,13,6,5714,664,5050,8.72%,11.62%
2020-01-01 00:16:50,13,7,4767,173,4594,7.27%,3.63%
2020-01-01 00:16:50,13,8,7220,392,6828,11.02%,5.43%
2020-01-01 00:16:50,13,9,7746,984,6762,11.82%,12.70%
2020-01-01 00:16:50,13,10,30473,6778,23695,46.50%,22.24%
2020-01-01 00:16:50,13,11,19368,2847,16521,29.55%,14.70%
2020-01-01 00:16:50,13,12,11689,1303,10386,17.84%,11.15%
2020-01-01 00:16:50,14,1,427,0,427,0.65%,0.00%
2020-01-01 00:16:50,14,2,1820,17,1803,2.78%,0.93%
2020-01-01 00:16:50,14,3,1228,10,1218,1.87%,0.81%
2020-01-01 00:16:50,14,4,5212,193,5019,7.95%,3.70%
2020-01-01 00:16:50,14,5,1056,4,1052,1.61%,0.38%
2020-01-01 00:16:50,14,6,5581,219,5362,8.52%,3.92%
2020-01-01 00:16:50,14,7,12884,1141,11743,19.66%,8.86%
2020-01-01 00:16:50,14,8,14597,1453,13144,22.27%,9.95%
2020-01-01 00:16:50,14,9,1267,6,1261,1.93%,0.47%
2020-01-01 00:16:50,14,10,3988,119,3869,6.09%,2.98%
2020-01-01 00:16:50,14,11,25443,4268,21175,38.82%,16.77%
2020-01-01 00:16:50,14,12,6483,296,6187,9.89%,4.57%
2020-01-01 00:16:50,15,1,429,2,427,0.65%,0.47%
2020-01-01 00:16:50,15,2,153,2,151,0.23%,1.31%
2020-01-01 00:16:50,15,3,3540,73,3467,5.40%,2.06%
2020-01-01 00:16:50,15,4,6189,321,5868,9.44%,5.19%
2020-01-01 00:16:50,15,5,10543,868,9675,16.09%,8.23%
2020-01-01 00:16:50,15,6,6466,370,6096,9.87%,5.72%
2020-01-01 00:16:50,15,7,3442,77,3365,5.25%,2.24%
2020-01-01 00:16:50,15,8,4920,168,4752,7.51%,3.41%
2020-01-01 00:16:50,15,9,10696,890,9806,16.32%,8.32%
2020-01-01 00:16:50,15,10,3966,250,3716,6.05%,6.30%
2020-01-01 00:16:50,15,11,9061,712,8349,13.83%,7.86%
2020-01-01 00:16:50,15,12,24751,4575,20176,37.77%,18.48%
2020-01-01 00:16:50,16,1,425,1,424,0.65%,0.24%
2020-01-01 00:16:50,16,2,250,1,249,0.38%,0.40%
2020-01-01 00:16:50,16,3,1557,20,1537,2.38%,1.28%
2020-01-01 00:16:50,16,4,5090,188,4902,7.77%,3.69%
2020-01-01 00:16:50,16,5,8963,634,8329,13.68%,7.07%
2020-01-01 00:16:50,16,6,5969,258,5711,9.11%,4.32%
2020-01-01 00:16:50,16,7,2891,68,2823,4.41%,2.35%
2020-01-01 00:16:50,16,8,8061,460,7601,12.30%,5.71%
2020-01-01 00:16:50,16,9,9380,695,8685,14.31%,7.41%
2020-01-01 00:16:50,16,10,1591,24,1567,2.43%,1.51%
2020-01-01 00:16:50,16,11,9808,705,9103,14.97%,7.19%
2020-01-01 00:16:50,16,12,27107,4979,22128,41.36%,18.37%
2020-01-01 00:17:00,1,1,17469,2191,15278,26.66%,12.54%
2020-01-01 00:17:00,1,2,6664,382,6282,10.17%,5.73%
2020-01-01 00:17:00,1,3,519,2,517,0.79%,0.39%
2020-01-01 00:17:00,1,4,10333,821,9512,15.77%,7.95%
2020-01-01 00:17:00,1,5,9986,767,9219,15.24%,7.68%
2020-01-01 00:17:00,1,6,9938,764,9174,15.16%,7.69%
2020-01-01 00:17:00,1,7,6124,333,5791,9.34%,5.44%
2020-01-01 00:17:00,1,8,4730,197,4533,7.22%,4.16%
2020-01-01 00:17:00,1,9,9891,756,9135,15.09%,7.64%
2020-01-01 00:17:00,1,10,3999,141,3858,6.10%,3.53%
2020-01-01 00:17:00,1,11,4073,145,3928,6.21%,3.56%
2020-01-01 00:17:00,1,12,9869,752,9117,15.06%,7.62%
2020-01-01 00:17:00,2,1,1877,23,1854,2.86%,1.23%
2020-01-01 00:17:00,2,2,32275,6786,25489,49.25%,21.03%
2020-01-01 00:17:00,2,3,26101,4497,21604,39.83%,17.23%
2020-01-01 00:17:00,2,4,1808,22,1786,2.76%,1.22%
2020-01-01 00:17:00,2,5,14770,1581,13189,22.54%,10.70%
2020-01-01 00:17:00,2,6,67,0,67,0.10%,0.00%
2020-01-01 00:17:00,2,7,4276,144,4132,6.52%,3.37%
2020-01-01 00:17:00,2,8,2473,57,2416,3.77%,2.30%
2020-01-01 00:17:00,2,9,14720,1574,13146,22.46%,10.69%
2020-01-01 00:17:00,2,10,1726,20,1706,2.63%,1.16%
2020-01-01 00:17:00,2,11,1748,22,1726,2.67%,1.26%
2020-01-01 00:17:00,2,12,14576,1550,13026,22.24%,10.63%
2020-01-01 00:17:00,3,1,1606,26,1580,2.45%,1.62%
2020-01-01 00:17:00,3,2,25967,4526,21441,39.62%,17.43%
2020-01-01 00:17:00,3,3,75135,30474,44661,114.65%,40.56%
2020-01-01 00:17:00,3,4,8529,570,7959,13.01%,6.68%
2020-01-01 00:17:00,3,5,45574,12752,32822,69.54%,27.98%
2020-01-01 00:17:00,3,6,9299,666,8633,14.19%,7.16%
2020-01-01 00:17:00,3,7,22574,3442,19132,34.45%,15.25%
2020-01-01 00:17:00,3,8,18432,2351,16081,28.12%,12.75%
2020-01-01 00:17:00,3,9,35721,8193,27528,54.51%,22.94%
2020-01-01 00:17:00,3,10,6659,347,6312,10.16%,5.21%
2020-01-01 00:17:00,3,11,2738,46,2692,4.18%,1.68%
2020-01-01 00:17:00,3,12,25577,4452,21125,39.03%,17.41%
2020-01-01 00:17:00,4,1,541,3,538,0.83%,0.55%
2020-01-01 00:17:00,4,2,356,1,355,0.54%,0.28%
2020-01-01 00:17:00,4,3,682,5,677,1.04%,0.73%
2020-01-01 00:17:00,4,4,28152,5259,22893,42.96%,18.68%
2020-01-01 00:17:00,4,5,17370,2156,15214,26.50%,12.41%
2020-01-01 00:17:00,4,6,23853,3871,19982,36.40%,16.23%
2020-01-01 00:17:00,4,7,5235,214,5021,7.99%,4.09%
2020-01-01 00:17:00,4,8,3000,62,2938,4.58%,2.07%
2020-01-01 00:17:00,4,9,15399,1705,13694,23.50%,11.07%
2020-01-01 00:17:00,4,10,1944,30,1914,2.97%,1.54%
2020-01-01 00:17:00,4,11,184,0,184,0.28%,0.00%
2020-01-01 00:17:00,4,12,12492,1142,11350,19.06%,9.14%
2020-01-01 00:17:00,5,1,3018,68,2950,4.61%,2.25%
2020-01-01 00:17:00,5,2,815,8,807,1.24%,0.98%
2020-01-01 00:17:00,5,3,1249,16,1233,1.91%,1.28%
2020-01-01 00:17:00,5,4,23321,3786,19535,35.59%,16.23%
2020-01-01 00:17:00,5,5,9439,683,8756,14.40%,7.24%
2020-01-01 00:17:00,5,6,14316,1483,12833,21.84%,10.36%
2020-01-01 00:17:00,5,7,4416,140,4276,6.74%,3.17%
2020-01-01 00:17:00,5,8,3284,76,3208,5.01%,2.31%
2020-01-01 00:17:00,5,9,7952,485,7467,12.13%,6.10%
2020-01-01 00:17:00,5,10,1332,12,1320,2.03%,0.90%
2020-01-01 00:17:00,5,11,577,2,575,0.88%,0.35%
2020-01-01 00:17:00,5,12,6467,318,6149,9.87%,4.92%
2020-01-01 00:17:00,6,1,1071,7,1064,1.63%,0.65%
2020-01-01 00:17:00,6,2,1209,12,1197,1.84%,0.99%
2020-01-01 00:17:00,6,3,1753,24,1729,2.67%,1.37%
2020-01-01 00:17:00,6,4,1978,32,1946,3.02%,1.62%
2020-01-01 00:17:00,6,5,12942,1254,11688,19.75%,9.69%
2020-01-01 00:17:00,6,6,4818,192,4626,7.35%,3.99%
2020-01-01 00:17:00,6,7,2298,48,2250,3.51%,2.09%
2020-01-01 00:17:00,6,8,1880,35,1845,2.87%,1.86%
2020-01-01 00:17:00,6,9,6039,259,5780,9.21%,4.29%
2020-01-01 00:17:00,6,10,2037,28,2009,3.11%,1.37%
2020-01-01 00:17:00,6,11,448,1,447,0.68%,0.22%
2020-01-01 00:17:00,6,12,3927,117,3810,5.99%,2.98%
2020-01-01 00:17:00,7,1,421,1,420,0.64%,0.24%
2020-01-01 00:17:00,7,2,208,1,207,0.32%,0.48%
2020-01-01 00:17:00,7,3,616,2,614,0.94%,0.32%
2020-01-01 00:17:00,7,4,2910,79,2831,4.44%,2.71%
2020-01-01 00:17:00,7,5,7309,375,6934,11.15%,5.13%
2020-01-01 00:17:00,7,6,13945,1373,12572,21.28%,9.85%
2020-01-01 00:17:00,7,7,3638,116,3522,5.55%,3.19%
2020-01-01 00:17:00,7,8,1655,26,1629,2.53%,1.57%
2020-01-01 00:17:00,7,9,6024,250,5774,9.19%,4.15%
2020-01-01 00:17:00,7,10,1087,8,1079,1.66%,0.74%
2020-01-01 00:17:00,7,11,229,0,229,0.35%,0.00%
2020-01-01 00:17:00,7,12,4916,167,4749,7.50%,3.40%
2020-01-01 00:17:00,8,1,592,4,588,0.90%,0.68%
2020-01-01 00:17:00,8,2,58,0,58,0.09%,0.00%
2020-01-01 00:17:00,8,3,1708,16,1692,2.61%,0.94%
2020-01-01 00:17:00,8,4,3062,78,2984,4.67%,2.55%
2020-01-01 00:17:00,8,5,8297,550,7747,12.66%,6.63%
2020-01-01 00:17:00,8,6,15918,1873,14045,24.29%,11.77%
2020-01-01 00:17:00,8,7,4496,161,4335,6.86%,3.58%
2020-01-01 00:17:00,8,8,2002,35,1967,3.05%,1.75%
2020-01-01 00:17:00,8,9,6358,362,5996,9.70%,5.69%
2020-01-01 00:17:00,8,10,1761,29,1732,2.69%,1.65%
2020-01-01 00:17:00,8,11,163,0,163,0.25%,0.00%
2020-01-01 00:17:00,8,12,4568,185,4383,6.97%,4.05%
2020-01-01 00:17:00,9,1,310,1,309,0.47%,0.32%
2020-01-01 00:17:00,9,2,2061,31,2030,3.14%,1.50%
2020-01-01 00:17:00,9,3,1409,15,1394,2.15%,1.06%
2020-01-01 00:17:00,9,4,3879,113,3766,5.92%,2.91%
2020-01-01 00:17:00,9,5,518,2,516,0.79%,0.39%
2020-01-01 00:17:00,9,6,4911,192,4719,7.49%,3.91%
2020-01-01 00:17:00,9,7,26285,4709,21576,40.11%,17.92%
2020-01-01 00:17:00,9,8,10230,756,9474,15.61%,7.39%
2020-01-01 00:17:00,9,9,331,2,329,0.51%,0.60%
2020-01-01 00:17:00,9,10,2348,48,2300,3.58%,2.04%
2020-01-01 00:17:00,9,11,9197,640,8557,14.03%,6.96%
2020-01-01 00:17:00,9,12,6472,324,6148,9.88%,5.01%
2020-01-01 00:17:00,10,1,1608,244,1364,2.45%,15.17%
2020-01-01 00:17:00,10,2,3568,295,3273,5.44%,8.27%
2020-01-01 00:17:00,10,3,1810,19,1791,2.76%,1.05%
2020-01-01 00:17:00,10,4,3668,916,2752,5.60%,24.97%
2020-01-01 00:17:00,10,5,894,42,852,1.36%,4.70%
2020-01-01 00:17:00,10,6,5559,1045,4514,8.48%,18.80%
2020-01-01 00:17:00,10,7,10685,1765,8920,16.30%,16.52%
2020-01-01 00:17:00,10,8,29513,7495,22018,45.03%,25.40%
2020-01-01 00:17:00,10,9,661,4,657,1.01%,0.61%
2020-01-01 00:17:00,10,10,2083,29,2054,3.18%,1.39%
2020-01-01 00:17:00,10,11,14414,1890,12524,21.99%,13.11%
2020-01-01 00:17:00,10,12,11534,1362,10172,17.60%,11.81%
2020-01-01 00:17:00,11,1,2446,49,2397,3.73%,2.00%
2020-01-01 00:17:00,11,2,3483,107,3376,5.31%,3.07%
2020-01-01 00:17:00,11,3,869,7,862,1.33%,0.81%
2020-01-01 00:17:00,11,4,4795,173,4622,7.32%,3.61%
2020-01-01 00:17:00,11,5,212,0,212,0.32%,0.00%
2020-01-01 00:17:00,11,6,5702,259,5443,8.70%,4.54%
2020-01-01 00:17:00,11,7,11046,887,10159,16.85%,8.03%
2020-01-01 00:17:00,11,8,25108,4272,20836,38.31%,17.01%
2020-01-01 00:17:00,11,9,274,0,274,0.42%,0.00%
2020-01-01 00:17:00,11,10,2896,70,2826,4.42%,2.42%
2020-01-01 00:17:00,11,11,9605,692,8913,14.66%,7.20%
2020-01-01 00:17:00,11,12,6373,314,6059,9.72%,4.93%
2020-01-01 00:17:00,12,1,28,0,28,0.04%,0.00%
2020-01-01 00:17:00,12,2,466,127,339,0.71%,27.25%
2020-01-01 00:17:00,12,3,3806,239,3567,5.81%,6.28%
2020-01-01 00:17:00,12,4,2322,37,2285,3.54%,1.59%
2020-01-01 00:17:00,12,5,8646,652,7994,13.19%,7.54%
2020-01-01 00:17:00,12,6,4126,124,4002,6.30%,3.01%
2020-01-01 00:17:00,12,7,1673,36,1637,2.55%,2.15%
2020-01-01 00:17:00,12,8,1623,288,1335,2.48%,17.74%
2020-01-01 00:17:00,12,9,22019,4250,17769,33.60%,19.30%
2020-01-01 00:17:00,12,10,4946,424,4522,7.55%,8.57%
2020-01-01 00:17:00,12,11,1954,293,1661,2.98%,14.99%
2020-01-01 00:17:00,12,12,7936,1284,6652,12.11%,16.18%
2020-01-01 00:17:00,13,1,2106,29,2077,3.21%,1.38%
2020-01-01 00:17:00,13,2,2469,40,2429,3.77%,1.62%
2020-01-01 00:17:00,13,3,699,26,673,1.07%,3.72%
2020-01-01 00:17:00,13,4,4650,690,3960,7.10%,14.84%
2020-01-01 00:17:00,13,5,6681,993,5688,10.19%,14.86%
2020-01-01 00:17:00,13,6,5184,733,4451,7.91%,14.14%
2020-01-01 00:17:00,13,7,4297,132,4165,6.56%,3.07%
2020-01-01 00:17:00,13,8,8220,521,7699,12.54%,6.34%
2020-01-01 00:17:00,13,9,7031,1019,6012,10.73%,14.49%
2020-01-01 00:17:00,13,10,28558,6162,22396,43.58%,21.58%
2020-01-01 00:17:00,13,11,18262,2641,15621,27.87%,14.46%
2020-01-01 00:17:00,13,12,9610,988,8622,14.66%,10.28%
2020-01-01 00:17:00,14,1,311,2,309,0.47%,0.64%
2020-01-01 00:17:00,14,2,1227,9,1218,1.87%,0.73%
2020-01-01 00:17:00,14,3,765,4,761,1.17%,0.52%
2020-01-01 00:17:00,14,4,4071,120,3951,6.21%,2.95%
2020-01-01 00:17:00,14,5,1144,5,1139,1.75%,0.44%
2020-01-01 00:17:00,14,6,4352,140,4212,6.64%,3.22%
2020-01-01 00:17:00,14,7,12119,1038,11081,18.49%,8.57%
2020-01-01 00:17:00,14,8,13777,1369,12408,21.02%,9.94%
2020-01-01 00:17:00,14,9,1247,5,1242,1.90%,0.40%
2020-01-01 00:17:00,14,10,4210,127,4083,6.42%,3.02%
2020-01-01 00:17:00,14,11,26240,4679,21561,40.04%,17.83%
2020-01-01 00:17:00,14,12,7860,483,7377,11.99%,6.15%
2020-01-01 00:17:00,15,1,505,2,503,0.77%,0.40%
2020-01-01 00:17:00,15,2,147,0,147,0.22%,0.00%
2020-01-01 00:17:00,15,3,3397,97,3300,5.18%,2.86%
2020-01-01 00:17:00,15,4,6583,328,6255,10.04%,4.98%
2020-01-01 00:17:00,15,5,10931,935,9996,16.68%,8.55%
2020-01-01 00:17:00,15,6,6880,391,6489,10.50%,5.68%
2020-01-01 00:17:00,15,7,3360,93,3267,5.13%,2.77%
2020-01-01 00:17:00,15,8,5139,208,4931,7.84%,4.05%
2020-01-01 00:17:00,15,9,11125,966,10159,16.98%,8.68%
2020-01-01 00:17:00,15,10,4973,315,4658,7.59%,6.33%
2020-01-01 00:17:00,15,11,10270,917,9353,15.67%,8.93%
2020-01-01 00:17:00,15,12,26906,5533,21373,41.06%,20.56%
2020-01-01 00:17:00,16,1,355,2,353,0.54%,0.56%
2020-01-01 00:17:00,16,2,255,0,255,0.39%,0.00%
2020-01-01 00:17:00,16,3,2061,34,2027,3.14%,1.65%
2020-01-01 00:17:00,16,4,3617,113,3504,5.52%,3.12%
2020-01-01 00:17:00,16,5,8286,679,7607,12.64%,8.19%
2020-01-01 00:17:00,16,6,4476,167,4309,6.83%,3.73%
2020-01-01 00:17:00,16,7,3260,70,3190,4.97%,2.15%
2020-01-01 00:17:00,16,8,7118,434,6684,10.86%,6.10%
2020-01-01 00:17:00,16,9,8792,826,7966,13.42%,9.39%
2020-01-01 00:17:00,16,10,2183,38,2145,3.33%,1.74%
2020-01-01 00:17:00,16,11,9581,755,8826,14.62%,7.88%
2020-01-01 00:17:00,16,12,26177,4880,21297,39.94%,18.64%
2020-01-01 00:17:10,1,1,21311,3154,18157,32.52%,14.80%
2020-01-01 00:17:10,1,2,12548,1125,11423,19.15%,8.97%
2020-01-01 00:17:10,1,3,535,2,533,0.82%,0.37%
2020-01-01 00:17:10,1,4,8408,526,7882,12.83%,6.26%
2020-01-01 00:17:10,1,5,7957,477,7480,12.14%,5.99%
2020-01-01 00:17:10,1,6,7995,487,7508,12.20%,6.09%
2020-01-01 00:17:10,1,7,11999,1030,10969,18.31%,8.58%
2020-01-01 00:17:10,1,8,6060,262,5798,9.25%,4.32%
2020-01-01 00:17:10,1,9,7886,470,7416,12.03%,5.96%
2020-01-01 00:17:10,1,10,5269,191,5078,8.04%,3.62%
2020-01-01 00:17:10,1,11,5359,196,5163,8.18%,3.66%
2020-01-01 00:17:10,1,12,7873,469,7404,12.01%,5.96%
2020-01-01 00:17:10,2,1,3029,82,2947,4.62%,2.71%
2020-01-01 00:17:10,2,2,42362,11254,31108,64.64%,26.57%
2020-01-01 00:17:10,2,3,35777,8340,27437,54.59%,23.31%
2020-01-01 00:17:10,2,4,2905,76,2829,4.43%,2.62%
2020-01-01 00:17:10,2,5,13124,1307,11817,20.03%,9.96%
2020-01-01 00:17:10,2,6,29,0,29,0.04%,0.00%
2020-01-01 00:17:10,2,7,3544,109,3435,5.41%,3.08%
2020-01-01 00:17:10,2,8,2514,59,2455,3.84%,2.35%
2020-01-01 00:17:10,2,9,13080,1300,11780,19.96%,9.94%
2020-01-01 00:17:10,2,10,1872,27,1845,2.86%,1.44%
2020-01-01 00:17:10,2,11,1893,28,1865,2.89%,1.48%
2020-01-01 00:17:10,2,12,12907,1268,11639,19.69%,9.82%
2020-01-01 00:17:10,3,1,1932,27,1905,2.95%,1.40%
2020-01-01 00:17:10,3,2,24907,4257,20650,38.01%,17.09%
2020-01-01 00:17:10,3,3,86861,38782,48079,132.54%,44.65%
2020-01-01 00:17:10,3,4,16410,1904,14506,25.04%,11.60%
2020-01-01 00:17:10,3,5,57505,19177,38328,87.75%,33.35%
2020-01-01 00:17:10,3,6,18076,2302,15774,27.58%,12.74%
2020-01-01 00:17:10,3,7,21279,3175,18104,32.47%,14.92%
2020-01-01 00:17:10,3,8,13936,1375,12561,21.26%,9.87%
2020-01-01 00:17:10,3,9,39114,9708,29406,59.68%,24.82%
2020-01-01 00:17:10,3,10,4246,135,4111,6.48%,3.18%
2020-01-01 00:17:10,3,11,1875,29,1846,2.86%,1.55%
2020-01-01 00:17:10,3,12,31655,6588,25067,48.30%,20.81%
2020-01-01 00:17:10,4,1,518,2,516,0.79%,0.39%
2020-01-01 00:17:10,4,2,329,0,329,0.50%,0.00%
2020-01-01 00:17:10,4,3,715,4,711,1.09%,0.56%
2020-01-01 00:17:10,4,4,26331,4646,21685,40.18%,17.64%
2020-01-01 00:17:10,4,5,16394,1900,14494,25.02%,11.59%
2020-01-01 00:17:10,4,6,22704,3507,19197,34.64%,15.45%
2020-01-01 00:17:10,4,7,5186,201,4985,7.91%,3.88%
2020-01-01 00:17:10,4,8,3015,75,2940,4.60%,2.49%
2020-01-01 00:17:10,4,9,14472,1451,13021,22.08%,10.03%
2020-01-01 00:17:10,4,10,1927,30,1897,2.94%,1.56%
2020-01-01 00:17:10,4,11,178,0,178,0.27%,0.00%
2020-01-01 00:17:10,4,12,11301,886,10415,17.24%,7.84%
2020-01-01 00:17:10,5,1,2790,57,2733,4.26%,2.04%
2020-01-01 00:17:10,5,2,735,2,733,1.12%,0.27%
2020-01-01 00:17:10,5,3,541,3,538,0.83%,0.55%
2020-01-01 00:17:10,5,4,21257,3057,18200,32.44%,14.38%
2020-01-01 00:17:10,5,5,8593,523,8070,13.11%,6.09%
2020-01-01 00:17:10,5,6,13678,1289,12389,20.87%,9.42%
2020-01-01 00:17:10,5,7,4565,177,4388,6.97%,3.88%
2020-01-01 00:17:10,5,8,3327,98,3229,5.08%,2.95%
2020-01-01 00:17:10,5,9,7333,376,6957,11.19%,5.13%
2020-01-01 00:17:10,5,10,874,5,869,1.33%,0.57%
2020-01-01 00:17:10,5,11,558,4,554,0.85%,0.72%
2020-01-01 00:17:10,5,12,6271,282,5989,9.57%,4.50%
2020-01-01 00:17:10,6,1,942,5,937,1.44%,0.53%
2020-01-01 00:17:10,6,2,979,7,972,1.49%,0.72%
2020-01-01 00:17:10,6,3,1782,17,1765,2.72%,0.95%
2020-01-01 00:17:10,6,4,1580,17,1563,2.41%,1.08%
2020-01-01 00:17:10,6,5,11562,1008,10554,17.64%,8.72%
2020-01-01 00:17:10,6,6,4362,160,4202,6.66%,3.67%
2020-01-01 00:17:10,6,7,2363,54,2309,3.61%,2.29%
2020-01-01 00:17:10,6,8,1759,24,1735,2.68%,1.36%
2020-01-01 00:17:10,6,9,5024,215,4809,7.67%,4.28%
2020-01-01 00:17:10,6,10,1662,30,1632,2.54%,1.81%
2020-01-01 00:17:10,6,11,427,1,426,0.65%,0.23%
2020-01-01 00:17:10,6,12,3284,82,3202,5.01%,2.50%
2020-01-01 00:17:10,7,1,447,1,446,0.68%,0.22%
2020-01-01 00:17:10,7,2,191,0,191,0.29%,0.00%
2020-01-01 00:17:10,7,3,612,5,607,0.93%,0.82%
2020-01-01 00:17:10,7,4,1706,25,1681,2.60%,1.47%
2020-01-01 00:17:10,7,5,7524,425,7099,11.48%,5.65%
2020-01-01 00:17:10,7,6,12752,1220,11532,19.46%,9.57%
2020-01-01 00:17:10,7,7,3466,112,3354,5.29%,3.23%
2020-01-01 00:17:10,7,8,1592,20,1572,2.43%,1.26%
2020-01-01 00:17:10,7,9,6760,335,6425,10.31%,4.96%
2020-01-01 00:17:10,7,10,1677,17,1660,2.56%,1.01%
2020-01-01 00:17:10,7,11,109,0,109,0.17%,0.00%
2020-01-01 00:17:10,7,12,5063,214,4849,7.73%,4.23%
2020-01-01 00:17:10,8,1,443,4,439,0.68%,0.90%
2020-01-01 00:17:10,8,2,73,0,73,0.11%,0.00%
2020-01-01 00:17:10,8,3,1877,42,1835,2.86%,2.24%
2020-01-01 00:17:10,8,4,2570,43,2527,3.92%,1.67%
2020-01-01 00:17:10,8,5,7907,451,7456,12.07%,5.70%
2020-01-01 00:17:10,8,6,15347,1681,13666,23.42%,10.95%
2020-01-01 00:17:10,8,7,4796,232,4564,7.32%,4.84%
2020-01-01 00:17:10,8,8,2363,63,2300,3.61%,2.67%
2020-01-01 00:17:10,8,9,5835,251,5584,8.90%,4.30%
2020-01-01 00:17:10,8,10,1507,15,1492,2.30%,1.00%
2020-01-01 00:17:10,8,11,126,0,126,0.19%,0.00%
2020-01-01 00:17:10,8,12,4298,139,4159,6.56%,3.23%
2020-01-01 00:17:10,9,1,504,2,502,0.77%,0.40%
2020-01-01 00:17:10,9,2,1973,31,1942,3.01%,1.57%
2020-01-01 00:17:10,9,3,1109,9,1100,1.69%,0.81%
2020-01-01 00:17:10,9,4,5464,238,5226,8.34%,4.36%
2020-01-01 00:17:10,9,5,194,1,193,0.30%,0.52%
2020-01-01 00:17:10,9,6,6295,302,5993,9.61%,4.80%
2020-01-01 00:17:10,9,7,26320,4604,21716,40.16%,17.49%
2020-01-01 00:17:10,9,8,10524,765,9759,16.06%,7.27%
2020-01-01 00:17:10,9,9,110,1,109,0.17%,0.91%
2020-01-01 00:17:10,9,10,4113,116,3997,6.28%,2.82%
2020-01-01 00:17:10,9,11,9430,602,8828,14.39%,6.38%
2020-01-01 00:17:10,9,12,5007,162,4845,7.64%,3.24%
2020-01-01 00:17:10,10,1,1163,197,966,1.77%,16.94%
2020-01-01 00:17:10,10,2,3220,269,2951,4.91%,8.35%
2020-01-01 00:17:10,10,3,1884,35,1849,2.87%,1.86%
2020-01-01 00:17:10,10,4,3637,829,2808,5.55%,22.79%
2020-01-01 00:17:10,10,5,729,36,693,1.11%,4.94%
2020-01-01 00:17:10,10,6,5254,948,4306,8.02%,18.04%
2020-01-01 00:17:10,10,7,10514,1629,8885,16.04%,15.49%
2020-01-01 00:17:10,10,8,27010,6393,20617,41.21%,23.67%
2020-01-01 00:17:10,10,9,803,3,800,1.23%,0.37%
2020-01-01 00:17:10,10,10,2532,33,2499,3.86%,1.30%
2020-01-01 00:17:10,10,11,13296,1657,11639,20.29%,12.46%
2020-01-01 00:17:10,10,12,10074,1200,8874,15.37%,11.91%
2020-01-01 00:17:10,11,1,2413,50,2363,3.68%,2.07%
2020-01-01 00:17:10,11,2,3288,93,3195,5.02%,2.83%
2020-01-01 00:17:10,11,3,729,8,721,1.11%,1.10%
2020-01-01 00:17:10,11,4,2850,57,2793,4.35%,2.00%
2020-01-01 00:17:10,11,5,156,0,156,0.24%,0.00%
2020-01-01 00:17:10,11,6,3485,84,3401,5.32%,2.41%
2020-01-01 00:17:10,11,7,8298,530,7768,12.66%,6.39%
2020-01-01 00:17:10,11,8,20260,2902,17358,30.91%,14.32%
2020-01-01 00:17:10,11,9,183,0,183,0.28%,0.00%
2020-01-01 00:17:10,11,10,2535,74,2461,3.87%,2.92%
2020-01-01 00:17:10,11,11,8700,603,8097,13.28%,6.93%
2020-01-01 00:17:10,11,12,5848,260,5588,8.92%,4.45%
2020-01-01 00:17:10,12,1,37,0,37,0.06%,0.00%
2020-01-01 00:17:10,12,2,520,153,367,0.79%,29.42%
2020-01-01 00:17:10,12,3,2381,192,2189,3.63%,8.06%
2020-01-01 00:17:10,12,4,2610,64,2546,3.98%,2.45%
2020-01-01 00:17:10,12,5,8020,593,7427,12.24%,7.39%
2020-01-01 00:17:10,12,6,4892,186,4706,7.46%,3.80%
2020-01-01 00:17:10,12,7,2072,38,2034,3.16%,1.83%
2020-01-01 00:17:10,12,8,1364,280,1084,2.08%,20.53%
2020-01-01 00:17:10,12,9,19834,3521,16313,30.26%,17.75%
2020-01-01 00:17:10,12,10,4024,373,3651,6.14%,9.27%
2020-01-01 00:17:10,12,11,1492,282,1210,2.28%,18.90%
2020-01-01 00:17:10,12,12,7283,958,6325,11.11%,13.15%
2020-01-01 00:17:10,13,1,2084,32,2052,3.18%,1.54%
2020-01-01 00:17:10,13,2,2376,40,2336,3.63%,1.68%
2020-01-01 00:17:10,13,3,661,3,658,1.01%,0.45%
2020-01-01 00:17:10,13,4,3780,433,3347,5.77%,11.46%
2020-01-01 00:17:10,13,5,5537,605,4932,8.45%,10.93%
2020-01-01 00:17:10,13,6,4273,457,3816,6.52%,10.70%
2020-01-01 00:17:10,13,7,4440,160,4280,6.77%,3.60%
2020-01-01 00:17:10,13,8,7229,396,6833,11.03%,5.48%
2020-01-01 00:17:10,13,9,5881,628,5253,8.97%,10.68%
2020-01-01 00:17:10,13,10,23514,4246,19268,35.88%,18.06%
2020-01-01 00:17:10,13,11,15497,2017,13480,23.65%,13.02%
2020-01-01 00:17:10,13,12,7880,788,7092,12.02%,10.00%
2020-01-01 00:17:10,14,1,313,2,311,0.48%,0.64%
2020-01-01 00:17:10,14,2,1466,13,1453,2.24%,0.89%
2020-01-01 00:17:10,14,3,989,6,983,1.51%,0.61%
2020-01-01 00:17:10,14,4,4207,124,4083,6.42%,2.95%
2020-01-01 00:17:10,14,5,1378,16,1362,2.10%,1.16%
2020-01-01 00:17:10,14,6,4523,141,4382,6.90%,3.12%
2020-01-01 00:17:10,14,7,12194,1067,11127,18.61%,8.75%
2020-01-01 00:17:10,14,8,13670,1323,12347,20.86%,9.68%
2020-01-01 00:17:10,14,9,1527,20,1507,2.33%,1.31%
2020-01-01 00:17:10,14,10,3994,137,3857,6.09%,3.43%
2020-01-01 00:17:10,14,11,25128,4287,20841,38.34%,17.06%
2020-01-01 00:17:10,14,12,7254,401,6853,11.07%,5.53%
2020-01-01 00:17:10,15,1,557,3,554,0.85%,0.54%
2020-01-01 00:17:10,15,2,120,0,120,0.18%,0.00%
2020-01-01 00:17:10,15,3,3552,89,3463,5.42%,2.51%
2020-01-01 00:17:10,15,4,5272,215,5057,8.04%,4.08%
2020-01-01 00:17:10,15,5,9629,700,8929,14.69%,7.27%
2020-01-01 00:17:10,15,6,5483,230,5253,8.37%,4.19%
2020-01-01 00:17:10,15,7,3520,97,3423,5.37%,2.76%
2020-01-01 00:17:10,15,8,5203,203,5000,7.94%,3.90%
2020-01-01 00:17:10,15,9,9844,729,9115,15.02%,7.41%
2020-01-01 00:17:10,15,10,4877,266,4611,7.44%,5.45%
2020-01-01 00:17:10,15,11,10239,848,9391,15.62%,8.28%
2020-01-01 00:17:10,15,12,26503,5060,21443,40.44%,19.09%
2020-01-01 00:17:10,16,1,487,0,487,0.74%,0.00%
2020-01-01 00:17:10,16,2,263,0,263,0.40%,0.00%
2020-01-01 00:17:10,16,3,1246,9,1237,1.90%,0.72%
2020-01-01 00:17:10,16,4,3707,102,3605,5.66%,2.75%
2020-01-01 00:17:10,16,5,6820,396,6424,10.41%,5.81%
2020-01-01 00:17:10,16,6,4450,161,4289,6.79%,3.62%
2020-01-01 00:17:10,16,7,3229,89,3140,4.93%,2.76%
2020-01-01 00:17:10,16,8,6665,429,6236,10.17%,6.44%
2020-01-01 00:17:10,16,9,7237,432,6805,11.04%,5.97%
2020-01-01 00:17:10,16,10,1481,19,1462,2.26%,1.28%
2020-01-01 00:17:10,16,11,8426,612,7814,12.86%,7.26%
2020-01-01 00:17:10,16,12,23589,3931,19658,35.99%,16.66%
2020-01-01 00:17:20,1,1,22050,3345,18705,33.65%,15.17%
2020-01-01 00:17:20,1,2,7938,445,7493,12.11%,5.61%
2020-01-01 00:17:20,1,3,500,1,499,0.76%,0.20%
2020-01-01 00:17:20,1,4,13659,1337,12322,20.84%,9.79%
2020-01-01 00:17:20,1,5,12478,1133,11345,19.04%,9.08%
2020-01-01 00:17:20,1,6,12561,1148,11413,19.17%,9.14%
2020-01-01 00:17:20,1,7,7427,393,7034,11.33%,5.29%
2020-01-01 00:17:20,1,8,4914,180,4734,7.50%,3.66%
2020-01-01 00:17:20,1,9,12351,1110,11241,18.85%,8.99%
2020-01-01 00:17:20,1,10,4439,147,4292,6.77%,3.31%
2020-01-01 00:17:20,1,11,4546,156,4390,6.94%,3.43%
2020-01-01 00:17:20,1,12,12319,1106,11213,18.80%,8.98%
2020-01-01 00:17:20,2,1,550,2,548,0.84%,0.36%
2020-01-01 00:17:20,2,2,28317,5315,23002,43.21%,18.77%
2020-01-01 00:17:20,2,3,23650,3815,19835,36.09%,16.13%
2020-01-01 00:17:20,2,4,499,2,497,0.76%,0.40%
2020-01-01 00:17:20,2,5,14261,1446,12815,21.76%,10.14%
2020-01-01 00:17:20,2,6,19,0,19,0.03%,0.00%
2020-01-01 00:17:20,2,7,4073,131,3942,6.21%,3.22%
2020-01-01 00:17:20,2,8,3334,91,3243,5.09%,2.73%
2020-01-01 00:17:20,2,9,14172,1423,12749,21.62%,10.04%
2020-01-01 00:17:20,2,10,2555,58,2497,3.90%,2.27%
2020-01-01 00:17:20,2,11,2584,60,2524,3.94%,2.32%
2020-01-01 00:17:20,2,12,13952,1376,12576,21.29%,9.86%
2020-01-01 00:17:20,3,1,1512,23,1489,2.31%,1.52%
2020-01-01 00:17:20,3,2,26230,4595,21635,40.02%,17.52%
2020-01-01 00:17:20,3,3,76795,31615,45180,117.18%,41.17%
2020-01-01 00:17:20,3,4,11392,899,10493,17.38%,7.89%
2020-01-01 00:17:20,3,5,49620,14760,34860,75.71%,29.75%
2020-01-01 00:17:20,3,6,14487,1452,13035,22.11%,10.02%
2020-01-01 00:17:20,3,7,22768,3470,19298,34.74%,15.24%
2020-01-01 00:17:20,3,8,18541,2344,16197,28.29%,12.64%
2020-01-01 00:17:20,3,9,34745,7723,27022,53.02%,22.23%
2020-01-01 00:17:20,3,10,7053,381,6672,10.76%,5.40%
2020-01-01 00:17:20,3,11,2562,48,2514,3.91%,1.87%
2020-01-01 00:17:20,3,12,25094,4236,20858,38.29%,16.88%
2020-01-01 00:17:20,4,1,504,0,504,0.77%,0.00%
2020-01-01 00:17:20,4,2,318,0,318,0.49%,0.00%
2020-01-01 00:17:20,4,3,602,3,599,0.92%,0.50%
2020-01-01 00:17:20,4,4,27305,5178,22127,41.66%,18.96%
2020-01-01 00:17:20,4,5,16230,1849,14381,24.77%,11.39%
2020-01-01 00:17:20,4,6,22953,3740,19213,35.02%,16.29%
2020-01-01 00:17:20,4,7,5337,247,5090,8.14%,4.63%
2020-01-01 00:17:20,4,8,3074,87,2987,4.69%,2.83%
2020-01-01 00:17:20,4,9,14459,1457,13002,22.06%,10.08%
2020-01-01 00:17:20,4,10,1821,31,1790,2.78%,1.70%
2020-01-01 00:17:20,4,11,242,2,240,0.37%,0.83%
2020-01-01 00:17:20,4,12,11748,959,10789,17.93%,8.16%
2020-01-01 00:17:20,5,1,3254,71,3183,4.97%,2.18%
2020-01-01 00:17:20,5,2,783,4,779,1.19%,0.51%
2020-01-01 00:17:20,5,3,1966,31,1935,3.00%,1.58%
2020-01-01 00:17:20,5,4,24087,3923,20164,36.75%,16.29%
2020-01-01 00:17:20,5,5,9789,688,9101,14.94%,7.03%
2020-01-01 00:17:20,5,6,16587,1897,14690,25.31%,11.44%
2020-01-01 00:17:20,5,7,6200,304,5896,9.46%,4.90%
2020-01-01 00:17:20,5,8,2877,60,2817,4.39%,2.09%
2020-01-01 00:17:20,5,9,7668,427,7241,11.70%,5.57%
2020-01-01 00:17:20,5,10,980,13,967,1.50%,1.33%
2020-01-01 00:17:20,5,11,481,0,481,0.73%,0.00%
2020-01-01 00:17:20,5,12,6367,302,6065,9.72%,4.74%
2020-01-01 00:17:20,6,1,1039,10,1029,1.59%,0.96%
2020-01-01 00:17:20,6,2,1111,12,1099,1.70%,1.08%
2020-01-01 00:17:20,6,3,1741,35,1706,2.66%,2.01%
2020-01-01 00:17:20,6,4,1215,21,1194,1.85%,1.73%
2020-01-01 00:17:20,6,5,12271,1135,11136,18.72%,9.25%
2020-01-01 00:17:20,6,6,4510,195,4315,6.88%,4.32%
2020-01-01 00:17:20,6,7,2857,70,2787,4.36%,2.45%
2020-01-01 00:17:20,6,8,1838,35,1803,2.80%,1.90%
2020-01-01 00:17:20,6,9,5839,237,5602,8.91%,4.06%
2020-01-01 00:17:20,6,10,1719,24,1695,2.62%,1.40%
2020-01-01 00:17:20,6,11,423,2,421,0.65%,0.47%
2020-01-01 00:17:20,6,12,4075,121,3954,6.22%,2.97%
2020-01-01 00:17:20,7,1,596,2,594,0.91%,0.34%
2020-01-01 00:17:20,7,2,139,0,139,0.21%,0.00%
2020-01-01 00:17:20,7,3,641,4,637,0.98%,0.62%
2020-01-01 00:17:20,7,4,2264,30,2234,3.45%,1.33%
2020-01-01 00:17:20,7,5,6952,408,6544,10.61%,5.87%
2020-01-01 00:17:20,7,6,12657,1219,11438,19.31%,9.63%
2020-01-01 00:17:20,7,7,3404,99,3305,5.19%,2.91%
2020-01-01 00:17:20,7,8,1205,16,1189,1.84%,1.33%
2020-01-01 00:17:20,7,9,6149,319,5830,9.38%,5.19%
2020-01-01 00:17:20,7,10,1239,6,1233,1.89%,0.48%
2020-01-01 00:17:20,7,11,81,0,81,0.12%,0.00%
2020-01-01 00:17:20,7,12,4927,225,4702,7.52%,4.57%
2020-01-01 00:17:20,8,1,513,2,511,0.78%,0.39%
2020-01-01 00:17:20,8,2,89,0,89,0.14%,0.00%
2020-01-01 00:17:20,8,3,2108,31,2077,3.22%,1.47%
2020-01-01 00:17:20,8,4,2780,57,2723,4.24%,2.05%
2020-01-01 00:17:20,8,5,8468,537,7931,12.92%,6.34%
2020-01-01 00:17:20,8,6,16337,1876,14461,24.93%,11.48%
2020-01-01 00:17:20,8,7,5061,184,4877,7.72%,3.64%
2020-01-01 00:17:20,8,8,2337,30,2307,3.57%,1.28%
2020-01-01 00:17:20,8,9,6039,266,5773,9.21%,4.40%
2020-01-01 00:17:20,8,10,1814,30,1784,2.77%,1.65%
2020-01-01 00:17:20,8,11,95,0,95,0.14%,0.00%
2020-01-01 00:17:20,8,12,4215,123,4092,6.43%,2.92%
2020-01-01 00:17:20,9,1,1289,6,1283,1.97%,0.47%
2020-01-01 00:17:20,9,2,5315,223,5092,8.11%,4.20%
2020-01-01 00:17:20,9,3,3662,102,3560,5.59%,2.79%
2020-01-01 00:17:20,9,4,7927,443,7484,12.10%,5.59%
2020-01-01 00:17:20,9,5,558,4,554,0.85%,0.72%
2020-01-01 00:17:20,9,6,9146,595,8551,13.96%,6.51%
2020-01-01 00:17:20,9,7,31087,6348,24739,47.43%,20.42%
2020-01-01 00:17:20,9,8,11542,1065,10477,17.61%,9.23%
2020-01-01 00:17:20,9,9,419,3,416,0.64%,0.72%
2020-01-01 00:17:20,9,10,4720,192,4528,7.20%,4.07%
2020-01-01 00:17:20,9,11,10632,920,9712,16.22%,8.65%
2020-01-01 00:17:20,9,12,5622,230,5392,8.58%,4.09%
2020-01-01 00:17:20,10,1,1455,277,1178,2.22%,19.04%
2020-01-01 00:17:20,10,2,3191,334,2857,4.87%,10.47%
2020-01-01 00:17:20,10,3,1616,32,1584,2.47%,1.98%
2020-01-01 00:17:20,10,4,4031,1115,2916,6.15%,27.66%
2020-01-01 00:17:20,10,5,753,92,661,1.15%,12.22%
2020-01-01 00:17:20,10,6,5795,1306,4489,8.84%,22.54%
2020-01-01 00:17:20,10,7,10662,1999,8663,16.27%,18.75%
2020-01-01 00:17:20,10,8,28691,7428,21263,43.78%,25.89%
2020-01-01 00:17:20,10,9,591,5,586,0.90%,0.85%
2020-01-01 00:17:20,10,10,2701,59,2642,4.12%,2.18%
2020-01-01 00:17:20,10,11,14071,1871,12200,21.47%,13.30%
2020-01-01 00:17:20,10,12,10522,1311,9211,16.06%,12.46%
2020-01-01 00:17:20,11,1,2653,59,2594,4.05%,2.22%
2020-01-01 00:17:20,11,2,3461,93,3368,5.28%,2.69%
2020-01-01 00:17:20,11,3,625,4,621,0.95%,0.64%
2020-01-01 00:17:20,11,4,3586,106,3480,5.47%,2.96%
2020-01-01 00:17:20,11,5,161,0,161,0.25%,0.00%
2020-01-01 00:17:20,11,6,4411,162,4249,6.73%,3.67%
2020-01-01 00:17:20,11,7,9298,688,8610,14.19%,7.40%
2020-01-01 00:17:20,11,8,23165,3581,19584,35.35%,15.46%
2020-01-01 00:17:20,11,9,383,2,381,0.58%,0.52%
2020-01-01 00:17:20,11,10,3157,78,3079,4.82%,2.47%
2020-01-01 00:17:20,11,11,10238,749,9489,15.62%,7.32%
2020-01-01 00:17:20,11,12,6630,319,6311,10.12%,4.81%
2020-01-01 00:17:20,12,1,51,0,51,0.08%,0.00%
2020-01-01 00:17:20,12,2,566,161,405,0.86%,28.45%
2020-01-01 00:17:20,12,3,2527,185,2342,3.86%,7.32%
2020-01-01 00:17:20,12,4,2986,107,2879,4.56%,3.58%
2020-01-01 00:17:20,12,5,8416,723,7693,12.84%,8.59%
2020-01-01 00:17:20,12,6,4782,252,4530,7.30%,5.27%
2020-01-01 00:17:20,12,7,1618,18,1600,2.47%,1.11%
2020-01-01 00:17:20,12,8,1885,383,1502,2.88%,20.32%
2020-01-01 00:17:20,12,9,20963,4198,16765,31.99%,20.03%
2020-01-01 00:17:20,12,10,5022,540,4482,7.66%,10.75%
2020-01-01 00:17:20,12,11,2102,391,1711,3.21%,18.60%
2020-01-01 00:17:20,12,12,6822,1173,5649,10.41%,17.19%
2020-01-01 00:17:20,13,1,2250,40,2210,3.43%,1.78%
2020-01-01 00:17:20,13,2,2619,53,2566,4.00%,2.02%
2020-01-01 00:17:20,13,3,1054,11,1043,1.61%,1.04%
2020-01-01 00:17:20,13,4,5618,575,5043,8.57%,10.23%
2020-01-01 00:17:20,13,5,8202,885,7317,12.52%,10.79%
2020-01-01 00:17:20,13,6,6348,626,5722,9.69%,9.86%
2020-01-01 00:17:20,13,7,4652,148,4504,7.10%,3.18%
2020-01-01 00:17:20,13,8,7777,426,7351,11.87%,5.48%
2020-01-01 00:17:20,13,9,8484,922,7562,12.95%,10.87%
2020-01-01 00:17:20,13,10,28398,5840,22558,43.33%,20.56%
2020-01-01 00:17:20,13,11,17134,2314,14820,26.14%,13.51%
2020-01-01 00:17:20,13,12,9005,902,8103,13.74%,10.02%
2020-01-01 00:17:20,14,1,236,0,236,0.36%,0.00%
2020-01-01 00:17:20,14,2,1428,14,1414,2.18%,0.98%
2020-01-01 00:17:20,14,3,1073,8,1065,1.64%,0.75%
2020-01-01 00:17:20,14,4,3563,85,3478,5.44%,2.39%
2020-01-01 00:17:20,14,5,1369,11,1358,2.09%,0.80%
2020-01-01 00:17:20,14,6,3821,95,3726,5.83%,2.49%
2020-01-01 00:17:20,14,7,10963,844,10119,16.73%,7.70%
2020-01-01 00:17:20,14,8,12518,1104,11414,19.10%,8.82%
2020-01-01 00:17:20,14,9,1600,14,1586,2.44%,0.88%
2020-01-01 00:17:20,14,10,4347,136,4211,6.63%,3.13%
2020-01-01 00:17:20,14,11,25100,4152,20948,38.30%,16.54%
2020-01-01 00:17:20,14,12,7884,416,7468,12.03%,5.28%
2020-01-01 00:17:20,15,1,703,6,697,1.07%,0.85%
2020-01-01 00:17:20,15,2,152,0,152,0.23%,0.00%
2020-01-01 00:17:20,15,3,4060,120,3940,6.20%,2.96%
2020-01-01 00:17:20,15,4,4367,172,4195,6.66%,3.94%
2020-01-01 00:17:20,15,5,9165,641,8524,13.98%,6.99%
2020-01-01 00:17:20,15,6,4600,184,4416,7.02%,4.00%
2020-01-01 00:17:20,15,7,3685,102,3583,5.62%,2.77%
2020-01-01 00:17:20,15,8,5775,236,5539,8.81%,4.09%
2020-01-01 00:17:20,15,9,9395,674,8721,14.34%,7.17%
2020-01-01 00:17:20,15,10,5491,448,5043,8.38%,8.16%
2020-01-01 00:17:20,15,11,11455,1142,10313,17.48%,9.97%
2020-01-01 00:17:20,15,12,26848,5381,21467,40.97%,20.04%
2020-01-01 00:17:20,16,1,469,0,469,0.72%,0.00%
2020-01-01 00:17:20,16,2,284,1,283,0.43%,0.35%
2020-01-01 00:17:20,16,3,1485,30,1455,2.27%,2.02%
2020-01-01 00:17:20,16,4,4138,157,3981,6.31%,3.79%
2020-01-01 00:17:20,16,5,7373,493,6880,11.25%,6.69%
2020-01-01 00:17:20,16,6,4991,219,4772,7.62%,4.39%
2020-01-01 00:17:20,16,7,3408,70,3338,5.20%,2.05%
2020-01-01 00:17:20,16,8,7616,513,7103,11.62%,6.74%
2020-01-01 00:17:20,16,9,7940,556,7384,12.12%,7.00%
2020-01-01 00:17:20,16,10,1591,21,1570,2.43%,1.32%
2020-01-01 00:17:20,16,11,9441,699,8742,14.41%,7.40%
2020-01-01 00:17:20,16,12,25852,4658,21194,39.45%,18.02%
2020-01-01 00:17:30,1,1,21984,3269,18715,33.54%,14.87%
2020-01-01 00:17:30,1,2,10131,742,9389,15.46%,7.32%
2020-01-01 00:17:30,1,3,572,5,567,0.87%,0.87%
2020-01-01 00:17:30,1,4,11304,939,10365,17.25%,8.31%
2020-01-01 00:17:30,1,5,10834,870,9964,16.53%,8.03%
2020-01-01 00:17:30,1,6,10770,862,9908,16.43%,8.00%
2020-01-01 00:17:30,1,7,9543,661,8882,14.56%,6.93%
2020-01-01 00:17:30,1,8,7253,380,6873,11.07%,5.24%
2020-01-01 00:17:30,1,9,10733,858,9875,16.38%,7.99%
2020-01-01 00:17:30,1,10,6550,293,6257,9.99%,4.47%
2020-01-01 00:17:30,1,11,6656,309,6347,10.16%,4.64%
2020-01-01 00:17:30,1,12,10705,855,9850,16.33%,7.99%
2020-01-01 00:17:30,2,1,1533,14,1519,2.34%,0.91%
2020-01-01 00:17:30,2,2,33613,7285,26328,51.29%,21.67%
2020-01-01 00:17:30,2,3,26032,4593,21439,39.72%,17.64%
2020-01-01 00:17:30,2,4,1467,14,1453,2.24%,0.95%
2020-01-01 00:17:30,2,5,16962,2076,14886,25.88%,12.24%
2020-01-01 00:17:30,2,6,17,0,17,0.03%,0.00%
2020-01-01 00:17:30,2,7,6018,257,5761,9.18%,4.27%
2020-01-01 00:17:30,2,8,4805,170,4635,7.33%,3.54%
2020-01-01 00:17:30,2,9,16893,2058,14835,25.78%,12.18%
2020-01-01 00:17:30,2,10,3869,115,3754,5.90%,2.97%
2020-01-01 00:17:30,2,11,3890,116,3774,5.94%,2.98%
2020-01-01 00:17:30,2,12,16717,2019,14698,25.51%,12.08%
2020-01-01 00:17:30,3,1,1250,12,1238,1.91%,0.96%
2020-01-01 00:17:30,3,2,21126,3049,18077,32.24%,14.43%
2020-01-01 00:17:30,3,3,64254,23253,41001,98.04%,36.19%
2020-01-01 00:17:30,3,4,9050,655,8395,13.81%,7.24%
2020-01-01 00:17:30,3,5,40638,10368,30270,62.01%,25.51%
2020-01-01 00:17:30,3,6,10339,828,9511,15.78%,8.01%
2020-01-01 00:17:30,3,7,17859,2243,15616,27.25%,12.56%
2020-01-01 00:17:30,3,8,14933,1588,13345,22.79%,10.63%
2020-01-01 00:17:30,3,9,29941,5915,24026,45.69%,19.76%
2020-01-01 00:17:30,3,10,5554,215,5339,8.47%,3.87%
2020-01-01 00:17:30,3,11,1856,31,1825,2.83%,1.67%
2020-01-01 00:17:30,3,12,21765,3296,18469,33.21%,15.14%
2020-01-01 00:17:30,4,1,474,2,472,0.72%,0.42%
2020-01-01 00:17:30,4,2,294,1,293,0.45%,0.34%
2020-01-01 00:17:30,4,3,657,2,655,1.00%,0.30%
2020-01-01 00:17:30,4,4,27549,5106,22443,42.04%,18.53%
2020-01-01 00:17:30,4,5,17491,2108,15383,26.69%,12.05%
2020-01-01 00:17:30,4,6,23635,3790,19845,36.06%,16.04%
2020-01-01 00:17:30,4,7,4768,181,4587,7.28%,3.80%
2020-01-01 00:17:30,4,8,3061,81,2980,4.67%,2.65%
2020-01-01 00:17:30,4,9,15670,1733,13937,23.91%,11.06%
2020-01-01 00:17:30,4,10,1929,30,1899,2.94%,1.56%
2020-01-01 00:17:30,4,11,219,1,218,0.33%,0.46%
2020-01-01 00:17:30,4,12,12856,1182,11674,19.62%,9.19%
2020-01-01 00:17:30,5,1,3495,80,3415,5.33%,2.29%
2020-01-01 00:17:30,5,2,1191,6,1185,1.82%,0.50%
2020-01-01 00:17:30,5,3,777,6,771,1.19%,0.77%
2020-01-01 00:17:30,5,4,22831,3572,19259,34.84%,15.65%
2020-01-01 00:17:30,5,5,9248,616,8632,14.11%,6.66%
2020-01-01 00:17:30,5,6,14941,1566,13375,22.80%,10.48%
2020-01-01 00:17:30,5,7,5217,218,4999,7.96%,4.18%
2020-01-01 00:17:30,5,8,3703,114,3589,5.65%,3.08%
2020-01-01 00:17:30,5,9,8351,506,7845,12.74%,6.06%
2020-01-01 00:17:30,5,10,991,8,983,1.51%,0.81%
2020-01-01 00:17:30,5,11,646,8,638,0.99%,1.24%
2020-01-01 00:17:30,5,12,7098,370,6728,10.83%,5.21%
2020-01-01 00:17:30,6,1,1494,17,1477,2.28%,1.14%
2020-01-01 00:17:30,6,2,1563,20,1543,2.38%,1.28%
2020-01-01 00:17:30,6,3,2214,44,2170,3.38%,1.99%
2020-01-01 00:17:30,6,4,1418,12,1406,2.16%,0.85%
2020-01-01 00:17:30,6,5,16910,2125,14785,25.80%,12.57%
2020-01-01 00:17:30,6,6,5715,329,5386,8.72%,5.76%
2020-01-01 00:17:30,6,7,3778,189,3589,5.76%,5.00%
2020-01-01 00:17:30,6,8,2891,62,2829,4.41%,2.14%
2020-01-01 00:17:30,6,9,8740,623,8117,13.34%,7.13%
2020-01-01 00:17:30,6,10,3123,121,3002,4.77%,3.87%
2020-01-01 00:17:30,6,11,492,1,491,0.75%,0.20%
2020-01-01 00:17:30,6,12,5566,244,5322,8.49%,4.38%
2020-01-01 00:17:30,7,1,559,5,554,0.85%,0.89%
2020-01-01 00:17:30,7,2,165,1,164,0.25%,0.61%
2020-01-01 00:17:30,7,3,1115,13,1102,1.70%,1.17%
2020-01-01 00:17:30,7,4,2157,43,2114,3.29%,1.99%
2020-01-01 00:17:30,7,5,8286,527,7759,12.64%,6.36%
2020-01-01 00:17:30,7,6,14215,1484,12731,21.69%,10.44%
2020-01-01 00:17:30,7,7,3734,118,3616,5.70%,3.16%
2020-01-01 00:17:30,7,8,1328,14,1314,2.03%,1.05%
2020-01-01 00:17:30,7,9,6875,372,6503,10.49%,5.41%
2020-01-01 00:17:30,7,10,1185,10,1175,1.81%,0.84%
2020-01-01 00:17:30,7,11,118,0,118,0.18%,0.00%
2020-01-01 00:17:30,7,12,5676,263,5413,8.66%,4.63%
2020-01-01 00:17:30,8,1,673,4,669,1.03%,0.59%
2020-01-01 00:17:30,8,2,119,2,117,0.18%,1.68%
2020-01-01 00:17:30,8,3,2099,28,2071,3.20%,1.33%
2020-01-01 00:17:30,8,4,2931,61,2870,4.47%,2.08%
2020-01-01 00:17:30,8,5,8856,570,8286,13.51%,6.44%
2020-01-01 00:17:30,8,6,16415,1851,14564,25.05%,11.28%
2020-01-01 00:17:30,8,7,4586,144,4442,7.00%,3.14%
2020-01-01 00:17:30,8,8,1824,21,1803,2.78%,1.15%
2020-01-01 00:17:30,8,9,6454,330,6124,9.85%,5.11%
2020-01-01 00:17:30,8,10,1833,22,1811,2.80%,1.20%
2020-01-01 00:17:30,8,11,131,0,131,0.20%,0.00%
2020-01-01 00:17:30,8,12,4606,173,4433,7.03%,3.76%
2020-01-01 00:17:30,9,1,1287,7,1280,1.96%,0.54%
2020-01-01 00:17:30,9,2,2866,55,2811,4.37%,1.92%
2020-01-01 00:17:30,9,3,1189,10,1179,1.81%,0.84%
2020-01-01 00:17:30,9,4,3856,106,3750,5.88%,2.75%
2020-01-01 00:17:30,9,5,600,1,599,0.92%,0.17%
2020-01-01 00:17:30,9,6,4874,158,4716,7.44%,3.24%
2020-01-01 00:17:30,9,7,23427,3670,19757,35.75%,15.67%
2020-01-01 00:17:30,9,8,10822,856,9966,16.51%,7.91%
2020-01-01 00:17:30,9,9,197,0,197,0.30%,0.00%
2020-01-01 00:17:30,9,10,4135,143,3992,6.31%,3.46%
2020-01-01 00:17:30,9,11,9634,701,8933,14.70%,7.28%
2020-01-01 00:17:30,9,12,5178,204,4974,7.90%,3.94%
2020-01-01 00:17:30,10,1,1454,300,1154,2.22%,20.63%
2020-01-01 00:17:30,10,2,3526,359,3167,5.38%,10.18%
2020-01-01 00:17:30,10,3,1922,18,1904,2.93%,0.94%
2020-01-01 00:17:30,10,4,4345,1238,3107,6.63%,28.49%
2020-01-01 00:17:30,10,5,731,46,685,1.12%,6.29%
2020-01-01 00:17:30,10,6,6666,1417,5249,10.17%,21.26%
2020-01-01 00:17:30,10,7,12147,2286,9861,18.53%,18.82%
2020-01-01 00:17:30,10,8,32178,8680,23498,49.10%,26.97%
2020-01-01 00:17:30,10,9,896,4,892,1.37%,0.45%
2020-01-01 00:17:30,10,10,2812,46,2766,4.29%,1.64%
2020-01-01 00:17:30,10,11,15139,2052,13087,23.10%,13.55%
2020-01-01 00:17:30,10,12,11701,1450,10251,17.85%,12.39%
2020-01-01 00:17:30,11,1,3091,71,3020,4.72%,2.30%
2020-01-01 00:17:30,11,2,4459,165,4294,6.80%,3.70%
2020-01-01 00:17:30,11,3,1237,15,1222,1.89%,1.21%
2020-01-01 00:17:30,11,4,4913,194,4719,7.50%,3.95%
2020-01-01 00:17:30,11,5,268,2,266,0.41%,0.75%
2020-01-01 00:17:30,11,6,5918,291,5627,9.03%,4.92%
2020-01-01 00:17:30,11,7,12003,1070,10933,18.32%,8.91%
2020-01-01 00:17:30,11,8,27540,5024,22516,42.02%,18.24%
2020-01-01 00:17:30,11,9,401,0,401,0.61%,0.00%
2020-01-01 00:17:30,11,10,2968,64,2904,4.53%,2.16%
2020-01-01 00:17:30,11,11,11791,972,10819,17.99%,8.24%
2020-01-01 00:17:30,11,12,8276,485,7791,12.63%,5.86%
2020-01-01 00:17:30,12,1,46,0,46,0.07%,0.00%
2020-01-01 00:17:30,12,2,883,192,691,1.35%,21.74%
2020-01-01 00:17:30,12,3,4122,321,3801,6.29%,7.79%
2020-01-01 00:17:30,12,4,3049,81,2968,4.65%,2.66%
2020-01-01 00:17:30,12,5,10871,1024,9847,16.59%,9.42%
2020-01-01 00:17:30,12,6,4900,209,4691,7.48%,4.27%
2020-01-01 00:17:30,12,7,1698,25,1673,2.59%,1.47%
2020-01-01 00:17:30,12,8,1625,317,1308,2.48%,19.51%
2020-01-01 00:17:30,12,9,23133,4658,18475,35.30%,20.14%
2020-01-01 00:17:30,12,10,4499,429,4070,6.86%,9.54%
2020-01-01 00:17:30,12,11,1979,330,1649,3.02%,16.68%
2020-01-01 00:17:30,12,12,7307,1131,6176,11.15%,15.48%
2020-01-01 00:17:30,13,1,2385,43,2342,3.64%,1.80%
2020-01-01 00:17:30,13,2,2705,54,2651,4.13%,2.00%
2020-01-01 00:17:30,13,3,1065,3,1062,1.63%,0.28%
2020-01-01 00:17:30,13,4,5331,530,4801,8.13%,9.94%
2020-01-01 00:17:30,13,5,8031,868,7163,12.25%,10.81%
2020-01-01 00:17:30,13,6,6116,585,5531,9.33%,9.57%
2020-01-01 00:17:30,13,7,4911,177,4734,7.49%,3.60%
2020-01-01 00:17:30,13,8,7231,389,6842,11.03%,5.38%
2020-01-01 00:17:30,13,9,8351,896,7455,12.74%,10.73%
2020-01-01 00:17:30,13,10,29121,6102,23019,44.44%,20.95%
2020-01-01 00:17:30,13,11,17914,2457,15457,27.33%,13.72%
2020-01-01 00:17:30,13,12,10085,1004,9081,15.39%,9.96%
2020-01-01 00:17:30,14,1,328,2,326,0.50%,0.61%
2020-01-01 00:17:30,14,2,1470,16,1454,2.24%,1.09%
2020-01-01 00:17:30,14,3,820,5,815,1.25%,0.61%
2020-01-01 00:17:30,14,4,3315,93,3222,5.06%,2.81%
2020-01-01 00:17:30,14,5,1444,14,1430,2.20%,0.97%
2020-01-01 00:17:30,14,6,3640,108,3532,5.55%,2.97%
2020-01-01 00:17:30,14,7,11065,873,10192,16.88%,7.89%
2020-01-01 00:17:30,14,8,12708,1145,11563,19.39%,9.01%
2020-01-01 00:17:30,14,9,1675,18,1657,2.56%,1.07%
2020-01-01 00:17:30,14,10,4553,147,4406,6.95%,3.23%
2020-01-01 00:17:30,14,11,25417,4269,21148,38.78%,16.80%
2020-01-01 00:17:30,14,12,7951,452,7499,12.13%,5.68%
2020-01-01 00:17:30,15,1,484,2,482,0.74%,0.41%
2020-01-01 00:17:30,15,2,110,0,110,0.17%,0.00%
2020-01-01 00:17:30,15,3,3845,95,3750,5.87%,2.47%
2020-01-01 00:17:30,15,4,4628,191,4437,7.06%,4.13%
2020-01-01 00:17:30,15,5,9511,697,8814,14.51%,7.33%
2020-01-01 00:17:30,15,6,4901,209,4692,7.48%,4.26%
2020-01-01 00:17:30,15,7,3690,147,3543,5.63%,3.98%
2020-01-01 00:17:30,15,8,5766,277,5489,8.80%,4.80%
2020-01-01 00:17:30,15,9,9737,733,9004,14.86%,7.53%
2020-01-01 00:17:30,15,10,4105,356,3749,6.26%,8.67%
2020-01-01 00:17:30,15,11,9969,963,9006,15.21%,9.66%
2020-01-01 00:17:30,15,12,25157,4684,20473,38.39%,18.62%
2020-01-01 00:17:30,16,1,478,4,474,0.73%,0.84%
2020-01-01 00:17:30,16,2,276,3,273,0.42%,1.09%
2020-01-01 00:17:30,16,3,1985,36,1949,3.03%,1.81%
2020-01-01 00:17:30,16,4,4441,149,4292,6.78%,3.36%
2020-01-01 00:17:30,16,5,8328,581,7747,12.71%,6.98%
2020-01-01 00:17:30,16,6,5362,209,5153,8.18%,3.90%
2020-01-01 00:17:30,16,7,3194,79,3115,4.87%,2.47%
2020-01-01 00:17:30,16,8,7300,452,6848,11.14%,6.19%
2020-01-01 00:17:30,16,9,8787,641,8146,13.41%,7.29%
2020-01-01 00:17:30,16,10,1599,26,1573,2.44%,1.63%
2020-01-01 00:17:30,16,11,9108,680,8428,13.90%,7.47%
2020-01-01 00:17:30,16,12,26197,4756,21441,39.97%,18.15%
2020-01-01 00:17:40,1,1,17294,2089,15205,26.39%,12.08%
2020-01-01 00:17:40,1,2,5701,256,5445,8.70%,4.49%
2020-01-01 00:17:40,1,3,376,0,376,0.57%,0.00%
2020-01-01 00:17:40,1,4,11177,936,10241,17.05%,8.37%
2020-01-01 00:17:40,1,5,10847,877,9970,16.55%,8.09%
2020-01-01 00:17:40,1,6,10798,873,9925,16.48%,8.08%
2020-01-01 00:17:40,1,7,5310,213,5097,8.10%,4.01%
2020-01-01 00:17:40,1,8,4091,126,3965,6.24%,3.08%
2020-01-01 00:17:40,1,9,10727,860,9867,16.37%,8.02%
2020-01-01 00:17:40,1,10,3215,75,3140,4.91%,2.33%
2020-01-01 00:17:40,1,11,3293,85,3208,5.02%,2.58%
2020-01-01 00:17:40,1,12,10699,852,9847,16.33%,7.96%
2020-01-01 00:17:40,2,1,1566,19,1547,2.39%,1.21%
2020-01-01 00:17:40,2,2,32044,6736,25308,48.90%,21.02%
2020-01-01 00:17:40,2,3,26781,4825,21956,40.86%,18.02%
2020-01-01 00:17:40,2,4,1500,16,1484,2.29%,1.07%
2020-01-01 00:17:40,2,5,17958,2265,15693,27.40%,12.61%
2020-01-01 00:17:40,2,6,54,0,54,0.08%,0.00%
2020-01-01 00:17:40,2,7,3687,90,3597,5.63%,2.44%
2020-01-01 00:17:40,2,8,2997,61,2936,4.57%,2.04%
2020-01-01 00:17:40,2,9,17472,2143,15329,26.66%,12.27%
2020-01-01 00:17:40,2,10,2404,44,2360,3.67%,1.83%
2020-01-01 00:17:40,2,11,2410,44,2366,3.68%,1.83%
2020-01-01 00:17:40,2,12,17268,2097,15171,26.35%,12.14%
2020-01-01 00:17:40,3,1,1612,9,1603,2.46%,0.56%
2020-01-01 00:17:40,3,2,22120,3314,18806,33.75%,14.98%
2020-01-01 00:17:40,3,3,69736,26890,42846,106.41%,38.56%
2020-01-01 00:17:40,3,4,10518,784,9734,16.05%,7.45%
2020-01-01 00:17:40,3,5,46300,13182,33118,70.65%,28.47%
2020-01-01 00:17:40,3,6,11715,973,10742,17.88%,8.31%
2020-01-01 00:17:40,3,7,18631,2409,16222,28.43%,12.93%
2020-01-01 00:17:40,3,8,15700,1734,13966,23.96%,11.04%
2020-01-01 00:17:40,3,9,34157,7620,26537,52.12%,22.31%
2020-01-01 00:17:40,3,10,4615,152,4463,7.04%,3.29%
2020-01-01 00:17:40,3,11,1779,19,1760,2.71%,1.07%
2020-01-01 00:17:40,3,12,26500,4842,21658,40.44%,18.27%
2020-01-01 00:17:40,4,1,449,1,448,0.69%,0.22%
2020-01-01 00:17:40,4,2,246,0,246,0.38%,0.00%
2020-01-01 00:17:40,4,3,1013,1,1012,1.55%,0.10%
2020-01-01 00:17:40,4,4,26923,4805,22118,41.08%,17.85%
2020-01-01 00:17:40,4,5,17641,2119,15522,26.92%,12.01%
2020-01-01 00:17:40,4,6,23627,3770,19857,36.05%,15.96%
2020-01-01 00:17:40,4,7,4430,180,4250,6.76%,4.06%
2020-01-01 00:17:40,4,8,2872,76,2796,4.38%,2.65%
2020-01-01 00:17:40,4,9,15410,1623,13787,23.51%,10.53%
2020-01-01 00:17:40,4,10,1741,23,1718,2.66%,1.32%
2020-01-01 00:17:40,4,11,165,0,165,0.25%,0.00%
2020-01-01 00:17:40,4,12,12830,1130,11700,19.58%,8.81%
2020-01-01 00:17:40,5,1,2663,49,2614,4.06%,1.84%
2020-01-01 00:17:40,5,2,809,3,806,1.23%,0.37%
2020-01-01 00:17:40,5,3,1111,14,1097,1.70%,1.26%
2020-01-01 00:17:40,5,4,23308,3774,19534,35.57%,16.19%
2020-01-01 00:17:40,5,5,11730,1029,10701,17.90%,8.77%
2020-01-01 00:17:40,5,6,16880,2108,14772,25.76%,12.49%
2020-01-01 00:17:40,5,7,4689,170,4519,7.15%,3.63%
2020-01-01 00:17:40,5,8,3477,91,3386,5.31%,2.62%
2020-01-01 00:17:40,5,9,9742,718,9024,14.87%,7.37%
2020-01-01 00:17:40,5,10,885,4,881,1.35%,0.45%
2020-01-01 00:17:40,5,11,932,11,921,1.42%,1.18%
2020-01-01 00:17:40,5,12,8440,528,7912,12.88%,6.26%
2020-01-01 00:17:40,6,1,1022,15,1007,1.56%,1.47%
2020-01-01 00:17:40,6,2,1141,17,1124,1.74%,1.49%
2020-01-01 00:17:40,6,3,1536,26,1510,2.34%,1.69%
2020-01-01 00:17:40,6,4,1273,7,1266,1.94%,0.55%
2020-01-01 00:17:40,6,5,15121,1737,13384,23.07%,11.49%
2020-01-01 00:17:40,6,6,3888,120,3768,5.93%,3.09%
2020-01-01 00:17:40,6,7,2104,37,2067,3.21%,1.76%
2020-01-01 00:17:40,6,8,1536,27,1509,2.34%,1.76%
2020-01-01 00:17:40,6,9,9394,655,8739,14.33%,6.97%
2020-01-01 00:17:40,6,10,2512,46,2466,3.83%,1.83%
2020-01-01 00:17:40,6,11,506,2,504,0.77%,0.40%
2020-01-01 00:17:40,6,12,6761,359,6402,10.32%,5.31%
2020-01-01 00:17:40,7,1,607,1,606,0.93%,0.16%
2020-01-01 00:17:40,7,2,84,0,84,0.13%,0.00%
2020-01-01 00:17:40,7,3,1655,22,1633,2.53%,1.33%
2020-01-01 00:17:40,7,4,2016,32,1984,3.08%,1.59%
2020-01-01 00:17:40,7,5,7439,377,7062,11.35%,5.07%
2020-01-01 00:17:40,7,6,13245,1169,12076,20.21%,8.83%
2020-01-01 00:17:40,7,7,3767,121,3646,5.75%,3.21%
2020-01-01 00:17:40,7,8,1425,20,1405,2.17%,1.40%
2020-01-01 00:17:40,7,9,5715,235,5480,8.72%,4.11%
2020-01-01 00:17:40,7,10,1538,13,1525,2.35%,0.85%
2020-01-01 00:17:40,7,11,85,0,85,0.13%,0.00%
2020-01-01 00:17:40,7,12,4236,124,4112,6.46%,2.93%
2020-01-01 00:17:40,8,1,388,0,388,0.59%,0.00%
2020-01-01 00:17:40,8,2,84,0,84,0.13%,0.00%
2020-01-01 00:17:40,8,3,1523,26,1497,2.32%,1.71%
2020-01-01 00:17:40,8,4,2761,61,2700,4.21%,2.21%
2020-01-01 00:17:40,8,5,8427,502,7925,12.86%,5.96%
2020-01-01 00:17:40,8,6,16389,1892,14497,25.01%,11.54%
2020-01-01 00:17:40,8,7,5137,208,4929,7.84%,4.05%
2020-01-01 00:17:40,8,8,2155,36,2119,3.29%,1.67%
2020-01-01 00:17:40,8,9,6639,295,6344,10.13%,4.44%
2020-01-01 00:17:40,8,10,1920,24,1896,2.93%,1.25%
2020-01-01 00:17:40,8,11,178,0,178,0.27%,0.00%
2020-01-01 00:17:40,8,12,4660,154,4506,7.11%,3.30%
2020-01-01 00:17:40,9,1,933,1,932,1.42%,0.11%
2020-01-01 00:17:40,9,2,2383,35,2348,3.64%,1.47%
2020-01-01 00:17:40,9,3,971,7,964,1.48%,0.72%
2020-01-01 00:17:40,9,4,7598,393,7205,11.59%,5.17%
2020-01-01 00:17:40,9,5,220,0,220,0.34%,0.00%
2020-01-01 00:17:40,9,6,8039,442,7597,12.27%,5.50%
2020-01-01 00:17:40,9,7,28550,5405,23145,43.56%,18.93%
2020-01-01 00:17:40,9,8,12340,1062,11278,18.83%,8.61%
2020-01-01 00:17:40,9,9,179,0,179,0.27%,0.00%
2020-01-01 00:17:40,9,10,4146,79,4067,6.33%,1.91%
2020-01-01 00:17:40,9,11,10886,819,10067,16.61%,7.52%
2020-01-01 00:17:40,9,12,6500,323,6177,9.92%,4.97%
2020-01-01 00:17:40,10,1,1142,294,848,1.74%,25.74%
2020-01-01 00:17:40,10,2,2748,334,2414,4.19%,12.15%
2020-01-01 00:17:40,10,3,1427,16,1411,2.18%,1.12%
2020-01-01 00:17:40,10,4,4666,1185,3481,7.12%,25.40%
2020-01-01 00:17:40,10,5,651,5,646,0.99%,0.77%
2020-01-01 00:17:40,10,6,6483,1310,5173,9.89%,20.21%
2020-01-01 00:17:40,10,7,11240,2120,9120,17.15%,18.86%
2020-01-01 00:17:40,10,8,28333,7145,21188,43.23%,25.22%
2020-01-01 00:17:40,10,9,697,2,695,1.06%,0.29%
2020-01-01 00:17:40,10,10,2174,43,2131,3.32%,1.98%
2020-01-01 00:17:40,10,11,12227,1480,10747,18.66%,12.10%
2020-01-01 00:17:40,10,12,9371,1065,8306,14.30%,11.36%
2020-01-01 00:17:40,11,1,2526,41,2485,3.85%,1.62%
2020-01-01 00:17:40,11,2,7580,421,7159,11.57%,5.55%
2020-01-01 00:17:40,11,3,4886,186,4700,7.46%,3.81%
2020-01-01 00:17:40,11,4,3527,83,3444,5.38%,2.35%
2020-01-01 00:17:40,11,5,617,1,616,0.94%,0.16%
2020-01-01 00:17:40,11,6,4812,175,4637,7.34%,3.64%
2020-01-01 00:17:40,11,7,13940,1375,12565,21.27%,9.86%
2020-01-01 00:17:40,11,8,33636,7442,26194,51.32%,22.13%
2020-01-01 00:17:40,11,9,273,1,272,0.42%,0.37%
2020-01-01 00:17:40,11,10,2795,65,2730,4.26%,2.33%
2020-01-01 00:17:40,11,11,15934,1815,14119,24.31%,11.39%
2020-01-01 00:17:40,11,12,12792,1161,11631,19.52%,9.08%
2020-01-01 00:17:40,12,1,47,0,47,0.07%,0.00%
2020-01-01 00:17:40,12,2,781,257,524,1.19%,32.91%
2020-01-01 00:17:40,12,3,3279,338,2941,5.00%,10.31%
2020-01-01 00:17:40,12,4,3027,42,2985,4.62%,1.39%
2020-01-01 00:17:40,12,5,9566,902,8664,14.60%,9.43%
2020-01-01 00:17:40,12,6,5396,230,5166,8.23%,4.26%
2020-01-01 00:17:40,12,7,2267,67,2200,3.46%,2.96%
2020-01-01 00:17:40,12,8,904,253,651,1.38%,27.99%
2020-01-01 00:17:40,12,9,21244,4120,17124,32.42%,19.39%
2020-01-01 00:17:40,12,10,3488,333,3155,5.32%,9.55%
2020-01-01 00:17:40,12,11,1163,256,907,1.77%,22.01%
2020-01-01 00:17:40,12,12,7402,1047,6355,11.29%,14.14%
2020-01-01 00:17:40,13,1,2335,47,2288,3.56%,2.01%
2020-01-01 00:17:40,13,2,2604,59,2545,3.97%,2.27%
2020-01-01 00:17:40,13,3,1045,4,1041,1.59%,0.38%
2020-01-01 00:17:40,13,4,5052,473,4579,7.71%,9.36%
2020-01-01 00:17:40,13,5,7611,778,6833,11.61%,10.22%
2020-01-01 00:17:40,13,6,5762,535,5227,8.79%,9.28%
2020-01-01 00:17:40,13,7,4475,161,4314,6.83%,3.60%
2020-01-01 00:17:40,13,8,6371,310,6061,9.72%,4.87%
2020-01-01 00:17:40,13,9,7941,816,7125,12.12%,10.28%
2020-01-01 00:17:40,13,10,25916,5013,20903,39.54%,19.34%
2020-01-01 00:17:40,13,11,15538,1986,13552,23.71%,12.78%
2020-01-01 00:17:40,13,12,8680,876,7804,13.24%,10.09%
2020-01-01 00:17:40,14,1,523,2,521,0.80%,0.38%
2020-01-01 00:17:40,14,2,1999,33,1966,3.05%,1.65%
2020-01-01 00:17:40,14,3,1231,19,1212,1.88%,1.54%
2020-01-01 00:17:40,14,4,3925,115,3810,5.99%,2.93%
2020-01-01 00:17:40,14,5,1318,21,1297,2.01%,1.59%
2020-01-01 00:17:40,14,6,4293,157,4136,6.55%,3.66%
2020-01-01 00:17:40,14,7,11192,951,10241,17.08%,8.50%
2020-01-01 00:17:40,14,8,13374,1327,12047,20.41%,9.92%
2020-01-01 00:17:40,14,9,1450,23,1427,2.21%,1.59%
2020-01-01 00:17:40,14,10,4119,135,3984,6.29%,3.28%
2020-01-01 00:17:40,14,11,24861,4241,20620,37.93%,17.06%
2020-01-01 00:17:40,14,12,7187,428,6759,10.97%,5.96%
2020-01-01 00:17:40,15,1,412,2,410,0.63%,0.49%
2020-01-01 00:17:40,15,2,104,0,104,0.16%,0.00%
2020-01-01 00:17:40,15,3,3340,86,3254,5.10%,2.57%
2020-01-01 00:17:40,15,4,5747,250,5497,8.77%,4.35%
2020-01-01 00:17:40,15,5,10899,881,10018,16.63%,8.08%
2020-01-01 00:17:40,15,6,6017,271,5746,9.18%,4.50%
2020-01-01 00:17:40,15,7,3380,81,3299,5.16%,2.40%
2020-01-01 00:17:40,15,8,5261,212,5049,8.03%,4.03%
2020-01-01 00:17:40,15,9,11034,898,10136,16.84%,8.14%
2020-01-01 00:17:40,15,10,4608,227,4381,7.03%,4.93%
2020-01-01 00:17:40,15,11,10010,744,9266,15.27%,7.43%
2020-01-01 00:17:40,15,12,26717,5021,21696,40.77%,18.79%
2020-01-01 00:17:40,16,1,355,2,353,0.54%,0.56%
2020-01-01 00:17:40,16,2,260,0,260,0.40%,0.00%
2020-01-01 00:17:40,16,3,1412,14,1398,2.15%,0.99%
2020-01-01 00:17:40,16,4,4350,148,4202,6.64%,3.40%
2020-01-01 00:17:40,16,5,8139,538,7601,12.42%,6.61%
2020-01-01 00:17:40,16,6,5178,225,4953,7.90%,4.35%
2020-01-01 00:17:40,16,7,3074,82,2992,4.69%,2.67%
2020-01-01 00:17:40,16,8,6762,351,6411,10.32%,5.19%
2020-01-01 00:17:40,16,9,8518,585,7933,13.00%,6.87%
2020-01-01 00:17:40,16,10,1673,23,1650,2.55%,1.37%
2020-01-01 00:17:40,16,11,8739,596,8143,13.33%,6.82%
2020-01-01 00:17:40,16,12,26579,4919,21660,40.56%,18.51%
2020-01-01 00:17:50,1,1,15111,1677,13434,23.06%,11.10%
2020-01-01 00:17:50,1,2,6028,297,5731,9.20%,4.93%
2020-01-01 00:17:50,1,3,623,4,619,0.95%,0.64%
2020-01-01 00:17:50,1,4,8761,604,8157,13.37%,6.89%
2020-01-01 00:17:50,1,5,8130,534,7596,12.41%,6.57%
2020-01-01 00:17:50,1,6,7994,521,7473,12.20%,6.52%
2020-01-01 00:17:50,1,7,5381,240,5141,8.21%,4.46%
2020-01-01 00:17:50,1,8,3152,74,3078,4.81%,2.35%
2020-01-01 00:17:50,1,9,7971,519,7452,12.16%,6.51%
2020-01-01 00:17:50,1,10,2636,50,2586,4.02%,1.90%
2020-01-01 00:17:50,1,11,2718,57,2661,4.15%,2.10%
2020-01-01 00:17:50,1,12,7930,517,7413,12.10%,6.52%
2020-01-01 00:17:50,2,1,570,3,567,0.87%,0.53%
2020-01-01 00:17:50,2,2,28468,5303,23165,43.44%,18.63%
2020-01-01 00:17:50,2,3,23822,3757,20065,36.35%,15.77%
2020-01-01 00:17:50,2,4,498,1,497,0.76%,0.20%
2020-01-01 00:17:50,2,5,13456,1220,12236,20.53%,9.07%
2020-01-01 00:17:50,2,6,28,0,28,0.04%,0.00%
2020-01-01 00:17:50,2,7,4068,129,3939,6.21%,3.17%
2020-01-01 00:17:50,2,8,3042,75,2967,4.64%,2.47%
2020-01-01 00:17:50,2,9,13309,1196,12113,20.31%,8.99%
2020-01-01 00:17:50,2,10,2407,40,2367,3.67%,1.66%
2020-01-01 00:17:50,2,11,2414,40,2374,3.68%,1.66%
2020-01-01 00:17:50,2,12,13121,1164,11957,20.02%,8.87%
2020-01-01 00:17:50,3,1,1909,24,1885,2.91%,1.26%
2020-01-01 00:17:50,3,2,23505,3781,19724,35.87%,16.09%
2020-01-01 00:17:50,3,3,69422,26554,42868,105.93%,38.25%
2020-01-01 00:17:50,3,4,9047,596,8451,13.80%,6.59%
2020-01-01 00:17:50,3,5,44092,11917,32175,67.28%,27.03%
2020-01-01 00:17:50,3,6,10122,724,9398,15.44%,7.15%
2020-01-01 00:17:50,3,7,19804,2771,17033,30.22%,13.99%
2020-01-01 00:17:50,3,8,15364,1679,13685,23.44%,10.93%
2020-01-01 00:17:50,3,9,33665,7345,26320,51.37%,21.82%
2020-01-01 00:17:50,3,10,5410,198,5212,8.26%,3.66%
2020-01-01 00:17:50,3,11,2678,67,2611,4.09%,2.50%
2020-01-01 00:17:50,3,12,24645,4112,20533,37.61%,16.68%
2020-01-01 00:17:50,4,1,478,5,473,0.73%,1.05%
2020-01-01 00:17:50,4,2,278,1,277,0.42%,0.36%
2020-01-01 00:17:50,4,3,958,3,955,1.46%,0.31%
2020-01-01 00:17:50,4,4,27960,5194,22766,42.66%,18.58%
2020-01-01 00:17:50,4,5,17392,2090,15302,26.54%,12.02%
2020-01-01 00:17:50,4,6,24403,4059,20344,37.24%,16.63%
2020-01-01 00:17:50,4,7,5493,246,5247,8.38%,4.48%
2020-01-01 00:17:50,4,8,2772,59,2713,4.23%,2.13%
2020-01-01 00:17:50,4,9,15077,1592,13485,23.01%,10.56%
2020-01-01 00:17:50,4,10,2089,31,2058,3.19%,1.48%
2020-01-01 00:17:50,4,11,169,0,169,0.26%,0.00%
2020-01-01 00:17:50,4,12,12363,1097,11266,18.86%,8.87%
2020-01-01 00:17:50,5,1,2629,59,2570,4.01%,2.24%
2020-01-01 00:17:50,5,2,757,4,753,1.16%,0.53%
2020-01-01 00:17:50,5,3,448,1,447,0.68%,0.22%
2020-01-01 00:17:50,5,4,28320,5310,23010,43.21%,18.75%
2020-01-01 00:17:50,5,5,11138,932,10206,17.00%,8.37%
2020-01-01 00:17:50,5,6,16588,1966,14622,25.31%,11.85%
2020-01-01 00:17:50,5,7,4922,185,4737,7.51%,3.76%
2020-01-01 00:17:50,5,8,3752,103,3649,5.73%,2.75%
2020-01-01 00:17:50,5,9,10491,824,9667,16.01%,7.85%
2020-01-01 00:17:50,5,10,919,10,909,1.40%,1.09%
2020-01-01 00:17:50,5,11,749,5,744,1.14%,0.67%
2020-01-01 00:17:50,5,12,8986,603,8383,13.71%,6.71%
2020-01-01 00:17:50,6,1,1130,10,1120,1.72%,0.88%
2020-01-01 00:17:50,6,2,1258,14,1244,1.92%,1.11%
2020-01-01 00:17:50,6,3,1724,20,1704,2.63%,1.16%
2020-01-01 00:17:50,6,4,1436,17,1419,2.19%,1.18%
2020-01-01 00:17:50,6,5,12640,1133,11507,19.29%,8.96%
2020-01-01 00:17:50,6,6,4293,140,4153,6.55%,3.26%
2020-01-01 00:17:50,6,7,2365,45,2320,3.61%,1.90%
2020-01-01 00:17:50,6,8,1809,25,1784,2.76%,1.38%
2020-01-01 00:17:50,6,9,6250,289,5961,9.54%,4.62%
2020-01-01 00:17:50,6,10,1895,19,1876,2.89%,1.00%
2020-01-01 00:17:50,6,11,480,3,477,0.73%,0.62%
2020-01-01 00:17:50,6,12,4301,128,4173,6.56%,2.98%
2020-01-01 00:17:50,7,1,369,0,369,0.56%,0.00%
2020-01-01 00:17:50,7,2,93,0,93,0.14%,0.00%
2020-01-01 00:17:50,7,3,908,5,903,1.39%,0.55%
2020-01-01 00:17:50,7,4,1187,10,1177,1.81%,0.84%
2020-01-01 00:17:50,7,5,7997,444,7553,12.20%,5.55%
2020-01-01 00:17:50,7,6,12702,1099,11603,19.38%,8.65%
2020-01-01 00:17:50,7,7,3461,94,3367,5.28%,2.72%
2020-01-01 00:17:50,7,8,1529,23,1506,2.33%,1.50%
2020-01-01 00:17:50,7,9,6981,334,6647,10.65%,4.78%
2020-01-01 00:17:50,7,10,1617,15,1602,2.47%,0.93%
2020-01-01 00:17:50,7,11,63,0,63,0.10%,0.00%
2020-01-01 00:17:50,7,12,5409,199,5210,8.25%,3.68%
2020-01-01 00:17:50,8,1,418,1,417,0.64%,0.24%
2020-01-01 00:17:50,8,2,80,0,80,0.12%,0.00%
2020-01-01 00:17:50,8,3,1456,22,1434,2.22%,1.51%
2020-01-01 00:17:50,8,4,2832,69,2763,4.32%,2.44%
2020-01-01 00:17:50,8,5,8552,555,7997,13.05%,6.49%
2020-01-01 00:17:50,8,6,17785,2231,15554,27.14%,12.54%
2020-01-01 00:17:50,8,7,6355,274,6081,9.70%,4.31%
2020-01-01 00:17:50,8,8,2611,34,2577,3.98%,1.30%
2020-01-01 00:17:50,8,9,6788,337,6451,10.36%,4.96%
2020-01-01 00:17:50,8,10,2126,35,2091,3.24%,1.65%
2020-01-01 00:17:50,8,11,255,0,255,0.39%,0.00%
2020-01-01 00:17:50,8,12,4564,160,4404,6.96%,3.51%
2020-01-01 00:17:50,9,1,273,0,273,0.42%,0.00%
2020-01-01 00:17:50,9,2,3388,92,3296,5.17%,2.72%
2020-01-01 00:17:50,9,3,2762,62,2700,4.21%,2.24%
2020-01-01 00:17:50,9,4,7932,472,7460,12.10%,5.95%
2020-01-01 00:17:50,9,5,514,2,512,0.78%,0.39%
2020-01-01 00:17:50,9,6,8941,588,8353,13.64%,6.58%
2020-01-01 00:17:50,9,7,35029,7897,27132,53.45%,22.54%
2020-01-01 00:17:50,9,8,16347,1869,14478,24.94%,11.43%
2020-01-01 00:17:50,9,9,270,0,270,0.41%,0.00%
2020-01-01 00:17:50,9,10,7239,401,6838,11.05%,5.54%
2020-01-01 00:17:50,9,11,14913,1579,13334,22.76%,10.59%
2020-01-01 00:17:50,9,12,7317,390,6927,11.16%,5.33%
2020-01-01 00:17:50,10,1,1028,169,859,1.57%,16.44%
2020-01-01 00:17:50,10,2,2633,201,2432,4.02%,7.63%
2020-01-01 00:17:50,10,3,1485,17,1468,2.27%,1.14%
2020-01-01 00:17:50,10,4,4175,908,3267,6.37%,21.75%
2020-01-01 00:17:50,10,5,695,14,681,1.06%,2.01%
2020-01-01 00:17:50,10,6,6129,1025,5104,9.35%,16.72%
2020-01-01 00:17:50,10,7,10488,1598,8890,16.00%,15.24%
2020-01-01 00:17:50,10,8,28586,6941,21645,43.62%,24.28%
2020-01-01 00:17:50,10,9,536,0,536,0.82%,0.00%
2020-01-01 00:17:50,10,10,2203,39,2164,3.36%,1.77%
2020-01-01 00:17:50,10,11,13392,1792,11600,20.43%,13.38%
2020-01-01 00:17:50,10,12,10654,1336,9318,16.26%,12.54%
2020-01-01 00:17:50,11,1,2174,31,2143,3.32%,1.43%
2020-01-01 00:17:50,11,2,3924,104,3820,5.99%,2.65%
2020-01-01 00:17:50,11,3,1632,21,1611,2.49%,1.29%
2020-01-01 00:17:50,11,4,3092,65,3027,4.72%,2.10%
2020-01-01 00:17:50,11,5,199,0,199,0.30%,0.00%
2020-01-01 00:17:50,11,6,3948,113,3835,6.02%,2.86%
2020-01-01 00:17:50,11,7,9842,688,9154,15.02%,6.99%
2020-01-01 00:17:50,11,8,23787,3886,19901,36.30%,16.34%
2020-01-01 00:17:50,11,9,216,0,216,0.33%,0.00%
2020-01-01 00:17:50,11,10,2668,53,2615,4.07%,1.99%
2020-01-01 00:17:50,11,11,9569,628,8941,14.60%,6.56%
2020-01-01 00:17:50,11,12,6562,295,6267,10.01%,4.50%
2020-01-01 00:17:50,12,1,96,1,95,0.15%,1.04%
2020-01-01 00:17:50,12,2,805,202,603,1.23%,25.09%
2020-01-01 00:17:50,12,3,3080,262,2818,4.70%,8.51%
2020-01-01 00:17:50,12,4,2439,39,2400,3.72%,1.60%
2020-01-01 00:17:50,12,5,9298,782,8516,14.19%,8.41%
2020-01-01 00:17:50,12,6,4720,163,4557,7.20%,3.45%
2020-01-01 00:17:50,12,7,2087,53,2034,3.18%,2.54%
2020-01-01 00:17:50,12,8,1024,297,727,1.56%,29.00%
2020-01-01 00:17:50,12,9,22208,4352,17856,33.89%,19.60%
2020-01-01 00:17:50,12,10,3347,359,2988,5.11%,10.73%
2020-01-01 00:17:50,12,11,1241,297,944,1.89%,23.93%
2020-01-01 00:17:50,12,12,8319,1178,7141,12.69%,14.16%
2020-01-01 00:17:50,13,1,2066,26,2040,3.15%,1.26%
2020-01-01 00:17:50,13,2,2421,38,2383,3.69%,1.57%
2020-01-01 00:17:50,13,3,577,20,557,0.88%,3.47%
2020-01-01 00:17:50,13,4,4883,383,4500,7.45%,7.84%
2020-01-01 00:17:50,13,5,7173,667,6506,10.95%,9.30%
2020-01-01 00:17:50,13,6,5622,437,5185,8.58%,7.77%
2020-01-01 00:17:50,13,7,4919,175,4744,7.51%,3.56%
2020-01-01 00:17:50,13,8,6863,333,6530,10.47%,4.85%
2020-01-01 00:17:50,13,9,7411,686,6725,11.31%,9.26%
2020-01-01 00:17:50,13,10,26409,5132,21277,40.30%,19.43%
2020-01-01 00:17:50,13,11,16339,2168,14171,24.93%,13.27%
2020-01-01 00:17:50,13,12,8895,962,7933,13.57%,10.82%
2020-01-01 00:17:50,14,1,359,1,358,0.55%,0.28%
2020-01-01 00:17:50,14,2,1417,12,1405,2.16%,0.85%
2020-01-01 00:17:50,14,3,851,6,845,1.30%,0.71%
2020-01-01 00:17:50,14,4,5061,175,4886,7.72%,3.46%
2020-01-01 00:17:50,14,5,1334,12,1322,2.04%,0.90%
2020-01-01 00:17:50,14,6,5236,188,5048,7.99%,3.59%
2020-01-01 00:17:50,14,7,11993,997,10996,18.30%,8.31%
2020-01-01 00:17:50,14,8,13895,1326,12569,21.20%,9.54%
2020-01-01 00:17:50,14,9,1519,15,1504,2.32%,0.99%
2020-01-01 00:17:50,14,10,4078,129,3949,6.22%,3.16%
2020-01-01 00:17:50,14,11,27454,5033,22421,41.89%,18.33%
2020-01-01 00:17:50,14,12,9136,582,8554,13.94%,6.37%
2020-01-01 00:17:50,15,1,600,1,599,0.92%,0.17%
2020-01-01 00:17:50,15,2,89,0,89,0.14%,0.00%
2020-01-01 00:17:50,15,3,5592,246,5346,8.53%,4.40%
2020-01-01 00:17:50,15,4,4291,178,4113,6.55%,4.15%
2020-01-01 00:17:50,15,5,11676,1027,10649,17.82%,8.80%
2020-01-01 00:17:50,15,6,4579,199,4380,6.99%,4.35%
2020-01-01 00:17:50,15,7,3627,110,3517,5.53%,3.03%
2020-01-01 00:17:50,15,8,5946,275,5671,9.07%,4.62%
2020-01-01 00:17:50,15,9,11859,1057,10802,18.10%,8.91%
2020-01-01 00:17:50,15,10,5261,240,5021,8.03%,4.56%
2020-01-01 00:17:50,15,11,11300,943,10357,17.24%,8.35%
2020-01-01 00:17:50,15,12,29102,5971,23131,44.41%,20.52%
2020-01-01 00:17:50,16,1,363,1,362,0.55%,0.28%
2020-01-01 00:17:50,16,2,260,0,260,0.40%,0.00%
2020-01-01 00:17:50,16,3,1504,14,1490,2.29%,0.93%
2020-01-01 00:17:50,16,4,3816,99,3717,5.82%,2.59%
2020-01-01 00:17:50,16,5,7223,433,6790,11.02%,5.99%
2020-01-01 00:17:50,16,6,4573,157,4416,6.98%,3.43%
2020-01-01 00:17:50,16,7,3364,92,3272,5.13%,2.73%
2020-01-01 00:17:50,16,8,7406,475,6931,11.30%,6.41%
2020-01-01 00:17:50,16,9,7556,475,7081,11.53%,6.29%
2020-01-01 00:17:50,16,10,1822,28,1794,2.78%,1.54%
2020-01-01 00:17:50,16,11,9506,731,8775,14.51%,7.69%
2020-01-01 00:17:50,16,12,24923,4285,20638,38.03%,17.19%
2020-01-01 00:18:00,1,1,17528,2159,15369,26.75%,12.32%
2020-01-01 00:18:00,1,2,6840,357,6483,10.44%,5.22%
2020-01-01 00:18:00,1,3,453,2,451,0.69%,0.44%
2020-01-01 00:18:00,1,4,10321,752,9569,15.75%,7.29%
2020-01-01 00:18:00,1,5,10009,721,9288,15.27%,7.20%
2020-01-01 00:18:00,1,6,9942,707,9235,15.17%,7.11%
2020-01-01 00:18:00,1,7,6371,306,6065,9.72%,4.80%
2020-01-01 00:18:00,1,8,5407,219,5188,8.25%,4.05%
2020-01-01 00:18:00,1,9,9896,703,9193,15.10%,7.10%
2020-01-01 00:18:00,1,10,3923,115,3808,5.99%,2.93%
2020-01-01 00:18:00,1,11,4023,121,3902,6.14%,3.01%
2020-01-01 00:18:00,1,12,9844,690,9154,15.02%,7.01%
2020-01-01 00:18:00,2,1,505,9,496,0.77%,1.78%
2020-01-01 00:18:00,2,2,22494,3407,19087,34.32%,15.15%
2020-01-01 00:18:00,2,3,16830,1970,14860,25.68%,11.71%
2020-01-01 00:18:00,2,4,441,7,434,0.67%,1.59%
2020-01-01 00:18:00,2,5,10362,808,9554,15.81%,7.80%
2020-01-01 00:18:00,2,6,35,0,35,0.05%,0.00%
2020-01-01 00:18:00,2,7,5134,195,4939,7.83%,3.80%
2020-01-01 00:18:00,2,8,3619,99,3520,5.52%,2.74%
2020-01-01 00:18:00,2,9,10217,785,9432,15.59%,7.68%
2020-01-01 00:18:00,2,10,2930,74,2856,4.47%,2.53%
2020-01-01 00:18:00,2,11,2949,75,2874,4.50%,2.54%
2020-01-01 00:18:00,2,12,10078,760,9318,15.38%,7.54%
2020-01-01 00:18:00,3,1,9914,698,9216,15.13%,7.04%
2020-01-01 00:18:00,3,2,29145,5573,23572,44.47%,19.12%
2020-01-01 00:18:00,3,3,82660,35607,47053,126.13%,43.08%
2020-01-01 00:18:00,3,4,5700,238,5462,8.70%,4.18%
2020-01-01 00:18:00,3,5,50930,15429,35501,77.71%,30.29%
2020-01-01 00:18:00,3,6,9869,705,9164,15.06%,7.14%
2020-01-01 00:18:00,3,7,17120,2056,15064,26.12%,12.01%
2020-01-01 00:18:00,3,8,14651,1495,13156,22.36%,10.20%
2020-01-01 00:18:00,3,9,40857,10320,30537,62.34%,25.26%
2020-01-01 00:18:00,3,10,11156,851,10305,17.02%,7.63%
2020-01-01 00:18:00,3,11,1670,17,1653,2.55%,1.02%
2020-01-01 00:18:00,3,12,24869,4055,20814,37.95%,16.31%
2020-01-01 00:18:00,4,1,614,6,608,0.94%,0.98%
2020-01-01 00:18:00,4,2,391,6,385,0.60%,1.53%
2020-01-01 00:18:00,4,3,755,6,749,1.15%,0.79%
2020-01-01 00:18:00,4,4,27578,5077,22501,42.08%,18.41%
2020-01-01 00:18:00,4,5,16793,1999,14794,25.62%,11.90%
2020-01-01 00:18:00,4,6,23416,3714,19702,35.73%,15.86%
2020-01-01 00:18:00,4,7,5501,254,5247,8.39%,4.62%
2020-01-01 00:18:00,4,8,3275,104,3171,5.00%,3.18%
2020-01-01 00:18:00,4,9,14890,1597,13293,22.72%,10.73%
2020-01-01 00:18:00,4,10,1904,33,1871,2.91%,1.73%
2020-01-01 00:18:00,4,11,203,0,203,0.31%,0.00%
2020-01-01 00:18:00,4,12,12397,1096,11301,18.92%,8.84%
2020-01-01 00:18:00,5,1,2837,73,2764,4.33%,2.57%
2020-01-01 00:18:00,5,2,1431,21,1410,2.18%,1.47%
2020-01-01 00:18:00,5,3,402,2,400,0.61%,0.50%
2020-01-01 00:18:00,5,4,23445,3744,19701,35.77%,15.97%
2020-01-01 00:18:00,5,5,9998,743,9255,15.26%,7.43%
2020-01-01 00:18:00,5,6,16475,1931,14544,25.14%,11.72%
2020-01-01 00:18:00,5,7,5835,266,5569,8.90%,4.56%
2020-01-01 00:18:00,5,8,3437,107,3330,5.24%,3.11%
2020-01-01 00:18:00,5,9,9473,664,8809,14.45%,7.01%
2020-01-01 00:18:00,5,10,1196,15,1181,1.82%,1.25%
2020-01-01 00:18:00,5,11,546,6,540,0.83%,1.10%
2020-01-01 00:18:00,5,12,7995,471,7524,12.20%,5.89%
2020-01-01 00:18:00,6,1,1217,15,1202,1.86%,1.23%
2020-01-01 00:18:00,6,2,1350,18,1332,2.06%,1.33%
2020-01-01 00:18:00,6,3,1868,38,1830,2.85%,2.03%
2020-01-01 00:18:00,6,4,1331,27,1304,2.03%,2.03%
2020-01-01 00:18:00,6,5,13151,1294,11857,20.07%,9.84%
2020-01-01 00:18:00,6,6,4531,173,4358,6.91%,3.82%
2020-01-01 00:18:00,6,7,2568,76,2492,3.92%,2.96%
2020-01-01 00:18:00,6,8,2056,47,2009,3.14%,2.29%
2020-01-01 00:18:00,6,9,6473,326,6147,9.88%,5.04%
2020-01-01 00:18:00,6,10,1661,17,1644,2.53%,1.02%
2020-01-01 00:18:00,6,11,404,1,403,0.62%,0.25%
2020-01-01 00:18:00,6,12,4733,193,4540,7.22%,4.08%
2020-01-01 00:18:00,7,1,455,1,454,0.69%,0.22%
2020-01-01 00:18:00,7,2,280,1,279,0.43%,0.36%
2020-01-01 00:18:00,7,3,662,4,658,1.01%,0.60%
2020-01-01 00:18:00,7,4,2106,42,2064,3.21%,1.99%
2020-01-01 00:18:00,7,5,6577,344,6233,10.04%,5.23%
2020-01-01 00:18:00,7,6,12558,1173,11385,19.16%,9.34%
2020-01-01 00:18:00,7,7,3832,112,3720,5.85%,2.92%
2020-01-01 00:18:00,7,8,2155,41,2114,3.29%,1.90%
2020-01-01 00:18:00,7,9,5641,253,5388,8.61%,4.49%
2020-01-01 00:18:00,7,10,948,6,942,1.45%,0.63%
2020-01-01 00:18:00,7,11,52,0,52,0.08%,0.00%
2020-01-01 00:18:00,7,12,4664,186,4478,7.12%,3.99%
2020-01-01 00:18:00,8,1,524,2,522,0.80%,0.38%
2020-01-01 00:18:00,8,2,72,0,72,0.11%,0.00%
2020-01-01 00:18:00,8,3,1498,18,1480,2.29%,1.20%
2020-01-01 00:18:00,8,4,2937,85,2852,4.48%,2.89%
2020-01-01 00:18:00,8,5,8519,580,7939,13.00%,6.81%
2020-01-01 00:18:00,8,6,16865,2052,14813,25.73%,12.17%
2020-01-01 00:18:00,8,7,5343,187,5156,8.15%,3.50%
2020-01-01 00:18:00,8,8,2294,35,2259,3.50%,1.53%
2020-01-01 00:18:00,8,9,6606,327,6279,10.08%,4.95%
2020-01-01 00:18:00,8,10,1763,17,1746,2.69%,0.96%
2020-01-01 00:18:00,8,11,79,2,77,0.12%,2.53%
2020-01-01 00:18:00,8,12,4822,183,4639,7.36%,3.80%
2020-01-01 00:18:00,9,1,303,0,303,0.46%,0.00%
2020-01-01 00:18:00,9,2,2290,56,2234,3.49%,2.45%
2020-01-01 00:18:00,9,3,1566,31,1535,2.39%,1.98%
2020-01-01 00:18:00,9,4,5001,177,4824,7.63%,3.54%
2020-01-01 00:18:00,9,5,668,0,668,1.02%,0.00%
2020-01-01 00:18:00,9,6,6347,284,6063,9.68%,4.47%
2020-01-01 00:18:00,9,7,25255,4320,20935,38.54%,17.11%
2020-01-01 00:18:00,9,8,10217,791,9426,15.59%,7.74%
2020-01-01 00:18:00,9,9,448,0,448,0.68%,0.00%
2020-01-01 00:18:00,9,10,3019,62,2957,4.61%,2.05%
2020-01-01 00:18:00,9,11,9111,642,8469,13.90%,7.05%
2020-01-01 00:18:00,9,12,5784,258,5526,8.83%,4.46%
2020-01-01 00:18:00,10,1,1080,225,855,1.65%,20.83%
2020-01-01 00:18:00,10,2,3054,287,2767,4.66%,9.40%
2020-01-01 00:18:00,10,3,1867,39,1828,2.85%,2.09%
2020-01-01 00:18:00,10,4,4538,1003,3535,6.92%,22.10%
2020-01-01 00:18:00,10,5,925,64,861,1.41%,6.92%
2020-01-01 00:18:00,10,6,6475,1194,5281,9.88%,18.44%
2020-01-01 00:18:00,10,7,11248,1899,9349,17.16%,16.88%
2020-01-01 00:18:00,10,8,29834,7527,22307,45.52%,25.23%
2020-01-01 00:18:00,10,9,742,4,738,1.13%,0.54%
2020-01-01 00:18:00,10,10,2504,39,2465,3.82%,1.56%
2020-01-01 00:18:00,10,11,13641,1746,11895,20.81%,12.80%
2020-01-01 00:18:00,10,12,10530,1272,9258,16.07%,12.08%
2020-01-01 00:18:00,11,1,1916,30,1886,2.92%,1.57%
2020-01-01 00:18:00,11,2,4173,128,4045,6.37%,3.07%
2020-01-01 00:18:00,11,3,2075,30,2045,3.17%,1.45%
2020-01-01 00:18:00,11,4,3424,96,3328,5.22%,2.80%
2020-01-01 00:18:00,11,5,375,3,372,0.57%,0.80%
2020-01-01 00:18:00,11,6,4568,177,4391,6.97%,3.87%
2020-01-01 00:18:00,11,7,10465,793,9672,15.97%,7.58%
2020-01-01 00:18:00,11,8,26097,4559,21538,39.82%,17.47%
2020-01-01 00:18:00,11,9,168,1,167,0.26%,0.60%
2020-01-01 00:18:00,11,10,2908,72,2836,4.44%,2.48%
2020-01-01 00:18:00,11,11,10514,826,9688,16.04%,7.86%
2020-01-01 00:18:00,11,12,6992,394,6598,10.67%,5.64%
2020-01-01 00:18:00,12,1,25,0,25,0.04%,0.00%
2020-01-01 00:18:00,12,2,433,157,276,0.66%,36.26%
2020-01-01 00:18:00,12,3,1956,179,1777,2.98%,9.15%
2020-01-01 00:18:00,12,4,2858,47,2811,4.36%,1.64%
2020-01-01 00:18:00,12,5,7052,527,6525,10.76%,7.47%
2020-01-01 00:18:00,12,6,4375,157,4218,6.68%,3.59%
2020-01-01 00:18:00,12,7,1332,13,1319,2.03%,0.98%
2020-01-01 00:18:00,12,8,1201,167,1034,1.83%,13.91%
2020-01-01 00:18:00,12,9,20873,3785,17088,31.85%,18.13%
2020-01-01 00:18:00,12,10,3586,232,3354,5.47%,6.47%
2020-01-01 00:18:00,12,11,1384,172,1212,2.11%,12.43%
2020-01-01 00:18:00,12,12,8742,1175,7567,13.34%,13.44%
2020-01-01 00:18:00,13,1,1550,27,1523,2.37%,1.74%
2020-01-01 00:18:00,13,2,1931,32,1899,2.95%,1.66%
2020-01-01 00:18:00,13,3,712,13,699,1.09%,1.83%
2020-01-01 00:18:00,13,4,4283,513,3770,6.54%,11.98%
2020-01-01 00:18:00,13,5,6676,786,5890,10.19%,11.77%
2020-01-01 00:18:00,13,6,4971,562,4409,7.59%,11.31%
2020-01-01 00:18:00,13,7,4112,147,3965,6.27%,3.57%
2020-01-01 00:18:00,13,8,6773,350,6423,10.33%,5.17%
2020-01-01 00:18:00,13,9,7026,819,6207,10.72%,11.66%
2020-01-01 00:18:00,13,10,27960,5793,22167,42.66%,20.72%
2020-01-01 00:18:00,13,11,17882,2446,15436,27.29%,13.68%
2020-01-01 00:18:00,13,12,10623,1050,9573,16.21%,9.88%
2020-01-01 00:18:00,14,1,469,2,467,0.72%,0.43%
2020-01-01 00:18:00,14,2,1338,12,1326,2.04%,0.90%
2020-01-01 00:18:00,14,3,660,3,657,1.01%,0.45%
2020-01-01 00:18:00,14,4,3708,104,3604,5.66%,2.80%
2020-01-01 00:18:00,14,5,1454,18,1436,2.22%,1.24%
2020-01-01 00:18:00,14,6,4070,133,3937,6.21%,3.27%
2020-01-01 00:18:00,14,7,10999,891,10108,16.78%,8.10%
2020-01-01 00:18:00,14,8,12512,1131,11381,19.09%,9.04%
2020-01-01 00:18:00,14,9,1633,21,1612,2.49%,1.29%
2020-01-01 00:18:00,14,10,3901,131,3770,5.95%,3.36%
2020-01-01 00:18:00,14,11,24720,4202,20518,37.72%,17.00%
2020-01-01 00:18:00,14,12,7799,443,7356,11.90%,5.68%
2020-01-01 00:18:00,15,1,414,1,413,0.63%,0.24%
2020-01-01 00:18:00,15,2,174,1,173,0.27%,0.57%
2020-01-01 00:18:00,15,3,10004,721,9283,15.26%,7.21%
2020-01-01 00:18:00,15,4,5224,239,4985,7.97%,4.58%
2020-01-01 00:18:00,15,5,16108,1875,14233,24.58%,11.64%
2020-01-01 00:18:00,15,6,5521,300,5221,8.42%,5.43%
2020-01-01 00:18:00,15,7,3333,91,3242,5.09%,2.73%
2020-01-01 00:18:00,15,8,5564,241,5323,8.49%,4.33%
2020-01-01 00:18:00,15,9,16311,1926,14385,24.89%,11.81%
2020-01-01 00:18:00,15,10,4940,303,4637,7.54%,6.13%
2020-01-01 00:18:00,15,11,10667,945,9722,16.28%,8.86%
2020-01-01 00:18:00,15,12,32262,7321,24941,49.23%,22.69%
2020-01-01 00:18:00,16,1,333,4,329,0.51%,1.20%
2020-01-01 00:18:00,16,2,210,0,210,0.32%,0.00%
2020-01-01 00:18:00,16,3,1527,21,1506,2.33%,1.38%
2020-01-01 00:18:00,16,4,3951,122,3829,6.03%,3.09%
2020-01-01 00:18:00,16,5,7797,526,7271,11.90%,6.75%
2020-01-01 00:18:00,16,6,4721,182,4539,7.20%,3.86%
2020-01-01 00:18:00,16,7,3178,100,3078,4.85%,3.15%
2020-01-01 00:18:00,16,8,7098,455,6643,10.83%,6.41%
2020-01-01 00:18:00,16,9,8273,566,7707,12.62%,6.84%
2020-01-01 00:18:00,16,10,3145,82,3063,4.80%,2.61%
2020-01-01 00:18:00,16,11,10412,878,9534,15.89%,8.43%
2020-01-01 00:18:00,16,12,26638,4754,21884,40.65%,17.85%
2020-01-01 00:18:10,1,1,18956,2593,16363,28.92%,13.68%
2020-01-01 00:18:10,1,2,7799,446,7353,11.90%,5.72%
2020-01-01 00:18:10,1,3,639,1,638,0.98%,0.16%
2020-01-01 00:18:10,1,4,10653,927,9726,16.26%,8.70%
2020-01-01 00:18:10,1,5,10237,873,9364,15.62%,8.53%
2020-01-01 00:18:10,1,6,10170,862,9308,15.52%,8.48%
2020-01-01 00:18:10,1,7,7146,375,6771,10.90%,5.25%
2020-01-01 00:18:10,1,8,6505,318,6187,9.93%,4.89%
2020-01-01 00:18:10,1,9,10152,857,9295,15.49%,8.44%
2020-01-01 00:18:10,1,10,6043,277,5766,9.22%,4.58%
2020-01-01 00:18:10,1,11,6179,290,5889,9.43%,4.69%
2020-01-01 00:18:10,1,12,10128,852,9276,15.45%,8.41%
2020-01-01 00:18:10,2,1,647,2,645,0.99%,0.31%
2020-01-01 00:18:10,2,2,23479,3784,19695,35.83%,16.12%
2020-01-01 00:18:10,2,3,19063,2601,16462,29.09%,13.64%
2020-01-01 00:18:10,2,4,603,2,601,0.92%,0.33%
2020-01-01 00:18:10,2,5,11200,939,10261,17.09%,8.38%
2020-01-01 00:18:10,2,6,48,0,48,0.07%,0.00%
2020-01-01 00:18:10,2,7,3760,102,3658,5.74%,2.71%
2020-01-01 00:18:10,2,8,2532,47,2485,3.86%,1.86%
2020-01-01 00:18:10,2,9,11172,937,10235,17.05%,8.39%
2020-01-01 00:18:10,2,10,1808,27,1781,2.76%,1.49%
2020-01-01 00:18:10,2,11,1827,29,1798,2.79%,1.59%
2020-01-01 00:18:10,2,12,11006,915,10091,16.79%,8.31%
2020-01-01 00:18:10,3,1,1446,15,1431,2.21%,1.04%
2020-01-01 00:18:10,3,2,21790,3291,18499,33.25%,15.10%
2020-01-01 00:18:10,3,3,79879,33796,46083,121.89%,42.31%
2020-01-01 00:18:10,3,4,10784,782,10002,16.46%,7.25%
2020-01-01 00:18:10,3,5,53883,17117,36766,82.22%,31.77%
2020-01-01 00:18:10,3,6,12031,987,11044,18.36%,8.20%
2020-01-01 00:18:10,3,7,18762,2463,16299,28.63%,13.13%
2020-01-01 00:18:10,3,8,16417,1900,14517,25.05%,11.57%
2020-01-01 00:18:10,3,9,41495,10766,30729,63.32%,25.95%
2020-01-01 00:18:10,3,10,10117,671,9446,15.44%,6.63%
2020-01-01 00:18:10,3,11,1423,17,1406,2.17%,1.19%
2020-01-01 00:18:10,3,12,27173,4969,22204,41.46%,18.29%
2020-01-01 00:18:10,4,1,593,2,591,0.90%,0.34%
2020-01-01 00:18:10,4,2,373,1,372,0.57%,0.27%
2020-01-01 00:18:10,4,3,1109,12,1097,1.69%,1.08%
2020-01-01 00:18:10,4,4,28337,5394,22943,43.24%,19.04%
2020-01-01 00:18:10,4,5,17037,2057,14980,26.00%,12.07%
2020-01-01 00:18:10,4,6,23902,3917,19985,36.47%,16.39%
2020-01-01 00:18:10,4,7,5448,245,5203,8.31%,4.50%
2020-01-01 00:18:10,4,8,2979,69,2910,4.55%,2.32%
2020-01-01 00:18:10,4,9,14723,1553,13170,22.47%,10.55%
2020-01-01 00:18:10,4,10,2249,40,2209,3.43%,1.78%
2020-01-01 00:18:10,4,11,184,0,184,0.28%,0.00%
2020-01-01 00:18:10,4,12,11890,1005,10885,18.14%,8.45%
2020-01-01 00:18:10,5,1,2598,61,2537,3.96%,2.35%
2020-01-01 00:18:10,5,2,711,6,705,1.08%,0.84%
2020-01-01 00:18:10,5,3,2036,25,2011,3.11%,1.23%
2020-01-01 00:18:10,5,4,30924,6281,24643,47.19%,20.31%
2020-01-01 00:18:10,5,5,10126,745,9381,15.45%,7.36%
2020-01-01 00:18:10,5,6,25100,4242,20858,38.30%,16.90%
2020-01-01 00:18:10,5,7,14505,1476,13029,22.13%,10.18%
2020-01-01 00:18:10,5,8,2942,67,2875,4.49%,2.28%
2020-01-01 00:18:10,5,9,7972,484,7488,12.16%,6.07%
2020-01-01 00:18:10,5,10,1328,20,1308,2.03%,1.51%
2020-01-01 00:18:10,5,11,491,5,486,0.75%,1.02%
2020-01-01 00:18:10,5,12,6426,315,6111,9.81%,4.90%
2020-01-01 00:18:10,6,1,987,14,973,1.51%,1.42%
2020-01-01 00:18:10,6,2,1085,16,1069,1.66%,1.47%
2020-01-01 00:18:10,6,3,1606,24,1582,2.45%,1.49%
2020-01-01 00:18:10,6,4,1988,31,1957,3.03%,1.56%
2020-01-01 00:18:10,6,5,13772,1389,12383,21.01%,10.09%
2020-01-01 00:18:10,6,6,5378,229,5149,8.21%,4.26%
2020-01-01 00:18:10,6,7,2911,76,2835,4.44%,2.61%
2020-01-01 00:18:10,6,8,2489,61,2428,3.80%,2.45%
2020-01-01 00:18:10,6,9,6438,331,6107,9.82%,5.14%
2020-01-01 00:18:10,6,10,1806,22,1784,2.76%,1.22%
2020-01-01 00:18:10,6,11,450,0,450,0.69%,0.00%
2020-01-01 00:18:10,6,12,4607,201,4406,7.03%,4.36%
2020-01-01 00:18:10,7,1,318,1,317,0.49%,0.31%
2020-01-01 00:18:10,7,2,84,0,84,0.13%,0.00%
2020-01-01 00:18:10,7,3,772,6,766,1.18%,0.78%
2020-01-01 00:18:10,7,4,2342,47,2295,3.57%,2.01%
2020-01-01 00:18:10,7,5,6632,334,6298,10.12%,5.04%
2020-01-01 00:18:10,7,6,13985,1444,12541,21.34%,10.33%
2020-01-01 00:18:10,7,7,4970,201,4769,7.58%,4.04%
2020-01-01 00:18:10,7,8,2693,57,2636,4.11%,2.12%
2020-01-01 00:18:10,7,9,5521,230,5291,8.42%,4.17%
2020-01-01 00:18:10,7,10,772,9,763,1.18%,1.17%
2020-01-01 00:18:10,7,11,87,0,87,0.13%,0.00%
2020-01-01 00:18:10,7,12,4758,171,4587,7.26%,3.59%
2020-01-01 00:18:10,8,1,632,3,629,0.96%,0.47%
2020-01-01 00:18:10,8,2,56,0,56,0.09%,0.00%
2020-01-01 00:18:10,8,3,1559,14,1545,2.38%,0.90%
2020-01-01 00:18:10,8,4,3073,74,2999,4.69%,2.41%
2020-01-01 00:18:10,8,5,8475,516,7959,12.93%,6.09%
2020-01-01 00:18:10,8,6,15797,1764,14033,24.10%,11.17%
2020-01-01 00:18:10,8,7,4123,128,3995,6.29%,3.10%
2020-01-01 00:18:10,8,8,1735,31,1704,2.65%,1.79%
2020-01-01 00:18:10,8,9,6654,332,6322,10.15%,4.99%
2020-01-01 00:18:10,8,10,1727,26,1701,2.64%,1.51%
2020-01-01 00:18:10,8,11,164,0,164,0.25%,0.00%
2020-01-01 00:18:10,8,12,4943,188,4755,7.54%,3.80%
2020-01-01 00:18:10,9,1,380,2,378,0.58%,0.53%
2020-01-01 00:18:10,9,2,2285,45,2240,3.49%,1.97%
2020-01-01 00:18:10,9,3,1627,21,1606,2.48%,1.29%
2020-01-01 00:18:10,9,4,4925,170,4755,7.51%,3.45%
2020-01-01 00:18:10,9,5,465,1,464,0.71%,0.22%
2020-01-01 00:18:10,9,6,6481,276,6205,9.89%,4.26%
2020-01-01 00:18:10,9,7,27156,4942,22214,41.44%,18.20%
2020-01-01 00:18:10,9,8,11432,929,10503,17.44%,8.13%
2020-01-01 00:18:10,9,9,258,0,258,0.39%,0.00%
2020-01-01 00:18:10,9,10,4386,144,4242,6.69%,3.28%
2020-01-01 00:18:10,9,11,10535,786,9749,16.08%,7.46%
2020-01-01 00:18:10,9,12,5728,236,5492,8.74%,4.12%
2020-01-01 00:18:10,10,1,1324,265,1059,2.02%,20.02%
2020-01-01 00:18:10,10,2,3147,314,2833,4.80%,9.98%
2020-01-01 00:18:10,10,3,1674,17,1657,2.55%,1.02%
2020-01-01 00:18:10,10,4,3510,890,2620,5.36%,25.36%
2020-01-01 00:18:10,10,5,951,106,845,1.45%,11.15%
2020-01-01 00:18:10,10,6,5864,1103,4761,8.95%,18.81%
2020-01-01 00:18:10,10,7,10717,1854,8863,16.35%,17.30%
2020-01-01 00:18:10,10,8,29318,7265,22053,44.74%,24.78%
2020-01-01 00:18:10,10,9,411,1,410,0.63%,0.24%
2020-01-01 00:18:10,10,10,1969,31,1938,3.00%,1.57%
2020-01-01 00:18:10,10,11,13922,1599,12323,21.24%,11.49%
2020-01-01 00:18:10,10,12,11152,1115,10037,17.02%,10.00%
2020-01-01 00:18:10,11,1,2038,42,1996,3.11%,2.06%
2020-01-01 00:18:10,11,2,3002,79,2923,4.58%,2.63%
2020-01-01 00:18:10,11,3,739,4,735,1.13%,0.54%
2020-01-01 00:18:10,11,4,3023,82,2941,4.61%,2.71%
2020-01-01 00:18:10,11,5,260,4,256,0.40%,1.54%
2020-01-01 00:18:10,11,6,4071,150,3921,6.21%,3.68%
2020-01-01 00:18:10,11,7,8660,594,8066,13.21%,6.86%
2020-01-01 00:18:10,11,8,21813,3408,18405,33.28%,15.62%
2020-01-01 00:18:10,11,9,143,0,143,0.22%,0.00%
2020-01-01 00:18:10,11,10,2875,59,2816,4.39%,2.05%
2020-01-01 00:18:10,11,11,9744,714,9030,14.87%,7.33%
2020-01-01 00:18:10,11,12,6354,305,6049,9.70%,4.80%
2020-01-01 00:18:10,12,1,120,0,120,0.18%,0.00%
2020-01-01 00:18:10,12,2,456,104,352,0.70%,22.81%
2020-01-01 00:18:10,12,3,3215,166,3049,4.91%,5.16%
2020-01-01 00:18:10,12,4,2847,50,2797,4.34%,1.76%
2020-01-01 00:18:10,12,5,8262,578,7684,12.61%,7.00%
2020-01-01 00:18:10,12,6,4436,143,4293,6.77%,3.22%
2020-01-01 00:18:10,12,7,1425,22,1403,2.17%,1.54%
2020-01-01 00:18:10,12,8,1313,230,1083,2.00%,17.52%
2020-01-01 00:18:10,12,9,21488,4048,17440,32.79%,18.84%
2020-01-01 00:18:10,12,10,4400,358,4042,6.71%,8.14%
2020-01-01 00:18:10,12,11,1517,234,1283,2.31%,15.43%
2020-01-01 00:18:10,12,12,8382,1306,7076,12.79%,15.58%
2020-01-01 00:18:10,13,1,1631,23,1608,2.49%,1.41%
2020-01-01 00:18:10,13,2,1941,33,1908,2.96%,1.70%
2020-01-01 00:18:10,13,3,711,7,704,1.08%,0.98%
2020-01-01 00:18:10,13,4,5214,763,4451,7.96%,14.63%
2020-01-01 00:18:10,13,5,7380,1068,6312,11.26%,14.47%
2020-01-01 00:18:10,13,6,5738,795,4943,8.76%,13.86%
2020-01-01 00:18:10,13,7,4160,122,4038,6.35%,2.93%
2020-01-01 00:18:10,13,8,6662,344,6318,10.17%,5.16%
2020-01-01 00:18:10,13,9,7868,1120,6748,12.01%,14.23%
2020-01-01 00:18:10,13,10,28683,6271,22412,43.77%,21.86%
2020-01-01 00:18:10,13,11,17466,2482,14984,26.65%,14.21%
2020-01-01 00:18:10,13,12,10409,1125,9284,15.88%,10.81%
2020-01-01 00:18:10,14,1,206,0,206,0.31%,0.00%
2020-01-01 00:18:10,14,2,1343,5,1338,2.05%,0.37%
2020-01-01 00:18:10,14,3,999,2,997,1.52%,0.20%
2020-01-01 00:18:10,14,4,2787,72,2715,4.25%,2.58%
2020-01-01 00:18:10,14,5,1671,25,1646,2.55%,1.50%
2020-01-01 00:18:10,14,6,3071,84,2987,4.69%,2.74%
2020-01-01 00:18:10,14,7,10457,809,9648,15.96%,7.74%
2020-01-01 00:18:10,14,8,12103,1083,11020,18.47%,8.95%
2020-01-01 00:18:10,14,9,1894,34,1860,2.89%,1.80%
2020-01-01 00:18:10,14,10,5073,189,4884,7.74%,3.73%
2020-01-01 00:18:10,14,11,26986,4892,22094,41.18%,18.13%
2020-01-01 00:18:10,14,12,9460,607,8853,14.43%,6.42%
2020-01-01 00:18:10,15,1,542,2,540,0.83%,0.37%
2020-01-01 00:18:10,15,2,81,0,81,0.12%,0.00%
2020-01-01 00:18:10,15,3,3259,90,3169,4.97%,2.76%
2020-01-01 00:18:10,15,4,5407,269,5138,8.25%,4.98%
2020-01-01 00:18:10,15,5,9447,733,8714,14.41%,7.76%
2020-01-01 00:18:10,15,6,5736,330,5406,8.75%,5.75%
2020-01-01 00:18:10,15,7,3000,83,2917,4.58%,2.77%
2020-01-01 00:18:10,15,8,5158,220,4938,7.87%,4.27%
2020-01-01 00:18:10,15,9,9636,759,8877,14.70%,7.88%
2020-01-01 00:18:10,15,10,4355,334,4021,6.65%,7.67%
2020-01-01 00:18:10,15,11,9640,866,8774,14.71%,8.98%
2020-01-01 00:18:10,15,12,25296,4891,20405,38.60%,19.34%
2020-01-01 00:18:10,16,1,388,0,388,0.59%,0.00%
2020-01-01 00:18:10,16,2,240,0,240,0.37%,0.00%
2020-01-01 00:18:10,16,3,1173,9,1164,1.79%,0.77%
2020-01-01 00:18:10,16,4,4455,162,4293,6.80%,3.64%
2020-01-01 00:18:10,16,5,7140,431,6709,10.89%,6.04%
2020-01-01 00:18:10,16,6,5137,212,4925,7.84%,4.13%
2020-01-01 00:18:10,16,7,3079,86,2993,4.70%,2.79%
2020-01-01 00:18:10,16,8,7499,592,6907,11.44%,7.89%
2020-01-01 00:18:10,16,9,7665,475,7190,11.70%,6.20%
2020-01-01 00:18:10,16,10,1331,8,1323,2.03%,0.60%
2020-01-01 00:18:10,16,11,8972,742,8230,13.69%,8.27%
2020-01-01 00:18:10,16,12,24048,4106,19942,36.69%,17.07%
2020-01-01 00:18:20,1,1,18136,2353,15783,27.67%,12.97%
2020-01-01 00:18:20,1,2,9229,651,8578,14.08%,7.05%
2020-01-01 00:18:20,1,3,1031,10,1021,1.57%,0.97%
2020-01-01 00:18:20,1,4,8573,610,7963,13.08%,7.12%
2020-01-01 00:18:20,1,5,8250,553,7697,12.59%,6.70%
2020-01-01 00:18:20,1,6,8185,551,7634,12.49%,6.73%
2020-01-01 00:18:20,1,7,8166,521,7645,12.46%,6.38%
2020-01-01 00:18:20,1,8,7168,361,6807,10.94%,5.04%
2020-01-01 00:18:20,1,9,8152,545,7607,12.44%,6.69%
2020-01-01 00:18:20,1,10,6545,287,6258,9.99%,4.39%
2020-01-01 00:18:20,1,11,6700,300,6400,10.22%,4.48%
2020-01-01 00:18:20,1,12,8114,540,7574,12.38%,6.66%
2020-01-01 00:18:20,2,1,427,0,427,0.65%,0.00%
2020-01-01 00:18:20,2,2,24501,4093,20408,37.39%,16.71%
2020-01-01 00:18:20,2,3,18961,2524,16437,28.93%,13.31%
2020-01-01 00:18:20,2,4,362,0,362,0.55%,0.00%
2020-01-01 00:18:20,2,5,11263,929,10334,17.19%,8.25%
2020-01-01 00:18:20,2,6,69,0,69,0.11%,0.00%
2020-01-01 00:18:20,2,7,5084,195,4889,7.76%,3.84%
2020-01-01 00:18:20,2,8,3745,113,3632,5.71%,3.02%
2020-01-01 00:18:20,2,9,11155,906,10249,17.02%,8.12%
2020-01-01 00:18:20,2,10,3044,71,2973,4.64%,2.33%
2020-01-01 00:18:20,2,11,3066,72,2994,4.68%,2.35%
2020-01-01 00:18:20,2,12,11044,895,10149,16.85%,8.10%
2020-01-01 00:18:20,3,1,1629,22,1607,2.49%,1.35%
2020-01-01 00:18:20,3,2,24569,4079,20490,37.49%,16.60%
2020-01-01 00:18:20,3,3,71802,28134,43668,109.56%,39.18%
2020-01-01 00:18:20,3,4,11100,891,10209,16.94%,8.03%
2020-01-01 00:18:20,3,5,46302,13127,33175,70.65%,28.35%
2020-01-01 00:18:20,3,6,12357,1097,11260,18.86%,8.88%
2020-01-01 00:18:20,3,7,21113,3056,18057,32.22%,14.47%
2020-01-01 00:18:20,3,8,17182,2066,15116,26.22%,12.02%
2020-01-01 00:18:20,3,9,33378,7163,26215,50.93%,21.46%
2020-01-01 00:18:20,3,10,3942,115,3827,6.02%,2.92%
2020-01-01 00:18:20,3,11,1623,24,1599,2.48%,1.48%
2020-01-01 00:18:20,3,12,26106,4473,21633,39.83%,17.13%
2020-01-01 00:18:20,4,1,562,6,556,0.86%,1.07%
2020-01-01 00:18:20,4,2,359,3,356,0.55%,0.84%
2020-01-01 00:18:20,4,3,624,3,621,0.95%,0.48%
2020-01-01 00:18:20,4,4,27610,5125,22485,42.13%,18.56%
2020-01-01 00:18:20,4,5,17201,2091,15110,26.25%,12.16%
2020-01-01 00:18:20,4,6,23854,3892,19962,36.40%,16.32%
2020-01-01 00:18:20,4,7,5237,217,5020,7.99%,4.14%
2020-01-01 00:18:20,4,8,2834,73,2761,4.32%,2.58%
2020-01-01 00:18:20,4,9,15270,1669,13601,23.30%,10.93%
2020-01-01 00:18:20,4,10,2172,50,2122,3.31%,2.30%
2020-01-01 00:18:20,4,11,272,0,272,0.42%,0.00%
2020-01-01 00:18:20,4,12,12486,1113,11373,19.05%,8.91%
2020-01-01 00:18:20,5,1,3507,95,3412,5.35%,2.71%
2020-01-01 00:18:20,5,2,940,5,935,1.43%,0.53%
2020-01-01 00:18:20,5,3,436,3,433,0.67%,0.69%
2020-01-01 00:18:20,5,4,23444,3737,19707,35.77%,15.94%
2020-01-01 00:18:20,5,5,9635,668,8967,14.70%,6.93%
2020-01-01 00:18:20,5,6,15004,1602,13402,22.89%,10.68%
2020-01-01 00:18:20,5,7,4848,205,4643,7.40%,4.23%
2020-01-01 00:18:20,5,8,3398,102,3296,5.18%,3.00%
2020-01-01 00:18:20,5,9,9038,590,8448,13.79%,6.53%
2020-01-01 00:18:20,5,10,924,8,916,1.41%,0.87%
2020-01-01 00:18:20,5,11,650,4,646,0.99%,0.62%
2020-01-01 00:18:20,5,12,7381,403,6978,11.26%,5.46%
2020-01-01 00:18:20,6,1,970,5,965,1.48%,0.52%
2020-01-01 00:18:20,6,2,1077,7,1070,1.64%,0.65%
2020-01-01 00:18:20,6,3,1492,17,1475,2.28%,1.14%
2020-01-01 00:18:20,6,4,2036,43,1993,3.11%,2.11%
2020-01-01 00:18:20,6,5,14472,1450,13022,22.08%,10.02%
2020-01-01 00:18:20,6,6,5518,227,5291,8.42%,4.11%
2020-01-01 00:18:20,6,7,2993,86,2907,4.57%,2.87%
2020-01-01 00:18:20,6,8,2485,65,2420,3.79%,2.62%
2020-01-01 00:18:20,6,9,7156,366,6790,10.92%,5.11%
2020-01-01 00:18:20,6,10,1804,27,1777,2.75%,1.50%
2020-01-01 00:18:20,6,11,504,3,501,0.77%,0.60%
2020-01-01 00:18:20,6,12,5321,198,5123,8.12%,3.72%
2020-01-01 00:18:20,7,1,533,3,530,0.81%,0.56%
2020-01-01 00:18:20,7,2,214,0,214,0.33%,0.00%
2020-01-01 00:18:20,7,3,728,1,727,1.11%,0.14%
2020-01-01 00:18:20,7,4,2491,134,2357,3.80%,5.38%
2020-01-01 00:18:20,7,5,8071,447,7624,12.32%,5.54%
2020-01-01 00:18:20,7,6,14305,1484,12821,21.83%,10.37%
2020-01-01 00:18:20,7,7,3704,99,3605,5.65%,2.67%
2020-01-01 00:18:20,7,8,1669,24,1645,2.55%,1.44%
2020-01-01 00:18:20,7,9,7008,340,6668,10.69%,4.85%
2020-01-01 00:18:20,7,10,1470,10,1460,2.24%,0.68%
2020-01-01 00:18:20,7,11,59,0,59,0.09%,0.00%
2020-01-01 00:18:20,7,12,5538,225,5313,8.45%,4.06%
2020-01-01 00:18:20,8,1,548,0,548,0.84%,0.00%
2020-01-01 00:18:20,8,2,68,0,68,0.10%,0.00%
2020-01-01 00:18:20,8,3,1729,19,1710,2.64%,1.10%
2020-01-01 00:18:20,8,4,3990,118,3872,6.09%,2.96%
2020-01-01 00:18:20,8,5,8698,525,8173,13.27%,6.04%
2020-01-01 00:18:20,8,6,18423,2356,16067,28.11%,12.79%
2020-01-01 00:18:20,8,7,5604,240,5364,8.55%,4.28%
2020-01-01 00:18:20,8,8,3106,78,3028,4.74%,2.51%
2020-01-01 00:18:20,8,9,6483,306,6177,9.89%,4.72%
2020-01-01 00:18:20,8,10,1716,29,1687,2.62%,1.69%
2020-01-01 00:18:20,8,11,176,0,176,0.27%,0.00%
2020-01-01 00:18:20,8,12,4783,166,4617,7.30%,3.47%
2020-01-01 00:18:20,9,1,308,2,306,0.47%,0.65%
2020-01-01 00:18:20,9,2,3639,109,3530,5.55%,3.00%
2020-01-01 00:18:20,9,3,2965,74,2891,4.52%,2.50%
2020-01-01 00:18:20,9,4,5578,253,5325,8.51%,4.54%
2020-01-01 00:18:20,9,5,277,1,276,0.42%,0.36%
2020-01-01 00:18:20,9,6,6659,355,6304,10.16%,5.33%
2020-01-01 00:18:20,9,7,27437,5041,22396,41.87%,18.37%
2020-01-01 00:18:20,9,8,10495,826,9669,16.01%,7.87%
2020-01-01 00:18:20,9,9,170,0,170,0.26%,0.00%
2020-01-01 00:18:20,9,10,3356,79,3277,5.12%,2.35%
2020-01-01 00:18:20,9,11,9635,712,8923,14.70%,7.39%
2020-01-01 00:18:20,9,12,5836,259,5577,8.91%,4.44%
2020-01-01 00:18:20,10,1,1554,292,1262,2.37%,18.79%
2020-01-01 00:18:20,10,2,3520,370,3150,5.37%,10.51%
2020-01-01 00:18:20,10,3,1816,25,1791,2.77%,1.38%
2020-01-01 00:18:20,10,4,4003,1115,2888,6.11%,27.85%
2020-01-01 00:18:20,10,5,1053,123,930,1.61%,11.68%
2020-01-01 00:18:20,10,6,5810,1317,4493,8.87%,22.67%
2020-01-01 00:18:20,10,7,11181,2121,9060,17.06%,18.97%
2020-01-01 00:18:20,10,8,29519,7503,22016,45.04%,25.42%
2020-01-01 00:18:20,10,9,575,2,573,0.88%,0.35%
2020-01-01 00:18:20,10,10,2479,56,2423,3.78%,2.26%
2020-01-01 00:18:20,10,11,13406,1575,11831,20.46%,11.75%
2020-01-01 00:18:20,10,12,10222,1091,9131,15.60%,10.67%
2020-01-01 00:18:20,11,1,2244,40,2204,3.42%,1.78%
2020-01-01 00:18:20,11,2,4140,136,4004,6.32%,3.29%
2020-01-01 00:18:20,11,3,1406,11,1395,2.15%,0.78%
2020-01-01 00:18:20,11,4,3627,89,3538,5.53%,2.45%
2020-01-01 00:18:20,11,5,220,0,220,0.34%,0.00%
2020-01-01 00:18:20,11,6,4310,123,4187,6.58%,2.85%
2020-01-01 00:18:20,11,7,10349,787,9562,15.79%,7.60%
2020-01-01 00:18:20,11,8,26035,4573,21462,39.73%,17.56%
2020-01-01 00:18:20,11,9,234,0,234,0.36%,0.00%
2020-01-01 00:18:20,11,10,3584,109,3475,5.47%,3.04%
2020-01-01 00:18:20,11,11,11576,997,10579,17.66%,8.61%
2020-01-01 00:18:20,11,12,7522,425,7097,11.48%,5.65%
2020-01-01 00:18:20,12,1,84,0,84,0.13%,0.00%
2020-01-01 00:18:20,12,2,423,113,310,0.65%,26.71%
2020-01-01 00:18:20,12,3,2146,146,2000,3.27%,6.80%
2020-01-01 00:18:20,12,4,3118,67,3051,4.76%,2.15%
2020-01-01 00:18:20,12,5,7748,516,7232,11.82%,6.66%
2020-01-01 00:18:20,12,6,4969,156,4813,7.58%,3.14%
2020-01-01 00:18:20,12,7,1705,14,1691,2.60%,0.82%
2020-01-01 00:18:20,12,8,1377,214,1163,2.10%,15.54%
2020-01-01 00:18:20,12,9,20359,3615,16744,31.07%,17.76%
2020-01-01 00:18:20,12,10,4014,304,3710,6.12%,7.57%
2020-01-01 00:18:20,12,11,1608,219,1389,2.45%,13.62%
2020-01-01 00:18:20,12,12,7589,1057,6532,11.58%,13.93%
2020-01-01 00:18:20,13,1,1952,30,1922,2.98%,1.54%
2020-01-01 00:18:20,13,2,2382,47,2335,3.63%,1.97%
2020-01-01 00:18:20,13,3,750,7,743,1.14%,0.93%
2020-01-01 00:18:20,13,4,5479,636,4843,8.36%,11.61%
2020-01-01 00:18:20,13,5,7807,1043,6764,11.91%,13.36%
2020-01-01 00:18:20,13,6,5938,676,5262,9.06%,11.38%
2020-01-01 00:18:20,13,7,4830,186,4644,7.37%,3.85%
2020-01-01 00:18:20,13,8,7231,434,6797,11.03%,6.00%
2020-01-01 00:18:20,13,9,8215,1078,7137,12.54%,13.12%
2020-01-01 00:18:20,13,10,28490,6036,22454,43.47%,21.19%
2020-01-01 00:18:20,13,11,17555,2435,15120,26.79%,13.87%
2020-01-01 00:18:20,13,12,9892,988,8904,15.09%,9.99%
2020-01-01 00:18:20,14,1,533,5,528,0.81%,0.94%
2020-01-01 00:18:20,14,2,1721,21,1700,2.63%,1.22%
2020-01-01 00:18:20,14,3,938,7,931,1.43%,0.75%
2020-01-01 00:18:20,14,4,3886,93,3793,5.93%,2.39%
2020-01-01 00:18:20,14,5,2329,41,2288,3.55%,1.76%
2020-01-01 00:18:20,14,6,4115,106,4009,6.28%,2.58%
2020-01-01 00:18:20,14,7,11696,1015,10681,17.85%,8.68%
2020-01-01 00:18:20,14,8,13791,1400,12391,21.04%,10.15%
2020-01-01 00:18:20,14,9,2692,56,2636,4.11%,2.08%
2020-01-01 00:18:20,14,10,5599,229,5370,8.54%,4.09%
2020-01-01 00:18:20,14,11,28942,5655,23287,44.16%,19.54%
2020-01-01 00:18:20,14,12,9164,635,8529,13.98%,6.93%
2020-01-01 00:18:20,15,1,639,5,634,0.98%,0.78%
2020-01-01 00:18:20,15,2,182,1,181,0.28%,0.55%
2020-01-01 00:18:20,15,3,6786,350,6436,10.35%,5.16%
2020-01-01 00:18:20,15,4,5505,246,5259,8.40%,4.47%
2020-01-01 00:18:20,15,5,13123,1271,11852,20.02%,9.69%
2020-01-01 00:18:20,15,6,5822,297,5525,8.88%,5.10%
2020-01-01 00:18:20,15,7,3125,78,3047,4.77%,2.50%
2020-01-01 00:18:20,15,8,5032,178,4854,7.68%,3.54%
2020-01-01 00:18:20,15,9,13306,1304,12002,20.30%,9.80%
2020-01-01 00:18:20,15,10,5396,374,5022,8.23%,6.93%
2020-01-01 00:18:20,15,11,10672,973,9699,16.28%,9.12%
2020-01-01 00:18:20,15,12,29586,6279,23307,45.14%,21.22%
2020-01-01 00:18:20,16,1,482,1,481,0.74%,0.21%
2020-01-01 00:18:20,16,2,288,2,286,0.44%,0.69%
2020-01-01 00:18:20,16,3,1294,18,1276,1.97%,1.39%
2020-01-01 00:18:20,16,4,3413,89,3324,5.21%,2.61%
2020-01-01 00:18:20,16,5,7322,492,6830,11.17%,6.72%
2020-01-01 00:18:20,16,6,4323,136,4187,6.60%,3.15%
2020-01-01 00:18:20,16,7,3569,113,3456,5.45%,3.17%
2020-01-01 00:18:20,16,8,8181,617,7564,12.48%,7.54%
2020-01-01 00:18:20,16,9,7752,535,7217,11.83%,6.90%
2020-01-01 00:18:20,16,10,1508,21,1487,2.30%,1.39%
2020-01-01 00:18:20,16,11,9870,822,9048,15.06%,8.33%
2020-01-01 00:18:20,16,12,26825,4830,21995,40.93%,18.01%
2020-01-01 00:18:30,1,1,17895,2289,15606,27.31%,12.79%
2020-01-01 00:18:30,1,2,7120,384,6736,10.86%,5.39%
2020-01-01 00:18:30,1,3,2169,41,2128,3.31%,1.89%
2020-01-01 00:18:30,1,4,10107,798,9309,15.42%,7.90%
2020-01-01 00:18:30,1,5,9699,733,8966,14.80%,7.56%
2020-01-01 00:18:30,1,6,9639,727,8912,14.71%,7.54%
2020-01-01 00:18:30,1,7,4939,189,4750,7.54%,3.83%
2020-01-01 00:18:30,1,8,2722,53,2669,4.15%,1.95%
2020-01-01 00:18:30,1,9,9592,721,8871,14.64%,7.52%
2020-01-01 00:18:30,1,10,2319,31,2288,3.54%,1.34%
2020-01-01 00:18:30,1,11,2420,38,2382,3.69%,1.57%
2020-01-01 00:18:30,1,12,9565,712,8853,14.60%,7.44%
2020-01-01 00:18:30,2,1,1106,2,1104,1.69%,0.18%
2020-01-01 00:18:30,2,2,26635,4761,21874,40.64%,17.87%
2020-01-01 00:18:30,2,3,22160,3348,18812,33.81%,15.11%
2020-01-01 00:18:30,2,4,301,0,301,0.46%,0.00%
2020-01-01 00:18:30,2,5,12575,1119,11456,19.19%,8.90%
2020-01-01 00:18:30,2,6,22,0,22,0.03%,0.00%
2020-01-01 00:18:30,2,7,3348,83,3265,5.11%,2.48%
2020-01-01 00:18:30,2,8,2672,60,2612,4.08%,2.25%
2020-01-01 00:18:30,2,9,12502,1113,11389,19.08%,8.90%
2020-01-01 00:18:30,2,10,1946,26,1920,2.97%,1.34%
2020-01-01 00:18:30,2,11,1964,26,1938,3.00%,1.32%
2020-01-01 00:18:30,2,12,12307,1079,11228,18.78%,8.77%
2020-01-01 00:18:30,3,1,1761,27,1734,2.69%,1.53%
2020-01-01 00:18:30,3,2,23025,3641,19384,35.13%,15.81%
2020-01-01 00:18:30,3,3,81339,34809,46530,124.11%,42.79%
2020-01-01 00:18:30,3,4,12569,1136,11433,19.18%,9.04%
2020-01-01 00:18:30,3,5,56341,18613,37728,85.97%,33.04%
2020-01-01 00:18:30,3,6,13990,1409,12581,21.35%,10.07%
2020-01-01 00:18:30,3,7,18310,2294,16016,27.94%,12.53%
2020-01-01 00:18:30,3,8,15747,1743,14004,24.03%,11.07%
2020-01-01 00:18:30,3,9,41849,10978,30871,63.86%,26.23%
2020-01-01 00:18:30,3,10,14631,1535,13096,22.33%,10.49%
2020-01-01 00:18:30,3,11,1776,19,1757,2.71%,1.07%
2020-01-01 00:18:30,3,12,24020,3984,20036,36.65%,16.59%
2020-01-01 00:18:30,4,1,595,3,592,0.91%,0.50%
2020-01-01 00:18:30,4,2,368,0,368,0.56%,0.00%
2020-01-01 00:18:30,4,3,1656,12,1644,2.53%,0.72%
2020-01-01 00:18:30,4,4,28464,5386,23078,43.43%,18.92%
2020-01-01 00:18:30,4,5,18212,2346,15866,27.79%,12.88%
2020-01-01 00:18:30,4,6,24941,4249,20692,38.06%,17.04%
2020-01-01 00:18:30,4,7,5445,211,5234,8.31%,3.88%
2020-01-01 00:18:30,4,8,3291,86,3205,5.02%,2.61%
2020-01-01 00:18:30,4,9,15223,1665,13558,23.23%,10.94%
2020-01-01 00:18:30,4,10,1994,51,1943,3.04%,2.56%
2020-01-01 00:18:30,4,11,183,0,183,0.28%,0.00%
2020-01-01 00:18:30,4,12,12433,1094,11339,18.97%,8.80%
2020-01-01 00:18:30,5,1,2838,63,2775,4.33%,2.22%
2020-01-01 00:18:30,5,2,714,4,710,1.09%,0.56%
2020-01-01 00:18:30,5,3,518,3,515,0.79%,0.58%
2020-01-01 00:18:30,5,4,22206,3399,18807,33.88%,15.31%
2020-01-01 00:18:30,5,5,9196,654,8542,14.03%,7.11%
2020-01-01 00:18:30,5,6,13636,1364,12272,20.81%,10.00%
2020-01-01 00:18:30,5,7,3981,132,3849,6.07%,3.32%
2020-01-01 00:18:30,5,8,2765,69,2696,4.22%,2.50%
2020-01-01 00:18:30,5,9,8573,575,7998,13.08%,6.71%
2020-01-01 00:18:30,5,10,1318,16,1302,2.01%,1.21%
2020-01-01 00:18:30,5,11,256,3,253,0.39%,1.17%
2020-01-01 00:18:30,5,12,6381,328,6053,9.74%,5.14%
2020-01-01 00:18:30,6,1,1079,6,1073,1.65%,0.56%
2020-01-01 00:18:30,6,2,1135,7,1128,1.73%,0.62%
2020-01-01 00:18:30,6,3,1880,37,1843,2.87%,1.97%
2020-01-01 00:18:30,6,4,1128,8,1120,1.72%,0.71%
2020-01-01 00:18:30,6,5,13431,1339,12092,20.49%,9.97%
2020-01-01 00:18:30,6,6,4979,202,4777,7.60%,4.06%
2020-01-01 00:18:30,6,7,3524,85,3439,5.38%,2.41%
2020-01-01 00:18:30,6,8,2695,49,2646,4.11%,1.82%
2020-01-01 00:18:30,6,9,6289,296,5993,9.60%,4.71%
2020-01-01 00:18:30,6,10,1982,29,1953,3.02%,1.46%
2020-01-01 00:18:30,6,11,433,2,431,0.66%,0.46%
2020-01-01 00:18:30,6,12,4254,134,4120,6.49%,3.15%
2020-01-01 00:18:30,7,1,503,7,496,0.77%,1.39%
2020-01-01 00:18:30,7,2,145,0,145,0.22%,0.00%
2020-01-01 00:18:30,7,3,610,1,609,0.93%,0.16%
2020-01-01 00:18:30,7,4,2481,55,2426,3.79%,2.22%
2020-01-01 00:18:30,7,5,7038,334,6704,10.74%,4.75%
2020-01-01 00:18:30,7,6,12964,1211,11753,19.78%,9.34%
2020-01-01 00:18:30,7,7,3423,71,3352,5.22%,2.07%
2020-01-01 00:18:30,7,8,1532,21,1511,2.34%,1.37%
2020-01-01 00:18:30,7,9,6225,258,5967,9.50%,4.14%
2020-01-01 00:18:30,7,10,804,6,798,1.23%,0.75%
2020-01-01 00:18:30,7,11,124,0,124,0.19%,0.00%
2020-01-01 00:18:30,7,12,5427,195,5232,8.28%,3.59%
2020-01-01 00:18:30,8,1,417,2,415,0.64%,0.48%
2020-01-01 00:18:30,8,2,98,0,98,0.15%,0.00%
2020-01-01 00:18:30,8,3,2309,36,2273,3.52%,1.56%
2020-01-01 00:18:30,8,4,2674,79,2595,4.08%,2.95%
2020-01-01 00:18:30,8,5,9806,689,9117,14.96%,7.03%
2020-01-01 00:18:30,8,6,18466,2370,16096,28.18%,12.83%
2020-01-01 00:18:30,8,7,5568,277,5291,8.50%,4.97%
2020-01-01 00:18:30,8,8,2636,67,2569,4.02%,2.54%
2020-01-01 00:18:30,8,9,7275,374,6901,11.10%,5.14%
2020-01-01 00:18:30,8,10,3276,73,3203,5.00%,2.23%
2020-01-01 00:18:30,8,11,91,0,91,0.14%,0.00%
2020-01-01 00:18:30,8,12,4016,107,3909,6.13%,2.66%
2020-01-01 00:18:30,9,1,412,1,411,0.63%,0.24%
2020-01-01 00:18:30,9,2,1628,20,1608,2.48%,1.23%
2020-01-01 00:18:30,9,3,855,6,849,1.30%,0.70%
2020-01-01 00:18:30,9,4,4164,103,4061,6.35%,2.47%
2020-01-01 00:18:30,9,5,262,0,262,0.40%,0.00%
2020-01-01 00:18:30,9,6,5443,187,5256,8.31%,3.44%
2020-01-01 00:18:30,9,7,22654,3552,19102,34.57%,15.68%
2020-01-01 00:18:30,9,8,10215,770,9445,15.59%,7.54%
2020-01-01 00:18:30,9,9,226,0,226,0.34%,0.00%
2020-01-01 00:18:30,9,10,3427,65,3362,5.23%,1.90%
2020-01-01 00:18:30,9,11,9107,611,8496,13.90%,6.71%
2020-01-01 00:18:30,9,12,5384,226,5158,8.22%,4.20%
2020-01-01 00:18:30,10,1,1506,288,1218,2.30%,19.12%
2020-01-01 00:18:30,10,2,4857,428,4429,7.41%,8.81%
2020-01-01 00:18:30,10,3,3204,83,3121,4.89%,2.59%
2020-01-01 00:18:30,10,4,3847,942,2905,5.87%,24.49%
2020-01-01 00:18:30,10,5,931,116,815,1.42%,12.46%
2020-01-01 00:18:30,10,6,5819,1156,4663,8.88%,19.87%
2020-01-01 00:18:30,10,7,12203,2148,10055,18.62%,17.60%
2020-01-01 00:18:30,10,8,31838,8250,23588,48.58%,25.91%
2020-01-01 00:18:30,10,9,728,2,726,1.11%,0.27%
2020-01-01 00:18:30,10,10,3070,72,2998,4.68%,2.35%
2020-01-01 00:18:30,10,11,15533,2137,13396,23.70%,13.76%
2020-01-01 00:18:30,10,12,11595,1447,10148,17.69%,12.48%
2020-01-01 00:18:30,11,1,2446,52,2394,3.73%,2.13%
2020-01-01 00:18:30,11,2,4839,179,4660,7.38%,3.70%
2020-01-01 00:18:30,11,3,2153,40,2113,3.29%,1.86%
2020-01-01 00:18:30,11,4,3160,63,3097,4.82%,1.99%
2020-01-01 00:18:30,11,5,204,2,202,0.31%,0.98%
2020-01-01 00:18:30,11,6,3872,107,3765,5.91%,2.76%
2020-01-01 00:18:30,11,7,10262,760,9502,15.66%,7.41%
2020-01-01 00:18:30,11,8,24865,4195,20670,37.94%,16.87%
2020-01-01 00:18:30,11,9,203,0,203,0.31%,0.00%
2020-01-01 00:18:30,11,10,3176,88,3088,4.85%,2.77%
2020-01-01 00:18:30,11,11,10952,879,10073,16.71%,8.03%
2020-01-01 00:18:30,11,12,7276,394,6882,11.10%,5.42%
2020-01-01 00:18:30,12,1,68,0,68,0.10%,0.00%
2020-01-01 00:18:30,12,2,831,168,663,1.27%,20.22%
2020-01-01 00:18:30,12,3,2800,225,2575,4.27%,8.04%
2020-01-01 00:18:30,12,4,3304,135,3169,5.04%,4.09%
2020-01-01 00:18:30,12,5,8436,831,7605,12.87%,9.85%
2020-01-01 00:18:30,12,6,4902,245,4657,7.48%,5.00%
2020-01-01 00:18:30,12,7,1481,34,1447,2.26%,2.30%
2020-01-01 00:18:30,12,8,1772,399,1373,2.70%,22.52%
2020-01-01 00:18:30,12,9,22007,4731,17276,33.58%,21.50%
2020-01-01 00:18:30,12,10,5245,556,4689,8.00%,10.60%
2020-01-01 00:18:30,12,11,1975,403,1572,3.01%,20.41%
2020-01-01 00:18:30,12,12,7463,1277,6186,11.39%,17.11%
2020-01-01 00:18:30,13,1,1939,26,1913,2.96%,1.34%
2020-01-01 00:18:30,13,2,2311,43,2268,3.53%,1.86%
2020-01-01 00:18:30,13,3,1033,9,1024,1.58%,0.87%
2020-01-01 00:18:30,13,4,5069,600,4469,7.73%,11.84%
2020-01-01 00:18:30,13,5,7520,885,6635,11.47%,11.77%
2020-01-01 00:18:30,13,6,5691,636,5055,8.68%,11.18%
2020-01-01 00:18:30,13,7,4219,124,4095,6.44%,2.94%
2020-01-01 00:18:30,13,8,8181,498,7683,12.48%,6.09%
2020-01-01 00:18:30,13,9,8000,947,7053,12.21%,11.84%
2020-01-01 00:18:30,13,10,28273,5920,22353,43.14%,20.94%
2020-01-01 00:18:30,13,11,17812,2533,15279,27.18%,14.22%
2020-01-01 00:18:30,13,12,9256,960,8296,14.12%,10.37%
2020-01-01 00:18:30,14,1,262,0,262,0.40%,0.00%
2020-01-01 00:18:30,14,2,1596,18,1578,2.44%,1.13%
2020-01-01 00:18:30,14,3,1188,6,1182,1.81%,0.51%
2020-01-01 00:18:30,14,4,3128,74,3054,4.77%,2.37%
2020-01-01 00:18:30,14,5,1716,24,1692,2.62%,1.40%
2020-01-01 00:18:30,14,6,3418,92,3326,5.22%,2.69%
2020-01-01 00:18:30,14,7,10899,838,10061,16.63%,7.69%
2020-01-01 00:18:30,14,8,12270,1070,11200,18.72%,8.72%
2020-01-01 00:18:30,14,9,1843,27,1816,2.81%,1.47%
2020-01-01 00:18:30,14,10,4226,129,4097,6.45%,3.05%
2020-01-01 00:18:30,14,11,26104,4589,21515,39.83%,17.58%
2020-01-01 00:18:30,14,12,9224,645,8579,14.07%,6.99%
2020-01-01 00:18:30,15,1,515,3,512,0.79%,0.58%
2020-01-01 00:18:30,15,2,150,0,150,0.23%,0.00%
2020-01-01 00:18:30,15,3,3852,107,3745,5.88%,2.78%
2020-01-01 00:18:30,15,4,5085,243,4842,7.76%,4.78%
2020-01-01 00:18:30,15,5,9594,697,8897,14.64%,7.26%
2020-01-01 00:18:30,15,6,5304,261,5043,8.09%,4.92%
2020-01-01 00:18:30,15,7,3414,129,3285,5.21%,3.78%
2020-01-01 00:18:30,15,8,5831,310,5521,8.90%,5.32%
2020-01-01 00:18:30,15,9,9781,727,9054,14.92%,7.43%
2020-01-01 00:18:30,15,10,4872,395,4477,7.43%,8.11%
2020-01-01 00:18:30,15,11,10776,1090,9686,16.44%,10.12%
2020-01-01 00:18:30,15,12,26300,5181,21119,40.13%,19.70%
2020-01-01 00:18:30,16,1,465,4,461,0.71%,0.86%
2020-01-01 00:18:30,16,2,314,1,313,0.48%,0.32%
2020-01-01 00:18:30,16,3,1383,23,1360,2.11%,1.66%
2020-01-01 00:18:30,16,4,4838,152,4686,7.38%,3.14%
2020-01-01 00:18:30,16,5,8111,504,7607,12.38%,6.21%
2020-01-01 00:18:30,16,6,5768,239,5529,8.80%,4.14%
2020-01-01 00:18:30,16,7,4082,117,3965,6.23%,2.87%
2020-01-01 00:18:30,16,8,8097,558,7539,12.36%,6.89%
2020-01-01 00:18:30,16,9,8704,576,8128,13.28%,6.62%
2020-01-01 00:18:30,16,10,1759,27,1732,2.68%,1.53%
2020-01-01 00:18:30,16,11,10066,815,9251,15.36%,8.10%
2020-01-01 00:18:30,16,12,26436,4743,21693,40.34%,17.94%
2020-01-01 00:18:40,1,1,24109,3929,20180,36.79%,16.30%
2020-01-01 00:18:40,1,2,12606,1130,11476,19.24%,8.96%
2020-01-01 00:18:40,1,3,1525,10,1515,2.33%,0.66%
2020-01-01 00:18:40,1,4,11015,863,10152,16.81%,7.83%
2020-01-01 00:18:40,1,5,10643,816,9827,16.24%,7.67%
2020-01-01 00:18:40,1,6,10615,805,9810,16.20%,7.58%
2020-01-01 00:18:40,1,7,11070,900,10170,16.89%,8.13%
2020-01-01 00:18:40,1,8,9366,645,8721,14.29%,6.89%
2020-01-01 00:18:40,1,9,10559,796,9763,16.11%,7.54%
2020-01-01 00:18:40,1,10,8361,515,7846,12.76%,6.16%
2020-01-01 00:18:40,1,11,8592,545,8047,13.11%,6.34%
2020-01-01 00:18:40,1,12,10545,793,9752,16.09%,7.52%
2020-01-01 00:18:40,2,1,637,0,637,0.97%,0.00%
2020-01-01 00:18:40,2,2,28390,5401,22989,43.32%,19.02%
2020-01-01 00:18:40,2,3,22720,3545,19175,34.67%,15.60%
2020-01-01 00:18:40,2,4,548,0,548,0.84%,0.00%
2020-01-01 00:18:40,2,5,15416,1747,13669,23.52%,11.33%
2020-01-01 00:18:40,2,6,41,0,41,0.06%,0.00%
2020-01-01 00:18:40,2,7,5023,186,4837,7.66%,3.70%
2020-01-01 00:18:40,2,8,4260,138,4122,6.50%,3.24%
2020-01-01 00:18:40,2,9,15361,1738,13623,23.44%,11.31%
2020-01-01 00:18:40,2,10,3513,99,3414,5.36%,2.82%
2020-01-01 00:18:40,2,11,3523,100,3423,5.38%,2.84%
2020-01-01 00:18:40,2,12,15194,1700,13494,23.18%,11.19%
2020-01-01 00:18:40,3,1,1702,23,1679,2.60%,1.35%
2020-01-01 00:18:40,3,2,27774,5222,22552,42.38%,18.80%
2020-01-01 00:18:40,3,3,73436,29210,44226,112.05%,39.78%
2020-01-01 00:18:40,3,4,9418,634,8784,14.37%,6.73%
2020-01-01 00:18:40,3,5,40791,10431,30360,62.24%,25.57%
2020-01-01 00:18:40,3,6,10988,868,10120,16.77%,7.90%
2020-01-01 00:18:40,3,7,23874,3930,19944,36.43%,16.46%
2020-01-01 00:18:40,3,8,18652,2511,16141,28.46%,13.46%
2020-01-01 00:18:40,3,9,29414,5739,23675,44.88%,19.51%
2020-01-01 00:18:40,3,10,4871,182,4689,7.43%,3.74%
2020-01-01 00:18:40,3,11,1825,16,1809,2.78%,0.88%
2020-01-01 00:18:40,3,12,20672,2935,17737,31.54%,14.20%
2020-01-01 00:18:40,4,1,585,0,585,0.89%,0.00%
2020-01-01 00:18:40,4,2,363,0,363,0.55%,0.00%
2020-01-01 00:18:40,4,3,720,10,710,1.10%,1.39%
2020-01-01 00:18:40,4,4,28585,5484,23101,43.62%,19.18%
2020-01-01 00:18:40,4,5,17763,2215,15548,27.10%,12.47%
2020-01-01 00:18:40,4,6,24620,4081,20539,37.57%,16.58%
2020-01-01 00:18:40,4,7,5588,211,5377,8.53%,3.78%
2020-01-01 00:18:40,4,8,3066,55,3011,4.68%,1.79%
2020-01-01 00:18:40,4,9,16006,1824,14182,24.42%,11.40%
2020-01-01 00:18:40,4,10,1873,28,1845,2.86%,1.49%
2020-01-01 00:18:40,4,11,141,0,141,0.22%,0.00%
2020-01-01 00:18:40,4,12,12929,1186,11743,19.73%,9.17%
2020-01-01 00:18:40,5,1,3033,67,2966,4.63%,2.21%
2020-01-01 00:18:40,5,2,688,6,682,1.05%,0.87%
2020-01-01 00:18:40,5,3,577,3,574,0.88%,0.52%
2020-01-01 00:18:40,5,4,21426,3093,18333,32.69%,14.44%
2020-01-01 00:18:40,5,5,9006,546,8460,13.74%,6.06%
2020-01-01 00:18:40,5,6,13599,1349,12250,20.75%,9.92%
2020-01-01 00:18:40,5,7,4001,176,3825,6.11%,4.40%
2020-01-01 00:18:40,5,8,3009,64,2945,4.59%,2.13%
2020-01-01 00:18:40,5,9,7499,391,7108,11.44%,5.21%
2020-01-01 00:18:40,5,10,814,8,806,1.24%,0.98%
2020-01-01 00:18:40,5,11,456,6,450,0.70%,1.32%
2020-01-01 00:18:40,5,12,6498,297,6201,9.92%,4.57%
2020-01-01 00:18:40,6,1,937,8,929,1.43%,0.85%
2020-01-01 00:18:40,6,2,982,11,971,1.50%,1.12%
2020-01-01 00:18:40,6,3,1594,17,1577,2.43%,1.07%
2020-01-01 00:18:40,6,4,1449,13,1436,2.21%,0.90%
2020-01-01 00:18:40,6,5,13008,1222,11786,19.85%,9.39%
2020-01-01 00:18:40,6,6,5351,217,5134,8.16%,4.06%
2020-01-01 00:18:40,6,7,3314,87,3227,5.06%,2.63%
2020-01-01 00:18:40,6,8,2479,57,2422,3.78%,2.30%
2020-01-01 00:18:40,6,9,5783,241,5542,8.82%,4.17%
2020-01-01 00:18:40,6,10,1743,14,1729,2.66%,0.80%
2020-01-01 00:18:40,6,11,432,0,432,0.66%,0.00%
2020-01-01 00:18:40,6,12,3964,113,3851,6.05%,2.85%
2020-01-01 00:18:40,7,1,440,9,431,0.67%,2.05%
2020-01-01 00:18:40,7,2,207,0,207,0.32%,0.00%
2020-01-01 00:18:40,7,3,619,3,616,0.94%,0.48%
2020-01-01 00:18:40,7,4,2887,59,2828,4.41%,2.04%
2020-01-01 00:18:40,7,5,7497,381,7116,11.44%,5.08%
2020-01-01 00:18:40,7,6,14356,1330,13026,21.91%,9.26%
2020-01-01 00:18:40,7,7,3893,92,3801,5.94%,2.36%
2020-01-01 00:18:40,7,8,1731,22,1709,2.64%,1.27%
2020-01-01 00:18:40,7,9,6836,333,6503,10.43%,4.87%
2020-01-01 00:18:40,7,10,1406,18,1388,2.15%,1.28%
2020-01-01 00:18:40,7,11,82,0,82,0.13%,0.00%
2020-01-01 00:18:40,7,12,5342,187,5155,8.15%,3.50%
2020-01-01 00:18:40,8,1,477,0,477,0.73%,0.00%
2020-01-01 00:18:40,8,2,115,0,115,0.18%,0.00%
2020-01-01 00:18:40,8,3,1526,13,1513,2.33%,0.85%
2020-01-01 00:18:40,8,4,2879,64,2815,4.39%,2.22%
2020-01-01 00:18:40,8,5,8112,439,7673,12.38%,5.41%
2020-01-01 00:18:40,8,6,17555,2141,15414,26.79%,12.20%
2020-01-01 00:18:40,8,7,6279,328,5951,9.58%,5.22%
2020-01-01 00:18:40,8,8,3068,55,3013,4.68%,1.79%
2020-01-01 00:18:40,8,9,6236,255,5981,9.52%,4.09%
2020-01-01 00:18:40,8,10,1574,18,1556,2.40%,1.14%
2020-01-01 00:18:40,8,11,174,0,174,0.27%,0.00%
2020-01-01 00:18:40,8,12,4649,138,4511,7.09%,2.97%
2020-01-01 00:18:40,9,1,1215,7,1208,1.85%,0.58%
2020-01-01 00:18:40,9,2,2861,69,2792,4.37%,2.41%
2020-01-01 00:18:40,9,3,1164,15,1149,1.78%,1.29%
2020-01-01 00:18:40,9,4,3447,114,3333,5.26%,3.31%
2020-01-01 00:18:40,9,5,399,2,397,0.61%,0.50%
2020-01-01 00:18:40,9,6,5303,237,5066,8.09%,4.47%
2020-01-01 00:18:40,9,7,27200,5211,21989,41.50%,19.16%
2020-01-01 00:18:40,9,8,9735,683,9052,14.85%,7.02%
2020-01-01 00:18:40,9,9,322,1,321,0.49%,0.31%
2020-01-01 00:18:40,9,10,3002,76,2926,4.58%,2.53%
2020-01-01 00:18:40,9,11,8745,545,8200,13.34%,6.23%
2020-01-01 00:18:40,9,12,5501,213,5288,8.39%,3.87%
2020-01-01 00:18:40,10,1,1202,172,1030,1.83%,14.31%
2020-01-01 00:18:40,10,2,3654,246,3408,5.58%,6.73%
2020-01-01 00:18:40,10,3,2312,28,2284,3.53%,1.21%
2020-01-01 00:18:40,10,4,4196,1322,2874,6.40%,31.51%
2020-01-01 00:18:40,10,5,699,59,640,1.07%,8.44%
2020-01-01 00:18:40,10,6,6085,1489,4596,9.28%,24.47%
2020-01-01 00:18:40,10,7,12122,2302,9820,18.50%,18.99%
2020-01-01 00:18:40,10,8,28682,7213,21469,43.77%,25.15%
2020-01-01 00:18:40,10,9,978,11,967,1.49%,1.12%
2020-01-01 00:18:40,10,10,2800,57,2743,4.27%,2.04%
2020-01-01 00:18:40,10,11,13284,1698,11586,20.27%,12.78%
2020-01-01 00:18:40,10,12,9635,1137,8498,14.70%,11.80%
2020-01-01 00:18:40,11,1,2875,59,2816,4.39%,2.05%
2020-01-01 00:18:40,11,2,3795,103,3692,5.79%,2.71%
2020-01-01 00:18:40,11,3,750,4,746,1.14%,0.53%
2020-01-01 00:18:40,11,4,3749,105,3644,5.72%,2.80%
2020-01-01 00:18:40,11,5,175,1,174,0.27%,0.57%
2020-01-01 00:18:40,11,6,4834,170,4664,7.38%,3.52%
2020-01-01 00:18:40,11,7,10737,801,9936,16.38%,7.46%
2020-01-01 00:18:40,11,8,25086,4240,20846,38.28%,16.90%
2020-01-01 00:18:40,11,9,286,0,286,0.44%,0.00%
2020-01-01 00:18:40,11,10,2693,61,2632,4.11%,2.27%
2020-01-01 00:18:40,11,11,10422,780,9642,15.90%,7.48%
2020-01-01 00:18:40,11,12,7206,357,6849,11.00%,4.95%
2020-01-01 00:18:40,12,1,28,0,28,0.04%,0.00%
2020-01-01 00:18:40,12,2,633,164,469,0.97%,25.91%
2020-01-01 00:18:40,12,3,3135,226,2909,4.78%,7.21%
2020-01-01 00:18:40,12,4,4123,70,4053,6.29%,1.70%
2020-01-01 00:18:40,12,5,10262,802,9460,15.66%,7.82%
2020-01-01 00:18:40,12,6,6280,217,6063,9.58%,3.46%
2020-01-01 00:18:40,12,7,1950,43,1907,2.98%,2.21%
2020-01-01 00:18:40,12,8,1548,304,1244,2.36%,19.64%
2020-01-01 00:18:40,12,9,23493,4446,19047,35.85%,18.92%
2020-01-01 00:18:40,12,10,4763,429,4334,7.27%,9.01%
2020-01-01 00:18:40,12,11,1725,306,1419,2.63%,17.74%
2020-01-01 00:18:40,12,12,8005,1030,6975,12.21%,12.87%
2020-01-01 00:18:40,13,1,2265,39,2226,3.46%,1.72%
2020-01-01 00:18:40,13,2,2676,56,2620,4.08%,2.09%
2020-01-01 00:18:40,13,3,611,2,609,0.93%,0.33%
2020-01-01 00:18:40,13,4,5541,819,4722,8.45%,14.78%
2020-01-01 00:18:40,13,5,8423,1166,7257,12.85%,13.84%
2020-01-01 00:18:40,13,6,6634,904,5730,10.12%,13.63%
2020-01-01 00:18:40,13,7,4696,212,4484,7.17%,4.51%
2020-01-01 00:18:40,13,8,7354,467,6887,11.22%,6.35%
2020-01-01 00:18:40,13,9,8848,1208,7640,13.50%,13.65%
2020-01-01 00:18:40,13,10,28531,6442,22089,43.53%,22.58%
2020-01-01 00:18:40,13,11,16968,2694,14274,25.89%,15.88%
2020-01-01 00:18:40,13,12,9063,1313,7750,13.83%,14.49%
2020-01-01 00:18:40,14,1,216,0,216,0.33%,0.00%
2020-01-01 00:18:40,14,2,1204,11,1193,1.84%,0.91%
2020-01-01 00:18:40,14,3,759,5,754,1.16%,0.66%
2020-01-01 00:18:40,14,4,4185,134,4051,6.39%,3.20%
2020-01-01 00:18:40,14,5,1368,17,1351,2.09%,1.24%
2020-01-01 00:18:40,14,6,4537,155,4382,6.92%,3.42%
2020-01-01 00:18:40,14,7,12144,981,11163,18.53%,8.08%
2020-01-01 00:18:40,14,8,13970,1330,12640,21.32%,9.52%
2020-01-01 00:18:40,14,9,1630,20,1610,2.49%,1.23%
2020-01-01 00:18:40,14,10,4042,115,3927,6.17%,2.85%
2020-01-01 00:18:40,14,11,27265,4932,22333,41.60%,18.09%
2020-01-01 00:18:40,14,12,8973,597,8376,13.69%,6.65%
2020-01-01 00:18:40,15,1,470,4,466,0.72%,0.85%
2020-01-01 00:18:40,15,2,129,0,129,0.20%,0.00%
2020-01-01 00:18:40,15,3,3865,127,3738,5.90%,3.29%
2020-01-01 00:18:40,15,4,4527,154,4373,6.91%,3.40%
2020-01-01 00:18:40,15,5,8982,590,8392,13.71%,6.57%
2020-01-01 00:18:40,15,6,4790,168,4622,7.31%,3.51%
2020-01-01 00:18:40,15,7,3660,109,3551,5.58%,2.98%
2020-01-01 00:18:40,15,8,6127,281,5846,9.35%,4.59%
2020-01-01 00:18:40,15,9,9142,608,8534,13.95%,6.65%
2020-01-01 00:18:40,15,10,3615,103,3512,5.52%,2.85%
2020-01-01 00:18:40,15,11,10131,759,9372,15.46%,7.49%
2020-01-01 00:18:40,15,12,24516,4222,20294,37.41%,17.22%
2020-01-01 00:18:40,16,1,503,4,499,0.77%,0.80%
2020-01-01 00:18:40,16,2,269,0,269,0.41%,0.00%
2020-01-01 00:18:40,16,3,1629,24,1605,2.49%,1.47%
2020-01-01 00:18:40,16,4,3611,101,3510,5.51%,2.80%
2020-01-01 00:18:40,16,5,7284,441,6843,11.11%,6.05%
2020-01-01 00:18:40,16,6,4477,151,4326,6.83%,3.37%
2020-01-01 00:18:40,16,7,3432,94,3338,5.24%,2.74%
2020-01-01 00:18:40,16,8,7291,505,6786,11.13%,6.93%
2020-01-01 00:18:40,16,9,7772,493,7279,11.86%,6.34%
2020-01-01 00:18:40,16,10,1396,10,1386,2.13%,0.72%
2020-01-01 00:18:40,16,11,8889,690,8199,13.56%,7.76%
2020-01-01 00:18:40,16,12,24285,4083,20202,37.06%,16.81%
2020-01-01 00:18:50,1,1,15996,1857,14139,24.41%,11.61%
2020-01-01 00:18:50,1,2,5662,238,5424,8.64%,4.20%
2020-01-01 00:18:50,1,3,560,4,556,0.85%,0.71%
2020-01-01 00:18:50,1,4,9958,758,9200,15.19%,7.61%
2020-01-01 00:18:50,1,5,9725,720,9005,14.84%,7.40%
2020-01-01 00:18:50,1,6,9681,709,8972,14.77%,7.32%
2020-01-01 00:18:50,1,7,5083,202,4881,7.76%,3.97%
2020-01-01 00:18:50,1,8,4171,124,4047,6.36%,2.97%
2020-01-01 00:18:50,1,9,9637,704,8933,14.70%,7.31%
2020-01-01 00:18:50,1,10,3501,88,3413,5.34%,2.51%
2020-01-01 00:18:50,1,11,3599,90,3509,5.49%,2.50%
2020-01-01 00:18:50,1,12,9603,700,8903,14.65%,7.29%
2020-01-01 00:18:50,2,1,794,2,792,1.21%,0.25%
2020-01-01 00:18:50,2,2,30368,6014,24354,46.34%,19.80%
2020-01-01 00:18:50,2,3,25825,4526,21299,39.41%,17.53%
2020-01-01 00:18:50,2,4,706,2,704,1.08%,0.28%
2020-01-01 00:18:50,2,5,17640,2178,15462,26.92%,12.35%
2020-01-01 00:18:50,2,6,19,0,19,0.03%,0.00%
2020-01-01 00:18:50,2,7,3733,110,3623,5.70%,2.95%
2020-01-01 00:18:50,2,8,2918,80,2838,4.45%,2.74%
2020-01-01 00:18:50,2,9,17528,2160,15368,26.75%,12.32%
2020-01-01 00:18:50,2,10,2044,48,1996,3.12%,2.35%
2020-01-01 00:18:50,2,11,2171,50,2121,3.31%,2.30%
2020-01-01 00:18:50,2,12,17376,2115,15261,26.51%,12.17%
2020-01-01 00:18:50,3,1,1906,10,1896,2.91%,0.52%
2020-01-01 00:18:50,3,2,22999,3613,19386,35.09%,15.71%
2020-01-01 00:18:50,3,3,69639,26734,42905,106.26%,38.39%
2020-01-01 00:18:50,3,4,13488,1296,12192,20.58%,9.61%
2020-01-01 00:18:50,3,5,45558,12675,32883,69.52%,27.82%
2020-01-01 00:18:50,3,6,15078,1612,13466,23.01%,10.69%
2020-01-01 00:18:50,3,7,18943,2494,16449,28.90%,13.17%
2020-01-01 00:18:50,3,8,15937,1790,14147,24.32%,11.23%
2020-01-01 00:18:50,3,9,30017,5925,24092,45.80%,19.74%
2020-01-01 00:18:50,3,10,3356,91,3265,5.12%,2.71%
2020-01-01 00:18:50,3,11,2414,45,2369,3.68%,1.86%
2020-01-01 00:18:50,3,12,24258,3951,20307,37.01%,16.29%
2020-01-01 00:18:50,4,1,454,2,452,0.69%,0.44%
2020-01-01 00:18:50,4,2,294,1,293,0.45%,0.34%
2020-01-01 00:18:50,4,3,1143,13,1130,1.74%,1.14%
2020-01-01 00:18:50,4,4,27332,4994,22338,41.71%,18.27%
2020-01-01 00:18:50,4,5,17881,2257,15624,27.28%,12.62%
2020-01-01 00:18:50,4,6,23719,3841,19878,36.19%,16.19%
2020-01-01 00:18:50,4,7,4402,150,4252,6.72%,3.41%
2020-01-01 00:18:50,4,8,3009,63,2946,4.59%,2.09%
2020-01-01 00:18:50,4,9,15727,1779,13948,24.00%,11.31%
2020-01-01 00:18:50,4,10,1902,39,1863,2.90%,2.05%
2020-01-01 00:18:50,4,11,177,0,177,0.27%,0.00%
2020-01-01 00:18:50,4,12,13093,1235,11858,19.98%,9.43%
2020-01-01 00:18:50,5,1,2331,29,2302,3.56%,1.24%
2020-01-01 00:18:50,5,2,726,3,723,1.11%,0.41%
2020-01-01 00:18:50,5,3,566,1,565,0.86%,0.18%
2020-01-01 00:18:50,5,4,21871,3232,18639,33.37%,14.78%
2020-01-01 00:18:50,5,5,9459,647,8812,14.43%,6.84%
2020-01-01 00:18:50,5,6,14481,1521,12960,22.10%,10.50%
2020-01-01 00:18:50,5,7,4507,175,4332,6.88%,3.88%
2020-01-01 00:18:50,5,8,3438,93,3345,5.25%,2.71%
2020-01-01 00:18:50,5,9,8767,559,8208,13.38%,6.38%
2020-01-01 00:18:50,5,10,1528,19,1509,2.33%,1.24%
2020-01-01 00:18:50,5,11,872,13,859,1.33%,1.49%
2020-01-01 00:18:50,5,12,6565,336,6229,10.02%,5.12%
2020-01-01 00:18:50,6,1,1131,18,1113,1.73%,1.59%
2020-01-01 00:18:50,6,2,1268,20,1248,1.93%,1.58%
2020-01-01 00:18:50,6,3,3233,84,3149,4.93%,2.60%
2020-01-01 00:18:50,6,4,1433,28,1405,2.19%,1.95%
2020-01-01 00:18:50,6,5,18580,2499,16081,28.35%,13.45%
2020-01-01 00:18:50,6,6,5445,277,5168,8.31%,5.09%
2020-01-01 00:18:50,6,7,3520,137,3383,5.37%,3.89%
2020-01-01 00:18:50,6,8,2887,105,2782,4.41%,3.64%
2020-01-01 00:18:50,6,9,9682,726,8956,14.77%,7.50%
2020-01-01 00:18:50,6,10,2218,37,2181,3.38%,1.67%
2020-01-01 00:18:50,6,11,556,1,555,0.85%,0.18%
2020-01-01 00:18:50,6,12,7390,430,6960,11.28%,5.82%
2020-01-01 00:18:50,7,1,365,2,363,0.56%,0.55%
2020-01-01 00:18:50,7,2,236,0,236,0.36%,0.00%
2020-01-01 00:18:50,7,3,1692,19,1673,2.58%,1.12%
2020-01-01 00:18:50,7,4,1624,18,1606,2.48%,1.11%
2020-01-01 00:18:50,7,5,7494,401,7093,11.43%,5.35%
2020-01-01 00:18:50,7,6,12972,1230,11742,19.79%,9.48%
2020-01-01 00:18:50,7,7,3827,99,3728,5.84%,2.59%
2020-01-01 00:18:50,7,8,1159,12,1147,1.77%,1.04%
2020-01-01 00:18:50,7,9,5732,238,5494,8.75%,4.15%
2020-01-01 00:18:50,7,10,1297,7,1290,1.98%,0.54%
2020-01-01 00:18:50,7,11,75,0,75,0.11%,0.00%
2020-01-01 00:18:50,7,12,4445,141,4304,6.78%,3.17%
2020-01-01 00:18:50,8,1,379,0,379,0.58%,0.00%
2020-01-01 00:18:50,8,2,59,0,59,0.09%,0.00%
2020-01-01 00:18:50,8,3,1415,18,1397,2.16%,1.27%
2020-01-01 00:18:50,8,4,2699,47,2652,4.12%,1.74%
2020-01-01 00:18:50,8,5,7851,475,7376,11.98%,6.05%
2020-01-01 00:18:50,8,6,15834,1877,13957,24.16%,11.85%
2020-01-01 00:18:50,8,7,5136,197,4939,7.84%,3.84%
2020-01-01 00:18:50,8,8,1651,26,1625,2.52%,1.57%
2020-01-01 00:18:50,8,9,6140,296,5844,9.37%,4.82%
2020-01-01 00:18:50,8,10,1907,32,1875,2.91%,1.68%
2020-01-01 00:18:50,8,11,374,1,373,0.57%,0.27%
2020-01-01 00:18:50,8,12,4029,131,3898,6.15%,3.25%
2020-01-01 00:18:50,9,1,377,0,377,0.58%,0.00%
2020-01-01 00:18:50,9,2,2934,75,2859,4.48%,2.56%
2020-01-01 00:18:50,9,3,2015,32,1983,3.07%,1.59%
2020-01-01 00:18:50,9,4,7877,446,7431,12.02%,5.66%
2020-01-01 00:18:50,9,5,258,1,257,0.39%,0.39%
2020-01-01 00:18:50,9,6,8368,514,7854,12.77%,6.14%
2020-01-01 00:18:50,9,7,28820,5399,23421,43.98%,18.73%
2020-01-01 00:18:50,9,8,11759,882,10877,17.94%,7.50%
2020-01-01 00:18:50,9,9,222,1,221,0.34%,0.45%
2020-01-01 00:18:50,9,10,3902,109,3793,5.95%,2.79%
2020-01-01 00:18:50,9,11,10129,651,9478,15.46%,6.43%
2020-01-01 00:18:50,9,12,5983,244,5739,9.13%,4.08%
2020-01-01 00:18:50,10,1,1035,266,769,1.58%,25.70%
2020-01-01 00:18:50,10,2,3116,339,2777,4.75%,10.88%
2020-01-01 00:18:50,10,3,1934,35,1899,2.95%,1.81%
2020-01-01 00:18:50,10,4,4351,1096,3255,6.64%,25.19%
2020-01-01 00:18:50,10,5,559,1,558,0.85%,0.18%
2020-01-01 00:18:50,10,6,6435,1236,5199,9.82%,19.21%
2020-01-01 00:18:50,10,7,11445,2044,9401,17.46%,17.86%
2020-01-01 00:18:50,10,8,27737,7079,20658,42.32%,25.52%
2020-01-01 00:18:50,10,9,597,4,593,0.91%,0.67%
2020-01-01 00:18:50,10,10,2372,54,2318,3.62%,2.28%
2020-01-01 00:18:50,10,11,12134,1533,10601,18.52%,12.63%
2020-01-01 00:18:50,10,12,9122,1066,8056,13.92%,11.69%
2020-01-01 00:18:50,11,1,2354,34,2320,3.59%,1.44%
2020-01-01 00:18:50,11,2,3849,122,3727,5.87%,3.17%
2020-01-01 00:18:50,11,3,1325,13,1312,2.02%,0.98%
2020-01-01 00:18:50,11,4,3819,135,3684,5.83%,3.53%
2020-01-01 00:18:50,11,5,333,1,332,0.51%,0.30%
2020-01-01 00:18:50,11,6,4819,216,4603,7.35%,4.48%
2020-01-01 00:18:50,11,7,10385,829,9556,15.85%,7.98%
2020-01-01 00:18:50,11,8,33591,7423,26168,51.26%,22.10%
2020-01-01 00:18:50,11,9,289,1,288,0.44%,0.35%
2020-01-01 00:18:50,11,10,3403,94,3309,5.19%,2.76%
2020-01-01 00:18:50,11,11,19603,2755,16848,29.91%,14.05%
2020-01-01 00:18:50,11,12,15900,1816,14084,24.26%,11.42%
2020-01-01 00:18:50,12,1,48,0,48,0.07%,0.00%
2020-01-01 00:18:50,12,2,670,269,401,1.02%,40.15%
2020-01-01 00:18:50,12,3,2451,301,2150,3.74%,12.28%
2020-01-01 00:18:50,12,4,2889,48,2841,4.41%,1.66%
2020-01-01 00:18:50,12,5,8702,786,7916,13.28%,9.03%
2020-01-01 00:18:50,12,6,5329,233,5096,8.13%,4.37%
2020-01-01 00:18:50,12,7,2324,61,2263,3.55%,2.62%
2020-01-01 00:18:50,12,8,1382,241,1141,2.11%,17.44%
2020-01-01 00:18:50,12,9,23836,4932,18904,36.37%,20.69%
2020-01-01 00:18:50,12,10,4133,322,3811,6.31%,7.79%
2020-01-01 00:18:50,12,11,1605,243,1362,2.45%,15.14%
2020-01-01 00:18:50,12,12,8554,1184,7370,13.05%,13.84%
2020-01-01 00:18:50,13,1,2260,42,2218,3.45%,1.86%
2020-01-01 00:18:50,13,2,2670,51,2619,4.07%,1.91%
2020-01-01 00:18:50,13,3,818,10,808,1.25%,1.22%
2020-01-01 00:18:50,13,4,4449,406,4043,6.79%,9.13%
2020-01-01 00:18:50,13,5,6738,678,6060,10.28%,10.06%
2020-01-01 00:18:50,13,6,5166,450,4716,7.88%,8.71%
2020-01-01 00:18:50,13,7,5049,200,4849,7.70%,3.96%
2020-01-01 00:18:50,13,8,6671,348,6323,10.18%,5.22%
2020-01-01 00:18:50,13,9,7244,718,6526,11.05%,9.91%
2020-01-01 00:18:50,13,10,26055,5044,21011,39.76%,19.36%
2020-01-01 00:18:50,13,11,16028,2050,13978,24.46%,12.79%
2020-01-01 00:18:50,13,12,8888,862,8026,13.56%,9.70%
2020-01-01 00:18:50,14,1,429,3,426,0.65%,0.70%
2020-01-01 00:18:50,14,2,1655,14,1641,2.53%,0.85%
2020-01-01 00:18:50,14,3,1030,7,1023,1.57%,0.68%
2020-01-01 00:18:50,14,4,5016,193,4823,7.65%,3.85%
2020-01-01 00:18:50,14,5,1649,17,1632,2.52%,1.03%
2020-01-01 00:18:50,14,6,5368,222,5146,8.19%,4.14%
2020-01-01 00:18:50,14,7,12183,1022,11161,18.59%,8.39%
2020-01-01 00:18:50,14,8,13362,1197,12165,20.39%,8.96%
2020-01-01 00:18:50,14,9,1906,21,1885,2.91%,1.10%
2020-01-01 00:18:50,14,10,4576,144,4432,6.98%,3.15%
2020-01-01 00:18:50,14,11,25237,4145,21092,38.51%,16.42%
2020-01-01 00:18:50,14,12,7032,372,6660,10.73%,5.29%
2020-01-01 00:18:50,15,1,567,0,567,0.87%,0.00%
2020-01-01 00:18:50,15,2,171,0,171,0.26%,0.00%
2020-01-01 00:18:50,15,3,3628,112,3516,5.54%,3.09%
2020-01-01 00:18:50,15,4,4575,150,4425,6.98%,3.28%
2020-01-01 00:18:50,15,5,10004,748,9256,15.26%,7.48%
2020-01-01 00:18:50,15,6,4747,160,4587,7.24%,3.37%
2020-01-01 00:18:50,15,7,3872,115,3757,5.91%,2.97%
2020-01-01 00:18:50,15,8,5508,230,5278,8.40%,4.18%
2020-01-01 00:18:50,15,9,10151,765,9386,15.49%,7.54%
2020-01-01 00:18:50,15,10,4851,199,4652,7.40%,4.10%
2020-01-01 00:18:50,15,11,10466,837,9629,15.97%,8.00%
2020-01-01 00:18:50,15,12,26359,5035,21324,40.22%,19.10%
2020-01-01 00:18:50,16,1,536,1,535,0.82%,0.19%
2020-01-01 00:18:50,16,2,210,2,208,0.32%,0.95%
2020-01-01 00:18:50,16,3,1094,9,1085,1.67%,0.82%
2020-01-01 00:18:50,16,4,4236,212,4024,6.46%,5.00%
2020-01-01 00:18:50,16,5,8073,642,7431,12.32%,7.95%
2020-01-01 00:18:50,16,6,5506,298,5208,8.40%,5.41%
2020-01-01 00:18:50,16,7,3367,78,3289,5.14%,2.32%
2020-01-01 00:18:50,16,8,6996,342,6654,10.68%,4.89%
2020-01-01 00:18:50,16,9,8525,690,7835,13.01%,8.09%
2020-01-01 00:18:50,16,10,1451,10,1441,2.21%,0.69%
2020-01-01 00:18:50,16,11,8677,519,8158,13.24%,5.98%
2020-01-01 00:18:50,16,12,25718,4541,21177,39.24%,17.66%
2020-01-01 00:19:00,1,1,18313,2364,15949,27.94%,12.91%
2020-01-01 00:19:00,1,2,6851,348,6503,10.45%,5.08%
2020-01-01 00:19:00,1,3,684,3,681,1.04%,0.44%
2020-01-01 00:19:00,1,4,10782,907,9875,16.45%,8.41%
2020-01-01 00:19:00,1,5,10367,844,9523,15.82%,8.14%
2020-01-01 00:19:00,1,6,10269,828,9441,15.67%,8.06%
2020-01-01 00:19:00,1,7,6140,287,5853,9.37%,4.67%
2020-01-01 00:19:00,1,8,3707,109,3598,5.66%,2.94%
2020-01-01 00:19:00,1,9,10208,822,9386,15.58%,8.05%
2020-01-01 00:19:00,1,10,3027,72,2955,4.62%,2.38%
2020-01-01 00:19:00,1,11,3177,80,3097,4.85%,2.52%
2020-01-01 00:19:00,1,12,10181,818,9363,15.53%,8.03%
2020-01-01 00:19:00,2,1,2647,45,2602,4.04%,1.70%
2020-01-01 00:19:00,2,2,26945,4818,22127,41.11%,17.88%
2020-01-01 00:19:00,2,3,19917,2755,17162,30.39%,13.83%
2020-01-01 00:19:00,2,4,2532,40,2492,3.86%,1.58%
2020-01-01 00:19:00,2,5,10778,893,9885,16.45%,8.29%
2020-01-01 00:19:00,2,6,53,0,53,0.08%,0.00%
2020-01-01 00:19:00,2,7,4363,125,4238,6.66%,2.87%
2020-01-01 00:19:00,2,8,3334,68,3266,5.09%,2.04%
2020-01-01 00:19:00,2,9,10714,880,9834,16.35%,8.21%
2020-01-01 00:19:00,2,10,2402,38,2364,3.67%,1.58%
2020-01-01 00:19:00,2,11,2419,38,2381,3.69%,1.57%
2020-01-01 00:19:00,2,12,10527,850,9677,16.06%,8.07%
2020-01-01 00:19:00,3,1,1407,19,1388,2.15%,1.35%
2020-01-01 00:19:00,3,2,23120,3514,19606,35.28%,15.20%
2020-01-01 00:19:00,3,3,78462,32684,45778,119.72%,41.66%
2020-01-01 00:19:00,3,4,12782,1110,11672,19.50%,8.68%
2020-01-01 00:19:00,3,5,52901,16644,36257,80.72%,31.46%
2020-01-01 00:19:00,3,6,14267,1397,12870,21.77%,9.79%
2020-01-01 00:19:00,3,7,19995,2660,17335,30.51%,13.30%
2020-01-01 00:19:00,3,8,16620,1895,14725,25.36%,11.40%
2020-01-01 00:19:00,3,9,38292,9394,28898,58.43%,24.53%
2020-01-01 00:19:00,3,10,9381,624,8757,14.31%,6.65%
2020-01-01 00:19:00,3,11,1839,18,1821,2.81%,0.98%
2020-01-01 00:19:00,3,12,24728,4128,20600,37.73%,16.69%
2020-01-01 00:19:00,4,1,594,2,592,0.91%,0.34%
2020-01-01 00:19:00,4,2,374,2,372,0.57%,0.53%
2020-01-01 00:19:00,4,3,990,6,984,1.51%,0.61%
2020-01-01 00:19:00,4,4,27960,5163,22797,42.66%,18.47%
2020-01-01 00:19:00,4,5,17317,2092,15225,26.42%,12.08%
2020-01-01 00:19:00,4,6,23748,3822,19926,36.24%,16.09%
2020-01-01 00:19:00,4,7,4987,172,4815,7.61%,3.45%
2020-01-01 00:19:00,4,8,2991,57,2934,4.56%,1.91%
2020-01-01 00:19:00,4,9,15395,1668,13727,23.49%,10.83%
2020-01-01 00:19:00,4,10,2105,28,2077,3.21%,1.33%
2020-01-01 00:19:00,4,11,189,0,189,0.29%,0.00%
2020-01-01 00:19:00,4,12,12358,1129,11229,18.86%,9.14%
2020-01-01 00:19:00,5,1,2888,64,2824,4.41%,2.22%
2020-01-01 00:19:00,5,2,759,4,755,1.16%,0.53%
2020-01-01 00:19:00,5,3,2050,28,2022,3.13%,1.37%
2020-01-01 00:19:00,5,4,24307,4020,20287,37.09%,16.54%
2020-01-01 00:19:00,5,5,11138,909,10229,17.00%,8.16%
2020-01-01 00:19:00,5,6,16880,2036,14844,25.76%,12.06%
2020-01-01 00:19:00,5,7,4911,191,4720,7.49%,3.89%
2020-01-01 00:19:00,5,8,3676,94,3582,5.61%,2.56%
2020-01-01 00:19:00,5,9,8885,591,8294,13.56%,6.65%
2020-01-01 00:19:00,5,10,1091,12,1079,1.66%,1.10%
2020-01-01 00:19:00,5,11,600,6,594,0.92%,1.00%
2020-01-01 00:19:00,5,12,7498,421,7077,11.44%,5.61%
2020-01-01 00:19:00,6,1,1199,20,1179,1.83%,1.67%
2020-01-01 00:19:00,6,2,1281,23,1258,1.95%,1.80%
2020-01-01 00:19:00,6,3,1883,35,1848,2.87%,1.86%
2020-01-01 00:19:00,6,4,1746,24,1722,2.66%,1.37%
2020-01-01 00:19:00,6,5,14043,1413,12630,21.43%,10.06%
2020-01-01 00:19:00,6,6,4163,142,4021,6.35%,3.41%
2020-01-01 00:19:00,6,7,1845,43,1802,2.82%,2.33%
2020-01-01 00:19:00,6,8,1339,29,1310,2.04%,2.17%
2020-01-01 00:19:00,6,9,7617,435,7182,11.62%,5.71%
2020-01-01 00:19:00,6,10,1868,29,1839,2.85%,1.55%
2020-01-01 00:19:00,6,11,524,5,519,0.80%,0.95%
2020-01-01 00:19:00,6,12,5639,247,5392,8.60%,4.38%
2020-01-01 00:19:00,7,1,388,6,382,0.59%,1.55%
2020-01-01 00:19:00,7,2,156,1,155,0.24%,0.64%
2020-01-01 00:19:00,7,3,731,1,730,1.12%,0.14%
2020-01-01 00:19:00,7,4,2401,58,2343,3.66%,2.42%
2020-01-01 00:19:00,7,5,7482,400,7082,11.42%,5.35%
2020-01-01 00:19:00,7,6,13336,1269,12067,20.35%,9.52%
2020-01-01 00:19:00,7,7,3404,101,3303,5.19%,2.97%
2020-01-01 00:19:00,7,8,1306,20,1286,1.99%,1.53%
2020-01-01 00:19:00,7,9,6285,286,5999,9.59%,4.55%
2020-01-01 00:19:00,7,10,997,4,993,1.52%,0.40%
2020-01-01 00:19:00,7,11,96,0,96,0.15%,0.00%
2020-01-01 00:19:00,7,12,5240,184,5056,8.00%,3.51%
2020-01-01 00:19:00,8,1,424,1,423,0.65%,0.24%
2020-01-01 00:19:00,8,2,92,0,92,0.14%,0.00%
2020-01-01 00:19:00,8,3,1706,19,1687,2.60%,1.11%
2020-01-01 00:19:00,8,4,3017,66,2951,4.60%,2.19%
2020-01-01 00:19:00,8,5,8484,546,7938,12.95%,6.44%
2020-01-01 00:19:00,8,6,17804,2332,15472,27.17%,13.10%
2020-01-01 00:19:00,8,7,6135,336,5799,9.36%,5.48%
2020-01-01 00:19:00,8,8,2568,55,2513,3.92%,2.14%
2020-01-01 00:19:00,8,9,6572,351,6221,10.03%,5.34%
2020-01-01 00:19:00,8,10,2014,33,1981,3.07%,1.64%
2020-01-01 00:19:00,8,11,83,0,83,0.13%,0.00%
2020-01-01 00:19:00,8,12,4546,169,4377,6.94%,3.72%
2020-01-01 00:19:00,9,1,755,1,754,1.15%,0.13%
2020-01-01 00:19:00,9,2,3237,88,3149,4.94%,2.72%
2020-01-01 00:19:00,9,3,1939,37,1902,2.96%,1.91%
2020-01-01 00:19:00,9,4,4113,134,3979,6.28%,3.26%
2020-01-01 00:19:00,9,5,332,2,330,0.51%,0.60%
2020-01-01 00:19:00,9,6,5271,229,5042,8.04%,4.34%
2020-01-01 00:19:00,9,7,26980,4894,22086,41.17%,18.14%
2020-01-01 00:19:00,9,8,11636,950,10686,17.76%,8.16%
2020-01-01 00:19:00,9,9,147,0,147,0.22%,0.00%
2020-01-01 00:19:00,9,10,4645,176,4469,7.09%,3.79%
2020-01-01 00:19:00,9,11,10584,777,9807,16.15%,7.34%
2020-01-01 00:19:00,9,12,5586,222,5364,8.52%,3.97%
2020-01-01 00:19:00,10,1,1480,285,1195,2.26%,19.26%
2020-01-01 00:19:00,10,2,4543,425,4118,6.93%,9.36%
2020-01-01 00:19:00,10,3,2895,69,2826,4.42%,2.38%
2020-01-01 00:19:00,10,4,4278,1437,2841,6.53%,33.59%
2020-01-01 00:19:00,10,5,617,55,562,0.94%,8.91%
2020-01-01 00:19:00,10,6,6370,1608,4762,9.72%,25.24%
2020-01-01 00:19:00,10,7,12860,2630,10230,19.62%,20.45%
2020-01-01 00:19:00,10,8,31196,8482,22714,47.60%,27.19%
2020-01-01 00:19:00,10,9,722,4,718,1.10%,0.55%
2020-01-01 00:19:00,10,10,2342,44,2298,3.57%,1.88%
2020-01-01 00:19:00,10,11,14216,1969,12247,21.69%,13.85%
2020-01-01 00:19:00,10,12,11195,1448,9747,17.08%,12.93%
2020-01-01 00:19:00,11,1,2538,41,2497,3.87%,1.62%
2020-01-01 00:19:00,11,2,4940,174,4766,7.54%,3.52%
2020-01-01 00:19:00,11,3,2207,32,2175,3.37%,1.45%
2020-01-01 00:19:00,11,4,3485,79,3406,5.32%,2.27%
2020-01-01 00:19:00,11,5,221,0,221,0.34%,0.00%
2020-01-01 00:19:00,11,6,4537,143,4394,6.92%,3.15%
2020-01-01 00:19:00,11,7,11150,959,10191,17.01%,8.60%
2020-01-01 00:19:00,11,8,25398,4408,20990,38.75%,17.36%
2020-01-01 00:19:00,11,9,203,0,203,0.31%,0.00%
2020-01-01 00:19:00,11,10,2724,65,2659,4.16%,2.39%
2020-01-01 00:19:00,11,11,10723,813,9910,16.36%,7.58%
2020-01-01 00:19:00,11,12,7435,412,7023,11.34%,5.54%
2020-01-01 00:19:00,12,1,42,0,42,0.06%,0.00%
2020-01-01 00:19:00,12,2,572,170,402,0.87%,29.72%
2020-01-01 00:19:00,12,3,2890,219,2671,4.41%,7.58%
2020-01-01 00:19:00,12,4,3487,103,3384,5.32%,2.95%
2020-01-01 00:19:00,12,5,8878,768,8110,13.55%,8.65%
2020-01-01 00:19:00,12,6,5185,219,4966,7.91%,4.22%
2020-01-01 00:19:00,12,7,1525,20,1505,2.33%,1.31%
2020-01-01 00:19:00,12,8,1603,330,1273,2.45%,20.59%
2020-01-01 00:19:00,12,9,22842,4620,18222,34.85%,20.23%
2020-01-01 00:19:00,12,10,5647,560,5087,8.62%,9.92%
2020-01-01 00:19:00,12,11,2101,346,1755,3.21%,16.47%
2020-01-01 00:19:00,12,12,6945,1164,5781,10.60%,16.76%
2020-01-01 00:19:00,13,1,2608,56,2552,3.98%,2.15%
2020-01-01 00:19:00,13,2,3024,77,2947,4.61%,2.55%
2020-01-01 00:19:00,13,3,917,7,910,1.40%,0.76%
2020-01-01 00:19:00,13,4,5058,512,4546,7.72%,10.12%
2020-01-01 00:19:00,13,5,7673,916,6757,11.71%,11.94%
2020-01-01 00:19:00,13,6,5794,548,5246,8.84%,9.46%
2020-01-01 00:19:00,13,7,5186,189,4997,7.91%,3.64%
2020-01-01 00:19:00,13,8,7619,413,7206,11.63%,5.42%
2020-01-01 00:19:00,13,9,7989,941,7048,12.19%,11.78%
2020-01-01 00:19:00,13,10,27212,5554,21658,41.52%,20.41%
2020-01-01 00:19:00,13,11,16878,2272,14606,25.75%,13.46%
2020-01-01 00:19:00,13,12,8909,883,8026,13.59%,9.91%
2020-01-01 00:19:00,14,1,168,0,168,0.26%,0.00%
2020-01-01 00:19:00,14,2,1079,8,1071,1.65%,0.74%
2020-01-01 00:19:00,14,3,636,3,633,0.97%,0.47%
2020-01-01 00:19:00,14,4,3985,116,3869,6.08%,2.91%
2020-01-01 00:19:00,14,5,1346,8,1338,2.05%,0.59%
2020-01-01 00:19:00,14,6,4447,155,4292,6.79%,3.49%
2020-01-01 00:19:00,14,7,12038,1045,10993,18.37%,8.68%
2020-01-01 00:19:00,14,8,13519,1297,12222,20.63%,9.59%
2020-01-01 00:19:00,14,9,1710,15,1695,2.61%,0.88%
2020-01-01 00:19:00,14,10,4312,116,4196,6.58%,2.69%
2020-01-01 00:19:00,14,11,26181,4576,21605,39.95%,17.48%
2020-01-01 00:19:00,14,12,7930,442,7488,12.10%,5.57%
2020-01-01 00:19:00,15,1,553,1,552,0.84%,0.18%
2020-01-01 00:19:00,15,2,154,0,154,0.23%,0.00%
2020-01-01 00:19:00,15,3,3997,105,3892,6.10%,2.63%
2020-01-01 00:19:00,15,4,5266,327,4939,8.04%,6.21%
2020-01-01 00:19:00,15,5,10117,827,9290,15.44%,8.17%
2020-01-01 00:19:00,15,6,5488,355,5133,8.37%,6.47%
2020-01-01 00:19:00,15,7,3284,109,3175,5.01%,3.32%
2020-01-01 00:19:00,15,8,5342,229,5113,8.15%,4.29%
2020-01-01 00:19:00,15,9,10440,868,9572,15.93%,8.31%
2020-01-01 00:19:00,15,10,3560,274,3286,5.43%,7.70%
2020-01-01 00:19:00,15,11,8996,781,8215,13.73%,8.68%
2020-01-01 00:19:00,15,12,24891,4677,20214,37.98%,18.79%
2020-01-01 00:19:00,16,1,496,2,494,0.76%,0.40%
2020-01-01 00:19:00,16,2,237,2,235,0.36%,0.84%
2020-01-01 00:19:00,16,3,1859,27,1832,2.84%,1.45%
2020-01-01 00:19:00,16,4,3693,109,3584,5.64%,2.95%
2020-01-01 00:19:00,16,5,7355,436,6919,11.22%,5.93%
2020-01-01 00:19:00,16,6,4651,147,4504,7.10%,3.16%
2020-01-01 00:19:00,16,7,3200,118,3082,4.88%,3.69%
2020-01-01 00:19:00,16,8,6825,469,6356,10.41%,6.87%
2020-01-01 00:19:00,16,9,7805,482,7323,11.91%,6.18%
2020-01-01 00:19:00,16,10,1406,8,1398,2.15%,0.57%
2020-01-01 00:19:00,16,11,8442,650,7792,12.88%,7.70%
2020-01-01 00:19:00,16,12,24059,3988,20071,36.71%,16.58%
2020-01-01 00:19:10,1,1,18741,2567,16174,28.60%,13.70%
2020-01-01 00:19:10,1,2,6388,344,6044,9.75%,5.39%
2020-01-01 00:19:10,1,3,413,1,412,0.63%,0.24%
2020-01-01 00:19:10,1,4,11727,1058,10669,17.89%,9.02%
2020-01-01 00:19:10,1,5,11074,934,10140,16.90%,8.43%
2020-01-01 00:19:10,1,6,10958,915,10043,16.72%,8.35%
2020-01-01 00:19:10,1,7,5953,302,5651,9.08%,5.07%
2020-01-01 00:19:10,1,8,4485,153,4332,6.84%,3.41%
2020-01-01 00:19:10,1,9,10917,907,10010,16.66%,8.31%
2020-01-01 00:19:10,1,10,3918,112,3806,5.98%,2.86%
2020-01-01 00:19:10,1,11,4032,117,3915,6.15%,2.90%
2020-01-01 00:19:10,1,12,10889,904,9985,16.62%,8.30%
2020-01-01 00:19:10,2,1,533,4,529,0.81%,0.75%
2020-01-01 00:19:10,2,2,28292,5382,22910,43.17%,19.02%
2020-01-01 00:19:10,2,3,23076,3636,19440,35.21%,15.76%
2020-01-01 00:19:10,2,4,429,1,428,0.65%,0.23%
2020-01-01 00:19:10,2,5,14659,1539,13120,22.37%,10.50%
2020-01-01 00:19:10,2,6,48,0,48,0.07%,0.00%
2020-01-01 00:19:10,2,7,4669,155,4514,7.12%,3.32%
2020-01-01 00:19:10,2,8,3528,91,3437,5.38%,2.58%
2020-01-01 00:19:10,2,9,14590,1525,13065,22.26%,10.45%
2020-01-01 00:19:10,2,10,2641,48,2593,4.03%,1.82%
2020-01-01 00:19:10,2,11,2657,48,2609,4.05%,1.81%
2020-01-01 00:19:10,2,12,14390,1484,12906,21.96%,10.31%
2020-01-01 00:19:10,3,1,1428,11,1417,2.18%,0.77%
2020-01-01 00:19:10,3,2,20071,2726,17345,30.63%,13.58%
2020-01-01 00:19:10,3,3,71148,27772,43376,108.56%,39.03%
2020-01-01 00:19:10,3,4,9660,662,8998,14.74%,6.85%
2020-01-01 00:19:10,3,5,46361,13112,33249,70.74%,28.28%
2020-01-01 00:19:10,3,6,10606,800,9806,16.18%,7.54%
2020-01-01 00:19:10,3,7,16955,1954,15001,25.87%,11.52%
2020-01-01 00:19:10,3,8,13577,1290,12287,20.72%,9.50%
2020-01-01 00:19:10,3,9,35402,8039,27363,54.02%,22.71%
2020-01-01 00:19:10,3,10,5754,255,5499,8.78%,4.43%
2020-01-01 00:19:10,3,11,1585,17,1568,2.42%,1.07%
2020-01-01 00:19:10,3,12,25154,4316,20838,38.38%,17.16%
2020-01-01 00:19:10,4,1,573,2,571,0.87%,0.35%
2020-01-01 00:19:10,4,2,368,0,368,0.56%,0.00%
2020-01-01 00:19:10,4,3,1062,15,1047,1.62%,1.41%
2020-01-01 00:19:10,4,4,28545,5321,23224,43.56%,18.64%
2020-01-01 00:19:10,4,5,17827,2189,15638,27.20%,12.28%
2020-01-01 00:19:10,4,6,24616,4046,20570,37.56%,16.44%
2020-01-01 00:19:10,4,7,5281,191,5090,8.06%,3.62%
2020-01-01 00:19:10,4,8,3112,69,3043,4.75%,2.22%
2020-01-01 00:19:10,4,9,15561,1709,13852,23.74%,10.98%
2020-01-01 00:19:10,4,10,2027,35,1992,3.09%,1.73%
2020-01-01 00:19:10,4,11,236,0,236,0.36%,0.00%
2020-01-01 00:19:10,4,12,12552,1113,11439,19.15%,8.87%
2020-01-01 00:19:10,5,1,3005,57,2948,4.59%,1.90%
2020-01-01 00:19:10,5,2,881,4,877,1.34%,0.45%
2020-01-01 00:19:10,5,3,590,2,588,0.90%,0.34%
2020-01-01 00:19:10,5,4,22664,3543,19121,34.58%,15.63%
2020-01-01 00:19:10,5,5,9355,672,8683,14.27%,7.18%
2020-01-01 00:19:10,5,6,15440,1784,13656,23.56%,11.55%
2020-01-01 00:19:10,5,7,5415,240,5175,8.26%,4.43%
2020-01-01 00:19:10,5,8,3426,89,3337,5.23%,2.60%
2020-01-01 00:19:10,5,9,8635,569,8066,13.18%,6.59%
2020-01-01 00:19:10,5,10,868,7,861,1.32%,0.81%
2020-01-01 00:19:10,5,11,637,9,628,0.97%,1.41%
2020-01-01 00:19:10,5,12,7373,421,6952,11.25%,5.71%
2020-01-01 00:19:10,6,1,1154,8,1146,1.76%,0.69%
2020-01-01 00:19:10,6,2,1237,9,1228,1.89%,0.73%
2020-01-01 00:19:10,6,3,1694,22,1672,2.58%,1.30%
2020-01-01 00:19:10,6,4,1097,8,1089,1.67%,0.73%
2020-01-01 00:19:10,6,5,14815,1559,13256,22.61%,10.52%
2020-01-01 00:19:10,6,6,5233,185,5048,7.98%,3.54%
2020-01-01 00:19:10,6,7,3665,96,3569,5.59%,2.62%
2020-01-01 00:19:10,6,8,3102,64,3038,4.73%,2.06%
2020-01-01 00:19:10,6,9,7617,450,7167,11.62%,5.91%
2020-01-01 00:19:10,6,10,1878,28,1850,2.87%,1.49%
2020-01-01 00:19:10,6,11,413,0,413,0.63%,0.00%
2020-01-01 00:19:10,6,12,5673,246,5427,8.66%,4.34%
2020-01-01 00:19:10,7,1,434,2,432,0.66%,0.46%
2020-01-01 00:19:10,7,2,135,0,135,0.21%,0.00%
2020-01-01 00:19:10,7,3,1317,12,1305,2.01%,0.91%
2020-01-01 00:19:10,7,4,2649,61,2588,4.04%,2.30%
2020-01-01 00:19:10,7,5,8599,584,8015,13.12%,6.79%
2020-01-01 00:19:10,7,6,14630,1612,13018,22.32%,11.02%
2020-01-01 00:19:10,7,7,3343,109,3234,5.10%,3.26%
2020-01-01 00:19:10,7,8,1477,26,1451,2.25%,1.76%
2020-01-01 00:19:10,7,9,6626,385,6241,10.11%,5.81%
2020-01-01 00:19:10,7,10,1157,17,1140,1.77%,1.47%
2020-01-01 00:19:10,7,11,78,0,78,0.12%,0.00%
2020-01-01 00:19:10,7,12,5441,245,5196,8.30%,4.50%
2020-01-01 00:19:10,8,1,406,1,405,0.62%,0.25%
2020-01-01 00:19:10,8,2,123,0,123,0.19%,0.00%
2020-01-01 00:19:10,8,3,1694,23,1671,2.58%,1.36%
2020-01-01 00:19:10,8,4,2992,64,2928,4.57%,2.14%
2020-01-01 00:19:10,8,5,8614,544,8070,13.14%,6.32%
2020-01-01 00:19:10,8,6,17079,1978,15101,26.06%,11.58%
2020-01-01 00:19:10,8,7,5283,196,5087,8.06%,3.71%
2020-01-01 00:19:10,8,8,2167,39,2128,3.31%,1.80%
2020-01-01 00:19:10,8,9,6739,354,6385,10.28%,5.25%
2020-01-01 00:19:10,8,10,1846,25,1821,2.82%,1.35%
2020-01-01 00:19:10,8,11,79,0,79,0.12%,0.00%
2020-01-01 00:19:10,8,12,4829,194,4635,7.37%,4.02%
2020-01-01 00:19:10,9,1,577,1,576,0.88%,0.17%
2020-01-01 00:19:10,9,2,2281,36,2245,3.48%,1.58%
2020-01-01 00:19:10,9,3,1154,9,1145,1.76%,0.78%
2020-01-01 00:19:10,9,4,7834,449,7385,11.95%,5.73%
2020-01-01 00:19:10,9,5,331,2,329,0.51%,0.60%
2020-01-01 00:19:10,9,6,8890,581,8309,13.57%,6.54%
2020-01-01 00:19:10,9,7,26334,4618,21716,40.18%,17.54%
2020-01-01 00:19:10,9,8,9273,632,8641,14.15%,6.82%
2020-01-01 00:19:10,9,9,160,2,158,0.24%,1.25%
2020-01-01 00:19:10,9,10,2212,35,2177,3.38%,1.58%
2020-01-01 00:19:10,9,11,8202,497,7705,12.52%,6.06%
2020-01-01 00:19:10,9,12,5708,244,5464,8.71%,4.27%
2020-01-01 00:19:10,10,1,1454,287,1167,2.22%,19.74%
2020-01-01 00:19:10,10,2,3103,341,2762,4.73%,10.99%
2020-01-01 00:19:10,10,3,1444,21,1423,2.20%,1.45%
2020-01-01 00:19:10,10,4,4062,1469,2593,6.20%,36.16%
2020-01-01 00:19:10,10,5,580,56,524,0.89%,9.66%
2020-01-01 00:19:10,10,6,5989,1615,4374,9.14%,26.97%
2020-01-01 00:19:10,10,7,10876,2377,8499,16.60%,21.86%
2020-01-01 00:19:10,10,8,29416,7824,21592,44.89%,26.60%
2020-01-01 00:19:10,10,9,815,1,814,1.24%,0.12%
2020-01-01 00:19:10,10,10,2327,42,2285,3.55%,1.80%
2020-01-01 00:19:10,10,11,14932,2136,12796,22.78%,14.30%
2020-01-01 00:19:10,10,12,11750,1552,10198,17.93%,13.21%
2020-01-01 00:19:10,11,1,2422,39,2383,3.70%,1.61%
2020-01-01 00:19:10,11,2,3913,118,3795,5.97%,3.02%
2020-01-01 00:19:10,11,3,1251,13,1238,1.91%,1.04%
2020-01-01 00:19:10,11,4,3109,75,3034,4.74%,2.41%
2020-01-01 00:19:10,11,5,210,4,206,0.32%,1.90%
2020-01-01 00:19:10,11,6,4161,135,4026,6.35%,3.24%
2020-01-01 00:19:10,11,7,10336,820,9516,15.77%,7.93%
2020-01-01 00:19:10,11,8,24296,4062,20234,37.07%,16.72%
2020-01-01 00:19:10,11,9,185,1,184,0.28%,0.54%
2020-01-01 00:19:10,11,10,2945,71,2874,4.49%,2.41%
2020-01-01 00:19:10,11,11,10444,847,9597,15.94%,8.11%
2020-01-01 00:19:10,11,12,7027,381,6646,10.72%,5.42%
2020-01-01 00:19:10,12,1,46,0,46,0.07%,0.00%
2020-01-01 00:19:10,12,2,610,167,443,0.93%,27.38%
2020-01-01 00:19:10,12,3,2552,216,2336,3.89%,8.46%
2020-01-01 00:19:10,12,4,3069,51,3018,4.68%,1.66%
2020-01-01 00:19:10,12,5,7909,630,7279,12.07%,7.97%
2020-01-01 00:19:10,12,6,4566,154,4412,6.97%,3.37%
2020-01-01 00:19:10,12,7,1308,17,1291,2.00%,1.30%
2020-01-01 00:19:10,12,8,1596,343,1253,2.44%,21.49%
2020-01-01 00:19:10,12,9,21878,4456,17422,33.38%,20.37%
2020-01-01 00:19:10,12,10,5399,522,4877,8.24%,9.67%
2020-01-01 00:19:10,12,11,2056,348,1708,3.14%,16.93%
2020-01-01 00:19:10,12,12,7444,1237,6207,11.36%,16.62%
2020-01-01 00:19:10,13,1,2509,42,2467,3.83%,1.67%
2020-01-01 00:19:10,13,2,2838,54,2784,4.33%,1.90%
2020-01-01 00:19:10,13,3,1182,9,1173,1.80%,0.76%
2020-01-01 00:19:10,13,4,5127,502,4625,7.82%,9.79%
2020-01-01 00:19:10,13,5,8031,953,7078,12.25%,11.87%
2020-01-01 00:19:10,13,6,5849,552,5297,8.92%,9.44%
2020-01-01 00:19:10,13,7,5168,202,4966,7.89%,3.91%
2020-01-01 00:19:10,13,8,7492,409,7083,11.43%,5.46%
2020-01-01 00:19:10,13,9,8311,984,7327,12.68%,11.84%
2020-01-01 00:19:10,13,10,29173,6265,22908,44.51%,21.48%
2020-01-01 00:19:10,13,11,17640,2538,15102,26.92%,14.39%
2020-01-01 00:19:10,13,12,9747,1105,8642,14.87%,11.34%
2020-01-01 00:19:10,14,1,185,0,185,0.28%,0.00%
2020-01-01 00:19:10,14,2,1081,6,1075,1.65%,0.56%
2020-01-01 00:19:10,14,3,618,1,617,0.94%,0.16%
2020-01-01 00:19:10,14,4,7194,380,6814,10.98%,5.28%
2020-01-01 00:19:10,14,5,1367,12,1355,2.09%,0.88%
2020-01-01 00:19:10,14,6,7594,424,7170,11.59%,5.58%
2020-01-01 00:19:10,14,7,14909,1591,13318,22.75%,10.67%
2020-01-01 00:19:10,14,8,16254,1848,14406,24.80%,11.37%
2020-01-01 00:19:10,14,9,1773,20,1753,2.71%,1.13%
2020-01-01 00:19:10,14,10,4422,152,4270,6.75%,3.44%
2020-01-01 00:19:10,14,11,32544,6904,25640,49.66%,21.21%
2020-01-01 00:19:10,14,12,11444,964,10480,17.46%,8.42%
2020-01-01 00:19:10,15,1,496,8,488,0.76%,1.61%
2020-01-01 00:19:10,15,2,171,0,171,0.26%,0.00%
2020-01-01 00:19:10,15,3,3808,111,3697,5.81%,2.91%
2020-01-01 00:19:10,15,4,5569,255,5314,8.50%,4.58%
2020-01-01 00:19:10,15,5,10075,778,9297,15.37%,7.72%
2020-01-01 00:19:10,15,6,5763,272,5491,8.79%,4.72%
2020-01-01 00:19:10,15,7,2998,79,2919,4.57%,2.64%
2020-01-01 00:19:10,15,8,5458,247,5211,8.33%,4.53%
2020-01-01 00:19:10,15,9,10383,822,9561,15.84%,7.92%
2020-01-01 00:19:10,15,10,3313,268,3045,5.06%,8.09%
2020-01-01 00:19:10,15,11,8856,752,8104,13.51%,8.49%
2020-01-01 00:19:10,15,12,24699,4653,20046,37.69%,18.84%
2020-01-01 00:19:10,16,1,451,1,450,0.69%,0.22%
2020-01-01 00:19:10,16,2,259,0,259,0.40%,0.00%
2020-01-01 00:19:10,16,3,1976,26,1950,3.02%,1.32%
2020-01-01 00:19:10,16,4,5013,194,4819,7.65%,3.87%
2020-01-01 00:19:10,16,5,8588,595,7993,13.10%,6.93%
2020-01-01 00:19:10,16,6,5774,254,5520,8.81%,4.40%
2020-01-01 00:19:10,16,7,3219,92,3127,4.91%,2.86%
2020-01-01 00:19:10,16,8,7259,506,6753,11.08%,6.97%
2020-01-01 00:19:10,16,9,9047,650,8397,13.80%,7.18%
2020-01-01 00:19:10,16,10,1451,21,1430,2.21%,1.45%
2020-01-01 00:19:10,16,11,8951,693,8258,13.66%,7.74%
2020-01-01 00:19:10,16,12,25707,4598,21109,39.23%,17.89%
2020-01-01 00:19:20,1,1,19899,2798,17101,30.36%,14.06%
2020-01-01 00:19:20,1,2,7599,403,7196,11.60%,5.30%
2020-01-01 00:19:20,1,3,327,2,325,0.50%,0.61%
2020-01-01 00:19:20,1,4,11767,1077,10690,17.96%,9.15%
2020-01-01 00:19:20,1,5,11225,991,10234,17.13%,8.83%
2020-01-01 00:19:20,1,6,11168,979,10189,17.04%,8.77%
2020-01-01 00:19:20,1,7,7257,361,6896,11.07%,4.97%
2020-01-01 00:19:20,1,8,6492,284,6208,9.91%,4.37%
2020-01-01 00:19:20,1,9,11138,975,10163,17.00%,8.75%
2020-01-01 00:19:20,1,10,5995,234,5761,9.15%,3.90%
2020-01-01 00:19:20,1,11,6112,243,5869,9.33%,3.98%
2020-01-01 00:19:20,1,12,11107,969,10138,16.95%,8.72%
2020-01-01 00:19:20,2,1,689,2,687,1.05%,0.29%
2020-01-01 00:19:20,2,2,24983,4132,20851,38.12%,16.54%
2020-01-01 00:19:20,2,3,20597,2876,17721,31.43%,13.96%
2020-01-01 00:19:20,2,4,628,2,626,0.96%,0.32%
2020-01-01 00:19:20,2,5,11750,964,10786,17.93%,8.20%
2020-01-01 00:19:20,2,6,52,0,52,0.08%,0.00%
2020-01-01 00:19:20,2,7,3688,98,3590,5.63%,2.66%
2020-01-01 00:19:20,2,8,2320,34,2286,3.54%,1.47%
2020-01-01 00:19:20,2,9,11687,953,10734,17.83%,8.15%
2020-01-01 00:19:20,2,10,1495,18,1477,2.28%,1.20%
2020-01-01 00:19:20,2,11,1524,19,1505,2.33%,1.25%
2020-01-01 00:19:20,2,12,11531,926,10605,17.59%,8.03%
2020-01-01 00:19:20,3,1,1203,7,1196,1.84%,0.58%
2020-01-01 00:19:20,3,2,25593,4323,21270,39.05%,16.89%
2020-01-01 00:19:20,3,3,70334,27088,43246,107.32%,38.51%
2020-01-01 00:19:20,3,4,9029,633,8396,13.78%,7.01%
2020-01-01 00:19:20,3,5,42052,11004,31048,64.17%,26.17%
2020-01-01 00:19:20,3,6,10105,775,9330,15.42%,7.67%
2020-01-01 00:19:20,3,7,19557,2678,16879,29.84%,13.69%
2020-01-01 00:19:20,3,8,16840,2035,14805,25.70%,12.08%
2020-01-01 00:19:20,3,9,31611,6407,25204,48.23%,20.27%
2020-01-01 00:19:20,3,10,5282,203,5079,8.06%,3.84%
2020-01-01 00:19:20,3,11,2099,37,2062,3.20%,1.76%
2020-01-01 00:19:20,3,12,22924,3507,19417,34.98%,15.30%
2020-01-01 00:19:20,4,1,572,3,569,0.87%,0.52%
2020-01-01 00:19:20,4,2,378,3,375,0.58%,0.79%
2020-01-01 00:19:20,4,3,1305,12,1293,1.99%,0.92%
2020-01-01 00:19:20,4,4,27902,5199,22703,42.58%,18.63%
2020-01-01 00:19:20,4,5,17242,2151,15091,26.31%,12.48%
2020-01-01 00:19:20,4,6,23644,3809,19835,36.08%,16.11%
2020-01-01 00:19:20,4,7,5112,190,4922,7.80%,3.72%
2020-01-01 00:19:20,4,8,3133,64,3069,4.78%,2.04%
2020-01-01 00:19:20,4,9,14707,1583,13124,22.44%,10.76%
2020-01-01 00:19:20,4,10,1913,40,1873,2.92%,2.09%
2020-01-01 00:19:20,4,11,222,1,221,0.34%,0.45%
2020-01-01 00:19:20,4,12,12131,1065,11066,18.51%,8.78%
2020-01-01 00:19:20,5,1,2142,42,2100,3.27%,1.96%
2020-01-01 00:19:20,5,2,624,2,622,0.95%,0.32%
2020-01-01 00:19:20,5,3,1640,12,1628,2.50%,0.73%
2020-01-01 00:19:20,5,4,22930,3605,19325,34.99%,15.72%
2020-01-01 00:19:20,5,5,9027,599,8428,13.77%,6.64%
2020-01-01 00:19:20,5,6,13905,1424,12481,21.22%,10.24%
2020-01-01 00:19:20,5,7,4495,175,4320,6.86%,3.89%
2020-01-01 00:19:20,5,8,3539,117,3422,5.40%,3.31%
2020-01-01 00:19:20,5,9,7218,386,6832,11.01%,5.35%
2020-01-01 00:19:20,5,10,955,3,952,1.46%,0.31%
2020-01-01 00:19:20,5,11,500,8,492,0.76%,1.60%
2020-01-01 00:19:20,5,12,6039,275,5764,9.21%,4.55%
2020-01-01 00:19:20,6,1,1112,12,1100,1.70%,1.08%
2020-01-01 00:19:20,6,2,1158,13,1145,1.77%,1.12%
2020-01-01 00:19:20,6,3,2049,34,2015,3.13%,1.66%
2020-01-01 00:19:20,6,4,1678,24,1654,2.56%,1.43%
2020-01-01 00:19:20,6,5,12688,1173,11515,19.36%,9.24%
2020-01-01 00:19:20,6,6,4518,180,4338,6.89%,3.98%
2020-01-01 00:19:20,6,7,2251,45,2206,3.43%,2.00%
2020-01-01 00:19:20,6,8,1764,32,1732,2.69%,1.81%
2020-01-01 00:19:20,6,9,5862,245,5617,8.94%,4.18%
2020-01-01 00:19:20,6,10,1826,21,1805,2.79%,1.15%
2020-01-01 00:19:20,6,11,438,2,436,0.67%,0.46%
2020-01-01 00:19:20,6,12,3991,111,3880,6.09%,2.78%
2020-01-01 00:19:20,7,1,404,1,403,0.62%,0.25%
2020-01-01 00:19:20,7,2,131,0,131,0.20%,0.00%
2020-01-01 00:19:20,7,3,617,5,612,0.94%,0.81%
2020-01-01 00:19:20,7,4,2933,71,2862,4.48%,2.42%
2020-01-01 00:19:20,7,5,6415,264,6151,9.79%,4.12%
2020-01-01 00:19:20,7,6,12867,1214,11653,19.63%,9.43%
2020-01-01 00:19:20,7,7,3457,76,3381,5.27%,2.20%
2020-01-01 00:19:20,7,8,1407,13,1394,2.15%,0.92%
2020-01-01 00:19:20,7,9,5671,209,5462,8.65%,3.69%
2020-01-01 00:19:20,7,10,938,5,933,1.43%,0.53%
2020-01-01 00:19:20,7,11,104,1,103,0.16%,0.96%
2020-01-01 00:19:20,7,12,4734,151,4583,7.22%,3.19%
2020-01-01 00:19:20,8,1,669,6,663,1.02%,0.90%
2020-01-01 00:19:20,8,2,66,0,66,0.10%,0.00%
2020-01-01 00:19:20,8,3,1673,10,1663,2.55%,0.60%
2020-01-01 00:19:20,8,4,3211,89,3122,4.90%,2.77%
2020-01-01 00:19:20,8,5,8276,485,7791,12.63%,5.86%
2020-01-01 00:19:20,8,6,16329,1899,14430,24.92%,11.63%
2020-01-01 00:19:20,8,7,4681,160,4521,7.14%,3.42%
2020-01-01 00:19:20,8,8,1991,25,1966,3.04%,1.26%
2020-01-01 00:19:20,8,9,6390,296,6094,9.75%,4.63%
2020-01-01 00:19:20,8,10,1778,32,1746,2.71%,1.80%
2020-01-01 00:19:20,8,11,106,0,106,0.16%,0.00%
2020-01-01 00:19:20,8,12,4611,152,4459,7.04%,3.30%
2020-01-01 00:19:20,9,1,449,0,449,0.69%,0.00%
2020-01-01 00:19:20,9,2,1901,24,1877,2.90%,1.26%
2020-01-01 00:19:20,9,3,1101,8,1093,1.68%,0.73%
2020-01-01 00:19:20,9,4,24521,4067,20454,37.42%,16.59%
2020-01-01 00:19:20,9,5,420,2,418,0.64%,0.48%
2020-01-01 00:19:20,9,6,26153,4576,21577,39.91%,17.50%
2020-01-01 00:19:20,9,7,45533,12624,32909,69.48%,27.72%
2020-01-01 00:19:20,9,8,11375,963,10412,17.36%,8.47%
2020-01-01 00:19:20,9,9,233,0,233,0.36%,0.00%
2020-01-01 00:19:20,9,10,3204,53,3151,4.89%,1.65%
2020-01-01 00:19:20,9,11,10377,784,9593,15.83%,7.56%
2020-01-01 00:19:20,9,12,6794,334,6460,10.37%,4.92%
2020-01-01 00:19:20,10,1,1391,274,1117,2.12%,19.70%
2020-01-01 00:19:20,10,2,3525,331,3194,5.38%,9.39%
2020-01-01 00:19:20,10,3,2005,22,1983,3.06%,1.10%
2020-01-01 00:19:20,10,4,4506,1070,3436,6.88%,23.75%
2020-01-01 00:19:20,10,5,930,111,819,1.42%,11.94%
2020-01-01 00:19:20,10,6,6241,1280,4961,9.52%,20.51%
2020-01-01 00:19:20,10,7,10974,2049,8925,16.74%,18.67%
2020-01-01 00:19:20,10,8,28598,7241,21357,43.64%,25.32%
2020-01-01 00:19:20,10,9,403,1,402,0.61%,0.25%
2020-01-01 00:19:20,10,10,1837,25,1812,2.80%,1.36%
2020-01-01 00:19:20,10,11,12830,1502,11328,19.58%,11.71%
2020-01-01 00:19:20,10,12,10296,1103,9193,15.71%,10.71%
2020-01-01 00:19:20,11,1,1913,25,1888,2.92%,1.31%
2020-01-01 00:19:20,11,2,2771,68,2703,4.23%,2.45%
2020-01-01 00:19:20,11,3,708,4,704,1.08%,0.56%
2020-01-01 00:19:20,11,4,3082,64,3018,4.70%,2.08%
2020-01-01 00:19:20,11,5,258,1,257,0.39%,0.39%
2020-01-01 00:19:20,11,6,4237,135,4102,6.47%,3.19%
2020-01-01 00:19:20,11,7,8843,533,8310,13.49%,6.03%
2020-01-01 00:19:20,11,8,23192,3630,19562,35.39%,15.65%
2020-01-01 00:19:20,11,9,266,0,266,0.41%,0.00%
2020-01-01 00:19:20,11,10,2851,57,2794,4.35%,2.00%
2020-01-01 00:19:20,11,11,9977,737,9240,15.22%,7.39%
2020-01-01 00:19:20,11,12,6669,321,6348,10.18%,4.81%
2020-01-01 00:19:20,12,1,157,1,156,0.24%,0.64%
2020-01-01 00:19:20,12,2,529,114,415,0.81%,21.55%
2020-01-01 00:19:20,12,3,2427,152,2275,3.70%,6.26%
2020-01-01 00:19:20,12,4,2849,53,2796,4.35%,1.86%
2020-01-01 00:19:20,12,5,7579,508,7071,11.56%,6.70%
2020-01-01 00:19:20,12,6,4468,157,4311,6.82%,3.51%
2020-01-01 00:19:20,12,7,1473,14,1459,2.25%,0.95%
2020-01-01 00:19:20,12,8,1391,330,1061,2.12%,23.72%
2020-01-01 00:19:20,12,9,20507,3924,16583,31.29%,19.13%
2020-01-01 00:19:20,12,10,4814,471,4343,7.35%,9.78%
2020-01-01 00:19:20,12,11,1718,343,1375,2.62%,19.97%
2020-01-01 00:19:20,12,12,7536,1364,6172,11.50%,18.10%
2020-01-01 00:19:20,13,1,1846,29,1817,2.82%,1.57%
2020-01-01 00:19:20,13,2,2165,39,2126,3.30%,1.80%
2020-01-01 00:19:20,13,3,824,9,815,1.26%,1.09%
2020-01-01 00:19:20,13,4,5000,676,4324,7.63%,13.52%
2020-01-01 00:19:20,13,5,7466,1033,6433,11.39%,13.84%
2020-01-01 00:19:20,13,6,5783,730,5053,8.82%,12.62%
2020-01-01 00:19:20,13,7,4443,151,4292,6.78%,3.40%
2020-01-01 00:19:20,13,8,6897,380,6517,10.52%,5.51%
2020-01-01 00:19:20,13,9,7826,1073,6753,11.94%,13.71%
2020-01-01 00:19:20,13,10,27549,5907,21642,42.04%,21.44%
2020-01-01 00:19:20,13,11,17462,2536,14926,26.64%,14.52%
2020-01-01 00:19:20,13,12,10233,1092,9141,15.61%,10.67%
2020-01-01 00:19:20,14,1,282,0,282,0.43%,0.00%
2020-01-01 00:19:20,14,2,1846,31,1815,2.82%,1.68%
2020-01-01 00:19:20,14,3,1374,19,1355,2.10%,1.38%
2020-01-01 00:19:20,14,4,2923,73,2850,4.46%,2.50%
2020-01-01 00:19:20,14,5,1240,11,1229,1.89%,0.89%
2020-01-01 00:19:20,14,6,3402,94,3308,5.19%,2.76%
2020-01-01 00:19:20,14,7,11012,877,10135,16.80%,7.96%
2020-01-01 00:19:20,14,8,13089,1209,11880,19.97%,9.24%
2020-01-01 00:19:20,14,9,1419,12,1407,2.17%,0.85%
2020-01-01 00:19:20,14,10,4483,157,4326,6.84%,3.50%
2020-01-01 00:19:20,14,11,25534,4366,21168,38.96%,17.10%
2020-01-01 00:19:20,14,12,7563,439,7124,11.54%,5.80%
2020-01-01 00:19:20,15,1,487,2,485,0.74%,0.41%
2020-01-01 00:19:20,15,2,178,1,177,0.27%,0.56%
2020-01-01 00:19:20,15,3,3581,99,3482,5.46%,2.76%
2020-01-01 00:19:20,15,4,4920,224,4696,7.51%,4.55%
2020-01-01 00:19:20,15,5,9221,714,8507,14.07%,7.74%
2020-01-01 00:19:20,15,6,5184,295,4889,7.91%,5.69%
2020-01-01 00:19:20,15,7,3293,98,3195,5.02%,2.98%
2020-01-01 00:19:20,15,8,4987,211,4776,7.61%,4.23%
2020-01-01 00:19:20,15,9,9432,743,8689,14.39%,7.88%
2020-01-01 00:19:20,15,10,5520,427,5093,8.42%,7.74%
2020-01-01 00:19:20,15,11,10647,1016,9631,16.25%,9.54%
2020-01-01 00:19:20,15,12,25934,5062,20872,39.57%,19.52%
2020-01-01 00:19:20,16,1,369,1,368,0.56%,0.27%
2020-01-01 00:19:20,16,2,238,5,233,0.36%,2.10%
2020-01-01 00:19:20,16,3,3009,64,2945,4.59%,2.13%
2020-01-01 00:19:20,16,4,3863,110,3753,5.89%,2.85%
2020-01-01 00:19:20,16,5,8657,597,8060,13.21%,6.90%
2020-01-01 00:19:20,16,6,4619,148,4471,7.05%,3.20%
2020-01-01 00:19:20,16,7,3159,75,3084,4.82%,2.37%
2020-01-01 00:19:20,16,8,6934,414,6520,10.58%,5.97%
2020-01-01 00:19:20,16,9,9202,664,8538,14.04%,7.22%
2020-01-01 00:19:20,16,10,1459,13,1446,2.23%,0.89%
2020-01-01 00:19:20,16,11,8616,629,7987,13.15%,7.30%
2020-01-01 00:19:20,16,12,25152,4377,20775,38.38%,17.40%
2020-01-01 00:19:30,1,1,20817,3006,17811,31.76%,14.44%
2020-01-01 00:19:30,1,2,8352,504,7848,12.74%,6.03%
2020-01-01 00:19:30,1,3,514,0,514,0.78%,0.00%
2020-01-01 00:19:30,1,4,11884,1009,10875,18.13%,8.49%
2020-01-01 00:19:30,1,5,11362,947,10415,17.34%,8.33%
2020-01-01 00:19:30,1,6,11263,926,10337,17.19%,8.22%
2020-01-01 00:19:30,1,7,7831,441,7390,11.95%,5.63%
2020-01-01 00:19:30,1,8,5027,178,4849,7.67%,3.54%
2020-01-01 00:19:30,1,9,11214,921,10293,17.11%,8.21%
2020-01-01 00:19:30,1,10,4511,138,4373,6.88%,3.06%
2020-01-01 00:19:30,1,11,4604,149,4455,7.03%,3.24%
2020-01-01 00:19:30,1,12,11193,920,10273,17.08%,8.22%
2020-01-01 00:19:30,2,1,730,6,724,1.11%,0.82%
2020-01-01 00:19:30,2,2,30144,5866,24278,46.00%,19.46%
2020-01-01 00:19:30,2,3,25604,4305,21299,39.07%,16.81%
2020-01-01 00:19:30,2,4,669,5,664,1.02%,0.75%
2020-01-01 00:19:30,2,5,16598,1914,14684,25.33%,11.53%
2020-01-01 00:19:30,2,6,31,0,31,0.05%,0.00%
2020-01-01 00:19:30,2,7,3802,111,3691,5.80%,2.92%
2020-01-01 00:19:30,2,8,2876,63,2813,4.39%,2.19%
2020-01-01 00:19:30,2,9,16548,1907,14641,25.25%,11.52%
2020-01-01 00:19:30,2,10,2143,35,2108,3.27%,1.63%
2020-01-01 00:19:30,2,11,2156,37,2119,3.29%,1.72%
2020-01-01 00:19:30,2,12,16420,1884,14536,25.05%,11.47%
2020-01-01 00:19:30,3,1,1711,8,1703,2.61%,0.47%
2020-01-01 00:19:30,3,2,23444,3787,19657,35.77%,16.15%
2020-01-01 00:19:30,3,3,71368,27915,43453,108.90%,39.11%
2020-01-01 00:19:30,3,4,9309,634,8675,14.20%,6.81%
2020-01-01 00:19:30,3,5,46674,13337,33337,71.22%,28.57%
2020-01-01 00:19:30,3,6,10829,853,9976,16.52%,7.88%
2020-01-01 00:19:30,3,7,19121,2586,16535,29.18%,13.52%
2020-01-01 00:19:30,3,8,15740,1765,13975,24.02%,11.21%
2020-01-01 00:19:30,3,9,35226,8017,27209,53.75%,22.76%
2020-01-01 00:19:30,3,10,5150,189,4961,7.86%,3.67%
2020-01-01 00:19:30,3,11,1937,33,1904,2.96%,1.70%
2020-01-01 00:19:30,3,12,27281,4994,22287,41.63%,18.31%
2020-01-01 00:19:30,4,1,541,0,541,0.83%,0.00%
2020-01-01 00:19:30,4,2,361,0,361,0.55%,0.00%
2020-01-01 00:19:30,4,3,898,2,896,1.37%,0.22%
2020-01-01 00:19:30,4,4,28327,5277,23050,43.22%,18.63%
2020-01-01 00:19:30,4,5,17251,2033,15218,26.32%,11.78%
2020-01-01 00:19:30,4,6,24057,3846,20211,36.71%,15.99%
2020-01-01 00:19:30,4,7,5192,201,4991,7.92%,3.87%
2020-01-01 00:19:30,4,8,3123,67,3056,4.77%,2.15%
2020-01-01 00:19:30,4,9,15191,1616,13575,23.18%,10.64%
2020-01-01 00:19:30,4,10,1975,31,1944,3.01%,1.57%
2020-01-01 00:19:30,4,11,248,1,247,0.38%,0.40%
2020-01-01 00:19:30,4,12,12476,1115,11361,19.04%,8.94%
2020-01-01 00:19:30,5,1,2806,59,2747,4.28%,2.10%
2020-01-01 00:19:30,5,2,636,6,630,0.97%,0.94%
2020-01-01 00:19:30,5,3,925,7,918,1.41%,0.76%
2020-01-01 00:19:30,5,4,21122,3117,18005,32.23%,14.76%
2020-01-01 00:19:30,5,5,9407,694,8713,14.35%,7.38%
2020-01-01 00:19:30,5,6,14588,1580,13008,22.26%,10.83%
2020-01-01 00:19:30,5,7,4709,211,4498,7.19%,4.48%
2020-01-01 00:19:30,5,8,3420,102,3318,5.22%,2.98%
2020-01-01 00:19:30,5,9,8351,548,7803,12.74%,6.56%
2020-01-01 00:19:30,5,10,1320,16,1304,2.01%,1.21%
2020-01-01 00:19:30,5,11,458,1,457,0.70%,0.22%
2020-01-01 00:19:30,5,12,6819,349,6470,10.40%,5.12%
2020-01-01 00:19:30,6,1,1090,14,1076,1.66%,1.28%
2020-01-01 00:19:30,6,2,1147,14,1133,1.75%,1.22%
2020-01-01 00:19:30,6,3,1740,42,1698,2.66%,2.41%
2020-01-01 00:19:30,6,4,1371,8,1363,2.09%,0.58%
2020-01-01 00:19:30,6,5,12476,1107,11369,19.04%,8.87%
2020-01-01 00:19:30,6,6,4160,122,4038,6.35%,2.93%
2020-01-01 00:19:30,6,7,2381,45,2336,3.63%,1.89%
2020-01-01 00:19:30,6,8,1539,22,1517,2.35%,1.43%
2020-01-01 00:19:30,6,9,6359,279,6080,9.70%,4.39%
2020-01-01 00:19:30,6,10,1888,31,1857,2.88%,1.64%
2020-01-01 00:19:30,6,11,525,1,524,0.80%,0.19%
2020-01-01 00:19:30,6,12,4428,142,4286,6.76%,3.21%
2020-01-01 00:19:30,7,1,580,4,576,0.89%,0.69%
2020-01-01 00:19:30,7,2,208,0,208,0.32%,0.00%
2020-01-01 00:19:30,7,3,1576,11,1565,2.40%,0.70%
2020-01-01 00:19:30,7,4,2618,49,2569,3.99%,1.87%
2020-01-01 00:19:30,7,5,8149,503,7646,12.43%,6.17%
2020-01-01 00:19:30,7,6,14500,1503,12997,22.13%,10.37%
2020-01-01 00:19:30,7,7,3702,80,3622,5.65%,2.16%
2020-01-01 00:19:30,7,8,1173,8,1165,1.79%,0.68%
2020-01-01 00:19:30,7,9,6228,309,5919,9.50%,4.96%
2020-01-01 00:19:30,7,10,1066,7,1059,1.63%,0.66%
2020-01-01 00:19:30,7,11,79,0,79,0.12%,0.00%
2020-01-01 00:19:30,7,12,5180,222,4958,7.90%,4.29%
2020-01-01 00:19:30,8,1,632,1,631,0.96%,0.16%
2020-01-01 00:19:30,8,2,100,0,100,0.15%,0.00%
2020-01-01 00:19:30,8,3,2094,22,2072,3.20%,1.05%
2020-01-01 00:19:30,8,4,2912,58,2854,4.44%,1.99%
2020-01-01 00:19:30,8,5,8854,555,8299,13.51%,6.27%
2020-01-01 00:19:30,8,6,16726,1973,14753,25.52%,11.80%
2020-01-01 00:19:30,8,7,4897,204,4693,7.47%,4.17%
2020-01-01 00:19:30,8,8,2017,26,1991,3.08%,1.29%
2020-01-01 00:19:30,8,9,6510,305,6205,9.93%,4.69%
2020-01-01 00:19:30,8,10,1832,22,1810,2.80%,1.20%
2020-01-01 00:19:30,8,11,96,0,96,0.15%,0.00%
2020-01-01 00:19:30,8,12,4669,165,4504,7.12%,3.53%
2020-01-01 00:19:30,9,1,387,1,386,0.59%,0.26%
2020-01-01 00:19:30,9,2,1741,19,1722,2.66%,1.09%
2020-01-01 00:19:30,9,3,965,9,956,1.47%,0.93%
2020-01-01 00:19:30,9,4,5707,258,5449,8.71%,4.52%
2020-01-01 00:19:30,9,5,270,0,270,0.41%,0.00%
2020-01-01 00:19:30,9,6,6544,335,6209,9.99%,5.12%
2020-01-01 00:19:30,9,7,26399,4498,21901,40.28%,17.04%
2020-01-01 00:19:30,9,8,11455,875,10580,17.48%,7.64%
2020-01-01 00:19:30,9,9,203,0,203,0.31%,0.00%
2020-01-01 00:19:30,9,10,3431,55,3376,5.24%,1.60%
2020-01-01 00:19:30,9,11,9228,568,8660,14.08%,6.16%
2020-01-01 00:19:30,9,12,5467,214,5253,8.34%,3.91%
2020-01-01 00:19:30,10,1,1503,292,1211,2.29%,19.43%
2020-01-01 00:19:30,10,2,3218,353,2865,4.91%,10.97%
2020-01-01 00:19:30,10,3,1593,20,1573,2.43%,1.26%
2020-01-01 00:19:30,10,4,4069,1133,2936,6.21%,27.84%
2020-01-01 00:19:30,10,5,890,115,775,1.36%,12.92%
2020-01-01 00:19:30,10,6,6333,1379,4954,9.66%,21.77%
2020-01-01 00:19:30,10,7,11157,2199,8958,17.02%,19.71%
2020-01-01 00:19:30,10,8,31036,8269,22767,47.36%,26.64%
2020-01-01 00:19:30,10,9,406,2,404,0.62%,0.49%
2020-01-01 00:19:30,10,10,3301,93,3208,5.04%,2.82%
2020-01-01 00:19:30,10,11,14996,2050,12946,22.88%,13.67%
2020-01-01 00:19:30,10,12,10800,1360,9440,16.48%,12.59%
2020-01-01 00:19:30,11,1,2554,48,2506,3.90%,1.88%
2020-01-01 00:19:30,11,2,5166,185,4981,7.88%,3.58%
2020-01-01 00:19:30,11,3,2458,44,2414,3.75%,1.79%
2020-01-01 00:19:30,11,4,5402,236,5166,8.24%,4.37%
2020-01-01 00:19:30,11,5,227,4,223,0.35%,1.76%
2020-01-01 00:19:30,11,6,6257,312,5945,9.55%,4.99%
2020-01-01 00:19:30,11,7,13257,1336,11921,20.23%,10.08%
2020-01-01 00:19:30,11,8,27496,5080,22416,41.96%,18.48%
2020-01-01 00:19:30,11,9,286,1,285,0.44%,0.35%
2020-01-01 00:19:30,11,10,3081,97,2984,4.70%,3.15%
2020-01-01 00:19:30,11,11,10762,853,9909,16.42%,7.93%
2020-01-01 00:19:30,11,12,7218,382,6836,11.01%,5.29%
2020-01-01 00:19:30,12,1,59,0,59,0.09%,0.00%
2020-01-01 00:19:30,12,2,539,156,383,0.82%,28.94%
2020-01-01 00:19:30,12,3,2424,194,2230,3.70%,8.00%
2020-01-01 00:19:30,12,4,3255,165,3090,4.97%,5.07%
2020-01-01 00:19:30,12,5,8134,696,7438,12.41%,8.56%
2020-01-01 00:19:30,12,6,5044,271,4773,7.70%,5.37%
2020-01-01 00:19:30,12,7,1634,35,1599,2.49%,2.14%
2020-01-01 00:19:30,12,8,1461,356,1105,2.23%,24.37%
2020-01-01 00:19:30,12,9,21381,4296,17085,32.62%,20.09%
2020-01-01 00:19:30,12,10,4814,502,4312,7.35%,10.43%
2020-01-01 00:19:30,12,11,1722,362,1360,2.63%,21.02%
2020-01-01 00:19:30,12,12,7610,1305,6305,11.61%,17.15%
2020-01-01 00:19:30,13,1,2185,26,2159,3.33%,1.19%
2020-01-01 00:19:30,13,2,2486,36,2450,3.79%,1.45%
2020-01-01 00:19:30,13,3,1108,4,1104,1.69%,0.36%
2020-01-01 00:19:30,13,4,4395,481,3914,6.71%,10.94%
2020-01-01 00:19:30,13,5,7039,794,6245,10.74%,11.28%
2020-01-01 00:19:30,13,6,5041,531,4510,7.69%,10.53%
2020-01-01 00:19:30,13,7,4278,143,4135,6.53%,3.34%
2020-01-01 00:19:30,13,8,7735,461,7274,11.80%,5.96%
2020-01-01 00:19:30,13,9,7399,832,6567,11.29%,11.24%
2020-01-01 00:19:30,13,10,27899,5793,22106,42.57%,20.76%
2020-01-01 00:19:30,13,11,17451,2421,15030,26.63%,13.87%
2020-01-01 00:19:30,13,12,9418,1022,8396,14.37%,10.85%
2020-01-01 00:19:30,14,1,266,0,266,0.41%,0.00%
2020-01-01 00:19:30,14,2,1450,14,1436,2.21%,0.97%
2020-01-01 00:19:30,14,3,1015,6,1009,1.55%,0.59%
2020-01-01 00:19:30,14,4,4445,143,4302,6.78%,3.22%
2020-01-01 00:19:30,14,5,1507,25,1482,2.30%,1.66%
2020-01-01 00:19:30,14,6,4843,175,4668,7.39%,3.61%
2020-01-01 00:19:30,14,7,12555,1111,11444,19.16%,8.85%
2020-01-01 00:19:30,14,8,14110,1411,12699,21.53%,10.00%
2020-01-01 00:19:30,14,9,1698,33,1665,2.59%,1.94%
2020-01-01 00:19:30,14,10,3849,114,3735,5.87%,2.96%
2020-01-01 00:19:30,14,11,26289,4572,21717,40.11%,17.39%
2020-01-01 00:19:30,14,12,8040,479,7561,12.27%,5.96%
2020-01-01 00:19:30,15,1,538,6,532,0.82%,1.12%
2020-01-01 00:19:30,15,2,111,0,111,0.17%,0.00%
2020-01-01 00:19:30,15,3,4128,132,3996,6.30%,3.20%
2020-01-01 00:19:30,15,4,4959,239,4720,7.57%,4.82%
2020-01-01 00:19:30,15,5,9965,748,9217,15.21%,7.51%
2020-01-01 00:19:30,15,6,5254,271,4983,8.02%,5.16%
2020-01-01 00:19:30,15,7,3726,89,3637,5.69%,2.39%
2020-01-01 00:19:30,15,8,6136,262,5874,9.36%,4.27%
2020-01-01 00:19:30,15,9,10183,780,9403,15.54%,7.66%
2020-01-01 00:19:30,15,10,5264,423,4841,8.03%,8.04%
2020-01-01 00:19:30,15,11,11525,1139,10386,17.59%,9.88%
2020-01-01 00:19:30,15,12,26895,5290,21605,41.04%,19.67%
2020-01-01 00:19:30,16,1,570,1,569,0.87%,0.18%
2020-01-01 00:19:30,16,2,254,1,253,0.39%,0.39%
2020-01-01 00:19:30,16,3,1343,18,1325,2.05%,1.34%
2020-01-01 00:19:30,16,4,4054,95,3959,6.19%,2.34%
2020-01-01 00:19:30,16,5,7617,464,7153,11.62%,6.09%
2020-01-01 00:19:30,16,6,5159,172,4987,7.87%,3.33%
2020-01-01 00:19:30,16,7,3475,118,3357,5.30%,3.40%
2020-01-01 00:19:30,16,8,7859,582,7277,11.99%,7.41%
2020-01-01 00:19:30,16,9,8261,538,7723,12.61%,6.51%
2020-01-01 00:19:30,16,10,1922,26,1896,2.93%,1.35%
2020-01-01 00:19:30,16,11,10053,841,9212,15.34%,8.37%
2020-01-01 00:19:30,16,12,27048,4971,22077,41.27%,18.38%
2020-01-01 00:19:40,1,1,20589,2939,17650,31.42%,14.27%
2020-01-01 00:19:40,1,2,10345,818,9527,15.79%,7.91%
2020-01-01 00:19:40,1,3,1276,19,1257,1.95%,1.49%
2020-01-01 00:19:40,1,4,9690,710,8980,14.79%,7.33%
2020-01-01 00:19:40,1,5,9062,636,8426,13.83%,7.02%
2020-01-01 00:19:40,1,6,9016,623,8393,13.76%,6.91%
2020-01-01 00:19:40,1,7,9058,624,8434,13.82%,6.89%
2020-01-01 00:19:40,1,8,7574,425,7149,11.56%,5.61%
2020-01-01 00:19:40,1,9,8974,620,8354,13.69%,6.91%
2020-01-01 00:19:40,1,10,7080,369,6711,10.80%,5.21%
2020-01-01 00:19:40,1,11,7193,380,6813,10.98%,5.28%
2020-01-01 00:19:40,1,12,8951,616,8335,13.66%,6.88%
2020-01-01 00:19:40,2,1,502,4,498,0.77%,0.80%
2020-01-01 00:19:40,2,2,28169,5231,22938,42.98%,18.57%
2020-01-01 00:19:40,2,3,23528,3760,19768,35.90%,15.98%
2020-01-01 00:19:40,2,4,454,2,452,0.69%,0.44%
2020-01-01 00:19:40,2,5,13833,1364,12469,21.11%,9.86%
2020-01-01 00:19:40,2,6,31,0,31,0.05%,0.00%
2020-01-01 00:19:40,2,7,4123,123,4000,6.29%,2.98%
2020-01-01 00:19:40,2,8,3235,84,3151,4.94%,2.60%
2020-01-01 00:19:40,2,9,13751,1353,12398,20.98%,9.84%
2020-01-01 00:19:40,2,10,2329,43,2286,3.55%,1.85%
2020-01-01 00:19:40,2,11,2363,45,2318,3.61%,1.90%
2020-01-01 00:19:40,2,12,13559,1320,12239,20.69%,9.74%
2020-01-01 00:19:40,3,1,1703,24,1679,2.60%,1.41%
2020-01-01 00:19:40,3,2,22429,3461,18968,34.22%,15.43%
2020-01-01 00:19:40,3,3,79067,33155,45912,120.65%,41.93%
2020-01-01 00:19:40,3,4,11802,1033,10769,18.01%,8.75%
2020-01-01 00:19:40,3,5,54185,17381,36804,82.68%,32.08%
2020-01-01 00:19:40,3,6,13176,1270,11906,20.10%,9.64%
2020-01-01 00:19:40,3,7,18882,2501,16381,28.81%,13.25%
2020-01-01 00:19:40,3,8,15787,1791,13996,24.09%,11.34%
2020-01-01 00:19:40,3,9,40372,10301,30071,61.60%,25.52%
2020-01-01 00:19:40,3,10,8180,470,7710,12.48%,5.75%
2020-01-01 00:19:40,3,11,2028,26,2002,3.09%,1.28%
2020-01-01 00:19:40,3,12,29387,5777,23610,44.84%,19.66%
2020-01-01 00:19:40,4,1,579,2,577,0.88%,0.35%
2020-01-01 00:19:40,4,2,356,2,354,0.54%,0.56%
2020-01-01 00:19:40,4,3,830,9,821,1.27%,1.08%
2020-01-01 00:19:40,4,4,28178,5270,22908,43.00%,18.70%
2020-01-01 00:19:40,4,5,17009,1983,15026,25.95%,11.66%
2020-01-01 00:19:40,4,6,23699,3815,19884,36.16%,16.10%
2020-01-01 00:19:40,4,7,5190,202,4988,7.92%,3.89%
2020-01-01 00:19:40,4,8,3163,74,3089,4.83%,2.34%
2020-01-01 00:19:40,4,9,15218,1591,13627,23.22%,10.45%
2020-01-01 00:19:40,4,10,2062,29,2033,3.15%,1.41%
2020-01-01 00:19:40,4,11,230,0,230,0.35%,0.00%
2020-01-01 00:19:40,4,12,12147,1027,11120,18.53%,8.45%
2020-01-01 00:19:40,5,1,3220,90,3130,4.91%,2.80%
2020-01-01 00:19:40,5,2,700,4,696,1.07%,0.57%
2020-01-01 00:19:40,5,3,519,2,517,0.79%,0.39%
2020-01-01 00:19:40,5,4,23047,3554,19493,35.17%,15.42%
2020-01-01 00:19:40,5,5,8571,534,8037,13.08%,6.23%
2020-01-01 00:19:40,5,6,16609,1895,14714,25.34%,11.41%
2020-01-01 00:19:40,5,7,7557,408,7149,11.53%,5.40%
2020-01-01 00:19:40,5,8,2840,52,2788,4.33%,1.83%
2020-01-01 00:19:40,5,9,7923,458,7465,12.09%,5.78%
2020-01-01 00:19:40,5,10,1150,14,1136,1.75%,1.22%
2020-01-01 00:19:40,5,11,416,0,416,0.63%,0.00%
2020-01-01 00:19:40,5,12,6447,299,6148,9.84%,4.64%
2020-01-01 00:19:40,6,1,1132,13,1119,1.73%,1.15%
2020-01-01 00:19:40,6,2,1170,13,1157,1.79%,1.11%
2020-01-01 00:19:40,6,3,1626,23,1603,2.48%,1.41%
2020-01-01 00:19:40,6,4,1404,20,1384,2.14%,1.42%
2020-01-01 00:19:40,6,5,13079,1219,11860,19.96%,9.32%
2020-01-01 00:19:40,6,6,4299,128,4171,6.56%,2.98%
2020-01-01 00:19:40,6,7,2605,58,2547,3.97%,2.23%
2020-01-01 00:19:40,6,8,1580,32,1548,2.41%,2.03%
2020-01-01 00:19:40,6,9,6918,336,6582,10.56%,4.86%
2020-01-01 00:19:40,6,10,2366,39,2327,3.61%,1.65%
2020-01-01 00:19:40,6,11,403,2,401,0.61%,0.50%
2020-01-01 00:19:40,6,12,4505,143,4362,6.87%,3.17%
2020-01-01 00:19:40,7,1,595,6,589,0.91%,1.01%
2020-01-01 00:19:40,7,2,188,1,187,0.29%,0.53%
2020-01-01 00:19:40,7,3,621,3,618,0.95%,0.48%
2020-01-01 00:19:40,7,4,2581,52,2529,3.94%,2.01%
2020-01-01 00:19:40,7,5,7180,334,6846,10.96%,4.65%
2020-01-01 00:19:40,7,6,13239,1182,12057,20.20%,8.93%
2020-01-01 00:19:40,7,7,3446,101,3345,5.26%,2.93%
2020-01-01 00:19:40,7,8,1229,12,1217,1.88%,0.98%
2020-01-01 00:19:40,7,9,6437,269,6168,9.82%,4.18%
2020-01-01 00:19:40,7,10,1174,9,1165,1.79%,0.77%
2020-01-01 00:19:40,7,11,86,0,86,0.13%,0.00%
2020-01-01 00:19:40,7,12,5272,169,5103,8.04%,3.21%
2020-01-01 00:19:40,8,1,536,2,534,0.82%,0.37%
2020-01-01 00:19:40,8,2,78,0,78,0.12%,0.00%
2020-01-01 00:19:40,8,3,2150,32,2118,3.28%,1.49%
2020-01-01 00:19:40,8,4,2765,49,2716,4.22%,1.77%
2020-01-01 00:19:40,8,5,8470,485,7985,12.92%,5.73%
2020-01-01 00:19:40,8,6,16806,1960,14846,25.64%,11.66%
2020-01-01 00:19:40,8,7,5504,247,5257,8.40%,4.49%
2020-01-01 00:19:40,8,8,2592,59,2533,3.96%,2.28%
2020-01-01 00:19:40,8,9,6102,266,5836,9.31%,4.36%
2020-01-01 00:19:40,8,10,1658,19,1639,2.53%,1.15%
2020-01-01 00:19:40,8,11,85,0,85,0.13%,0.00%
2020-01-01 00:19:40,8,12,4448,139,4309,6.79%,3.12%
2020-01-01 00:19:40,9,1,1280,5,1275,1.95%,0.39%
2020-01-01 00:19:40,9,2,4004,108,3896,6.11%,2.70%
2020-01-01 00:19:40,9,3,2388,34,2354,3.64%,1.42%
2020-01-01 00:19:40,9,4,3524,78,3446,5.38%,2.21%
2020-01-01 00:19:40,9,5,391,0,391,0.60%,0.00%
2020-01-01 00:19:40,9,6,4625,142,4483,7.06%,3.07%
2020-01-01 00:19:40,9,7,24229,3890,20339,36.97%,16.06%
2020-01-01 00:19:40,9,8,9835,679,9156,15.01%,6.90%
2020-01-01 00:19:40,9,9,285,0,285,0.43%,0.00%
2020-01-01 00:19:40,9,10,2825,53,2772,4.31%,1.88%
2020-01-01 00:19:40,9,11,8818,561,8257,13.46%,6.36%
2020-01-01 00:19:40,9,12,5691,219,5472,8.68%,3.85%
2020-01-01 00:19:40,10,1,1352,278,1074,2.06%,20.56%
2020-01-01 00:19:40,10,2,2883,323,2560,4.40%,11.20%
2020-01-01 00:19:40,10,3,1415,16,1399,2.16%,1.13%
2020-01-01 00:19:40,10,4,3916,1128,2788,5.98%,28.80%
2020-01-01 00:19:40,10,5,777,116,661,1.19%,14.93%
2020-01-01 00:19:40,10,6,5924,1346,4578,9.04%,22.72%
2020-01-01 00:19:40,10,7,10517,2044,8473,16.05%,19.44%
2020-01-01 00:19:40,10,8,29522,7687,21835,45.05%,26.04%
2020-01-01 00:19:40,10,9,691,2,689,1.05%,0.29%
2020-01-01 00:19:40,10,10,2831,53,2778,4.32%,1.87%
2020-01-01 00:19:40,10,11,15049,2074,12975,22.96%,13.78%
2020-01-01 00:19:40,10,12,11419,1440,9979,17.42%,12.61%
2020-01-01 00:19:40,11,1,2576,48,2528,3.93%,1.86%
2020-01-01 00:19:40,11,2,3313,85,3228,5.06%,2.57%
2020-01-01 00:19:40,11,3,579,5,574,0.88%,0.86%
2020-01-01 00:19:40,11,4,4803,186,4617,7.33%,3.87%
2020-01-01 00:19:40,11,5,170,1,169,0.26%,0.59%
2020-01-01 00:19:40,11,6,5626,249,5377,8.58%,4.43%
2020-01-01 00:19:40,11,7,10518,814,9704,16.05%,7.74%
2020-01-01 00:19:40,11,8,24802,4157,20645,37.84%,16.76%
2020-01-01 00:19:40,11,9,351,1,350,0.54%,0.28%
2020-01-01 00:19:40,11,10,3274,76,3198,5.00%,2.32%
2020-01-01 00:19:40,11,11,10689,825,9864,16.31%,7.72%
2020-01-01 00:19:40,11,12,6985,381,6604,10.66%,5.45%
2020-01-01 00:19:40,12,1,79,0,79,0.12%,0.00%
2020-01-01 00:19:40,12,2,587,162,425,0.90%,27.60%
2020-01-01 00:19:40,12,3,3062,224,2838,4.67%,7.32%
2020-01-01 00:19:40,12,4,2871,149,2722,4.38%,5.19%
2020-01-01 00:19:40,12,5,8569,786,7783,13.08%,9.17%
2020-01-01 00:19:40,12,6,4819,296,4523,7.35%,6.14%
2020-01-01 00:19:40,12,7,1799,37,1762,2.75%,2.06%
2020-01-01 00:19:40,12,8,1627,355,1272,2.48%,21.82%
2020-01-01 00:19:40,12,9,21734,4505,17229,33.16%,20.73%
2020-01-01 00:19:40,12,10,4739,477,4262,7.23%,10.07%
2020-01-01 00:19:40,12,11,1979,365,1614,3.02%,18.44%
2020-01-01 00:19:40,12,12,7591,1235,6356,11.58%,16.27%
2020-01-01 00:19:40,13,1,2112,42,2070,3.22%,1.99%
2020-01-01 00:19:40,13,2,2448,54,2394,3.74%,2.21%
2020-01-01 00:19:40,13,3,1209,5,1204,1.84%,0.41%
2020-01-01 00:19:40,13,4,4832,465,4367,7.37%,9.62%
2020-01-01 00:19:40,13,5,7625,801,6824,11.63%,10.50%
2020-01-01 00:19:40,13,6,5653,530,5123,8.63%,9.38%
2020-01-01 00:19:40,13,7,4576,146,4430,6.98%,3.19%
2020-01-01 00:19:40,13,8,8169,482,7687,12.46%,5.90%
2020-01-01 00:19:40,13,9,7967,827,7140,12.16%,10.38%
2020-01-01 00:19:40,13,10,29157,6173,22984,44.49%,21.17%
2020-01-01 00:19:40,13,11,18202,2656,15546,27.77%,14.59%
2020-01-01 00:19:40,13,12,9707,1090,8617,14.81%,11.23%
2020-01-01 00:19:40,14,1,189,1,188,0.29%,0.53%
2020-01-01 00:19:40,14,2,1469,20,1449,2.24%,1.36%
2020-01-01 00:19:40,14,3,1143,7,1136,1.74%,0.61%
2020-01-01 00:19:40,14,4,3799,111,3688,5.80%,2.92%
2020-01-01 00:19:40,14,5,1315,8,1307,2.01%,0.61%
2020-01-01 00:19:40,14,6,4117,120,3997,6.28%,2.91%
2020-01-01 00:19:40,14,7,11505,962,10543,17.56%,8.36%
2020-01-01 00:19:40,14,8,12944,1199,11745,19.75%,9.26%
2020-01-01 00:19:40,14,9,1548,15,1533,2.36%,0.97%
2020-01-01 00:19:40,14,10,3930,118,3812,6.00%,3.00%
2020-01-01 00:19:40,14,11,25502,4394,21108,38.91%,17.23%
2020-01-01 00:19:40,14,12,8312,510,7802,12.68%,6.14%
2020-01-01 00:19:40,15,1,503,3,500,0.77%,0.60%
2020-01-01 00:19:40,15,2,153,0,153,0.23%,0.00%
2020-01-01 00:19:40,15,3,3947,112,3835,6.02%,2.84%
2020-01-01 00:19:40,15,4,4832,288,4544,7.37%,5.96%
2020-01-01 00:19:40,15,5,9637,791,8846,14.70%,8.21%
2020-01-01 00:19:40,15,6,5101,309,4792,7.78%,6.06%
2020-01-01 00:19:40,15,7,3935,112,3823,6.00%,2.85%
2020-01-01 00:19:40,15,8,6183,276,5907,9.43%,4.46%
2020-01-01 00:19:40,15,9,10005,835,9170,15.27%,8.35%
2020-01-01 00:19:40,15,10,6430,536,5894,9.81%,8.34%
2020-01-01 00:19:40,15,11,12778,1361,11417,19.50%,10.65%
2020-01-01 00:19:40,15,12,27737,5677,22060,42.32%,20.47%
2020-01-01 00:19:40,16,1,468,1,467,0.71%,0.21%
2020-01-01 00:19:40,16,2,283,1,282,0.43%,0.35%
2020-01-01 00:19:40,16,3,1235,9,1226,1.88%,0.73%
2020-01-01 00:19:40,16,4,4436,139,4297,6.77%,3.13%
2020-01-01 00:19:40,16,5,7520,455,7065,11.47%,6.05%
2020-01-01 00:19:40,16,6,5377,199,5178,8.20%,3.70%
2020-01-01 00:19:40,16,7,3145,79,3066,4.80%,2.51%
2020-01-01 00:19:40,16,8,6769,428,6341,10.33%,6.32%
2020-01-01 00:19:40,16,9,8100,515,7585,12.36%,6.36%
2020-01-01 00:19:40,16,10,1787,35,1752,2.73%,1.96%
2020-01-01 00:19:40,16,11,8780,647,8133,13.40%,7.37%
2020-01-01 00:19:40,16,12,25063,4210,20853,38.24%,16.80%
2020-01-01 00:19:50,1,1,23512,3764,19748,35.88%,16.01%
2020-01-01 00:19:50,1,2,14308,1506,12802,21.83%,10.53%
2020-01-01 00:19:50,1,3,1445,9,1436,2.20%,0.62%
2020-01-01 00:19:50,1,4,8666,570,8096,13.22%,6.58%
2020-01-01 00:19:50,1,5,8014,483,7531,12.23%,6.03%
2020-01-01 00:19:50,1,6,7982,489,7493,12.18%,6.13%
2020-01-01 00:19:50,1,7,12833,1221,11612,19.58%,9.51%
2020-01-01 00:19:50,1,8,11409,989,10420,17.41%,8.67%
2020-01-01 00:19:50,1,9,7897,473,7424,12.05%,5.99%
2020-01-01 00:19:50,1,10,10574,858,9716,16.13%,8.11%
2020-01-01 00:19:50,1,11,10655,870,9785,16.26%,8.17%
2020-01-01 00:19:50,1,12,7869,471,7398,12.01%,5.99%
2020-01-01 00:19:50,2,1,1067,12,1055,1.63%,1.12%
2020-01-01 00:19:50,2,2,25945,4542,21403,39.59%,17.51%
2020-01-01 00:19:50,2,3,19513,2692,16821,29.77%,13.80%
2020-01-01 00:19:50,2,4,982,12,970,1.50%,1.22%
2020-01-01 00:19:50,2,5,9672,680,8992,14.76%,7.03%
2020-01-01 00:19:50,2,6,28,0,28,0.04%,0.00%
2020-01-01 00:19:50,2,7,5360,220,5140,8.18%,4.10%
2020-01-01 00:19:50,2,8,4211,138,4073,6.43%,3.28%
2020-01-01 00:19:50,2,9,9599,670,8929,14.65%,6.98%
2020-01-01 00:19:50,2,10,3341,95,3246,5.10%,2.84%
2020-01-01 00:19:50,2,11,3353,97,3256,5.12%,2.89%
2020-01-01 00:19:50,2,12,9410,648,8762,14.36%,6.89%
2020-01-01 00:19:50,3,1,1936,40,1896,2.95%,2.07%
2020-01-01 00:19:50,3,2,25184,4229,20955,38.43%,16.79%
2020-01-01 00:19:50,3,3,76188,31004,45184,116.25%,40.69%
2020-01-01 00:19:50,3,4,10610,800,9810,16.19%,7.54%
2020-01-01 00:19:50,3,5,49792,14752,35040,75.98%,29.63%
2020-01-01 00:19:50,3,6,11317,906,10411,17.27%,8.01%
2020-01-01 00:19:50,3,7,21580,3160,18420,32.93%,14.64%
2020-01-01 00:19:50,3,8,16291,1848,14443,24.86%,11.34%
2020-01-01 00:19:50,3,9,37955,8971,28984,57.91%,23.64%
2020-01-01 00:19:50,3,10,5876,222,5654,8.97%,3.78%
2020-01-01 00:19:50,3,11,1965,30,1935,3.00%,1.53%
2020-01-01 00:19:50,3,12,26801,4758,22043,40.90%,17.75%
2020-01-01 00:19:50,4,1,579,4,575,0.88%,0.69%
2020-01-01 00:19:50,4,2,364,2,362,0.56%,0.55%
2020-01-01 00:19:50,4,3,685,2,683,1.05%,0.29%
2020-01-01 00:19:50,4,4,28452,5283,23169,43.41%,18.57%
2020-01-01 00:19:50,4,5,17669,2163,15506,26.96%,12.24%
2020-01-01 00:19:50,4,6,24310,3905,20405,37.09%,16.06%
2020-01-01 00:19:50,4,7,5300,195,5105,8.09%,3.68%
2020-01-01 00:19:50,4,8,3152,68,3084,4.81%,2.16%
2020-01-01 00:19:50,4,9,15872,1738,14134,24.22%,10.95%
2020-01-01 00:19:50,4,10,1852,20,1832,2.83%,1.08%
2020-01-01 00:19:50,4,11,190,0,190,0.29%,0.00%
2020-01-01 00:19:50,4,12,12520,1127,11393,19.10%,9.00%
2020-01-01 00:19:50,5,1,2939,59,2880,4.48%,2.01%
2020-01-01 00:19:50,5,2,699,7,692,1.07%,1.00%
2020-01-01 00:19:50,5,3,639,0,639,0.98%,0.00%
2020-01-01 00:19:50,5,4,24192,4008,20184,36.91%,16.57%
2020-01-01 00:19:50,5,5,10500,807,9693,16.02%,7.69%
2020-01-01 00:19:50,5,6,16319,1908,14411,24.90%,11.69%
2020-01-01 00:19:50,5,7,5263,227,5036,8.03%,4.31%
2020-01-01 00:19:50,5,8,2928,80,2848,4.47%,2.73%
2020-01-01 00:19:50,5,9,8980,610,8370,13.70%,6.79%
2020-01-01 00:19:50,5,10,1057,6,1051,1.61%,0.57%
2020-01-01 00:19:50,5,11,420,3,417,0.64%,0.71%
2020-01-01 00:19:50,5,12,7732,462,7270,11.80%,5.98%
2020-01-01 00:19:50,6,1,1175,16,1159,1.79%,1.36%
2020-01-01 00:19:50,6,2,1231,17,1214,1.88%,1.38%
2020-01-01 00:19:50,6,3,1818,30,1788,2.77%,1.65%
2020-01-01 00:19:50,6,4,1601,14,1587,2.44%,0.87%
2020-01-01 00:19:50,6,5,14357,1434,12923,21.91%,9.99%
2020-01-01 00:19:50,6,6,6305,307,5998,9.62%,4.87%
2020-01-01 00:19:50,6,7,4176,142,4034,6.37%,3.40%
2020-01-01 00:19:50,6,8,3359,99,3260,5.13%,2.95%
2020-01-01 00:19:50,6,9,5960,224,5736,9.09%,3.76%
2020-01-01 00:19:50,6,10,1854,21,1833,2.83%,1.13%
2020-01-01 00:19:50,6,11,437,0,437,0.67%,0.00%
2020-01-01 00:19:50,6,12,3991,103,3888,6.09%,2.58%
2020-01-01 00:19:50,7,1,471,2,469,0.72%,0.42%
2020-01-01 00:19:50,7,2,171,0,171,0.26%,0.00%
2020-01-01 00:19:50,7,3,1115,7,1108,1.70%,0.63%
2020-01-01 00:19:50,7,4,1739,25,1714,2.65%,1.44%
2020-01-01 00:19:50,7,5,7725,429,7296,11.79%,5.55%
2020-01-01 00:19:50,7,6,13168,1234,11934,20.09%,9.37%
2020-01-01 00:19:50,7,7,3628,108,3520,5.54%,2.98%
2020-01-01 00:19:50,7,8,1492,26,1466,2.28%,1.74%
2020-01-01 00:19:50,7,9,6566,300,6266,10.02%,4.57%
2020-01-01 00:19:50,7,10,1715,22,1693,2.62%,1.28%
2020-01-01 00:19:50,7,11,167,0,167,0.25%,0.00%
2020-01-01 00:19:50,7,12,4831,153,4678,7.37%,3.17%
2020-01-01 00:19:50,8,1,465,3,462,0.71%,0.65%
2020-01-01 00:19:50,8,2,96,1,95,0.15%,1.04%
2020-01-01 00:19:50,8,3,1646,17,1629,2.51%,1.03%
2020-01-01 00:19:50,8,4,2575,44,2531,3.93%,1.71%
2020-01-01 00:19:50,8,5,8229,503,7726,12.56%,6.11%
2020-01-01 00:19:50,8,6,16489,1924,14565,25.16%,11.67%
2020-01-01 00:19:50,8,7,5574,242,5332,8.51%,4.34%
2020-01-01 00:19:50,8,8,2164,46,2118,3.30%,2.13%
2020-01-01 00:19:50,8,9,6310,304,6006,9.63%,4.82%
2020-01-01 00:19:50,8,10,1719,23,1696,2.62%,1.34%
2020-01-01 00:19:50,8,11,146,0,146,0.22%,0.00%
2020-01-01 00:19:50,8,12,4564,176,4388,6.96%,3.86%
2020-01-01 00:19:50,9,1,745,3,742,1.14%,0.40%
2020-01-01 00:19:50,9,2,3020,78,2942,4.61%,2.58%
2020-01-01 00:19:50,9,3,1911,37,1874,2.92%,1.94%
2020-01-01 00:19:50,9,4,4831,176,4655,7.37%,3.64%
2020-01-01 00:19:50,9,5,217,0,217,0.33%,0.00%
2020-01-01 00:19:50,9,6,5698,247,5451,8.69%,4.33%
2020-01-01 00:19:50,9,7,25122,4183,20939,38.33%,16.65%
2020-01-01 00:19:50,9,8,9749,666,9083,14.88%,6.83%
2020-01-01 00:19:50,9,9,107,0,107,0.16%,0.00%
2020-01-01 00:19:50,9,10,2815,57,2758,4.30%,2.02%
2020-01-01 00:19:50,9,11,8698,530,8168,13.27%,6.09%
2020-01-01 00:19:50,9,12,5572,216,5356,8.50%,3.88%
2020-01-01 00:19:50,10,1,1595,210,1385,2.43%,13.17%
2020-01-01 00:19:50,10,2,3553,291,3262,5.42%,8.19%
2020-01-01 00:19:50,10,3,1772,38,1734,2.70%,2.14%
2020-01-01 00:19:50,10,4,3938,979,2959,6.01%,24.86%
2020-01-01 00:19:50,10,5,816,74,742,1.25%,9.07%
2020-01-01 00:19:50,10,6,5840,1158,4682,8.91%,19.83%
2020-01-01 00:19:50,10,7,11302,1908,9394,17.25%,16.88%
2020-01-01 00:19:50,10,8,28254,7017,21237,43.11%,24.84%
2020-01-01 00:19:50,10,9,713,7,706,1.09%,0.98%
2020-01-01 00:19:50,10,10,2145,39,2106,3.27%,1.82%
2020-01-01 00:19:50,10,11,12942,1621,11321,19.75%,12.53%
2020-01-01 00:19:50,10,12,10107,1192,8915,15.42%,11.79%
2020-01-01 00:19:50,11,1,2777,57,2720,4.24%,2.05%
2020-01-01 00:19:50,11,2,3703,89,3614,5.65%,2.40%
2020-01-01 00:19:50,11,3,720,4,716,1.10%,0.56%
2020-01-01 00:19:50,11,4,4129,113,4016,6.30%,2.74%
2020-01-01 00:19:50,11,5,154,1,153,0.23%,0.65%
2020-01-01 00:19:50,11,6,5099,169,4930,7.78%,3.31%
2020-01-01 00:19:50,11,7,10600,785,9815,16.17%,7.41%
2020-01-01 00:19:50,11,8,24293,4017,20276,37.07%,16.54%
2020-01-01 00:19:50,11,9,166,0,166,0.25%,0.00%
2020-01-01 00:19:50,11,10,2940,74,2866,4.49%,2.52%
2020-01-01 00:19:50,11,11,10032,762,9270,15.31%,7.60%
2020-01-01 00:19:50,11,12,6691,340,6351,10.21%,5.08%
2020-01-01 00:19:50,12,1,47,0,47,0.07%,0.00%
2020-01-01 00:19:50,12,2,664,165,499,1.01%,24.85%
2020-01-01 00:19:50,12,3,2671,211,2460,4.08%,7.90%
2020-01-01 00:19:50,12,4,3041,78,2963,4.64%,2.56%
2020-01-01 00:19:50,12,5,9177,786,8391,14.00%,8.56%
2020-01-01 00:19:50,12,6,5653,280,5373,8.63%,4.95%
2020-01-01 00:19:50,12,7,2413,29,2384,3.68%,1.20%
2020-01-01 00:19:50,12,8,2267,337,1930,3.46%,14.87%
2020-01-01 00:19:50,12,9,25305,5216,20089,38.61%,20.61%
2020-01-01 00:19:50,12,10,5257,506,4751,8.02%,9.63%
2020-01-01 00:19:50,12,11,2462,342,2120,3.76%,13.89%
2020-01-01 00:19:50,12,12,10180,1438,8742,15.53%,14.13%
2020-01-01 00:19:50,13,1,2547,52,2495,3.89%,2.04%
2020-01-01 00:19:50,13,2,2853,63,2790,4.35%,2.21%
2020-01-01 00:19:50,13,3,909,6,903,1.39%,0.66%
2020-01-01 00:19:50,13,4,4669,454,4215,7.12%,9.72%
2020-01-01 00:19:50,13,5,6954,704,6250,10.61%,10.12%
2020-01-01 00:19:50,13,6,5426,501,4925,8.28%,9.23%
2020-01-01 00:19:50,13,7,4981,188,4793,7.60%,3.77%
2020-01-01 00:19:50,13,8,7998,470,7528,12.20%,5.88%
2020-01-01 00:19:50,13,9,7280,735,6545,11.11%,10.10%
2020-01-01 00:19:50,13,10,27430,5547,21883,41.85%,20.22%
2020-01-01 00:19:50,13,11,17754,2572,15182,27.09%,14.49%
2020-01-01 00:19:50,13,12,9289,1067,8222,14.17%,11.49%
2020-01-01 00:19:50,14,1,293,1,292,0.45%,0.34%
2020-01-01 00:19:50,14,2,1209,7,1202,1.84%,0.58%
2020-01-01 00:19:50,14,3,704,2,702,1.07%,0.28%
2020-01-01 00:19:50,14,4,3660,94,3566,5.58%,2.57%
2020-01-01 00:19:50,14,5,1924,26,1898,2.94%,1.35%
2020-01-01 00:19:50,14,6,3856,100,3756,5.88%,2.59%
2020-01-01 00:19:50,14,7,11551,909,10642,17.63%,7.87%
2020-01-01 00:19:50,14,8,12801,1129,11672,19.53%,8.82%
2020-01-01 00:19:50,14,9,2057,27,2030,3.14%,1.31%
2020-01-01 00:19:50,14,10,4532,131,4401,6.92%,2.89%
2020-01-01 00:19:50,14,11,25308,4306,21002,38.62%,17.01%
2020-01-01 00:19:50,14,12,7765,430,7335,11.85%,5.54%
2020-01-01 00:19:50,15,1,718,5,713,1.10%,0.70%
2020-01-01 00:19:50,15,2,210,1,209,0.32%,0.48%
2020-01-01 00:19:50,15,3,3980,103,3877,6.07%,2.59%
2020-01-01 00:19:50,15,4,5523,229,5294,8.43%,4.15%
2020-01-01 00:19:50,15,5,10273,743,9530,15.68%,7.23%
2020-01-01 00:19:50,15,6,5845,256,5589,8.92%,4.38%
2020-01-01 00:19:50,15,7,3220,93,3127,4.91%,2.89%
2020-01-01 00:19:50,15,8,5814,270,5544,8.87%,4.64%
2020-01-01 00:19:50,15,9,10489,776,9713,16.00%,7.40%
2020-01-01 00:19:50,15,10,4711,223,4488,7.19%,4.73%
2020-01-01 00:19:50,15,11,10652,909,9743,16.25%,8.53%
2020-01-01 00:19:50,15,12,26261,4921,21340,40.07%,18.74%
2020-01-01 00:19:50,16,1,611,3,608,0.93%,0.49%
2020-01-01 00:19:50,16,2,230,0,230,0.35%,0.00%
2020-01-01 00:19:50,16,3,1397,19,1378,2.13%,1.36%
2020-01-01 00:19:50,16,4,4323,136,4187,6.60%,3.15%
2020-01-01 00:19:50,16,5,7653,487,7166,11.68%,6.36%
2020-01-01 00:19:50,16,6,5111,204,4907,7.80%,3.99%
2020-01-01 00:19:50,16,7,4131,115,4016,6.30%,2.78%
2020-01-01 00:19:50,16,8,7604,491,7113,11.60%,6.46%
2020-01-01 00:19:50,16,9,8109,531,7578,12.37%,6.55%
2020-01-01 00:19:50,16,10,1473,11,1462,2.25%,0.75%
2020-01-01 00:19:50,16,11,9359,700,8659,14.28%,7.48%
2020-01-01 00:19:50,16,12,25669,4529,21140,39.17%,17.64%
2020-01-01 00:20:00,1,1,29788,5877,23911,45.45%,19.73%
2020-01-01 00:20:00,1,2,16640,1887,14753,25.39%,11.34%
2020-01-01 00:20:00,1,3,2403,44,2359,3.67%,1.83%
2020-01-01 00:20:00,1,4,12714,1165,11549,19.40%,9.16%
2020-01-01 00:20:00,1,5,12306,1090,11216,18.78%,8.86%
2020-01-01 00:20:00,1,6,12250,1080,11170,18.69%,8.82%
2020-01-01 00:20:00,1,7,14219,1372,12847,21.70%,9.65%
2020-01-01 00:20:00,1,8,12055,995,11060,18.39%,8.25%
2020-01-01 00:20:00,1,9,12193,1070,11123,18.61%,8.78%
2020-01-01 00:20:00,1,10,11032,824,10208,16.83%,7.47%
2020-01-01 00:20:00,1,11,11155,840,10315,17.02%,7.53%
2020-01-01 00:20:00,1,12,12172,1068,11104,18.57%,8.77%
2020-01-01 00:20:00,2,1,748,5,743,1.14%,0.67%
2020-01-01 00:20:00,2,2,26272,4675,21597,40.09%,17.79%
2020-01-01 00:20:00,2,3,20474,2906,17568,31.24%,14.19%
2020-01-01 00:20:00,2,4,654,5,649,1.00%,0.76%
2020-01-01 00:20:00,2,5,12003,1057,10946,18.32%,8.81%
2020-01-01 00:20:00,2,6,22,0,22,0.03%,0.00%
2020-01-01 00:20:00,2,7,5034,195,4839,7.68%,3.87%
2020-01-01 00:20:00,2,8,4107,128,3979,6.27%,3.12%
2020-01-01 00:20:00,2,9,11868,1032,10836,18.11%,8.70%
2020-01-01 00:20:00,2,10,3301,81,3220,5.04%,2.45%
2020-01-01 00:20:00,2,11,3313,82,3231,5.06%,2.48%
2020-01-01 00:20:00,2,12,11699,1010,10689,17.85%,8.63%
2020-01-01 00:20:00,3,1,1320,15,1305,2.01%,1.14%
2020-01-01 00:20:00,3,2,26132,4691,21441,39.87%,17.95%
2020-01-01 00:20:00,3,3,66071,24330,41741,100.82%,36.82%
2020-01-01 00:20:00,3,4,6666,298,6368,10.17%,4.47%
2020-01-01 00:20:00,3,5,38843,9430,29413,59.27%,24.28%
2020-01-01 00:20:00,3,6,7331,355,6976,11.19%,4.84%
2020-01-01 00:20:00,3,7,21843,3352,18491,33.33%,15.35%
2020-01-01 00:20:00,3,8,16920,2048,14872,25.82%,12.10%
2020-01-01 00:20:00,3,9,31098,6281,24817,47.45%,20.20%
2020-01-01 00:20:00,3,10,5142,171,4971,7.85%,3.33%
2020-01-01 00:20:00,3,11,1616,24,1592,2.47%,1.49%
2020-01-01 00:20:00,3,12,22028,3244,18784,33.61%,14.73%
2020-01-01 00:20:00,4,1,522,2,520,0.80%,0.38%
2020-01-01 00:20:00,4,2,331,0,331,0.51%,0.00%
2020-01-01 00:20:00,4,3,707,1,706,1.08%,0.14%
2020-01-01 00:20:00,4,4,28102,5212,22890,42.88%,18.55%
2020-01-01 00:20:00,4,5,18121,2287,15834,27.65%,12.62%
2020-01-01 00:20:00,4,6,24287,3963,20324,37.06%,16.32%
2020-01-01 00:20:00,4,7,4970,169,4801,7.58%,3.40%
2020-01-01 00:20:00,4,8,2721,54,2667,4.15%,1.98%
2020-01-01 00:20:00,4,9,16114,1811,14303,24.59%,11.24%
2020-01-01 00:20:00,4,10,1910,24,1886,2.91%,1.26%
2020-01-01 00:20:00,4,11,153,0,153,0.23%,0.00%
2020-01-01 00:20:00,4,12,12928,1186,11742,19.73%,9.17%
2020-01-01 00:20:00,5,1,2874,66,2808,4.39%,2.30%
2020-01-01 00:20:00,5,2,801,5,796,1.22%,0.62%
2020-01-01 00:20:00,5,3,767,8,759,1.17%,1.04%
2020-01-01 00:20:00,5,4,25018,4170,20848,38.17%,16.67%
2020-01-01 00:20:00,5,5,10123,718,9405,15.45%,7.09%
2020-01-01 00:20:00,5,6,16742,1918,14824,25.55%,11.46%
2020-01-01 00:20:00,5,7,6138,294,5844,9.37%,4.79%
2020-01-01 00:20:00,5,8,3180,70,3110,4.85%,2.20%
2020-01-01 00:20:00,5,9,8965,560,8405,13.68%,6.25%
2020-01-01 00:20:00,5,10,1018,14,1004,1.55%,1.38%
2020-01-01 00:20:00,5,11,641,2,639,0.98%,0.31%
2020-01-01 00:20:00,5,12,7720,420,7300,11.78%,5.44%
2020-01-01 00:20:00,6,1,1122,17,1105,1.71%,1.52%
2020-01-01 00:20:00,6,2,1186,19,1167,1.81%,1.60%
2020-01-01 00:20:00,6,3,1711,29,1682,2.61%,1.69%
2020-01-01 00:20:00,6,4,1121,10,1111,1.71%,0.89%
2020-01-01 00:20:00,6,5,13845,1321,12524,21.13%,9.54%
2020-01-01 00:20:00,6,6,4591,163,4428,7.01%,3.55%
2020-01-01 00:20:00,6,7,2837,70,2767,4.33%,2.47%
2020-01-01 00:20:00,6,8,2164,40,2124,3.30%,1.85%
2020-01-01 00:20:00,6,9,7233,383,6850,11.04%,5.30%
2020-01-01 00:20:00,6,10,2252,33,2219,3.44%,1.47%
2020-01-01 00:20:00,6,11,517,4,513,0.79%,0.77%
2020-01-01 00:20:00,6,12,4858,166,4692,7.41%,3.42%
2020-01-01 00:20:00,7,1,551,2,549,0.84%,0.36%
2020-01-01 00:20:00,7,2,188,0,188,0.29%,0.00%
2020-01-01 00:20:00,7,3,1730,19,1711,2.64%,1.10%
2020-01-01 00:20:00,7,4,1592,21,1571,2.43%,1.32%
2020-01-01 00:20:00,7,5,8931,568,8363,13.63%,6.36%
2020-01-01 00:20:00,7,6,14055,1356,12699,21.45%,9.65%
2020-01-01 00:20:00,7,7,3481,88,3393,5.31%,2.53%
2020-01-01 00:20:00,7,8,1422,13,1409,2.17%,0.91%
2020-01-01 00:20:00,7,9,7157,376,6781,10.92%,5.25%
2020-01-01 00:20:00,7,10,2212,30,2182,3.38%,1.36%
2020-01-01 00:20:00,7,11,180,1,179,0.27%,0.56%
2020-01-01 00:20:00,7,12,4879,179,4700,7.44%,3.67%
2020-01-01 00:20:00,8,1,461,2,459,0.70%,0.43%
2020-01-01 00:20:00,8,2,92,1,91,0.14%,1.09%
2020-01-01 00:20:00,8,3,1559,21,1538,2.38%,1.35%
2020-01-01 00:20:00,8,4,3000,53,2947,4.58%,1.77%
2020-01-01 00:20:00,8,5,7924,479,7445,12.09%,6.04%
2020-01-01 00:20:00,8,6,16102,1933,14169,24.57%,12.00%
2020-01-01 00:20:00,8,7,5058,228,4830,7.72%,4.51%
2020-01-01 00:20:00,8,8,2051,43,2008,3.13%,2.10%
2020-01-01 00:20:00,8,9,6090,279,5811,9.29%,4.58%
2020-01-01 00:20:00,8,10,1681,19,1662,2.57%,1.13%
2020-01-01 00:20:00,8,11,207,1,206,0.32%,0.48%
2020-01-01 00:20:00,8,12,4347,139,4208,6.63%,3.20%
2020-01-01 00:20:00,9,1,1165,5,1160,1.78%,0.43%
2020-01-01 00:20:00,9,2,3361,91,3270,5.13%,2.71%
2020-01-01 00:20:00,9,3,1842,28,1814,2.81%,1.52%
2020-01-01 00:20:00,9,4,3562,88,3474,5.44%,2.47%
2020-01-01 00:20:00,9,5,230,1,229,0.35%,0.43%
2020-01-01 00:20:00,9,6,4130,116,4014,6.30%,2.81%
2020-01-01 00:20:00,9,7,26611,4621,21990,40.61%,17.36%
2020-01-01 00:20:00,9,8,12415,1053,11362,18.94%,8.48%
2020-01-01 00:20:00,9,9,126,1,125,0.19%,0.79%
2020-01-01 00:20:00,9,10,5526,209,5317,8.43%,3.78%
2020-01-01 00:20:00,9,11,11398,888,10510,17.39%,7.79%
2020-01-01 00:20:00,9,12,5586,226,5360,8.52%,4.05%
2020-01-01 00:20:00,10,1,1367,234,1133,2.09%,17.12%
2020-01-01 00:20:00,10,2,3385,308,3077,5.17%,9.10%
2020-01-01 00:20:00,10,3,1865,39,1826,2.85%,2.09%
2020-01-01 00:20:00,10,4,4130,963,3167,6.30%,23.32%
2020-01-01 00:20:00,10,5,734,51,683,1.12%,6.95%
2020-01-01 00:20:00,10,6,5858,1113,4745,8.94%,19.00%
2020-01-01 00:20:00,10,7,10933,1847,9086,16.68%,16.89%
2020-01-01 00:20:00,10,8,28669,7096,21573,43.75%,24.75%
2020-01-01 00:20:00,10,9,1019,10,1009,1.55%,0.98%
2020-01-01 00:20:00,10,10,2564,51,2513,3.91%,1.99%
2020-01-01 00:20:00,10,11,13918,1844,12074,21.24%,13.25%
2020-01-01 00:20:00,10,12,10608,1283,9325,16.19%,12.09%
2020-01-01 00:20:00,11,1,2690,50,2640,4.10%,1.86%
2020-01-01 00:20:00,11,2,3538,93,3445,5.40%,2.63%
2020-01-01 00:20:00,11,3,689,5,684,1.05%,0.73%
2020-01-01 00:20:00,11,4,3608,100,3508,5.51%,2.77%
2020-01-01 00:20:00,11,5,456,3,453,0.70%,0.66%
2020-01-01 00:20:00,11,6,4904,200,4704,7.48%,4.08%
2020-01-01 00:20:00,11,7,10596,826,9770,16.17%,7.80%
2020-01-01 00:20:00,11,8,24655,4203,20452,37.62%,17.05%
2020-01-01 00:20:00,11,9,192,0,192,0.29%,0.00%
2020-01-01 00:20:00,11,10,2935,71,2864,4.48%,2.42%
2020-01-01 00:20:00,11,11,9967,749,9218,15.21%,7.51%
2020-01-01 00:20:00,11,12,6661,350,6311,10.16%,5.25%
2020-01-01 00:20:00,12,1,29,0,29,0.04%,0.00%
2020-01-01 00:20:00,12,2,604,192,412,0.92%,31.79%
2020-01-01 00:20:00,12,3,2962,267,2695,4.52%,9.01%
2020-01-01 00:20:00,12,4,3383,91,3292,5.16%,2.69%
2020-01-01 00:20:00,12,5,10058,962,9096,15.35%,9.56%
2020-01-01 00:20:00,12,6,6276,346,5930,9.58%,5.51%
2020-01-01 00:20:00,12,7,2683,69,2614,4.09%,2.57%
2020-01-01 00:20:00,12,8,1535,283,1252,2.34%,18.44%
2020-01-01 00:20:00,12,9,24408,5015,19393,37.24%,20.55%
2020-01-01 00:20:00,12,10,4307,397,3910,6.57%,9.22%
2020-01-01 00:20:00,12,11,1664,284,1380,2.54%,17.07%
2020-01-01 00:20:00,12,12,9550,1251,8299,14.57%,13.10%
2020-01-01 00:20:00,13,1,2253,47,2206,3.44%,2.09%
2020-01-01 00:20:00,13,2,2598,68,2530,3.96%,2.62%
2020-01-01 00:20:00,13,3,794,5,789,1.21%,0.63%
2020-01-01 00:20:00,13,4,5729,569,5160,8.74%,9.93%
2020-01-01 00:20:00,13,5,7876,828,7048,12.02%,10.51%
2020-01-01 00:20:00,13,6,6464,613,5851,9.86%,9.48%
2020-01-01 00:20:00,13,7,5054,221,4833,7.71%,4.37%
2020-01-01 00:20:00,13,8,7309,402,6907,11.15%,5.50%
2020-01-01 00:20:00,13,9,8302,863,7439,12.67%,10.40%
2020-01-01 00:20:00,13,10,29082,6213,22869,44.38%,21.36%
2020-01-01 00:20:00,13,11,18044,2709,15335,27.53%,15.01%
2020-01-01 00:20:00,13,12,10261,1205,9056,15.66%,11.74%
2020-01-01 00:20:00,14,1,314,0,314,0.48%,0.00%
2020-01-01 00:20:00,14,2,1305,16,1289,1.99%,1.23%
2020-01-01 00:20:00,14,3,819,8,811,1.25%,0.98%
2020-01-01 00:20:00,14,4,4781,166,4615,7.30%,3.47%
2020-01-01 00:20:00,14,5,1649,25,1624,2.52%,1.52%
2020-01-01 00:20:00,14,6,5031,183,4848,7.68%,3.64%
2020-01-01 00:20:00,14,7,12606,1142,11464,19.24%,9.06%
2020-01-01 00:20:00,14,8,13866,1369,12497,21.16%,9.87%
2020-01-01 00:20:00,14,9,1764,29,1735,2.69%,1.64%
2020-01-01 00:20:00,14,10,4188,124,4064,6.39%,2.96%
2020-01-01 00:20:00,14,11,25444,4356,21088,38.82%,17.12%
2020-01-01 00:20:00,14,12,7148,390,6758,10.91%,5.46%
2020-01-01 00:20:00,15,1,493,3,490,0.75%,0.61%
2020-01-01 00:20:00,15,2,186,0,186,0.28%,0.00%
2020-01-01 00:20:00,15,3,3749,113,3636,5.72%,3.01%
2020-01-01 00:20:00,15,4,4976,166,4810,7.59%,3.34%
2020-01-01 00:20:00,15,5,9509,679,8830,14.51%,7.14%
2020-01-01 00:20:00,15,6,5191,186,5005,7.92%,3.58%
2020-01-01 00:20:00,15,7,3417,84,3333,5.21%,2.46%
2020-01-01 00:20:00,15,8,5903,283,5620,9.01%,4.79%
2020-01-01 00:20:00,15,9,9680,703,8977,14.77%,7.26%
2020-01-01 00:20:00,15,10,4254,140,4114,6.49%,3.29%
2020-01-01 00:20:00,15,11,10270,763,9507,15.67%,7.43%
2020-01-01 00:20:00,15,12,25811,4847,20964,39.38%,18.78%
2020-01-01 00:20:00,16,1,564,3,561,0.86%,0.53%
2020-01-01 00:20:00,16,2,185,3,182,0.28%,1.62%
2020-01-01 00:20:00,16,3,1657,23,1634,2.53%,1.39%
2020-01-01 00:20:00,16,4,4715,161,4554,7.19%,3.41%
2020-01-01 00:20:00,16,5,8355,589,7766,12.75%,7.05%
2020-01-01 00:20:00,16,6,5387,220,5167,8.22%,4.08%
2020-01-01 00:20:00,16,7,3670,93,3577,5.60%,2.53%
2020-01-01 00:20:00,16,8,7384,424,6960,11.27%,5.74%
2020-01-01 00:20:00,16,9,8831,650,8181,13.48%,7.36%
2020-01-01 00:20:00,16,10,1513,23,1490,2.31%,1.52%
2020-01-01 00:20:00,16,11,9189,626,8563,14.02%,6.81%
2020-01-01 00:20:00,16,12,26019,4588,21431,39.70%,17.63%
2020-01-01 00:20:10,1,1,21332,3071,18261,32.55%,14.40%
2020-01-01 00:20:10,1,2,8450,545,7905,12.89%,6.45%
2020-01-01 00:20:10,1,3,1548,17,1531,2.36%,1.10%
2020-01-01 00:20:10,1,4,12635,1135,11500,19.28%,8.98%
2020-01-01 00:20:10,1,5,12323,1080,11243,18.80%,8.76%
2020-01-01 00:20:10,1,6,12253,1068,11185,18.70%,8.72%
2020-01-01 00:20:10,1,7,6883,358,6525,10.50%,5.20%
2020-01-01 00:20:10,1,8,4347,144,4203,6.63%,3.31%
2020-01-01 00:20:10,1,9,12216,1064,11152,18.64%,8.71%
2020-01-01 00:20:10,1,10,3704,107,3597,5.65%,2.89%
2020-01-01 00:20:10,1,11,3807,112,3695,5.81%,2.94%
2020-01-01 00:20:10,1,12,12198,1060,11138,18.61%,8.69%
2020-01-01 00:20:10,2,1,951,6,945,1.45%,0.63%
2020-01-01 00:20:10,2,2,24137,3935,20202,36.83%,16.30%
2020-01-01 00:20:10,2,3,18987,2473,16514,28.97%,13.02%
2020-01-01 00:20:10,2,4,805,3,802,1.23%,0.37%
2020-01-01 00:20:10,2,5,10599,744,9855,16.17%,7.02%
2020-01-01 00:20:10,2,6,43,0,43,0.07%,0.00%
2020-01-01 00:20:10,2,7,4183,128,4055,6.38%,3.06%
2020-01-01 00:20:10,2,8,2777,77,2700,4.24%,2.77%
2020-01-01 00:20:10,2,9,10457,723,9734,15.96%,6.91%
2020-01-01 00:20:10,2,10,2235,50,2185,3.41%,2.24%
2020-01-01 00:20:10,2,11,2254,51,2203,3.44%,2.26%
2020-01-01 00:20:10,2,12,10327,708,9619,15.76%,6.86%
2020-01-01 00:20:10,3,1,1735,12,1723,2.65%,0.69%
2020-01-01 00:20:10,3,2,28171,5301,22870,42.99%,18.82%
2020-01-01 00:20:10,3,3,72263,28501,43762,110.26%,39.44%
2020-01-01 00:20:10,3,4,10861,878,9983,16.57%,8.08%
2020-01-01 00:20:10,3,5,42262,11238,31024,64.49%,26.59%
2020-01-01 00:20:10,3,6,11671,1029,10642,17.81%,8.82%
2020-01-01 00:20:10,3,7,24738,4207,20531,37.75%,17.01%
2020-01-01 00:20:10,3,8,21746,3312,18434,33.18%,15.23%
2020-01-01 00:20:10,3,9,30288,6121,24167,46.22%,20.21%
2020-01-01 00:20:10,3,10,4827,160,4667,7.37%,3.31%
2020-01-01 00:20:10,3,11,2455,52,2403,3.75%,2.12%
2020-01-01 00:20:10,3,12,22975,3636,19339,35.06%,15.83%
2020-01-01 00:20:10,4,1,531,2,529,0.81%,0.38%
2020-01-01 00:20:10,4,2,270,0,270,0.41%,0.00%
2020-01-01 00:20:10,4,3,888,10,878,1.35%,1.13%
2020-01-01 00:20:10,4,4,27994,5254,22740,42.72%,18.77%
2020-01-01 00:20:10,4,5,18407,2337,16070,28.09%,12.70%
2020-01-01 00:20:10,4,6,24143,3956,20187,36.84%,16.39%
2020-01-01 00:20:10,4,7,4444,133,4311,6.78%,2.99%
2020-01-01 00:20:10,4,8,2903,65,2838,4.43%,2.24%
2020-01-01 00:20:10,4,9,16346,1851,14495,24.94%,11.32%
2020-01-01 00:20:10,4,10,2220,49,2171,3.39%,2.21%
2020-01-01 00:20:10,4,11,146,0,146,0.22%,0.00%
2020-01-01 00:20:10,4,12,13221,1243,11978,20.17%,9.40%
2020-01-01 00:20:10,5,1,3266,78,3188,4.98%,2.39%
2020-01-01 00:20:10,5,2,924,6,918,1.41%,0.65%
2020-01-01 00:20:10,5,3,999,12,987,1.52%,1.20%
2020-01-01 00:20:10,5,4,27033,4907,22126,41.25%,18.15%
2020-01-01 00:20:10,5,5,10175,738,9437,15.53%,7.25%
2020-01-01 00:20:10,5,6,16589,1954,14635,25.31%,11.78%
2020-01-01 00:20:10,5,7,5872,261,5611,8.96%,4.44%
2020-01-01 00:20:10,5,8,4628,168,4460,7.06%,3.63%
2020-01-01 00:20:10,5,9,8866,573,8293,13.53%,6.46%
2020-01-01 00:20:10,5,10,1166,17,1149,1.78%,1.46%
2020-01-01 00:20:10,5,11,1048,15,1033,1.60%,1.43%
2020-01-01 00:20:10,5,12,7311,389,6922,11.16%,5.32%
2020-01-01 00:20:10,6,1,1102,12,1090,1.68%,1.09%
2020-01-01 00:20:10,6,2,1243,13,1230,1.90%,1.05%
2020-01-01 00:20:10,6,3,1570,16,1554,2.40%,1.02%
2020-01-01 00:20:10,6,4,1447,9,1438,2.21%,0.62%
2020-01-01 00:20:10,6,5,16595,1902,14693,25.32%,11.46%
2020-01-01 00:20:10,6,6,4457,143,4314,6.80%,3.21%
2020-01-01 00:20:10,6,7,2518,62,2456,3.84%,2.46%
2020-01-01 00:20:10,6,8,1902,36,1866,2.90%,1.89%
2020-01-01 00:20:10,6,9,10293,753,9540,15.71%,7.32%
2020-01-01 00:20:10,6,10,2483,40,2443,3.79%,1.61%
2020-01-01 00:20:10,6,11,479,1,478,0.73%,0.21%
2020-01-01 00:20:10,6,12,7744,443,7301,11.82%,5.72%
2020-01-01 00:20:10,7,1,373,3,370,0.57%,0.80%
2020-01-01 00:20:10,7,2,118,0,118,0.18%,0.00%
2020-01-01 00:20:10,7,3,1699,21,1678,2.59%,1.24%
2020-01-01 00:20:10,7,4,1695,36,1659,2.59%,2.12%
2020-01-01 00:20:10,7,5,8723,557,8166,13.31%,6.39%
2020-01-01 00:20:10,7,6,14165,1479,12686,21.61%,10.44%
2020-01-01 00:20:10,7,7,3703,123,3580,5.65%,3.32%
2020-01-01 00:20:10,7,8,1329,18,1311,2.03%,1.35%
2020-01-01 00:20:10,7,9,6962,336,6626,10.62%,4.83%
2020-01-01 00:20:10,7,10,1851,28,1823,2.82%,1.51%
2020-01-01 00:20:10,7,11,117,0,117,0.18%,0.00%
2020-01-01 00:20:10,7,12,5115,181,4934,7.80%,3.54%
2020-01-01 00:20:10,8,1,363,1,362,0.55%,0.28%
2020-01-01 00:20:10,8,2,79,0,79,0.12%,0.00%
2020-01-01 00:20:10,8,3,1340,13,1327,2.04%,0.97%
2020-01-01 00:20:10,8,4,2638,54,2584,4.03%,2.05%
2020-01-01 00:20:10,8,5,7784,467,7317,11.88%,6.00%
2020-01-01 00:20:10,8,6,16325,1884,14441,24.91%,11.54%
2020-01-01 00:20:10,8,7,5840,262,5578,8.91%,4.49%
2020-01-01 00:20:10,8,8,2185,49,2136,3.33%,2.24%
2020-01-01 00:20:10,8,9,6135,310,5825,9.36%,5.05%
2020-01-01 00:20:10,8,10,1924,29,1895,2.94%,1.51%
2020-01-01 00:20:10,8,11,327,1,326,0.50%,0.31%
2020-01-01 00:20:10,8,12,4080,134,3946,6.23%,3.28%
2020-01-01 00:20:10,9,1,1100,5,1095,1.68%,0.45%
2020-01-01 00:20:10,9,2,2898,60,2838,4.42%,2.07%
2020-01-01 00:20:10,9,3,1335,13,1322,2.04%,0.97%
2020-01-01 00:20:10,9,4,5451,237,5214,8.32%,4.35%
2020-01-01 00:20:10,9,5,299,1,298,0.46%,0.33%
2020-01-01 00:20:10,9,6,6129,294,5835,9.35%,4.80%
2020-01-01 00:20:10,9,7,24043,3879,20164,36.69%,16.13%
2020-01-01 00:20:10,9,8,9600,639,8961,14.65%,6.66%
2020-01-01 00:20:10,9,9,242,1,241,0.37%,0.41%
2020-01-01 00:20:10,9,10,2508,38,2470,3.83%,1.52%
2020-01-01 00:20:10,9,11,8497,502,7995,12.97%,5.91%
2020-01-01 00:20:10,9,12,5790,260,5530,8.83%,4.49%
2020-01-01 00:20:10,10,1,1413,408,1005,2.16%,28.87%
2020-01-01 00:20:10,10,2,3166,474,2692,4.83%,14.97%
2020-01-01 00:20:10,10,3,1578,29,1549,2.41%,1.84%
2020-01-01 00:20:10,10,4,4443,918,3525,6.78%,20.66%
2020-01-01 00:20:10,10,5,692,6,686,1.06%,0.87%
2020-01-01 00:20:10,10,6,6012,1002,5010,9.17%,16.67%
2020-01-01 00:20:10,10,7,11403,1971,9432,17.40%,17.28%
2020-01-01 00:20:10,10,8,28100,6935,21165,42.88%,24.68%
2020-01-01 00:20:10,10,9,589,2,587,0.90%,0.34%
2020-01-01 00:20:10,10,10,2537,44,2493,3.87%,1.73%
2020-01-01 00:20:10,10,11,12810,1631,11179,19.55%,12.73%
2020-01-01 00:20:10,10,12,9665,1170,8495,14.75%,12.11%
2020-01-01 00:20:10,11,1,2426,41,2385,3.70%,1.69%
2020-01-01 00:20:10,11,2,3592,87,3505,5.48%,2.42%
2020-01-01 00:20:10,11,3,1011,6,1005,1.54%,0.59%
2020-01-01 00:20:10,11,4,5626,217,5409,8.58%,3.86%
2020-01-01 00:20:10,11,5,451,2,449,0.69%,0.44%
2020-01-01 00:20:10,11,6,6863,335,6528,10.47%,4.88%
2020-01-01 00:20:10,11,7,12393,1076,11317,18.91%,8.68%
2020-01-01 00:20:10,11,8,26924,4802,22122,41.08%,17.84%
2020-01-01 00:20:10,11,9,293,0,293,0.45%,0.00%
2020-01-01 00:20:10,11,10,3207,73,3134,4.89%,2.28%
2020-01-01 00:20:10,11,11,9789,692,9097,14.94%,7.07%
2020-01-01 00:20:10,11,12,6370,292,6078,9.72%,4.58%
2020-01-01 00:20:10,12,1,52,0,52,0.08%,0.00%
2020-01-01 00:20:10,12,2,764,271,493,1.17%,35.47%
2020-01-01 00:20:10,12,3,3267,378,2889,4.99%,11.57%
2020-01-01 00:20:10,12,4,3405,116,3289,5.20%,3.41%
2020-01-01 00:20:10,12,5,10530,1082,9448,16.07%,10.28%
2020-01-01 00:20:10,12,6,6514,297,6217,9.94%,4.56%
2020-01-01 00:20:10,12,7,2926,49,2877,4.46%,1.67%
2020-01-01 00:20:10,12,8,1158,226,932,1.77%,19.52%
2020-01-01 00:20:10,12,9,22690,4512,18178,34.62%,19.89%
2020-01-01 00:20:10,12,10,3929,340,3589,6.00%,8.65%
2020-01-01 00:20:10,12,11,1397,226,1171,2.13%,16.18%
2020-01-01 00:20:10,12,12,7576,937,6639,11.56%,12.37%
2020-01-01 00:20:10,13,1,2195,37,2158,3.35%,1.69%
2020-01-01 00:20:10,13,2,2582,50,2532,3.94%,1.94%
2020-01-01 00:20:10,13,3,952,17,935,1.45%,1.79%
2020-01-01 00:20:10,13,4,5320,536,4784,8.12%,10.08%
2020-01-01 00:20:10,13,5,7717,917,6800,11.78%,11.88%
2020-01-01 00:20:10,13,6,6008,595,5413,9.17%,9.90%
2020-01-01 00:20:10,13,7,5013,190,4823,7.65%,3.79%
2020-01-01 00:20:10,13,8,6831,353,6478,10.42%,5.17%
2020-01-01 00:20:10,13,9,8036,951,7085,12.26%,11.83%
2020-01-01 00:20:10,13,10,27809,5738,22071,42.43%,20.63%
2020-01-01 00:20:10,13,11,16887,2355,14532,25.77%,13.95%
2020-01-01 00:20:10,13,12,9410,1016,8394,14.36%,10.80%
2020-01-01 00:20:10,14,1,476,2,474,0.73%,0.42%
2020-01-01 00:20:10,14,2,1917,47,1870,2.93%,2.45%
2020-01-01 00:20:10,14,3,1266,26,1240,1.93%,2.05%
2020-01-01 00:20:10,14,4,4560,159,4401,6.96%,3.49%
2020-01-01 00:20:10,14,5,1552,19,1533,2.37%,1.22%
2020-01-01 00:20:10,14,6,5017,192,4825,7.66%,3.83%
2020-01-01 00:20:10,14,7,12675,1183,11492,19.34%,9.33%
2020-01-01 00:20:10,14,8,14094,1431,12663,21.51%,10.15%
2020-01-01 00:20:10,14,9,1751,25,1726,2.67%,1.43%
2020-01-01 00:20:10,14,10,4199,107,4092,6.41%,2.55%
2020-01-01 00:20:10,14,11,25213,4268,20945,38.47%,16.93%
2020-01-01 00:20:10,14,12,6650,316,6334,10.15%,4.75%
2020-01-01 00:20:10,15,1,385,1,384,0.59%,0.26%
2020-01-01 00:20:10,15,2,157,0,157,0.24%,0.00%
2020-01-01 00:20:10,15,3,4178,148,4030,6.38%,3.54%
2020-01-01 00:20:10,15,4,4943,206,4737,7.54%,4.17%
2020-01-01 00:20:10,15,5,10251,780,9471,15.64%,7.61%
2020-01-01 00:20:10,15,6,5160,218,4942,7.87%,4.22%
2020-01-01 00:20:10,15,7,3692,153,3539,5.63%,4.14%
2020-01-01 00:20:10,15,8,5619,256,5363,8.57%,4.56%
2020-01-01 00:20:10,15,9,10399,807,9592,15.87%,7.76%
2020-01-01 00:20:10,15,10,4584,146,4438,6.99%,3.18%
2020-01-01 00:20:10,15,11,10374,763,9611,15.83%,7.35%
2020-01-01 00:20:10,15,12,26851,4987,21864,40.97%,18.57%
2020-01-01 00:20:10,16,1,422,1,421,0.64%,0.24%
2020-01-01 00:20:10,16,2,239,0,239,0.36%,0.00%
2020-01-01 00:20:10,16,3,2156,39,2117,3.29%,1.81%
2020-01-01 00:20:10,16,4,5509,259,5250,8.41%,4.70%
2020-01-01 00:20:10,16,5,9842,788,9054,15.02%,8.01%
2020-01-01 00:20:10,16,6,6334,316,6018,9.66%,4.99%
2020-01-01 00:20:10,16,7,3041,71,2970,4.64%,2.33%
2020-01-01 00:20:10,16,8,7391,448,6943,11.28%,6.06%
2020-01-01 00:20:10,16,9,10321,869,9452,15.75%,8.42%
2020-01-01 00:20:10,16,10,1559,12,1547,2.38%,0.77%
2020-01-01 00:20:10,16,11,9174,649,8525,14.00%,7.07%
2020-01-01 00:20:10,16,12,28472,5533,22939,43.44%,19.43%
2020-01-01 00:20:20,1,1,23191,3708,19483,35.39%,15.99%
2020-01-01 00:20:20,1,2,9105,602,8503,13.89%,6.61%
2020-01-01 00:20:20,1,3,784,7,777,1.20%,0.89%
2020-01-01 00:20:20,1,4,13677,1360,12317,20.87%,9.94%
2020-01-01 00:20:20,1,5,13569,1347,12222,20.70%,9.93%
2020-01-01 00:20:20,1,6,13414,1319,12095,20.47%,9.83%
2020-01-01 00:20:20,1,7,8311,502,7809,12.68%,6.04%
2020-01-01 00:20:20,1,8,7600,419,7181,11.60%,5.51%
2020-01-01 00:20:20,1,9,13385,1314,12071,20.42%,9.82%
2020-01-01 00:20:20,1,10,7105,349,6756,10.84%,4.91%
2020-01-01 00:20:20,1,11,7164,357,6807,10.93%,4.98%
2020-01-01 00:20:20,1,12,13364,1310,12054,20.39%,9.80%
2020-01-01 00:20:20,2,1,574,1,573,0.88%,0.17%
2020-01-01 00:20:20,2,2,26257,4604,21653,40.07%,17.53%
2020-01-01 00:20:20,2,3,20612,2923,17689,31.45%,14.18%
2020-01-01 00:20:20,2,4,532,1,531,0.81%,0.19%
2020-01-01 00:20:20,2,5,11487,989,10498,17.53%,8.61%
2020-01-01 00:20:20,2,6,40,0,40,0.06%,0.00%
2020-01-01 00:20:20,2,7,5063,190,4873,7.73%,3.75%
2020-01-01 00:20:20,2,8,4008,115,3893,6.12%,2.87%
2020-01-01 00:20:20,2,9,11377,980,10397,17.36%,8.61%
2020-01-01 00:20:20,2,10,3247,82,3165,4.95%,2.53%
2020-01-01 00:20:20,2,11,3250,82,3168,4.96%,2.52%
2020-01-01 00:20:20,2,12,11193,943,10250,17.08%,8.42%
2020-01-01 00:20:20,3,1,1437,16,1421,2.19%,1.11%
2020-01-01 00:20:20,3,2,24146,3997,20149,36.84%,16.55%
2020-01-01 00:20:20,3,3,71483,27876,43607,109.07%,39.00%
2020-01-01 00:20:20,3,4,6372,313,6059,9.72%,4.91%
2020-01-01 00:20:20,3,5,45633,12615,33018,69.63%,27.64%
2020-01-01 00:20:20,3,6,7679,440,7239,11.72%,5.73%
2020-01-01 00:20:20,3,7,21067,3062,18005,32.15%,14.53%
2020-01-01 00:20:20,3,8,15648,1709,13939,23.88%,10.92%
2020-01-01 00:20:20,3,9,37564,8824,28740,57.32%,23.49%
2020-01-01 00:20:20,3,10,4980,170,4810,7.60%,3.41%
2020-01-01 00:20:20,3,11,2075,22,2053,3.17%,1.06%
2020-01-01 00:20:20,3,12,28579,5313,23266,43.61%,18.59%
2020-01-01 00:20:20,4,1,392,1,391,0.60%,0.26%
2020-01-01 00:20:20,4,2,217,0,217,0.33%,0.00%
2020-01-01 00:20:20,4,3,1163,26,1137,1.77%,2.24%
2020-01-01 00:20:20,4,4,28179,5269,22910,43.00%,18.70%
2020-01-01 00:20:20,4,5,18024,2282,15742,27.50%,12.66%
2020-01-01 00:20:20,4,6,24751,4154,20597,37.77%,16.78%
2020-01-01 00:20:20,4,7,5390,206,5184,8.22%,3.82%
2020-01-01 00:20:20,4,8,2634,37,2597,4.02%,1.40%
2020-01-01 00:20:20,4,9,15557,1725,13832,23.74%,11.09%
2020-01-01 00:20:20,4,10,1901,26,1875,2.90%,1.37%
2020-01-01 00:20:20,4,11,141,0,141,0.22%,0.00%
2020-01-01 00:20:20,4,12,12984,1215,11769,19.81%,9.36%
2020-01-01 00:20:20,5,1,2905,64,2841,4.43%,2.20%
2020-01-01 00:20:20,5,2,664,3,661,1.01%,0.45%
2020-01-01 00:20:20,5,3,434,1,433,0.66%,0.23%
2020-01-01 00:20:20,5,4,24278,4066,20212,37.05%,16.75%
2020-01-01 00:20:20,5,5,10948,875,10073,16.71%,7.99%
2020-01-01 00:20:20,5,6,16976,2047,14929,25.90%,12.06%
2020-01-01 00:20:20,5,7,5628,267,5361,8.59%,4.74%
2020-01-01 00:20:20,5,8,3955,141,3814,6.03%,3.57%
2020-01-01 00:20:20,5,9,10341,794,9547,15.78%,7.68%
2020-01-01 00:20:20,5,10,1176,6,1170,1.79%,0.51%
2020-01-01 00:20:20,5,11,782,9,773,1.19%,1.15%
2020-01-01 00:20:20,5,12,8881,601,8280,13.55%,6.77%
2020-01-01 00:20:20,6,1,1223,15,1208,1.87%,1.23%
2020-01-01 00:20:20,6,2,1355,18,1337,2.07%,1.33%
2020-01-01 00:20:20,6,3,2095,31,2064,3.20%,1.48%
2020-01-01 00:20:20,6,4,1429,17,1412,2.18%,1.19%
2020-01-01 00:20:20,6,5,14575,1510,13065,22.24%,10.36%
2020-01-01 00:20:20,6,6,4049,156,3893,6.18%,3.85%
2020-01-01 00:20:20,6,7,2276,65,2211,3.47%,2.86%
2020-01-01 00:20:20,6,8,1748,34,1714,2.67%,1.95%
2020-01-01 00:20:20,6,9,8022,464,7558,12.24%,5.78%
2020-01-01 00:20:20,6,10,2020,29,1991,3.08%,1.44%
2020-01-01 00:20:20,6,11,426,3,423,0.65%,0.70%
2020-01-01 00:20:20,6,12,5911,247,5664,9.02%,4.18%
2020-01-01 00:20:20,7,1,336,3,333,0.51%,0.89%
2020-01-01 00:20:20,7,2,88,0,88,0.13%,0.00%
2020-01-01 00:20:20,7,3,1214,5,1209,1.85%,0.41%
2020-01-01 00:20:20,7,4,1376,15,1361,2.10%,1.09%
2020-01-01 00:20:20,7,5,8318,477,7841,12.69%,5.73%
2020-01-01 00:20:20,7,6,13258,1314,11944,20.23%,9.91%
2020-01-01 00:20:20,7,7,3480,146,3334,5.31%,4.20%
2020-01-01 00:20:20,7,8,1247,10,1237,1.90%,0.80%
2020-01-01 00:20:20,7,9,6992,344,6648,10.67%,4.92%
2020-01-01 00:20:20,7,10,1280,10,1270,1.95%,0.78%
2020-01-01 00:20:20,7,11,60,0,60,0.09%,0.00%
2020-01-01 00:20:20,7,12,5776,248,5528,8.81%,4.29%
2020-01-01 00:20:20,8,1,449,1,448,0.69%,0.22%
2020-01-01 00:20:20,8,2,56,0,56,0.09%,0.00%
2020-01-01 00:20:20,8,3,1342,10,1332,2.05%,0.75%
2020-01-01 00:20:20,8,4,2831,59,2772,4.32%,2.08%
2020-01-01 00:20:20,8,5,8629,540,8089,13.17%,6.26%
2020-01-01 00:20:20,8,6,16536,1973,14563,25.23%,11.93%
2020-01-01 00:20:20,8,7,5021,189,4832,7.66%,3.76%
2020-01-01 00:20:20,8,8,1478,22,1456,2.26%,1.49%
2020-01-01 00:20:20,8,9,6911,365,6546,10.55%,5.28%
2020-01-01 00:20:20,8,10,2330,51,2279,3.56%,2.19%
2020-01-01 00:20:20,8,11,219,1,218,0.33%,0.46%
2020-01-01 00:20:20,8,12,4513,140,4373,6.89%,3.10%
2020-01-01 00:20:20,9,1,2215,7,2208,3.38%,0.32%
2020-01-01 00:20:20,9,2,3780,70,3710,5.77%,1.85%
2020-01-01 00:20:20,9,3,1076,10,1066,1.64%,0.93%
2020-01-01 00:20:20,9,4,4738,181,4557,7.23%,3.82%
2020-01-01 00:20:20,9,5,319,1,318,0.49%,0.31%
2020-01-01 00:20:20,9,6,5483,238,5245,8.37%,4.34%
2020-01-01 00:20:20,9,7,27170,4890,22280,41.46%,18.00%
2020-01-01 00:20:20,9,8,11727,942,10785,17.89%,8.03%
2020-01-01 00:20:20,9,9,202,1,201,0.31%,0.50%
2020-01-01 00:20:20,9,10,4024,118,3906,6.14%,2.93%
2020-01-01 00:20:20,9,11,10313,722,9591,15.74%,7.00%
2020-01-01 00:20:20,9,12,5905,243,5662,9.01%,4.12%
2020-01-01 00:20:20,10,1,1199,194,1005,1.83%,16.18%
2020-01-01 00:20:20,10,2,2798,241,2557,4.27%,8.61%
2020-01-01 00:20:20,10,3,1374,11,1363,2.10%,0.80%
2020-01-01 00:20:20,10,4,4096,929,3167,6.25%,22.68%
2020-01-01 00:20:20,10,5,747,7,740,1.14%,0.94%
2020-01-01 00:20:20,10,6,6214,1077,5137,9.48%,17.33%
2020-01-01 00:20:20,10,7,11234,1770,9464,17.14%,15.76%
2020-01-01 00:20:20,10,8,28797,7167,21630,43.94%,24.89%
2020-01-01 00:20:20,10,9,507,1,506,0.77%,0.20%
2020-01-01 00:20:20,10,10,2230,27,2203,3.40%,1.21%
2020-01-01 00:20:20,10,11,13334,1794,11540,20.35%,13.45%
2020-01-01 00:20:20,10,12,10519,1299,9220,16.05%,12.35%
2020-01-01 00:20:20,11,1,2493,41,2452,3.80%,1.64%
2020-01-01 00:20:20,11,2,4221,147,4074,6.44%,3.48%
2020-01-01 00:20:20,11,3,1624,25,1599,2.48%,1.54%
2020-01-01 00:20:20,11,4,3737,101,3636,5.70%,2.70%
2020-01-01 00:20:20,11,5,198,0,198,0.30%,0.00%
2020-01-01 00:20:20,11,6,4495,151,4344,6.86%,3.36%
2020-01-01 00:20:20,11,7,10625,811,9814,16.21%,7.63%
2020-01-01 00:20:20,11,8,24701,4131,20570,37.69%,16.72%
2020-01-01 00:20:20,11,9,217,1,216,0.33%,0.46%
2020-01-01 00:20:20,11,10,2629,67,2562,4.01%,2.55%
2020-01-01 00:20:20,11,11,9982,784,9198,15.23%,7.85%
2020-01-01 00:20:20,11,12,6864,342,6522,10.47%,4.98%
2020-01-01 00:20:20,12,1,116,0,116,0.18%,0.00%
2020-01-01 00:20:20,12,2,865,227,638,1.32%,26.24%
2020-01-01 00:20:20,12,3,3530,306,3224,5.39%,8.67%
2020-01-01 00:20:20,12,4,2730,67,2663,4.17%,2.45%
2020-01-01 00:20:20,12,5,9861,953,8908,15.05%,9.66%
2020-01-01 00:20:20,12,6,5494,225,5269,8.38%,4.10%
2020-01-01 00:20:20,12,7,2582,45,2537,3.94%,1.74%
2020-01-01 00:20:20,12,8,912,297,615,1.39%,32.57%
2020-01-01 00:20:20,12,9,21633,4331,17302,33.01%,20.02%
2020-01-01 00:20:20,12,10,3407,362,3045,5.20%,10.63%
2020-01-01 00:20:20,12,11,1104,301,803,1.68%,27.26%
2020-01-01 00:20:20,12,12,7427,1099,6328,11.33%,14.80%
2020-01-01 00:20:20,13,1,2205,39,2166,3.36%,1.77%
2020-01-01 00:20:20,13,2,2636,49,2587,4.02%,1.86%
2020-01-01 00:20:20,13,3,833,17,816,1.27%,2.04%
2020-01-01 00:20:20,13,4,5163,423,4740,7.88%,8.19%
2020-01-01 00:20:20,13,5,7507,763,6744,11.45%,10.16%
2020-01-01 00:20:20,13,6,5922,492,5430,9.04%,8.31%
2020-01-01 00:20:20,13,7,5604,234,5370,8.55%,4.18%
2020-01-01 00:20:20,13,8,7760,443,7317,11.84%,5.71%
2020-01-01 00:20:20,13,9,7727,790,6937,11.79%,10.22%
2020-01-01 00:20:20,13,10,28316,5964,22352,43.21%,21.06%
2020-01-01 00:20:20,13,11,17946,2657,15289,27.38%,14.81%
2020-01-01 00:20:20,13,12,9662,1132,8530,14.74%,11.72%
2020-01-01 00:20:20,14,1,378,0,378,0.58%,0.00%
2020-01-01 00:20:20,14,2,1668,23,1645,2.55%,1.38%
2020-01-01 00:20:20,14,3,1106,12,1094,1.69%,1.08%
2020-01-01 00:20:20,14,4,4969,201,4768,7.58%,4.05%
2020-01-01 00:20:20,14,5,1304,12,1292,1.99%,0.92%
2020-01-01 00:20:20,14,6,5168,210,4958,7.89%,4.06%
2020-01-01 00:20:20,14,7,12110,1068,11042,18.48%,8.82%
2020-01-01 00:20:20,14,8,13966,1429,12537,21.31%,10.23%
2020-01-01 00:20:20,14,9,1408,14,1394,2.15%,0.99%
2020-01-01 00:20:20,14,10,4167,146,4021,6.36%,3.50%
2020-01-01 00:20:20,14,11,26161,4633,21528,39.92%,17.71%
2020-01-01 00:20:20,14,12,7797,460,7337,11.90%,5.90%
2020-01-01 00:20:20,15,1,545,0,545,0.83%,0.00%
2020-01-01 00:20:20,15,2,115,0,115,0.18%,0.00%
2020-01-01 00:20:20,15,3,3387,108,3279,5.17%,3.19%
2020-01-01 00:20:20,15,4,5128,223,4905,7.82%,4.35%
2020-01-01 00:20:20,15,5,10392,819,9573,15.86%,7.88%
2020-01-01 00:20:20,15,6,5409,239,5170,8.25%,4.42%
2020-01-01 00:20:20,15,7,3780,153,3627,5.77%,4.05%
2020-01-01 00:20:20,15,8,6012,324,5688,9.17%,5.39%
2020-01-01 00:20:20,15,9,10574,848,9726,16.13%,8.02%
2020-01-01 00:20:20,15,10,4942,184,4758,7.54%,3.72%
2020-01-01 00:20:20,15,11,11044,950,10094,16.85%,8.60%
2020-01-01 00:20:20,15,12,29118,5899,23219,44.43%,20.26%
2020-01-01 00:20:20,16,1,482,2,480,0.74%,0.41%
2020-01-01 00:20:20,16,2,309,0,309,0.47%,0.00%
2020-01-01 00:20:20,16,3,1141,7,1134,1.74%,0.61%
2020-01-01 00:20:20,16,4,4975,188,4787,7.59%,3.78%
2020-01-01 00:20:20,16,5,8011,518,7493,12.22%,6.47%
2020-01-01 00:20:20,16,6,5704,238,5466,8.70%,4.17%
2020-01-01 00:20:20,16,7,3459,71,3388,5.28%,2.05%
2020-01-01 00:20:20,16,8,7763,475,7288,11.85%,6.12%
2020-01-01 00:20:20,16,9,8463,568,7895,12.91%,6.71%
2020-01-01 00:20:20,16,10,1832,21,1811,2.80%,1.15%
2020-01-01 00:20:20,16,11,9954,737,9217,15.19%,7.40%
2020-01-01 00:20:20,16,12,26230,4655,21575,40.02%,17.75%
2020-01-01 00:20:30,1,1,12751,1254,11497,19.46%,9.83%
2020-01-01 00:20:30,1,2,5105,197,4908,7.79%,3.86%
2020-01-01 00:20:30,1,3,362,1,361,0.55%,0.28%
2020-01-01 00:20:30,1,4,7326,442,6884,11.18%,6.03%
2020-01-01 00:20:30,1,5,7040,422,6618,10.74%,5.99%
2020-01-01 00:20:30,1,6,6984,409,6575,10.66%,5.86%
2020-01-01 00:20:30,1,7,4720,170,4550,7.20%,3.60%
2020-01-01 00:20:30,1,8,3987,112,3875,6.08%,2.81%
2020-01-01 00:20:30,1,9,6934,406,6528,10.58%,5.86%
2020-01-01 00:20:30,1,10,3409,76,3333,5.20%,2.23%
2020-01-01 00:20:30,1,11,3488,85,3403,5.32%,2.44%
2020-01-01 00:20:30,1,12,6849,397,6452,10.45%,5.80%
2020-01-01 00:20:30,2,1,1288,14,1274,1.97%,1.09%
2020-01-01 00:20:30,2,2,30907,6211,24696,47.16%,20.10%
2020-01-01 00:20:30,2,3,22816,3529,19287,34.81%,15.47%
2020-01-01 00:20:30,2,4,1212,12,1200,1.85%,0.99%
2020-01-01 00:20:30,2,5,14194,1390,12804,21.66%,9.79%
2020-01-01 00:20:30,2,6,26,0,26,0.04%,0.00%
2020-01-01 00:20:30,2,7,6799,352,6447,10.37%,5.18%
2020-01-01 00:20:30,2,8,5891,267,5624,8.99%,4.53%
2020-01-01 00:20:30,2,9,14055,1362,12693,21.45%,9.69%
2020-01-01 00:20:30,2,10,5123,203,4920,7.82%,3.96%
2020-01-01 00:20:30,2,11,5146,204,4942,7.85%,3.96%
2020-01-01 00:20:30,2,12,13847,1326,12521,21.13%,9.58%
2020-01-01 00:20:30,3,1,1636,25,1611,2.50%,1.53%
2020-01-01 00:20:30,3,2,24238,4084,20154,36.98%,16.85%
2020-01-01 00:20:30,3,3,76168,31125,45043,116.22%,40.86%
2020-01-01 00:20:30,3,4,8373,546,7827,12.78%,6.52%
2020-01-01 00:20:30,3,5,50333,15160,35173,76.80%,30.12%
2020-01-01 00:20:30,3,6,9888,740,9148,15.09%,7.48%
2020-01-01 00:20:30,3,7,20889,3068,17821,31.87%,14.69%
2020-01-01 00:20:30,3,8,17465,2181,15284,26.65%,12.49%
2020-01-01 00:20:30,3,9,39628,9825,29803,60.47%,24.79%
2020-01-01 00:20:30,3,10,5402,198,5204,8.24%,3.67%
2020-01-01 00:20:30,3,11,2229,42,2187,3.40%,1.88%
2020-01-01 00:20:30,3,12,31637,6583,25054,48.27%,20.81%
2020-01-01 00:20:30,4,1,434,1,433,0.66%,0.23%
2020-01-01 00:20:30,4,2,262,0,262,0.40%,0.00%
2020-01-01 00:20:30,4,3,1274,16,1258,1.94%,1.26%
2020-01-01 00:20:30,4,4,27441,4986,22455,41.87%,18.17%
2020-01-01 00:20:30,4,5,17752,2130,15622,27.09%,12.00%
2020-01-01 00:20:30,4,6,23368,3692,19676,35.66%,15.80%
2020-01-01 00:20:30,4,7,4409,136,4273,6.73%,3.08%
2020-01-01 00:20:30,4,8,2844,58,2786,4.34%,2.04%
2020-01-01 00:20:30,4,9,15549,1645,13904,23.73%,10.58%
2020-01-01 00:20:30,4,10,2028,39,1989,3.09%,1.92%
2020-01-01 00:20:30,4,11,145,0,145,0.22%,0.00%
2020-01-01 00:20:30,4,12,12860,1143,11717,19.62%,8.89%
2020-01-01 00:20:30,5,1,2062,32,2030,3.15%,1.55%
2020-01-01 00:20:30,5,2,596,0,596,0.91%,0.00%
2020-01-01 00:20:30,5,3,434,0,434,0.66%,0.00%
2020-01-01 00:20:30,5,4,20443,2926,17517,31.19%,14.31%
2020-01-01 00:20:30,5,5,9503,658,8845,14.50%,6.92%
2020-01-01 00:20:30,5,6,14382,1487,12895,21.95%,10.34%
2020-01-01 00:20:30,5,7,4493,166,4327,6.86%,3.69%
2020-01-01 00:20:30,5,8,3535,100,3435,5.39%,2.83%
2020-01-01 00:20:30,5,9,8913,577,8336,13.60%,6.47%
2020-01-01 00:20:30,5,10,1174,16,1158,1.79%,1.36%
2020-01-01 00:20:30,5,11,841,8,833,1.28%,0.95%
2020-01-01 00:20:30,5,12,7330,385,6945,11.18%,5.25%
2020-01-01 00:20:30,6,1,1000,7,993,1.53%,0.70%
2020-01-01 00:20:30,6,2,1163,15,1148,1.77%,1.29%
2020-01-01 00:20:30,6,3,1664,27,1637,2.54%,1.62%
2020-01-01 00:20:30,6,4,1692,8,1684,2.58%,0.47%
2020-01-01 00:20:30,6,5,17118,2068,15050,26.12%,12.08%
2020-01-01 00:20:30,6,6,4378,139,4239,6.68%,3.17%
2020-01-01 00:20:30,6,7,2301,59,2242,3.51%,2.56%
2020-01-01 00:20:30,6,8,1783,41,1742,2.72%,2.30%
2020-01-01 00:20:30,6,9,10750,851,9899,16.40%,7.92%
2020-01-01 00:20:30,6,10,2170,42,2128,3.31%,1.94%
2020-01-01 00:20:30,6,11,406,0,406,0.62%,0.00%
2020-01-01 00:20:30,6,12,8458,535,7923,12.91%,6.33%
2020-01-01 00:20:30,7,1,380,4,376,0.58%,1.05%
2020-01-01 00:20:30,7,2,193,0,193,0.29%,0.00%
2020-01-01 00:20:30,7,3,1374,15,1359,2.10%,1.09%
2020-01-01 00:20:30,7,4,1604,21,1583,2.45%,1.31%
2020-01-01 00:20:30,7,5,7690,431,7259,11.73%,5.60%
2020-01-01 00:20:30,7,6,12516,1110,11406,19.10%,8.87%
2020-01-01 00:20:30,7,7,3190,55,3135,4.87%,1.72%
2020-01-01 00:20:30,7,8,931,3,928,1.42%,0.32%
2020-01-01 00:20:30,7,9,6207,293,5914,9.47%,4.72%
2020-01-01 00:20:30,7,10,1312,13,1299,2.00%,0.99%
2020-01-01 00:20:30,7,11,95,0,95,0.14%,0.00%
2020-01-01 00:20:30,7,12,4900,184,4716,7.48%,3.76%
2020-01-01 00:20:30,8,1,420,0,420,0.64%,0.00%
2020-01-01 00:20:30,8,2,118,1,117,0.18%,0.85%
2020-01-01 00:20:30,8,3,1624,29,1595,2.48%,1.79%
2020-01-01 00:20:30,8,4,2931,64,2867,4.47%,2.18%
2020-01-01 00:20:30,8,5,9048,560,8488,13.81%,6.19%
2020-01-01 00:20:30,8,6,17412,2067,15345,26.57%,11.87%
2020-01-01 00:20:30,8,7,5289,201,5088,8.07%,3.80%
2020-01-01 00:20:30,8,8,1909,34,1875,2.91%,1.78%
2020-01-01 00:20:30,8,9,7208,348,6860,11.00%,4.83%
2020-01-01 00:20:30,8,10,1877,30,1847,2.86%,1.60%
2020-01-01 00:20:30,8,11,290,3,287,0.44%,1.03%
2020-01-01 00:20:30,8,12,5218,180,5038,7.96%,3.45%
2020-01-01 00:20:30,9,1,314,1,313,0.48%,0.32%
2020-01-01 00:20:30,9,2,3307,84,3223,5.05%,2.54%
2020-01-01 00:20:30,9,3,2592,55,2537,3.96%,2.12%
2020-01-01 00:20:30,9,4,10115,706,9409,15.43%,6.98%
2020-01-01 00:20:30,9,5,241,2,239,0.37%,0.83%
2020-01-01 00:20:30,9,6,10912,833,10079,16.65%,7.63%
2020-01-01 00:20:30,9,7,31343,6423,24920,47.83%,20.49%
2020-01-01 00:20:30,9,8,11233,910,10323,17.14%,8.10%
2020-01-01 00:20:30,9,9,208,1,207,0.32%,0.48%
2020-01-01 00:20:30,9,10,4382,127,4255,6.69%,2.90%
2020-01-01 00:20:30,9,11,9949,727,9222,15.18%,7.31%
2020-01-01 00:20:30,9,12,5209,184,5025,7.95%,3.53%
2020-01-01 00:20:30,10,1,972,272,700,1.48%,27.98%
2020-01-01 00:20:30,10,2,2817,321,2496,4.30%,11.40%
2020-01-01 00:20:30,10,3,1527,16,1511,2.33%,1.05%
2020-01-01 00:20:30,10,4,4141,919,3222,6.32%,22.19%
2020-01-01 00:20:30,10,5,601,1,600,0.92%,0.17%
2020-01-01 00:20:30,10,6,6056,1032,5024,9.24%,17.04%
2020-01-01 00:20:30,10,7,11390,1861,9529,17.38%,16.34%
2020-01-01 00:20:30,10,8,27693,6742,20951,42.26%,24.35%
2020-01-01 00:20:30,10,9,602,5,597,0.92%,0.83%
2020-01-01 00:20:30,10,10,2092,38,2054,3.19%,1.82%
2020-01-01 00:20:30,10,11,12041,1429,10612,18.37%,11.87%
2020-01-01 00:20:30,10,12,9424,1046,8378,14.38%,11.10%
2020-01-01 00:20:30,11,1,1929,38,1891,2.94%,1.97%
2020-01-01 00:20:30,11,2,3336,93,3243,5.09%,2.79%
2020-01-01 00:20:30,11,3,1224,10,1214,1.87%,0.82%
2020-01-01 00:20:30,11,4,3746,98,3648,5.72%,2.62%
2020-01-01 00:20:30,11,5,179,1,178,0.27%,0.56%
2020-01-01 00:20:30,11,6,4400,152,4248,6.71%,3.45%
2020-01-01 00:20:30,11,7,9689,722,8967,14.78%,7.45%
2020-01-01 00:20:30,11,8,24032,3960,20072,36.67%,16.48%
2020-01-01 00:20:30,11,9,125,0,125,0.19%,0.00%
2020-01-01 00:20:30,11,10,2696,47,2649,4.11%,1.74%
2020-01-01 00:20:30,11,11,11330,948,10382,17.29%,8.37%
2020-01-01 00:20:30,11,12,8409,515,7894,12.83%,6.12%
2020-01-01 00:20:30,12,1,127,0,127,0.19%,0.00%
2020-01-01 00:20:30,12,2,695,264,431,1.06%,37.99%
2020-01-01 00:20:30,12,3,2592,312,2280,3.96%,12.04%
2020-01-01 00:20:30,12,4,2522,50,2472,3.85%,1.98%
2020-01-01 00:20:30,12,5,8580,767,7813,13.09%,8.94%
2020-01-01 00:20:30,12,6,4975,180,4795,7.59%,3.62%
2020-01-01 00:20:30,12,7,2358,41,2317,3.60%,1.74%
2020-01-01 00:20:30,12,8,827,204,623,1.26%,24.67%
2020-01-01 00:20:30,12,9,20493,3968,16525,31.27%,19.36%
2020-01-01 00:20:30,12,10,3105,264,2841,4.74%,8.50%
2020-01-01 00:20:30,12,11,1024,205,819,1.56%,20.02%
2020-01-01 00:20:30,12,12,7220,1044,6176,11.02%,14.46%
2020-01-01 00:20:30,13,1,2356,43,2313,3.59%,1.83%
2020-01-01 00:20:30,13,2,2711,59,2652,4.14%,2.18%
2020-01-01 00:20:30,13,3,564,2,562,0.86%,0.35%
2020-01-01 00:20:30,13,4,3960,527,3433,6.04%,13.31%
2020-01-01 00:20:30,13,5,6096,769,5327,9.30%,12.61%
2020-01-01 00:20:30,13,6,4801,582,4219,7.33%,12.12%
2020-01-01 00:20:30,13,7,5606,243,5363,8.55%,4.33%
2020-01-01 00:20:30,13,8,7159,378,6781,10.92%,5.28%
2020-01-01 00:20:30,13,9,6579,813,5766,10.04%,12.36%
2020-01-01 00:20:30,13,10,25680,4986,20694,39.18%,19.42%
2020-01-01 00:20:30,13,11,16016,2078,13938,24.44%,12.97%
2020-01-01 00:20:30,13,12,8342,812,7530,12.73%,9.73%
2020-01-01 00:20:30,14,1,489,3,486,0.75%,0.61%
2020-01-01 00:20:30,14,2,1629,18,1611,2.49%,1.10%
2020-01-01 00:20:30,14,3,946,4,942,1.44%,0.42%
2020-01-01 00:20:30,14,4,11841,1092,10749,18.07%,9.22%
2020-01-01 00:20:30,14,5,1181,8,1173,1.80%,0.68%
2020-01-01 00:20:30,14,6,12191,1143,11048,18.60%,9.38%
2020-01-01 00:20:30,14,7,18733,2506,16227,28.58%,13.38%
2020-01-01 00:20:30,14,8,20496,2934,17562,31.27%,14.31%
2020-01-01 00:20:30,14,9,1432,14,1418,2.19%,0.98%
2020-01-01 00:20:30,14,10,4086,142,3944,6.23%,3.48%
2020-01-01 00:20:30,14,11,33079,7145,25934,50.47%,21.60%
2020-01-01 00:20:30,14,12,8238,481,7757,12.57%,5.84%
2020-01-01 00:20:30,15,1,559,1,558,0.85%,0.18%
2020-01-01 00:20:30,15,2,120,0,120,0.18%,0.00%
2020-01-01 00:20:30,15,3,3647,94,3553,5.56%,2.58%
2020-01-01 00:20:30,15,4,4861,158,4703,7.42%,3.25%
2020-01-01 00:20:30,15,5,10335,735,9600,15.77%,7.11%
2020-01-01 00:20:30,15,6,5095,181,4914,7.77%,3.55%
2020-01-01 00:20:30,15,7,3449,89,3360,5.26%,2.58%
2020-01-01 00:20:30,15,8,5039,202,4837,7.69%,4.01%
2020-01-01 00:20:30,15,9,10524,765,9759,16.06%,7.27%
2020-01-01 00:20:30,15,10,4517,193,4324,6.89%,4.27%
2020-01-01 00:20:30,15,11,9783,767,9016,14.93%,7.84%
2020-01-01 00:20:30,15,12,25902,4891,21011,39.52%,18.88%
2020-01-01 00:20:30,16,1,415,1,414,0.63%,0.24%
2020-01-01 00:20:30,16,2,211,0,211,0.32%,0.00%
2020-01-01 00:20:30,16,3,1342,10,1332,2.05%,0.75%
2020-01-01 00:20:30,16,4,4333,141,4192,6.61%,3.25%
2020-01-01 00:20:30,16,5,7812,513,7299,11.92%,6.57%
2020-01-01 00:20:30,16,6,5327,203,5124,8.13%,3.81%
2020-01-01 00:20:30,16,7,3371,111,3260,5.14%,3.29%
2020-01-01 00:20:30,16,8,7178,411,6767,10.95%,5.73%
2020-01-01 00:20:30,16,9,8211,560,7651,12.53%,6.82%
2020-01-01 00:20:30,16,10,3412,107,3305,5.21%,3.14%
2020-01-01 00:20:30,16,11,10795,970,9825,16.47%,8.99%
2020-01-01 00:20:30,16,12,26940,5022,21918,41.11%,18.64%
2020-01-01 00:20:40,1,1,17585,2207,15378,26.83%,12.55%
2020-01-01 00:20:40,1,2,6354,322,6032,9.70%,5.07%
2020-01-01 00:20:40,1,3,733,2,731,1.12%,0.27%
2020-01-01 00:20:40,1,4,10923,906,10017,16.67%,8.29%
2020-01-01 00:20:40,1,5,10579,851,9728,16.14%,8.04%
2020-01-01 00:20:40,1,6,10577,858,9719,16.14%,8.11%
2020-01-01 00:20:40,1,7,5600,255,5345,8.54%,4.55%
2020-01-01 00:20:40,1,8,5122,206,4916,7.82%,4.02%
2020-01-01 00:20:40,1,9,10510,841,9669,16.04%,8.00%
2020-01-01 00:20:40,1,10,4470,163,4307,6.82%,3.65%
2020-01-01 00:20:40,1,11,4528,164,4364,6.91%,3.62%
2020-01-01 00:20:40,1,12,10460,833,9627,15.96%,7.96%
2020-01-01 00:20:40,2,1,838,26,812,1.28%,3.10%
2020-01-01 00:20:40,2,2,25055,4200,20855,38.23%,16.76%
2020-01-01 00:20:40,2,3,18973,2452,16521,28.95%,12.92%
2020-01-01 00:20:40,2,4,746,25,721,1.14%,3.35%
2020-01-01 00:20:40,2,5,13109,1156,11953,20.00%,8.82%
2020-01-01 00:20:40,2,6,35,0,35,0.05%,0.00%
2020-01-01 00:20:40,2,7,5205,209,4996,7.94%,4.02%
2020-01-01 00:20:40,2,8,3236,94,3142,4.94%,2.90%
2020-01-01 00:20:40,2,9,12951,1123,11828,19.76%,8.67%
2020-01-01 00:20:40,2,10,2575,50,2525,3.93%,1.94%
2020-01-01 00:20:40,2,11,2600,51,2549,3.97%,1.96%
2020-01-01 00:20:40,2,12,12779,1095,11684,19.50%,8.57%
2020-01-01 00:20:40,3,1,1715,18,1697,2.62%,1.05%
2020-01-01 00:20:40,3,2,23974,3916,20058,36.58%,16.33%
2020-01-01 00:20:40,3,3,70804,27629,43175,108.04%,39.02%
2020-01-01 00:20:40,3,4,8429,500,7929,12.86%,5.93%
2020-01-01 00:20:40,3,5,45103,12558,32545,68.82%,27.84%
2020-01-01 00:20:40,3,6,9520,625,8895,14.53%,6.57%
2020-01-01 00:20:40,3,7,20637,2959,17678,31.49%,14.34%
2020-01-01 00:20:40,3,8,16891,2010,14881,25.77%,11.90%
2020-01-01 00:20:40,3,9,35211,8006,27205,53.73%,22.74%
2020-01-01 00:20:40,3,10,4042,110,3932,6.17%,2.72%
2020-01-01 00:20:40,3,11,2223,48,2175,3.39%,2.16%
2020-01-01 00:20:40,3,12,28468,5390,23078,43.44%,18.93%
2020-01-01 00:20:40,4,1,547,3,544,0.83%,0.55%
2020-01-01 00:20:40,4,2,305,0,305,0.47%,0.00%
2020-01-01 00:20:40,4,3,1042,12,1030,1.59%,1.15%
2020-01-01 00:20:40,4,4,27898,5180,22718,42.57%,18.57%
2020-01-01 00:20:40,4,5,17549,2109,15440,26.78%,12.02%
2020-01-01 00:20:40,4,6,24141,3958,20183,36.84%,16.40%
2020-01-01 00:20:40,4,7,5337,217,5120,8.14%,4.07%
2020-01-01 00:20:40,4,8,2982,68,2914,4.55%,2.28%
2020-01-01 00:20:40,4,9,15389,1642,13747,23.48%,10.67%
2020-01-01 00:20:40,4,10,2301,53,2248,3.51%,2.30%
2020-01-01 00:20:40,4,11,141,0,141,0.22%,0.00%
2020-01-01 00:20:40,4,12,12435,1100,11335,18.97%,8.85%
2020-01-01 00:20:40,5,1,3173,75,3098,4.84%,2.36%
2020-01-01 00:20:40,5,2,863,8,855,1.32%,0.93%
2020-01-01 00:20:40,5,3,434,2,432,0.66%,0.46%
2020-01-01 00:20:40,5,4,23235,3692,19543,35.45%,15.89%
2020-01-01 00:20:40,5,5,10180,771,9409,15.53%,7.57%
2020-01-01 00:20:40,5,6,15196,1635,13561,23.19%,10.76%
2020-01-01 00:20:40,5,7,4516,178,4338,6.89%,3.94%
2020-01-01 00:20:40,5,8,3453,87,3366,5.27%,2.52%
2020-01-01 00:20:40,5,9,9616,707,8909,14.67%,7.35%
2020-01-01 00:20:40,5,10,1165,15,1150,1.78%,1.29%
2020-01-01 00:20:40,5,11,770,7,763,1.17%,0.91%
2020-01-01 00:20:40,5,12,7448,426,7022,11.36%,5.72%
2020-01-01 00:20:40,6,1,1092,6,1086,1.67%,0.55%
2020-01-01 00:20:40,6,2,1183,7,1176,1.81%,0.59%
2020-01-01 00:20:40,6,3,1830,20,1810,2.79%,1.09%
2020-01-01 00:20:40,6,4,1341,37,1304,2.05%,2.76%
2020-01-01 00:20:40,6,5,16749,2004,14745,25.56%,11.96%
2020-01-01 00:20:40,6,6,4208,170,4038,6.42%,4.04%
2020-01-01 00:20:40,6,7,2440,44,2396,3.72%,1.80%
2020-01-01 00:20:40,6,8,1975,33,1942,3.01%,1.67%
2020-01-01 00:20:40,6,9,10382,753,9629,15.84%,7.25%
2020-01-01 00:20:40,6,10,2286,33,2253,3.49%,1.44%
2020-01-01 00:20:40,6,11,435,0,435,0.66%,0.00%
2020-01-01 00:20:40,6,12,8036,466,7570,12.26%,5.80%
2020-01-01 00:20:40,7,1,245,2,243,0.37%,0.82%
2020-01-01 00:20:40,7,2,202,0,202,0.31%,0.00%
2020-01-01 00:20:40,7,3,1416,13,1403,2.16%,0.92%
2020-01-01 00:20:40,7,4,1182,8,1174,1.80%,0.68%
2020-01-01 00:20:40,7,5,7575,409,7166,11.56%,5.40%
2020-01-01 00:20:40,7,6,12288,1027,11261,18.75%,8.36%
2020-01-01 00:20:40,7,7,3496,90,3406,5.33%,2.57%
2020-01-01 00:20:40,7,8,1113,11,1102,1.70%,0.99%
2020-01-01 00:20:40,7,9,5960,249,5711,9.09%,4.18%
2020-01-01 00:20:40,7,10,1165,13,1152,1.78%,1.12%
2020-01-01 00:20:40,7,11,269,1,268,0.41%,0.37%
2020-01-01 00:20:40,7,12,4811,169,4642,7.34%,3.51%
2020-01-01 00:20:40,8,1,436,3,433,0.67%,0.69%
2020-01-01 00:20:40,8,2,146,0,146,0.22%,0.00%
2020-01-01 00:20:40,8,3,1695,14,1681,2.59%,0.83%
2020-01-01 00:20:40,8,4,2683,48,2635,4.09%,1.79%
2020-01-01 00:20:40,8,5,8967,597,8370,13.68%,6.66%
2020-01-01 00:20:40,8,6,16998,2013,14985,25.94%,11.84%
2020-01-01 00:20:40,8,7,5325,186,5139,8.13%,3.49%
2020-01-01 00:20:40,8,8,1912,33,1879,2.92%,1.73%
2020-01-01 00:20:40,8,9,7093,381,6712,10.82%,5.37%
2020-01-01 00:20:40,8,10,1738,25,1713,2.65%,1.44%
2020-01-01 00:20:40,8,11,228,0,228,0.35%,0.00%
2020-01-01 00:20:40,8,12,5303,230,5073,8.09%,4.34%
2020-01-01 00:20:40,9,1,818,1,817,1.25%,0.12%
2020-01-01 00:20:40,9,2,2964,54,2910,4.52%,1.82%
2020-01-01 00:20:40,9,3,1340,8,1332,2.04%,0.60%
2020-01-01 00:20:40,9,4,7004,366,6638,10.69%,5.23%
2020-01-01 00:20:40,9,5,442,3,439,0.67%,0.68%
2020-01-01 00:20:40,9,6,7929,468,7461,12.10%,5.90%
2020-01-01 00:20:40,9,7,28966,5623,23343,44.20%,19.41%
2020-01-01 00:20:40,9,8,11001,968,10033,16.79%,8.80%
2020-01-01 00:20:40,9,9,322,2,320,0.49%,0.62%
2020-01-01 00:20:40,9,10,3631,107,3524,5.54%,2.95%
2020-01-01 00:20:40,9,11,9806,776,9030,14.96%,7.91%
2020-01-01 00:20:40,9,12,5919,272,5647,9.03%,4.60%
2020-01-01 00:20:40,10,1,1094,287,807,1.67%,26.23%
2020-01-01 00:20:40,10,2,4795,433,4362,7.32%,9.03%
2020-01-01 00:20:40,10,3,3421,109,3312,5.22%,3.19%
2020-01-01 00:20:40,10,4,5429,923,4506,8.28%,17.00%
2020-01-01 00:20:40,10,5,478,2,476,0.73%,0.42%
2020-01-01 00:20:40,10,6,7211,1088,6123,11.00%,15.09%
2020-01-01 00:20:40,10,7,13861,2180,11681,21.15%,15.73%
2020-01-01 00:20:40,10,8,32185,8335,23850,49.11%,25.90%
2020-01-01 00:20:40,10,9,843,4,839,1.29%,0.47%
2020-01-01 00:20:40,10,10,2689,49,2640,4.10%,1.82%
2020-01-01 00:20:40,10,11,13010,1545,11465,19.85%,11.88%
2020-01-01 00:20:40,10,12,9763,1043,8720,14.90%,10.68%
2020-01-01 00:20:40,11,1,1893,38,1855,2.89%,2.01%
2020-01-01 00:20:40,11,2,2906,99,2807,4.43%,3.41%
2020-01-01 00:20:40,11,3,813,20,793,1.24%,2.46%
2020-01-01 00:20:40,11,4,3225,92,3133,4.92%,2.85%
2020-01-01 00:20:40,11,5,513,1,512,0.78%,0.19%
2020-01-01 00:20:40,11,6,4356,137,4219,6.65%,3.15%
2020-01-01 00:20:40,11,7,9059,610,8449,13.82%,6.73%
2020-01-01 00:20:40,11,8,22939,3576,19363,35.00%,15.59%
2020-01-01 00:20:40,11,9,220,1,219,0.34%,0.45%
2020-01-01 00:20:40,11,10,3556,91,3465,5.43%,2.56%
2020-01-01 00:20:40,11,11,10548,788,9760,16.09%,7.47%
2020-01-01 00:20:40,11,12,6732,333,6399,10.27%,4.95%
2020-01-01 00:20:40,12,1,53,0,53,0.08%,0.00%
2020-01-01 00:20:40,12,2,650,224,426,0.99%,34.46%
2020-01-01 00:20:40,12,3,2749,269,2480,4.19%,9.79%
2020-01-01 00:20:40,12,4,3071,64,3007,4.69%,2.08%
2020-01-01 00:20:40,12,5,11404,1078,10326,17.40%,9.45%
2020-01-01 00:20:40,12,6,6640,331,6309,10.13%,4.98%
2020-01-01 00:20:40,12,7,3444,107,3337,5.26%,3.11%
2020-01-01 00:20:40,12,8,1242,205,1037,1.90%,16.51%
2020-01-01 00:20:40,12,9,24228,4874,19354,36.97%,20.12%
2020-01-01 00:20:40,12,10,3740,276,3464,5.71%,7.38%
2020-01-01 00:20:40,12,11,1327,205,1122,2.02%,15.45%
2020-01-01 00:20:40,12,12,7517,1163,6354,11.47%,15.47%
2020-01-01 00:20:40,13,1,1953,33,1920,2.98%,1.69%
2020-01-01 00:20:40,13,2,2260,42,2218,3.45%,1.86%
2020-01-01 00:20:40,13,3,798,6,792,1.22%,0.75%
2020-01-01 00:20:40,13,4,5595,518,5077,8.54%,9.26%
2020-01-01 00:20:40,13,5,8276,893,7383,12.63%,10.79%
2020-01-01 00:20:40,13,6,6757,623,6134,10.31%,9.22%
2020-01-01 00:20:40,13,7,4777,160,4617,7.29%,3.35%
2020-01-01 00:20:40,13,8,6804,322,6482,10.38%,4.73%
2020-01-01 00:20:40,13,9,8734,947,7787,13.33%,10.84%
2020-01-01 00:20:40,13,10,28244,6016,22228,43.10%,21.30%
2020-01-01 00:20:40,13,11,17061,2492,14569,26.03%,14.61%
2020-01-01 00:20:40,13,12,9619,1157,8462,14.68%,12.03%
2020-01-01 00:20:40,14,1,349,2,347,0.53%,0.57%
2020-01-01 00:20:40,14,2,1453,28,1425,2.22%,1.93%
2020-01-01 00:20:40,14,3,950,11,939,1.45%,1.16%
2020-01-01 00:20:40,14,4,5588,356,5232,8.53%,6.37%
2020-01-01 00:20:40,14,5,1704,24,1680,2.60%,1.41%
2020-01-01 00:20:40,14,6,5894,381,5513,8.99%,6.46%
2020-01-01 00:20:40,14,7,12361,1166,11195,18.86%,9.43%
2020-01-01 00:20:40,14,8,13942,1428,12514,21.27%,10.24%
2020-01-01 00:20:40,14,9,2059,33,2026,3.14%,1.60%
2020-01-01 00:20:40,14,10,4779,185,4594,7.29%,3.87%
2020-01-01 00:20:40,14,11,29233,5694,23539,44.61%,19.48%
2020-01-01 00:20:40,14,12,10217,779,9438,15.59%,7.62%
2020-01-01 00:20:40,15,1,491,0,491,0.75%,0.00%
2020-01-01 00:20:40,15,2,138,0,138,0.21%,0.00%
2020-01-01 00:20:40,15,3,3485,86,3399,5.32%,2.47%
2020-01-01 00:20:40,15,4,5714,255,5459,8.72%,4.46%
2020-01-01 00:20:40,15,5,10882,849,10033,16.60%,7.80%
2020-01-01 00:20:40,15,6,5967,273,5694,9.10%,4.58%
2020-01-01 00:20:40,15,7,3901,145,3756,5.95%,3.72%
2020-01-01 00:20:40,15,8,5996,295,5701,9.15%,4.92%
2020-01-01 00:20:40,15,9,11132,893,10239,16.99%,8.02%
2020-01-01 00:20:40,15,10,4773,188,4585,7.28%,3.94%
2020-01-01 00:20:40,15,11,10913,985,9928,16.65%,9.03%
2020-01-01 00:20:40,15,12,28408,5724,22684,43.35%,20.15%
2020-01-01 00:20:40,16,1,449,5,444,0.69%,1.11%
2020-01-01 00:20:40,16,2,195,1,194,0.30%,0.51%
2020-01-01 00:20:40,16,3,1307,15,1292,1.99%,1.15%
2020-01-01 00:20:40,16,4,3561,97,3464,5.43%,2.72%
2020-01-01 00:20:40,16,5,6626,412,6214,10.11%,6.22%
2020-01-01 00:20:40,16,6,4356,147,4209,6.65%,3.37%
2020-01-01 00:20:40,16,7,3866,111,3755,5.90%,2.87%
2020-01-01 00:20:40,16,8,8105,448,7657,12.37%,5.53%
2020-01-01 00:20:40,16,9,7076,448,6628,10.80%,6.33%
2020-01-01 00:20:40,16,10,1357,23,1334,2.07%,1.69%
2020-01-01 00:20:40,16,11,9640,658,8982,14.71%,6.83%
2020-01-01 00:20:40,16,12,25096,4320,20776,38.29%,17.21%
2020-01-01 00:20:50,1,1,22027,3276,18751,33.61%,14.87%
2020-01-01 00:20:50,1,2,7046,350,6696,10.75%,4.97%
2020-01-01 00:20:50,1,3,243,2,241,0.37%,0.82%
2020-01-01 00:20:50,1,4,14747,1542,13205,22.50%,10.46%
2020-01-01 00:20:50,1,5,14413,1470,12943,21.99%,10.20%
2020-01-01 00:20:50,1,6,14420,1476,12944,22.00%,10.24%
2020-01-01 00:20:50,1,7,6792,320,6472,10.36%,4.71%
2020-01-01 00:20:50,1,8,5884,232,5652,8.98%,3.94%
2020-01-01 00:20:50,1,9,14345,1461,12884,21.89%,10.18%
2020-01-01 00:20:50,1,10,5112,185,4927,7.80%,3.62%
2020-01-01 00:20:50,1,11,5156,187,4969,7.87%,3.63%
2020-01-01 00:20:50,1,12,14306,1450,12856,21.83%,10.14%
2020-01-01 00:20:50,2,1,1336,9,1327,2.04%,0.67%
2020-01-01 00:20:50,2,2,26291,4653,21638,40.12%,17.70%
2020-01-01 00:20:50,2,3,20262,2860,17402,30.92%,14.12%
2020-01-01 00:20:50,2,4,1275,6,1269,1.95%,0.47%
2020-01-01 00:20:50,2,5,12567,1138,11429,19.18%,9.06%
2020-01-01 00:20:50,2,6,24,0,24,0.04%,0.00%
2020-01-01 00:20:50,2,7,4650,177,4473,7.10%,3.81%
2020-01-01 00:20:50,2,8,3557,107,3450,5.43%,3.01%
2020-01-01 00:20:50,2,9,12440,1114,11326,18.98%,8.95%
2020-01-01 00:20:50,2,10,2935,65,2870,4.48%,2.21%
2020-01-01 00:20:50,2,11,2980,69,2911,4.55%,2.32%
2020-01-01 00:20:50,2,12,12261,1078,11183,18.71%,8.79%
2020-01-01 00:20:50,3,1,1741,18,1723,2.66%,1.03%
2020-01-01 00:20:50,3,2,25976,4538,21438,39.64%,17.47%
2020-01-01 00:20:50,3,3,71948,28287,43661,109.78%,39.32%
2020-01-01 00:20:50,3,4,10319,743,9576,15.75%,7.20%
2020-01-01 00:20:50,3,5,44080,12043,32037,67.26%,27.32%
2020-01-01 00:20:50,3,6,11667,968,10699,17.80%,8.30%
2020-01-01 00:20:50,3,7,22264,3395,18869,33.97%,15.25%
2020-01-01 00:20:50,3,8,18875,2467,16408,28.80%,13.07%
2020-01-01 00:20:50,3,9,31910,6708,25202,48.69%,21.02%
2020-01-01 00:20:50,3,10,3447,78,3369,5.26%,2.26%
2020-01-01 00:20:50,3,11,1978,34,1944,3.02%,1.72%
2020-01-01 00:20:50,3,12,26318,4670,21648,40.16%,17.74%
2020-01-01 00:20:50,4,1,496,3,493,0.76%,0.60%
2020-01-01 00:20:50,4,2,279,1,278,0.43%,0.36%
2020-01-01 00:20:50,4,3,888,8,880,1.35%,0.90%
2020-01-01 00:20:50,4,4,27684,5039,22645,42.24%,18.20%
2020-01-01 00:20:50,4,5,17186,2068,15118,26.22%,12.03%
2020-01-01 00:20:50,4,6,23715,3783,19932,36.19%,15.95%
2020-01-01 00:20:50,4,7,5368,237,5131,8.19%,4.42%
2020-01-01 00:20:50,4,8,2911,65,2846,4.44%,2.23%
2020-01-01 00:20:50,4,9,14956,1536,13420,22.82%,10.27%
2020-01-01 00:20:50,4,10,2035,30,2005,3.11%,1.47%
2020-01-01 00:20:50,4,11,131,0,131,0.20%,0.00%
2020-01-01 00:20:50,4,12,12310,1063,11247,18.78%,8.64%
2020-01-01 00:20:50,5,1,2887,56,2831,4.41%,1.94%
2020-01-01 00:20:50,5,2,747,2,745,1.14%,0.27%
2020-01-01 00:20:50,5,3,546,2,544,0.83%,0.37%
2020-01-01 00:20:50,5,4,23623,3824,19799,36.05%,16.19%
2020-01-01 00:20:50,5,5,10577,854,9723,16.14%,8.07%
2020-01-01 00:20:50,5,6,16281,1933,14348,24.84%,11.87%
2020-01-01 00:20:50,5,7,5207,212,4995,7.95%,4.07%
2020-01-01 00:20:50,5,8,3727,115,3612,5.69%,3.09%
2020-01-01 00:20:50,5,9,9928,775,9153,15.15%,7.81%
2020-01-01 00:20:50,5,10,1060,3,1057,1.62%,0.28%
2020-01-01 00:20:50,5,11,851,1,850,1.30%,0.12%
2020-01-01 00:20:50,5,12,8210,525,7685,12.53%,6.39%
2020-01-01 00:20:50,6,1,967,14,953,1.48%,1.45%
2020-01-01 00:20:50,6,2,1098,17,1081,1.68%,1.55%
2020-01-01 00:20:50,6,3,1728,38,1690,2.64%,2.20%
2020-01-01 00:20:50,6,4,1077,10,1067,1.64%,0.93%
2020-01-01 00:20:50,6,5,15412,1738,13674,23.52%,11.28%
2020-01-01 00:20:50,6,6,3661,113,3548,5.59%,3.09%
2020-01-01 00:20:50,6,7,2173,49,2124,3.32%,2.25%
2020-01-01 00:20:50,6,8,1540,24,1516,2.35%,1.56%
2020-01-01 00:20:50,6,9,9754,690,9064,14.88%,7.07%
2020-01-01 00:20:50,6,10,2339,48,2291,3.57%,2.05%
2020-01-01 00:20:50,6,11,425,4,421,0.65%,0.94%
2020-01-01 00:20:50,6,12,7354,406,6948,11.22%,5.52%
2020-01-01 00:20:50,7,1,469,3,466,0.72%,0.64%
2020-01-01 00:20:50,7,2,174,0,174,0.27%,0.00%
2020-01-01 00:20:50,7,3,1523,12,1511,2.32%,0.79%
2020-01-01 00:20:50,7,4,1633,18,1615,2.49%,1.10%
2020-01-01 00:20:50,7,5,8451,515,7936,12.90%,6.09%
2020-01-01 00:20:50,7,6,13533,1311,12222,20.65%,9.69%
2020-01-01 00:20:50,7,7,3392,109,3283,5.18%,3.21%
2020-01-01 00:20:50,7,8,1108,19,1089,1.69%,1.71%
2020-01-01 00:20:50,7,9,6525,329,6196,9.96%,5.04%
2020-01-01 00:20:50,7,10,1658,12,1646,2.53%,0.72%
2020-01-01 00:20:50,7,11,144,1,143,0.22%,0.69%
2020-01-01 00:20:50,7,12,4858,188,4670,7.41%,3.87%
2020-01-01 00:20:50,8,1,452,3,449,0.69%,0.66%
2020-01-01 00:20:50,8,2,130,0,130,0.20%,0.00%
2020-01-01 00:20:50,8,3,2006,34,1972,3.06%,1.69%
2020-01-01 00:20:50,8,4,2672,51,2621,4.08%,1.91%
2020-01-01 00:20:50,8,5,9223,628,8595,14.07%,6.81%
2020-01-01 00:20:50,8,6,16599,2006,14593,25.33%,12.09%
2020-01-01 00:20:50,8,7,4673,201,4472,7.13%,4.30%
2020-01-01 00:20:50,8,8,1814,20,1794,2.77%,1.10%
2020-01-01 00:20:50,8,9,7022,370,6652,10.71%,5.27%
2020-01-01 00:20:50,8,10,1690,22,1668,2.58%,1.30%
2020-01-01 00:20:50,8,11,249,0,249,0.38%,0.00%
2020-01-01 00:20:50,8,12,5190,200,4990,7.92%,3.85%
2020-01-01 00:20:50,9,1,360,2,358,0.55%,0.56%
2020-01-01 00:20:50,9,2,3988,118,3870,6.09%,2.96%
2020-01-01 00:20:50,9,3,2808,63,2745,4.28%,2.24%
2020-01-01 00:20:50,9,4,7400,396,7004,11.29%,5.35%
2020-01-01 00:20:50,9,5,376,2,374,0.57%,0.53%
2020-01-01 00:20:50,9,6,8570,523,8047,13.08%,6.10%
2020-01-01 00:20:50,9,7,30239,5881,24358,46.14%,19.45%
2020-01-01 00:20:50,9,8,9675,645,9030,14.76%,6.67%
2020-01-01 00:20:50,9,9,309,2,307,0.47%,0.65%
2020-01-01 00:20:50,9,10,2548,48,2500,3.89%,1.88%
2020-01-01 00:20:50,9,11,8162,476,7686,12.45%,5.83%
2020-01-01 00:20:50,9,12,5305,205,5100,8.09%,3.86%
2020-01-01 00:20:50,10,1,1426,283,1143,2.18%,19.85%
2020-01-01 00:20:50,10,2,4963,432,4531,7.57%,8.70%
2020-01-01 00:20:50,10,3,3128,66,3062,4.77%,2.11%
2020-01-01 00:20:50,10,4,3979,795,3184,6.07%,19.98%
2020-01-01 00:20:50,10,5,524,5,519,0.80%,0.95%
2020-01-01 00:20:50,10,6,5572,882,4690,8.50%,15.83%
2020-01-01 00:20:50,10,7,12558,1946,10612,19.16%,15.50%
2020-01-01 00:20:50,10,8,29569,7448,22121,45.12%,25.19%
2020-01-01 00:20:50,10,9,704,3,701,1.07%,0.43%
2020-01-01 00:20:50,10,10,3043,62,2981,4.64%,2.04%
2020-01-01 00:20:50,10,11,13120,1586,11534,20.02%,12.09%
2020-01-01 00:20:50,10,12,9479,1038,8441,14.46%,10.95%
2020-01-01 00:20:50,11,1,2028,43,1985,3.09%,2.12%
2020-01-01 00:20:50,11,2,3190,101,3089,4.87%,3.17%
2020-01-01 00:20:50,11,3,912,35,877,1.39%,3.84%
2020-01-01 00:20:50,11,4,5048,190,4858,7.70%,3.76%
2020-01-01 00:20:50,11,5,426,2,424,0.65%,0.47%
2020-01-01 00:20:50,11,6,6035,279,5756,9.21%,4.62%
2020-01-01 00:20:50,11,7,10915,858,10057,16.65%,7.86%
2020-01-01 00:20:50,11,8,24638,4166,20472,37.59%,16.91%
2020-01-01 00:20:50,11,9,208,1,207,0.32%,0.48%
2020-01-01 00:20:50,11,10,3414,88,3326,5.21%,2.58%
2020-01-01 00:20:50,11,11,9975,798,9177,15.22%,8.00%
2020-01-01 00:20:50,11,12,6336,337,5999,9.67%,5.32%
2020-01-01 00:20:50,12,1,71,1,70,0.11%,1.41%
2020-01-01 00:20:50,12,2,683,219,464,1.04%,32.06%
2020-01-01 00:20:50,12,3,2357,243,2114,3.60%,10.31%
2020-01-01 00:20:50,12,4,2618,52,2566,3.99%,1.99%
2020-01-01 00:20:50,12,5,9342,794,8548,14.25%,8.50%
2020-01-01 00:20:50,12,6,5957,247,5710,9.09%,4.15%
2020-01-01 00:20:50,12,7,3214,71,3143,4.90%,2.21%
2020-01-01 00:20:50,12,8,1019,207,812,1.55%,20.31%
2020-01-01 00:20:50,12,9,21301,4139,17162,32.50%,19.43%
2020-01-01 00:20:50,12,10,3466,266,3200,5.29%,7.67%
2020-01-01 00:20:50,12,11,1151,208,943,1.76%,18.07%
2020-01-01 00:20:50,12,12,7422,1133,6289,11.33%,15.27%
2020-01-01 00:20:50,13,1,2083,49,2034,3.18%,2.35%
2020-01-01 00:20:50,13,2,2377,60,2317,3.63%,2.52%
2020-01-01 00:20:50,13,3,968,6,962,1.48%,0.62%
2020-01-01 00:20:50,13,4,5224,521,4703,7.97%,9.97%
2020-01-01 00:20:50,13,5,7994,859,7135,12.20%,10.75%
2020-01-01 00:20:50,13,6,6396,608,5788,9.76%,9.51%
2020-01-01 00:20:50,13,7,5312,242,5070,8.11%,4.56%
2020-01-01 00:20:50,13,8,7240,412,6828,11.05%,5.69%
2020-01-01 00:20:50,13,9,8412,909,7503,12.84%,10.81%
2020-01-01 00:20:50,13,10,29599,6290,23309,45.16%,21.25%
2020-01-01 00:20:50,13,11,17223,2392,14831,26.28%,13.89%
2020-01-01 00:20:50,13,12,9303,984,8319,14.20%,10.58%
2020-01-01 00:20:50,14,1,460,0,460,0.70%,0.00%
2020-01-01 00:20:50,14,2,1646,26,1620,2.51%,1.58%
2020-01-01 00:20:50,14,3,1026,15,1011,1.57%,1.46%
2020-01-01 00:20:50,14,4,4223,228,3995,6.44%,5.40%
2020-01-01 00:20:50,14,5,1599,18,1581,2.44%,1.13%
2020-01-01 00:20:50,14,6,4414,237,4177,6.74%,5.37%
2020-01-01 00:20:50,14,7,10884,978,9906,16.61%,8.99%
2020-01-01 00:20:50,14,8,12212,1163,11049,18.63%,9.52%
2020-01-01 00:20:50,14,9,1891,23,1868,2.89%,1.22%
2020-01-01 00:20:50,14,10,5007,155,4852,7.64%,3.10%
2020-01-01 00:20:50,14,11,24811,4165,20646,37.86%,16.79%
2020-01-01 00:20:50,14,12,7302,367,6935,11.14%,5.03%
2020-01-01 00:20:50,15,1,506,4,502,0.77%,0.79%
2020-01-01 00:20:50,15,2,128,0,128,0.20%,0.00%
2020-01-01 00:20:50,15,3,3519,85,3434,5.37%,2.42%
2020-01-01 00:20:50,15,4,5744,261,5483,8.76%,4.54%
2020-01-01 00:20:50,15,5,10875,830,10045,16.59%,7.63%
2020-01-01 00:20:50,15,6,6027,281,5746,9.20%,4.66%
2020-01-01 00:20:50,15,7,3930,116,3814,6.00%,2.95%
2020-01-01 00:20:50,15,8,5935,285,5650,9.06%,4.80%
2020-01-01 00:20:50,15,9,11155,882,10273,17.02%,7.91%
2020-01-01 00:20:50,15,10,3501,100,3401,5.34%,2.86%
2020-01-01 00:20:50,15,11,9592,708,8884,14.64%,7.38%
2020-01-01 00:20:50,15,12,26631,5112,21519,40.64%,19.20%
2020-01-01 00:20:50,16,1,463,0,463,0.71%,0.00%
2020-01-01 00:20:50,16,2,199,0,199,0.30%,0.00%
2020-01-01 00:20:50,16,3,1433,15,1418,2.19%,1.05%
2020-01-01 00:20:50,16,4,4977,189,4788,7.59%,3.80%
2020-01-01 00:20:50,16,5,8393,606,7787,12.81%,7.22%
2020-01-01 00:20:50,16,6,5827,271,5556,8.89%,4.65%
2020-01-01 00:20:50,16,7,3710,105,3605,5.66%,2.83%
2020-01-01 00:20:50,16,8,7469,388,7081,11.40%,5.19%
2020-01-01 00:20:50,16,9,8783,653,8130,13.40%,7.43%
2020-01-01 00:20:50,16,10,1560,28,1532,2.38%,1.79%
2020-01-01 00:20:50,16,11,9276,620,8656,14.15%,6.68%
2020-01-01 00:20:50,16,12,26038,4674,21364,39.73%,17.95%
2020-01-01 00:21:00,1,1,21115,3179,17936,32.22%,15.06%
2020-01-01 00:21:00,1,2,10503,821,9682,16.03%,7.82%
2020-01-01 00:21:00,1,3,480,0,480,0.73%,0.00%
2020-01-01 00:21:00,1,4,10192,775,9417,15.55%,7.60%
2020-01-01 00:21:00,1,5,9864,734,9130,15.05%,7.44%
2020-01-01 00:21:00,1,6,9825,735,9090,14.99%,7.48%
2020-01-01 00:21:00,1,7,10009,745,9264,15.27%,7.44%
2020-01-01 00:21:00,1,8,7785,446,7339,11.88%,5.73%
2020-01-01 00:21:00,1,9,9733,723,9010,14.85%,7.43%
2020-01-01 00:21:00,1,10,7140,379,6761,10.89%,5.31%
2020-01-01 00:21:00,1,11,7208,389,6819,11.00%,5.40%
2020-01-01 00:21:00,1,12,9704,720,8984,14.81%,7.42%
2020-01-01 00:21:00,2,1,646,1,645,0.99%,0.15%
2020-01-01 00:21:00,2,2,26571,4773,21798,40.54%,17.96%
2020-01-01 00:21:00,2,3,21710,3247,18463,33.13%,14.96%
2020-01-01 00:21:00,2,4,481,0,481,0.73%,0.00%
2020-01-01 00:21:00,2,5,13579,1317,12262,20.72%,9.70%
2020-01-01 00:21:00,2,6,24,0,24,0.04%,0.00%
2020-01-01 00:21:00,2,7,4202,134,4068,6.41%,3.19%
2020-01-01 00:21:00,2,8,3088,85,3003,4.71%,2.75%
2020-01-01 00:21:00,2,9,13404,1288,12116,20.45%,9.61%
2020-01-01 00:21:00,2,10,2409,51,2358,3.68%,2.12%
2020-01-01 00:21:00,2,11,2421,51,2370,3.69%,2.11%
2020-01-01 00:21:00,2,12,13226,1253,11973,20.18%,9.47%
2020-01-01 00:21:00,3,1,1662,14,1648,2.54%,0.84%
2020-01-01 00:21:00,3,2,23307,3669,19638,35.56%,15.74%
2020-01-01 00:21:00,3,3,69944,26895,43049,106.73%,38.45%
2020-01-01 00:21:00,3,4,9631,667,8964,14.70%,6.93%
2020-01-01 00:21:00,3,5,44001,12066,31935,67.14%,27.42%
2020-01-01 00:21:00,3,6,10622,806,9816,16.21%,7.59%
2020-01-01 00:21:00,3,7,20007,2742,17265,30.53%,13.71%
2020-01-01 00:21:00,3,8,16810,1973,14837,25.65%,11.74%
2020-01-01 00:21:00,3,9,32980,7179,25801,50.32%,21.77%
2020-01-01 00:21:00,3,10,3394,92,3302,5.18%,2.71%
2020-01-01 00:21:00,3,11,2611,57,2554,3.98%,2.18%
2020-01-01 00:21:00,3,12,27330,5024,22306,41.70%,18.38%
2020-01-01 00:21:00,4,1,496,2,494,0.76%,0.40%
2020-01-01 00:21:00,4,2,325,0,325,0.50%,0.00%
2020-01-01 00:21:00,4,3,1047,8,1039,1.60%,0.76%
2020-01-01 00:21:00,4,4,27784,5114,22670,42.40%,18.41%
2020-01-01 00:21:00,4,5,17663,2204,15459,26.95%,12.48%
2020-01-01 00:21:00,4,6,24291,3987,20304,37.07%,16.41%
2020-01-01 00:21:00,4,7,5415,210,5205,8.26%,3.88%
2020-01-01 00:21:00,4,8,2971,72,2899,4.53%,2.42%
2020-01-01 00:21:00,4,9,15412,1702,13710,23.52%,11.04%
2020-01-01 00:21:00,4,10,1788,20,1768,2.73%,1.12%
2020-01-01 00:21:00,4,11,125,0,125,0.19%,0.00%
2020-01-01 00:21:00,4,12,12826,1202,11624,19.57%,9.37%
2020-01-01 00:21:00,5,1,3136,88,3048,4.79%,2.81%
2020-01-01 00:21:00,5,2,818,7,811,1.25%,0.86%
2020-01-01 00:21:00,5,3,376,3,373,0.57%,0.80%
2020-01-01 00:21:00,5,4,27741,5151,22590,42.33%,18.57%
2020-01-01 00:21:00,5,5,9094,600,8494,13.88%,6.60%
2020-01-01 00:21:00,5,6,14341,1510,12831,21.88%,10.53%
2020-01-01 00:21:00,5,7,4793,205,4588,7.31%,4.28%
2020-01-01 00:21:00,5,8,3468,112,3356,5.29%,3.23%
2020-01-01 00:21:00,5,9,8547,534,8013,13.04%,6.25%
2020-01-01 00:21:00,5,10,817,3,814,1.25%,0.37%
2020-01-01 00:21:00,5,11,726,6,720,1.11%,0.83%
2020-01-01 00:21:00,5,12,6909,348,6561,10.54%,5.04%
2020-01-01 00:21:00,6,1,1045,10,1035,1.59%,0.96%
2020-01-01 00:21:00,6,2,1123,11,1112,1.71%,0.98%
2020-01-01 00:21:00,6,3,1619,20,1599,2.47%,1.24%
2020-01-01 00:21:00,6,4,1339,7,1332,2.04%,0.52%
2020-01-01 00:21:00,6,5,18001,2289,15712,27.47%,12.72%
2020-01-01 00:21:00,6,6,4663,191,4472,7.12%,4.10%
2020-01-01 00:21:00,6,7,2804,89,2715,4.28%,3.17%
2020-01-01 00:21:00,6,8,2324,71,2253,3.55%,3.06%
2020-01-01 00:21:00,6,9,11190,901,10289,17.07%,8.05%
2020-01-01 00:21:00,6,10,2778,63,2715,4.24%,2.27%
2020-01-01 00:21:00,6,11,611,4,607,0.93%,0.65%
2020-01-01 00:21:00,6,12,8346,509,7837,12.73%,6.10%
2020-01-01 00:21:00,7,1,556,13,543,0.85%,2.34%
2020-01-01 00:21:00,7,2,172,0,172,0.26%,0.00%
2020-01-01 00:21:00,7,3,1214,16,1198,1.85%,1.32%
2020-01-01 00:21:00,7,4,1583,41,1542,2.42%,2.59%
2020-01-01 00:21:00,7,5,7604,428,7176,11.60%,5.63%
2020-01-01 00:21:00,7,6,11996,1002,10994,18.30%,8.35%
2020-01-01 00:21:00,7,7,2776,63,2713,4.24%,2.27%
2020-01-01 00:21:00,7,8,781,2,779,1.19%,0.26%
2020-01-01 00:21:00,7,9,6311,291,6020,9.63%,4.61%
2020-01-01 00:21:00,7,10,1437,24,1413,2.19%,1.67%
2020-01-01 00:21:00,7,11,107,0,107,0.16%,0.00%
2020-01-01 00:21:00,7,12,4914,177,4737,7.50%,3.60%
2020-01-01 00:21:00,8,1,600,2,598,0.92%,0.33%
2020-01-01 00:21:00,8,2,104,0,104,0.16%,0.00%
2020-01-01 00:21:00,8,3,2432,53,2379,3.71%,2.18%
2020-01-01 00:21:00,8,4,2777,46,2731,4.24%,1.66%
2020-01-01 00:21:00,8,5,8696,598,8098,13.27%,6.88%
2020-01-01 00:21:00,8,6,15969,1809,14160,24.37%,11.33%
2020-01-01 00:21:00,8,7,4437,141,4296,6.77%,3.18%
2020-01-01 00:21:00,8,8,1539,26,1513,2.35%,1.69%
2020-01-01 00:21:00,8,9,6133,300,5833,9.36%,4.89%
2020-01-01 00:21:00,8,10,1599,23,1576,2.44%,1.44%
2020-01-01 00:21:00,8,11,289,1,288,0.44%,0.35%
2020-01-01 00:21:00,8,12,4431,159,4272,6.76%,3.59%
2020-01-01 00:21:00,9,1,327,0,327,0.50%,0.00%
2020-01-01 00:21:00,9,2,1829,16,1813,2.79%,0.87%
2020-01-01 00:21:00,9,3,1110,2,1108,1.69%,0.18%
2020-01-01 00:21:00,9,4,5017,231,4786,7.66%,4.60%
2020-01-01 00:21:00,9,5,381,0,381,0.58%,0.00%
2020-01-01 00:21:00,9,6,5880,308,5572,8.97%,5.24%
2020-01-01 00:21:00,9,7,24431,3959,20472,37.28%,16.20%
2020-01-01 00:21:00,9,8,12130,1030,11100,18.51%,8.49%
2020-01-01 00:21:00,9,9,342,0,342,0.52%,0.00%
2020-01-01 00:21:00,9,10,4155,117,4038,6.34%,2.82%
2020-01-01 00:21:00,9,11,9727,649,9078,14.84%,6.67%
2020-01-01 00:21:00,9,12,5210,205,5005,7.95%,3.93%
2020-01-01 00:21:00,10,1,1296,347,949,1.98%,26.77%
2020-01-01 00:21:00,10,2,4260,453,3807,6.50%,10.63%
2020-01-01 00:21:00,10,3,2721,56,2665,4.15%,2.06%
2020-01-01 00:21:00,10,4,4475,1110,3365,6.83%,24.80%
2020-01-01 00:21:00,10,5,421,1,420,0.64%,0.24%
2020-01-01 00:21:00,10,6,5974,1194,4780,9.12%,19.99%
2020-01-01 00:21:00,10,7,12408,2249,10159,18.93%,18.13%
2020-01-01 00:21:00,10,8,29068,7273,21795,44.35%,25.02%
2020-01-01 00:21:00,10,9,779,6,773,1.19%,0.77%
2020-01-01 00:21:00,10,10,2907,64,2843,4.44%,2.20%
2020-01-01 00:21:00,10,11,13181,1409,11772,20.11%,10.69%
2020-01-01 00:21:00,10,12,9734,912,8822,14.85%,9.37%
2020-01-01 00:21:00,11,1,2243,49,2194,3.42%,2.18%
2020-01-01 00:21:00,11,2,3510,105,3405,5.36%,2.99%
2020-01-01 00:21:00,11,3,1106,10,1096,1.69%,0.90%
2020-01-01 00:21:00,11,4,6570,346,6224,10.03%,5.27%
2020-01-01 00:21:00,11,5,408,4,404,0.62%,0.98%
2020-01-01 00:21:00,11,6,7678,458,7220,11.72%,5.97%
2020-01-01 00:21:00,11,7,13087,1240,11847,19.97%,9.48%
2020-01-01 00:21:00,11,8,27266,5191,22075,41.60%,19.04%
2020-01-01 00:21:00,11,9,142,0,142,0.22%,0.00%
2020-01-01 00:21:00,11,10,3559,104,3455,5.43%,2.92%
2020-01-01 00:21:00,11,11,10652,891,9761,16.25%,8.36%
2020-01-01 00:21:00,11,12,6885,400,6485,10.51%,5.81%
2020-01-01 00:21:00,12,1,54,0,54,0.08%,0.00%
2020-01-01 00:21:00,12,2,685,224,461,1.05%,32.70%
2020-01-01 00:21:00,12,3,2638,257,2381,4.03%,9.74%
2020-01-01 00:21:00,12,4,3615,87,3528,5.52%,2.41%
2020-01-01 00:21:00,12,5,10252,953,9299,15.64%,9.30%
2020-01-01 00:21:00,12,6,6805,362,6443,10.38%,5.32%
2020-01-01 00:21:00,12,7,3028,75,2953,4.62%,2.48%
2020-01-01 00:21:00,12,8,1278,266,1012,1.95%,20.81%
2020-01-01 00:21:00,12,9,23168,4671,18497,35.35%,20.16%
2020-01-01 00:21:00,12,10,3981,364,3617,6.07%,9.14%
2020-01-01 00:21:00,12,11,1398,268,1130,2.13%,19.17%
2020-01-01 00:21:00,12,12,7387,1141,6246,11.27%,15.45%
2020-01-01 00:21:00,13,1,1970,24,1946,3.01%,1.22%
2020-01-01 00:21:00,13,2,2303,35,2268,3.51%,1.52%
2020-01-01 00:21:00,13,3,661,2,659,1.01%,0.30%
2020-01-01 00:21:00,13,4,5249,538,4711,8.01%,10.25%
2020-01-01 00:21:00,13,5,7649,841,6808,11.67%,10.99%
2020-01-01 00:21:00,13,6,6275,625,5650,9.57%,9.96%
2020-01-01 00:21:00,13,7,4753,153,4600,7.25%,3.22%
2020-01-01 00:21:00,13,8,6491,304,6187,9.90%,4.68%
2020-01-01 00:21:00,13,9,7981,874,7107,12.18%,10.95%
2020-01-01 00:21:00,13,10,26713,5291,21422,40.76%,19.81%
2020-01-01 00:21:00,13,11,16547,2098,14449,25.25%,12.68%
2020-01-01 00:21:00,13,12,9438,879,8559,14.40%,9.31%
2020-01-01 00:21:00,14,1,237,1,236,0.36%,0.42%
2020-01-01 00:21:00,14,2,1462,16,1446,2.23%,1.09%
2020-01-01 00:21:00,14,3,1064,7,1057,1.62%,0.66%
2020-01-01 00:21:00,14,4,3994,156,3838,6.09%,3.91%
2020-01-01 00:21:00,14,5,1413,17,1396,2.16%,1.20%
2020-01-01 00:21:00,14,6,4230,168,4062,6.45%,3.97%
2020-01-01 00:21:00,14,7,10602,809,9793,16.18%,7.63%
2020-01-01 00:21:00,14,8,12366,1091,11275,18.87%,8.82%
2020-01-01 00:21:00,14,9,1711,26,1685,2.61%,1.52%
2020-01-01 00:21:00,14,10,4562,164,4398,6.96%,3.59%
2020-01-01 00:21:00,14,11,24551,4131,20420,37.46%,16.83%
2020-01-01 00:21:00,14,12,7298,405,6893,11.14%,5.55%
2020-01-01 00:21:00,15,1,554,2,552,0.85%,0.36%
2020-01-01 00:21:00,15,2,222,2,220,0.34%,0.90%
2020-01-01 00:21:00,15,3,3915,125,3790,5.97%,3.19%
2020-01-01 00:21:00,15,4,5595,283,5312,8.54%,5.06%
2020-01-01 00:21:00,15,5,11109,1021,10088,16.95%,9.19%
2020-01-01 00:21:00,15,6,5838,313,5525,8.91%,5.36%
2020-01-01 00:21:00,15,7,4220,119,4101,6.44%,2.82%
2020-01-01 00:21:00,15,8,5916,256,5660,9.03%,4.33%
2020-01-01 00:21:00,15,9,11331,1055,10276,17.29%,9.31%
2020-01-01 00:21:00,15,10,4599,168,4431,7.02%,3.65%
2020-01-01 00:21:00,15,11,10669,880,9789,16.28%,8.25%
2020-01-01 00:21:00,15,12,27748,5531,22217,42.34%,19.93%
2020-01-01 00:21:00,16,1,485,4,481,0.74%,0.82%
2020-01-01 00:21:00,16,2,241,1,240,0.37%,0.41%
2020-01-01 00:21:00,16,3,1457,9,1448,2.22%,0.62%
2020-01-01 00:21:00,16,4,6137,288,5849,9.36%,4.69%
2020-01-01 00:21:00,16,5,9740,708,9032,14.86%,7.27%
2020-01-01 00:21:00,16,6,6949,353,6596,10.60%,5.08%
2020-01-01 00:21:00,16,7,3806,117,3689,5.81%,3.07%
2020-01-01 00:21:00,16,8,7645,491,7154,11.67%,6.42%
2020-01-01 00:21:00,16,9,10150,767,9383,15.49%,7.56%
2020-01-01 00:21:00,16,10,1816,11,1805,2.77%,0.61%
2020-01-01 00:21:00,16,11,9677,719,8958,14.77%,7.43%
2020-01-01 00:21:00,16,12,27843,5205,22638,42.49%,18.69%
2020-01-01 00:21:10,1,1,17433,2135,15298,26.60%,12.25%
2020-01-01 00:21:10,1,2,4711,169,4542,7.19%,3.59%
2020-01-01 00:21:10,1,3,320,0,320,0.49%,0.00%
2020-01-01 00:21:10,1,4,12231,1109,11122,18.66%,9.07%
2020-01-01 00:21:10,1,5,11765,1033,10732,17.95%,8.78%
2020-01-01 00:21:10,1,6,11706,1021,10685,17.86%,8.72%
2020-01-01 00:21:10,1,7,4379,144,4235,6.68%,3.29%
2020-01-01 00:21:10,1,8,3124,70,3054,4.77%,2.24%
2020-01-01 00:21:10,1,9,11651,1013,10638,17.78%,8.69%
2020-01-01 00:21:10,1,10,2472,42,2430,3.77%,1.70%
2020-01-01 00:21:10,1,11,2552,45,2507,3.89%,1.76%
2020-01-01 00:21:10,1,12,11624,1012,10612,17.74%,8.71%
2020-01-01 00:21:10,2,1,378,1,377,0.58%,0.26%
2020-01-01 00:21:10,2,2,29643,5861,23782,45.23%,19.77%
2020-01-01 00:21:10,2,3,23452,3791,19661,35.78%,16.16%
2020-01-01 00:21:10,2,4,331,0,331,0.51%,0.00%
2020-01-01 00:21:10,2,5,12121,1063,11058,18.50%,8.77%
2020-01-01 00:21:10,2,6,68,0,68,0.10%,0.00%
2020-01-01 00:21:10,2,7,5785,238,5547,8.83%,4.11%
2020-01-01 00:21:10,2,8,4362,140,4222,6.66%,3.21%
2020-01-01 00:21:10,2,9,12061,1052,11009,18.40%,8.72%
2020-01-01 00:21:10,2,10,3759,99,3660,5.74%,2.63%
2020-01-01 00:21:10,2,11,3763,99,3664,5.74%,2.63%
2020-01-01 00:21:10,2,12,11846,1017,10829,18.08%,8.59%
2020-01-01 00:21:10,3,1,1626,24,1602,2.48%,1.48%
2020-01-01 00:21:10,3,2,24561,4019,20542,37.48%,16.36%
2020-01-01 00:21:10,3,3,65344,23797,41547,99.71%,36.42%
2020-01-01 00:21:10,3,4,7278,350,6928,11.11%,4.81%
2020-01-01 00:21:10,3,5,39691,9936,29755,60.56%,25.03%
2020-01-01 00:21:10,3,6,8717,516,8201,13.30%,5.92%
2020-01-01 00:21:10,3,7,21162,3051,18111,32.29%,14.42%
2020-01-01 00:21:10,3,8,16449,1893,14556,25.10%,11.51%
2020-01-01 00:21:10,3,9,30486,6147,24339,46.52%,20.16%
2020-01-01 00:21:10,3,10,4164,123,4041,6.35%,2.95%
2020-01-01 00:21:10,3,11,2102,28,2074,3.21%,1.33%
2020-01-01 00:21:10,3,12,22412,3391,19021,34.20%,15.13%
2020-01-01 00:21:10,4,1,429,0,429,0.65%,0.00%
2020-01-01 00:21:10,4,2,277,0,277,0.42%,0.00%
2020-01-01 00:21:10,4,3,759,3,756,1.16%,0.40%
2020-01-01 00:21:10,4,4,28396,5338,23058,43.33%,18.80%
2020-01-01 00:21:10,4,5,17644,2126,15518,26.92%,12.05%
2020-01-01 00:21:10,4,6,24687,4091,20596,37.67%,16.57%
2020-01-01 00:21:10,4,7,5759,260,5499,8.79%,4.51%
2020-01-01 00:21:10,4,8,3320,86,3234,5.07%,2.59%
2020-01-01 00:21:10,4,9,15618,1661,13957,23.83%,10.64%
2020-01-01 00:21:10,4,10,2305,38,2267,3.52%,1.65%
2020-01-01 00:21:10,4,11,140,0,140,0.21%,0.00%
2020-01-01 00:21:10,4,12,12639,1085,11554,19.29%,8.58%
2020-01-01 00:21:10,5,1,3267,90,3177,4.99%,2.75%
2020-01-01 00:21:10,5,2,1254,11,1243,1.91%,0.88%
2020-01-01 00:21:10,5,3,1520,19,1501,2.32%,1.25%
2020-01-01 00:21:10,5,4,25809,4506,21303,39.38%,17.46%
2020-01-01 00:21:10,5,5,11494,935,10559,17.54%,8.13%
2020-01-01 00:21:10,5,6,17091,2020,15071,26.08%,11.82%
2020-01-01 00:21:10,5,7,5158,195,4963,7.87%,3.78%
2020-01-01 00:21:10,5,8,3683,97,3586,5.62%,2.63%
2020-01-01 00:21:10,5,9,9620,662,8958,14.68%,6.88%
2020-01-01 00:21:10,5,10,995,1,994,1.52%,0.10%
2020-01-01 00:21:10,5,11,793,6,787,1.21%,0.76%
2020-01-01 00:21:10,5,12,8301,492,7809,12.67%,5.93%
2020-01-01 00:21:10,6,1,971,13,958,1.48%,1.34%
2020-01-01 00:21:10,6,2,1025,13,1012,1.56%,1.27%
2020-01-01 00:21:10,6,3,1489,15,1474,2.27%,1.01%
2020-01-01 00:21:10,6,4,1383,9,1374,2.11%,0.65%
2020-01-01 00:21:10,6,5,14745,1694,13051,22.50%,11.49%
2020-01-01 00:21:10,6,6,4508,194,4314,6.88%,4.30%
2020-01-01 00:21:10,6,7,2668,99,2569,4.07%,3.71%
2020-01-01 00:21:10,6,8,2011,78,1933,3.07%,3.88%
2020-01-01 00:21:10,6,9,8313,519,7794,12.68%,6.24%
2020-01-01 00:21:10,6,10,2797,63,2734,4.27%,2.25%
2020-01-01 00:21:10,6,11,532,5,527,0.81%,0.94%
2020-01-01 00:21:10,6,12,5437,226,5211,8.30%,4.16%
2020-01-01 00:21:10,7,1,538,2,536,0.82%,0.37%
2020-01-01 00:21:10,7,2,131,0,131,0.20%,0.00%
2020-01-01 00:21:10,7,3,1412,16,1396,2.15%,1.13%
2020-01-01 00:21:10,7,4,1592,21,1571,2.43%,1.32%
2020-01-01 00:21:10,7,5,9625,704,8921,14.69%,7.31%
2020-01-01 00:21:10,7,6,14869,1540,13329,22.69%,10.36%
2020-01-01 00:21:10,7,7,3608,112,3496,5.51%,3.10%
2020-01-01 00:21:10,7,8,1411,18,1393,2.15%,1.28%
2020-01-01 00:21:10,7,9,8148,525,7623,12.43%,6.44%
2020-01-01 00:21:10,7,10,1650,30,1620,2.52%,1.82%
2020-01-01 00:21:10,7,11,107,0,107,0.16%,0.00%
2020-01-01 00:21:10,7,12,6577,338,6239,10.04%,5.14%
2020-01-01 00:21:10,8,1,379,2,377,0.58%,0.53%
2020-01-01 00:21:10,8,2,41,0,41,0.06%,0.00%
2020-01-01 00:21:10,8,3,1973,29,1944,3.01%,1.47%
2020-01-01 00:21:10,8,4,2837,52,2785,4.33%,1.83%
2020-01-01 00:21:10,8,5,8719,549,8170,13.30%,6.30%
2020-01-01 00:21:10,8,6,16690,1926,14764,25.47%,11.54%
2020-01-01 00:21:10,8,7,5034,196,4838,7.68%,3.89%
2020-01-01 00:21:10,8,8,2198,31,2167,3.35%,1.41%
2020-01-01 00:21:10,8,9,6485,307,6178,9.90%,4.73%
2020-01-01 00:21:10,8,10,1645,27,1618,2.51%,1.64%
2020-01-01 00:21:10,8,11,233,0,233,0.36%,0.00%
2020-01-01 00:21:10,8,12,4765,183,4582,7.27%,3.84%
2020-01-01 00:21:10,9,1,673,2,671,1.03%,0.30%
2020-01-01 00:21:10,9,2,2996,57,2939,4.57%,1.90%
2020-01-01 00:21:10,9,3,1943,30,1913,2.96%,1.54%
2020-01-01 00:21:10,9,4,7100,382,6718,10.83%,5.38%
2020-01-01 00:21:10,9,5,229,0,229,0.35%,0.00%
2020-01-01 00:21:10,9,6,7998,478,7520,12.20%,5.98%
2020-01-01 00:21:10,9,7,27434,4997,22437,41.86%,18.21%
2020-01-01 00:21:10,9,8,9882,677,9205,15.08%,6.85%
2020-01-01 00:21:10,9,9,207,0,207,0.32%,0.00%
2020-01-01 00:21:10,9,10,2546,45,2501,3.88%,1.77%
2020-01-01 00:21:10,9,11,8667,524,8143,13.22%,6.05%
2020-01-01 00:21:10,9,12,5822,256,5566,8.88%,4.40%
2020-01-01 00:21:10,10,1,1318,175,1143,2.01%,13.28%
2020-01-01 00:21:10,10,2,4352,282,4070,6.64%,6.48%
2020-01-01 00:21:10,10,3,2879,58,2821,4.39%,2.01%
2020-01-01 00:21:10,10,4,3830,726,3104,5.84%,18.96%
2020-01-01 00:21:10,10,5,613,1,612,0.94%,0.16%
2020-01-01 00:21:10,10,6,5936,856,5080,9.06%,14.42%
2020-01-01 00:21:10,10,7,11927,1663,10264,18.20%,13.94%
2020-01-01 00:21:10,10,8,32336,8099,24237,49.34%,25.05%
2020-01-01 00:21:10,10,9,1078,14,1064,1.64%,1.30%
2020-01-01 00:21:10,10,10,3037,94,2943,4.63%,3.10%
2020-01-01 00:21:10,10,11,15723,2028,13695,23.99%,12.90%
2020-01-01 00:21:10,10,12,11827,1316,10511,18.05%,11.13%
2020-01-01 00:21:10,11,1,3248,89,3159,4.96%,2.74%
2020-01-01 00:21:10,11,2,7567,438,7129,11.55%,5.79%
2020-01-01 00:21:10,11,3,4157,122,4035,6.34%,2.93%
2020-01-01 00:21:10,11,4,3567,142,3425,5.44%,3.98%
2020-01-01 00:21:10,11,5,158,0,158,0.24%,0.00%
2020-01-01 00:21:10,11,6,4321,186,4135,6.59%,4.30%
2020-01-01 00:21:10,11,7,14083,1403,12680,21.49%,9.96%
2020-01-01 00:21:10,11,8,28762,5497,23265,43.89%,19.11%
2020-01-01 00:21:10,11,9,214,0,214,0.33%,0.00%
2020-01-01 00:21:10,11,10,3432,85,3347,5.24%,2.48%
2020-01-01 00:21:10,11,11,10861,826,10035,16.57%,7.61%
2020-01-01 00:21:10,11,12,7055,388,6667,10.77%,5.50%
2020-01-01 00:21:10,12,1,29,0,29,0.04%,0.00%
2020-01-01 00:21:10,12,2,616,222,394,0.94%,36.04%
2020-01-01 00:21:10,12,3,2388,249,2139,3.64%,10.43%
2020-01-01 00:21:10,12,4,2644,48,2596,4.03%,1.82%
2020-01-01 00:21:10,12,5,8571,692,7879,13.08%,8.07%
2020-01-01 00:21:10,12,6,5196,159,5037,7.93%,3.06%
2020-01-01 00:21:10,12,7,2402,25,2377,3.67%,1.04%
2020-01-01 00:21:10,12,8,1395,267,1128,2.13%,19.14%
2020-01-01 00:21:10,12,9,21219,4162,17057,32.38%,19.61%
2020-01-01 00:21:10,12,10,3989,406,3583,6.09%,10.18%
2020-01-01 00:21:10,12,11,1566,272,1294,2.39%,17.37%
2020-01-01 00:21:10,12,12,8090,1172,6918,12.34%,14.49%
2020-01-01 00:21:10,13,1,2266,35,2231,3.46%,1.54%
2020-01-01 00:21:10,13,2,2568,49,2519,3.92%,1.91%
2020-01-01 00:21:10,13,3,854,7,847,1.30%,0.82%
2020-01-01 00:21:10,13,4,4913,535,4378,7.50%,10.89%
2020-01-01 00:21:10,13,5,7243,807,6436,11.05%,11.14%
2020-01-01 00:21:10,13,6,5624,590,5034,8.58%,10.49%
2020-01-01 00:21:10,13,7,4701,164,4537,7.17%,3.49%
2020-01-01 00:21:10,13,8,7369,391,6978,11.24%,5.31%
2020-01-01 00:21:10,13,9,7482,829,6653,11.42%,11.08%
2020-01-01 00:21:10,13,10,28085,5764,22321,42.85%,20.52%
2020-01-01 00:21:10,13,11,17636,2431,15205,26.91%,13.78%
2020-01-01 00:21:10,13,12,9821,1016,8805,14.99%,10.35%
2020-01-01 00:21:10,14,1,238,0,238,0.36%,0.00%
2020-01-01 00:21:10,14,2,1452,19,1433,2.22%,1.31%
2020-01-01 00:21:10,14,3,1044,12,1032,1.59%,1.15%
2020-01-01 00:21:10,14,4,4665,140,4525,7.12%,3.00%
2020-01-01 00:21:10,14,5,1734,27,1707,2.65%,1.56%
2020-01-01 00:21:10,14,6,4874,153,4721,7.44%,3.14%
2020-01-01 00:21:10,14,7,13009,1139,11870,19.85%,8.76%
2020-01-01 00:21:10,14,8,14377,1405,12972,21.94%,9.77%
2020-01-01 00:21:10,14,9,1867,31,1836,2.85%,1.66%
2020-01-01 00:21:10,14,10,4438,138,4300,6.77%,3.11%
2020-01-01 00:21:10,14,11,27401,4882,22519,41.81%,17.82%
2020-01-01 00:21:10,14,12,8344,488,7856,12.73%,5.85%
2020-01-01 00:21:10,15,1,507,2,505,0.77%,0.39%
2020-01-01 00:21:10,15,2,171,1,170,0.26%,0.58%
2020-01-01 00:21:10,15,3,4230,122,4108,6.45%,2.88%
2020-01-01 00:21:10,15,4,5224,211,5013,7.97%,4.04%
2020-01-01 00:21:10,15,5,11005,889,10116,16.79%,8.08%
2020-01-01 00:21:10,15,6,5544,237,5307,8.46%,4.27%
2020-01-01 00:21:10,15,7,3877,127,3750,5.92%,3.28%
2020-01-01 00:21:10,15,8,5652,255,5397,8.62%,4.51%
2020-01-01 00:21:10,15,9,11200,912,10288,17.09%,8.14%
2020-01-01 00:21:10,15,10,4114,123,3991,6.28%,2.99%
2020-01-01 00:21:10,15,11,9896,698,9198,15.10%,7.05%
2020-01-01 00:21:10,15,12,26367,4831,21536,40.23%,18.32%
2020-01-01 00:21:10,16,1,531,2,529,0.81%,0.38%
2020-01-01 00:21:10,16,2,203,1,202,0.31%,0.49%
2020-01-01 00:21:10,16,3,1480,21,1459,2.26%,1.42%
2020-01-01 00:21:10,16,4,4299,142,4157,6.56%,3.30%
2020-01-01 00:21:10,16,5,7826,477,7349,11.94%,6.10%
2020-01-01 00:21:10,16,6,5061,199,4862,7.72%,3.93%
2020-01-01 00:21:10,16,7,3748,170,3578,5.72%,4.54%
2020-01-01 00:21:10,16,8,7637,533,7104,11.65%,6.98%
2020-01-01 00:21:10,16,9,8379,671,7708,12.79%,8.01%
2020-01-01 00:21:10,16,10,1643,16,1627,2.51%,0.97%
2020-01-01 00:21:10,16,11,9477,734,8743,14.46%,7.75%
2020-01-01 00:21:10,16,12,25365,4498,20867,38.70%,17.73%
2020-01-01 00:21:20,1,1,27980,5195,22785,42.69%,18.57%
2020-01-01 00:21:20,1,2,15912,1763,14149,24.28%,11.08%
2020-01-01 00:21:20,1,3,438,0,438,0.67%,0.00%
2020-01-01 00:21:20,1,4,11595,970,10625,17.69%,8.37%
2020-01-01 00:21:20,1,5,11332,931,10401,17.29%,8.22%
2020-01-01 00:21:20,1,6,11286,925,10361,17.22%,8.20%
2020-01-01 00:21:20,1,7,15460,1679,13781,23.59%,10.86%
2020-01-01 00:21:20,1,8,14644,1511,13133,22.34%,10.32%
2020-01-01 00:21:20,1,9,11243,918,10325,17.16%,8.17%
2020-01-01 00:21:20,1,10,13885,1359,12526,21.19%,9.79%
2020-01-01 00:21:20,1,11,14166,1412,12754,21.62%,9.97%
2020-01-01 00:21:20,1,12,11218,916,10302,17.12%,8.17%
2020-01-01 00:21:20,2,1,492,0,492,0.75%,0.00%
2020-01-01 00:21:20,2,2,22040,3291,18749,33.63%,14.93%
2020-01-01 00:21:20,2,3,17481,2099,15382,26.67%,12.01%
2020-01-01 00:21:20,2,4,386,0,386,0.59%,0.00%
2020-01-01 00:21:20,2,5,10723,836,9887,16.36%,7.80%
2020-01-01 00:21:20,2,6,58,0,58,0.09%,0.00%
2020-01-01 00:21:20,2,7,4045,104,3941,6.17%,2.57%
2020-01-01 00:21:20,2,8,3006,55,2951,4.59%,1.83%
2020-01-01 00:21:20,2,9,10663,826,9837,16.27%,7.75%
2020-01-01 00:21:20,2,10,2207,27,2180,3.37%,1.22%
2020-01-01 00:21:20,2,11,2224,28,2196,3.39%,1.26%
2020-01-01 00:21:20,2,12,10492,802,9690,16.01%,7.64%
2020-01-01 00:21:20,3,1,1492,24,1468,2.28%,1.61%
2020-01-01 00:21:20,3,2,22531,3502,19029,34.38%,15.54%
2020-01-01 00:21:20,3,3,77599,32351,45248,118.41%,41.69%
2020-01-01 00:21:20,3,4,14522,1555,12967,22.16%,10.71%
2020-01-01 00:21:20,3,5,54451,17671,36780,83.09%,32.45%
2020-01-01 00:21:20,3,6,16100,1896,14204,24.57%,11.78%
2020-01-01 00:21:20,3,7,18743,2495,16248,28.60%,13.31%
2020-01-01 00:21:20,3,8,15271,1678,13593,23.30%,10.99%
2020-01-01 00:21:20,3,9,37916,9019,28897,57.86%,23.79%
2020-01-01 00:21:20,3,10,6204,283,5921,9.47%,4.56%
2020-01-01 00:21:20,3,11,1979,29,1950,3.02%,1.47%
2020-01-01 00:21:20,3,12,28188,5144,23044,43.01%,18.25%
2020-01-01 00:21:20,4,1,561,3,558,0.86%,0.53%
2020-01-01 00:21:20,4,2,307,1,306,0.47%,0.33%
2020-01-01 00:21:20,4,3,835,4,831,1.27%,0.48%
2020-01-01 00:21:20,4,4,27581,5155,22426,42.09%,18.69%
2020-01-01 00:21:20,4,5,17178,2136,15042,26.21%,12.43%
2020-01-01 00:21:20,4,6,23737,3909,19828,36.22%,16.47%
2020-01-01 00:21:20,4,7,5132,198,4934,7.83%,3.86%
2020-01-01 00:21:20,4,8,3048,76,2972,4.65%,2.49%
2020-01-01 00:21:20,4,9,14938,1624,13314,22.79%,10.87%
2020-01-01 00:21:20,4,10,1918,25,1893,2.93%,1.30%
2020-01-01 00:21:20,4,11,248,1,247,0.38%,0.40%
2020-01-01 00:21:20,4,12,12422,1143,11279,18.95%,9.20%
2020-01-01 00:21:20,5,1,3202,84,3118,4.89%,2.62%
2020-01-01 00:21:20,5,2,1173,13,1160,1.79%,1.11%
2020-01-01 00:21:20,5,3,1198,7,1191,1.83%,0.58%
2020-01-01 00:21:20,5,4,22344,3437,18907,34.09%,15.38%
2020-01-01 00:21:20,5,5,9971,740,9231,15.21%,7.42%
2020-01-01 00:21:20,5,6,14758,1601,13157,22.52%,10.85%
2020-01-01 00:21:20,5,7,4348,177,4171,6.63%,4.07%
2020-01-01 00:21:20,5,8,3185,87,3098,4.86%,2.73%
2020-01-01 00:21:20,5,9,8654,569,8085,13.20%,6.57%
2020-01-01 00:21:20,5,10,990,9,981,1.51%,0.91%
2020-01-01 00:21:20,5,11,695,5,690,1.06%,0.72%
2020-01-01 00:21:20,5,12,7186,393,6793,10.96%,5.47%
2020-01-01 00:21:20,6,1,1039,10,1029,1.59%,0.96%
2020-01-01 00:21:20,6,2,1133,14,1119,1.73%,1.24%
2020-01-01 00:21:20,6,3,1664,23,1641,2.54%,1.38%
2020-01-01 00:21:20,6,4,1454,22,1432,2.22%,1.51%
2020-01-01 00:21:20,6,5,13839,1325,12514,21.12%,9.57%
2020-01-01 00:21:20,6,6,4857,168,4689,7.41%,3.46%
2020-01-01 00:21:20,6,7,2927,67,2860,4.47%,2.29%
2020-01-01 00:21:20,6,8,2509,48,2461,3.83%,1.91%
2020-01-01 00:21:20,6,9,7012,364,6648,10.70%,5.19%
2020-01-01 00:21:20,6,10,2238,36,2202,3.41%,1.61%
2020-01-01 00:21:20,6,11,482,1,481,0.74%,0.21%
2020-01-01 00:21:20,6,12,4729,166,4563,7.22%,3.51%
2020-01-01 00:21:20,7,1,558,1,557,0.85%,0.18%
2020-01-01 00:21:20,7,2,244,0,244,0.37%,0.00%
2020-01-01 00:21:20,7,3,722,3,719,1.10%,0.42%
2020-01-01 00:21:20,7,4,2152,31,2121,3.28%,1.44%
2020-01-01 00:21:20,7,5,7102,371,6731,10.84%,5.22%
2020-01-01 00:21:20,7,6,13508,1235,12273,20.61%,9.14%
2020-01-01 00:21:20,7,7,4229,109,4120,6.45%,2.58%
2020-01-01 00:21:20,7,8,2437,40,2397,3.72%,1.64%
2020-01-01 00:21:20,7,9,6075,285,5790,9.27%,4.69%
2020-01-01 00:21:20,7,10,929,9,920,1.42%,0.97%
2020-01-01 00:21:20,7,11,52,0,52,0.08%,0.00%
2020-01-01 00:21:20,7,12,5168,220,4948,7.89%,4.26%
2020-01-01 00:21:20,8,1,517,5,512,0.79%,0.97%
2020-01-01 00:21:20,8,2,102,4,98,0.16%,3.92%
2020-01-01 00:21:20,8,3,1526,16,1510,2.33%,1.05%
2020-01-01 00:21:20,8,4,3087,58,3029,4.71%,1.88%
2020-01-01 00:21:20,8,5,8088,491,7597,12.34%,6.07%
2020-01-01 00:21:20,8,6,15690,1761,13929,23.94%,11.22%
2020-01-01 00:21:20,8,7,4489,146,4343,6.85%,3.25%
2020-01-01 00:21:20,8,8,1862,26,1836,2.84%,1.40%
2020-01-01 00:21:20,8,9,6293,304,5989,9.60%,4.83%
2020-01-01 00:21:20,8,10,1740,19,1721,2.66%,1.09%
2020-01-01 00:21:20,8,11,132,0,132,0.20%,0.00%
2020-01-01 00:21:20,8,12,4555,168,4387,6.95%,3.69%
2020-01-01 00:21:20,9,1,1005,1,1004,1.53%,0.10%
2020-01-01 00:21:20,9,2,3288,67,3221,5.02%,2.04%
2020-01-01 00:21:20,9,3,1589,22,1567,2.42%,1.38%
2020-01-01 00:21:20,9,4,3844,95,3749,5.87%,2.47%
2020-01-01 00:21:20,9,5,855,4,851,1.30%,0.47%
2020-01-01 00:21:20,9,6,5838,238,5600,8.91%,4.08%
2020-01-01 00:21:20,9,7,25913,4452,21461,39.54%,17.18%
2020-01-01 00:21:20,9,8,9331,657,8674,14.24%,7.04%
2020-01-01 00:21:20,9,9,383,1,382,0.58%,0.26%
2020-01-01 00:21:20,9,10,2454,42,2412,3.74%,1.71%
2020-01-01 00:21:20,9,11,8096,485,7611,12.35%,5.99%
2020-01-01 00:21:20,9,12,5322,225,5097,8.12%,4.23%
2020-01-01 00:21:20,10,1,1228,271,957,1.87%,22.07%
2020-01-01 00:21:20,10,2,3490,323,3167,5.33%,9.26%
2020-01-01 00:21:20,10,3,2080,19,2061,3.17%,0.91%
2020-01-01 00:21:20,10,4,4006,988,3018,6.11%,24.66%
2020-01-01 00:21:20,10,5,959,58,901,1.46%,6.05%
2020-01-01 00:21:20,10,6,5634,1127,4507,8.60%,20.00%
2020-01-01 00:21:20,10,7,10876,1907,8969,16.60%,17.53%
2020-01-01 00:21:20,10,8,27250,6561,20689,41.58%,24.08%
2020-01-01 00:21:20,10,9,584,3,581,0.89%,0.51%
2020-01-01 00:21:20,10,10,2270,48,2222,3.46%,2.11%
2020-01-01 00:21:20,10,11,12871,1566,11305,19.64%,12.17%
2020-01-01 00:21:20,10,12,9919,1121,8798,15.14%,11.30%
2020-01-01 00:21:20,11,1,2375,62,2313,3.62%,2.61%
2020-01-01 00:21:20,11,2,3348,110,3238,5.11%,3.29%
2020-01-01 00:21:20,11,3,792,10,782,1.21%,1.26%
2020-01-01 00:21:20,11,4,4861,207,4654,7.42%,4.26%
2020-01-01 00:21:20,11,5,186,0,186,0.28%,0.00%
2020-01-01 00:21:20,11,6,5622,274,5348,8.58%,4.87%
2020-01-01 00:21:20,11,7,10591,880,9711,16.16%,8.31%
2020-01-01 00:21:20,11,8,24761,4195,20566,37.78%,16.94%
2020-01-01 00:21:20,11,9,281,0,281,0.43%,0.00%
2020-01-01 00:21:20,11,10,3016,67,2949,4.60%,2.22%
2020-01-01 00:21:20,11,11,10034,730,9304,15.31%,7.28%
2020-01-01 00:21:20,11,12,6527,316,6211,9.96%,4.84%
2020-01-01 00:21:20,12,1,97,0,97,0.15%,0.00%
2020-01-01 00:21:20,12,2,450,112,338,0.69%,24.89%
2020-01-01 00:21:20,12,3,2284,181,2103,3.49%,7.92%
2020-01-01 00:21:20,12,4,2694,68,2626,4.11%,2.52%
2020-01-01 00:21:20,12,5,7468,535,6933,11.40%,7.16%
2020-01-01 00:21:20,12,6,4545,159,4386,6.94%,3.50%
2020-01-01 00:21:20,12,7,1737,19,1718,2.65%,1.09%
2020-01-01 00:21:20,12,8,1097,149,948,1.67%,13.58%
2020-01-01 00:21:20,12,9,20477,3657,16820,31.25%,17.86%
2020-01-01 00:21:20,12,10,3855,225,3630,5.88%,5.84%
2020-01-01 00:21:20,12,11,1274,151,1123,1.94%,11.85%
2020-01-01 00:21:20,12,12,7254,1088,6166,11.07%,15.00%
2020-01-01 00:21:20,13,1,1747,17,1730,2.67%,0.97%
2020-01-01 00:21:20,13,2,2127,28,2099,3.25%,1.32%
2020-01-01 00:21:20,13,3,592,4,588,0.90%,0.68%
2020-01-01 00:21:20,13,4,5269,590,4679,8.04%,11.20%
2020-01-01 00:21:20,13,5,7323,930,6393,11.17%,12.70%
2020-01-01 00:21:20,13,6,5839,643,5196,8.91%,11.01%
2020-01-01 00:21:20,13,7,4425,141,4284,6.75%,3.19%
2020-01-01 00:21:20,13,8,6807,343,6464,10.39%,5.04%
2020-01-01 00:21:20,13,9,7607,953,6654,11.61%,12.53%
2020-01-01 00:21:20,13,10,26424,5215,21209,40.32%,19.74%
2020-01-01 00:21:20,13,11,16738,2157,14581,25.54%,12.89%
2020-01-01 00:21:20,13,12,9572,872,8700,14.61%,9.11%
2020-01-01 00:21:20,14,1,546,2,544,0.83%,0.37%
2020-01-01 00:21:20,14,2,1763,19,1744,2.69%,1.08%
2020-01-01 00:21:20,14,3,1030,6,1024,1.57%,0.58%
2020-01-01 00:21:20,14,4,4984,186,4798,7.60%,3.73%
2020-01-01 00:21:20,14,5,1349,9,1340,2.06%,0.67%
2020-01-01 00:21:20,14,6,5423,220,5203,8.27%,4.06%
2020-01-01 00:21:20,14,7,12887,1226,11661,19.66%,9.51%
2020-01-01 00:21:20,14,8,14571,1542,13029,22.23%,10.58%
2020-01-01 00:21:20,14,9,1591,15,1576,2.43%,0.94%
2020-01-01 00:21:20,14,10,4365,145,4220,6.66%,3.32%
2020-01-01 00:21:20,14,11,27457,5056,22401,41.90%,18.41%
2020-01-01 00:21:20,14,12,8141,489,7652,12.42%,6.01%
2020-01-01 00:21:20,15,1,646,4,642,0.99%,0.62%
2020-01-01 00:21:20,15,2,128,0,128,0.20%,0.00%
2020-01-01 00:21:20,15,3,6194,269,5925,9.45%,4.34%
2020-01-01 00:21:20,15,4,5325,231,5094,8.13%,4.34%
2020-01-01 00:21:20,15,5,12472,1185,11287,19.03%,9.50%
2020-01-01 00:21:20,15,6,5581,293,5288,8.52%,5.25%
2020-01-01 00:21:20,15,7,3410,105,3305,5.20%,3.08%
2020-01-01 00:21:20,15,8,6035,273,5762,9.21%,4.52%
2020-01-01 00:21:20,15,9,12633,1223,11410,19.28%,9.68%
2020-01-01 00:21:20,15,10,4777,280,4497,7.29%,5.86%
2020-01-01 00:21:20,15,11,10970,985,9985,16.74%,8.98%
2020-01-01 00:21:20,15,12,29469,6162,23307,44.97%,20.91%
2020-01-01 00:21:20,16,1,444,2,442,0.68%,0.45%
2020-01-01 00:21:20,16,2,299,2,297,0.46%,0.67%
2020-01-01 00:21:20,16,3,1955,48,1907,2.98%,2.46%
2020-01-01 00:21:20,16,4,3866,178,3688,5.90%,4.60%
2020-01-01 00:21:20,16,5,8463,645,7818,12.91%,7.62%
2020-01-01 00:21:20,16,6,4804,254,4550,7.33%,5.29%
2020-01-01 00:21:20,16,7,3624,123,3501,5.53%,3.39%
2020-01-01 00:21:20,16,8,7508,504,7004,11.46%,6.71%
2020-01-01 00:21:20,16,9,8891,697,8194,13.57%,7.84%
2020-01-01 00:21:20,16,10,1629,15,1614,2.49%,0.92%
2020-01-01 00:21:20,16,11,9343,727,8616,14.26%,7.78%
2020-01-01 00:21:20,16,12,27587,5189,22398,42.09%,18.81%
2020-01-01 00:21:30,1,1,23470,3828,19642,35.81%,16.31%
2020-01-01 00:21:30,1,2,11734,1034,10700,17.90%,8.81%
2020-01-01 00:21:30,1,3,378,0,378,0.58%,0.00%
2020-01-01 00:21:30,1,4,11333,981,10352,17.29%,8.66%
2020-01-01 00:21:30,1,5,11156,952,10204,17.02%,8.53%
2020-01-01 00:21:30,1,6,11080,938,10142,16.91%,8.47%
2020-01-01 00:21:30,1,7,11348,978,10370,17.32%,8.62%
2020-01-01 00:21:30,1,8,10768,868,9900,16.43%,8.06%
2020-01-01 00:21:30,1,9,11040,934,10106,16.85%,8.46%
2020-01-01 00:21:30,1,10,9977,734,9243,15.22%,7.36%
2020-01-01 00:21:30,1,11,10053,744,9309,15.34%,7.40%
2020-01-01 00:21:30,1,12,10991,923,10068,16.77%,8.40%
2020-01-01 00:21:30,2,1,1777,19,1758,2.71%,1.07%
2020-01-01 00:21:30,2,2,25554,4458,21096,38.99%,17.45%
2020-01-01 00:21:30,2,3,19107,2510,16597,29.15%,13.14%
2020-01-01 00:21:30,2,4,1701,18,1683,2.60%,1.06%
2020-01-01 00:21:30,2,5,11673,998,10675,17.81%,8.55%
2020-01-01 00:21:30,2,6,52,0,52,0.08%,0.00%
2020-01-01 00:21:30,2,7,4659,152,4507,7.11%,3.26%
2020-01-01 00:21:30,2,8,2943,60,2883,4.49%,2.04%
2020-01-01 00:21:30,2,9,11562,980,10582,17.64%,8.48%
2020-01-01 00:21:30,2,10,2073,31,2042,3.16%,1.50%
2020-01-01 00:21:30,2,11,2115,31,2084,3.23%,1.47%
2020-01-01 00:21:30,2,12,11305,947,10358,17.25%,8.38%
2020-01-01 00:21:30,3,1,1551,11,1540,2.37%,0.71%
2020-01-01 00:21:30,3,2,24247,3974,20273,37.00%,16.39%
2020-01-01 00:21:30,3,3,74395,29790,44605,113.52%,40.04%
2020-01-01 00:21:30,3,4,9313,593,8720,14.21%,6.37%
2020-01-01 00:21:30,3,5,48873,14340,34533,74.57%,29.34%
2020-01-01 00:21:30,3,6,11131,828,10303,16.98%,7.44%
2020-01-01 00:21:30,3,7,21362,3108,18254,32.60%,14.55%
2020-01-01 00:21:30,3,8,16851,1950,14901,25.71%,11.57%
2020-01-01 00:21:30,3,9,37284,8839,28445,56.89%,23.71%
2020-01-01 00:21:30,3,10,3596,84,3512,5.49%,2.34%
2020-01-01 00:21:30,3,11,1931,33,1898,2.95%,1.71%
2020-01-01 00:21:30,3,12,31539,6541,24998,48.12%,20.74%
2020-01-01 00:21:30,4,1,584,3,581,0.89%,0.51%
2020-01-01 00:21:30,4,2,390,2,388,0.60%,0.51%
2020-01-01 00:21:30,4,3,896,6,890,1.37%,0.67%
2020-01-01 00:21:30,4,4,27546,5035,22511,42.03%,18.28%
2020-01-01 00:21:30,4,5,17905,2215,15690,27.32%,12.37%
2020-01-01 00:21:30,4,6,23760,3822,19938,36.25%,16.09%
2020-01-01 00:21:30,4,7,4648,154,4494,7.09%,3.31%
2020-01-01 00:21:30,4,8,2798,61,2737,4.27%,2.18%
2020-01-01 00:21:30,4,9,14783,1535,13248,22.56%,10.38%
2020-01-01 00:21:30,4,10,1916,14,1902,2.92%,0.73%
2020-01-01 00:21:30,4,11,205,0,205,0.31%,0.00%
2020-01-01 00:21:30,4,12,12272,1107,11165,18.73%,9.02%
2020-01-01 00:21:30,5,1,2775,50,2725,4.23%,1.80%
2020-01-01 00:21:30,5,2,777,1,776,1.19%,0.13%
2020-01-01 00:21:30,5,3,531,1,530,0.81%,0.19%
2020-01-01 00:21:30,5,4,23559,3770,19789,35.95%,16.00%
2020-01-01 00:21:30,5,5,10023,745,9278,15.29%,7.43%
2020-01-01 00:21:30,5,6,16076,1876,14200,24.53%,11.67%
2020-01-01 00:21:30,5,7,5615,238,5377,8.57%,4.24%
2020-01-01 00:21:30,5,8,3929,107,3822,6.00%,2.72%
2020-01-01 00:21:30,5,9,9273,645,8628,14.15%,6.96%
2020-01-01 00:21:30,5,10,1358,11,1347,2.07%,0.81%
2020-01-01 00:21:30,5,11,796,8,788,1.21%,1.01%
2020-01-01 00:21:30,5,12,7629,467,7162,11.64%,6.12%
2020-01-01 00:21:30,6,1,1001,12,989,1.53%,1.20%
2020-01-01 00:21:30,6,2,1078,13,1065,1.64%,1.21%
2020-01-01 00:21:30,6,3,1715,33,1682,2.62%,1.92%
2020-01-01 00:21:30,6,4,1205,10,1195,1.84%,0.83%
2020-01-01 00:21:30,6,5,16899,2016,14883,25.79%,11.93%
2020-01-01 00:21:30,6,6,4966,178,4788,7.58%,3.58%
2020-01-01 00:21:30,6,7,3454,93,3361,5.27%,2.69%
2020-01-01 00:21:30,6,8,2817,69,2748,4.30%,2.45%
2020-01-01 00:21:30,6,9,9961,707,9254,15.20%,7.10%
2020-01-01 00:21:30,6,10,2094,42,2052,3.20%,2.01%
2020-01-01 00:21:30,6,11,364,2,362,0.56%,0.55%
2020-01-01 00:21:30,6,12,7731,446,7285,11.80%,5.77%
2020-01-01 00:21:30,7,1,415,2,413,0.63%,0.48%
2020-01-01 00:21:30,7,2,251,0,251,0.38%,0.00%
2020-01-01 00:21:30,7,3,2071,36,2035,3.16%,1.74%
2020-01-01 00:21:30,7,4,1452,17,1435,2.22%,1.17%
2020-01-01 00:21:30,7,5,7875,433,7442,12.02%,5.50%
2020-01-01 00:21:30,7,6,13242,1239,12003,20.21%,9.36%
2020-01-01 00:21:30,7,7,3894,112,3782,5.94%,2.88%
2020-01-01 00:21:30,7,8,1533,23,1510,2.34%,1.50%
2020-01-01 00:21:30,7,9,5704,229,5475,8.70%,4.01%
2020-01-01 00:21:30,7,10,994,6,988,1.52%,0.60%
2020-01-01 00:21:30,7,11,74,0,74,0.11%,0.00%
2020-01-01 00:21:30,7,12,4651,143,4508,7.10%,3.07%
2020-01-01 00:21:30,8,1,480,1,479,0.73%,0.21%
2020-01-01 00:21:30,8,2,122,0,122,0.19%,0.00%
2020-01-01 00:21:30,8,3,1628,18,1610,2.48%,1.11%
2020-01-01 00:21:30,8,4,2586,44,2542,3.95%,1.70%
2020-01-01 00:21:30,8,5,8619,577,8042,13.15%,6.69%
2020-01-01 00:21:30,8,6,16195,1935,14260,24.71%,11.95%
2020-01-01 00:21:30,8,7,4920,179,4741,7.51%,3.64%
2020-01-01 00:21:30,8,8,1914,36,1878,2.92%,1.88%
2020-01-01 00:21:30,8,9,6727,347,6380,10.26%,5.16%
2020-01-01 00:21:30,8,10,1804,31,1773,2.75%,1.72%
2020-01-01 00:21:30,8,11,245,0,245,0.37%,0.00%
2020-01-01 00:21:30,8,12,4771,192,4579,7.28%,4.02%
2020-01-01 00:21:30,9,1,548,0,548,0.84%,0.00%
2020-01-01 00:21:30,9,2,4148,104,4044,6.33%,2.51%
2020-01-01 00:21:30,9,3,3130,64,3066,4.78%,2.04%
2020-01-01 00:21:30,9,4,12640,1197,11443,19.29%,9.47%
2020-01-01 00:21:30,9,5,447,3,444,0.68%,0.67%
2020-01-01 00:21:30,9,6,13351,1326,12025,20.37%,9.93%
2020-01-01 00:21:30,9,7,31959,6784,25175,48.77%,21.23%
2020-01-01 00:21:30,9,8,9270,643,8627,14.14%,6.94%
2020-01-01 00:21:30,9,9,280,3,277,0.43%,1.07%
2020-01-01 00:21:30,9,10,3189,72,3117,4.87%,2.26%
2020-01-01 00:21:30,9,11,8154,496,7658,12.44%,6.08%
2020-01-01 00:21:30,9,12,4604,158,4446,7.03%,3.43%
2020-01-01 00:21:30,10,1,1423,278,1145,2.17%,19.54%
2020-01-01 00:21:30,10,2,3083,327,2756,4.70%,10.61%
2020-01-01 00:21:30,10,3,1460,12,1448,2.23%,0.82%
2020-01-01 00:21:30,10,4,3572,921,2651,5.45%,25.78%
2020-01-01 00:21:30,10,5,678,9,669,1.03%,1.33%
2020-01-01 00:21:30,10,6,5691,1039,4652,8.68%,18.26%
2020-01-01 00:21:30,10,7,10475,1743,8732,15.98%,16.64%
2020-01-01 00:21:30,10,8,25975,6249,19726,39.63%,24.06%
2020-01-01 00:21:30,10,9,554,3,551,0.85%,0.54%
2020-01-01 00:21:30,10,10,2117,28,2089,3.23%,1.32%
2020-01-01 00:21:30,10,11,11443,1343,10100,17.46%,11.74%
2020-01-01 00:21:30,10,12,8767,985,7782,13.38%,11.24%
2020-01-01 00:21:30,11,1,2183,36,2147,3.33%,1.65%
2020-01-01 00:21:30,11,2,3564,94,3470,5.44%,2.64%
2020-01-01 00:21:30,11,3,1187,12,1175,1.81%,1.01%
2020-01-01 00:21:30,11,4,3681,97,3584,5.62%,2.64%
2020-01-01 00:21:30,11,5,373,2,371,0.57%,0.54%
2020-01-01 00:21:30,11,6,4685,148,4537,7.15%,3.16%
2020-01-01 00:21:30,11,7,9760,663,9097,14.89%,6.79%
2020-01-01 00:21:30,11,8,22781,3636,19145,34.76%,15.96%
2020-01-01 00:21:30,11,9,214,1,213,0.33%,0.47%
2020-01-01 00:21:30,11,10,2981,85,2896,4.55%,2.85%
2020-01-01 00:21:30,11,11,9850,770,9080,15.03%,7.82%
2020-01-01 00:21:30,11,12,6530,353,6177,9.96%,5.41%
2020-01-01 00:21:30,12,1,46,0,46,0.07%,0.00%
2020-01-01 00:21:30,12,2,626,207,419,0.96%,33.07%
2020-01-01 00:21:30,12,3,2608,233,2375,3.98%,8.93%
2020-01-01 00:21:30,12,4,2510,54,2456,3.83%,2.15%
2020-01-01 00:21:30,12,5,9581,796,8785,14.62%,8.31%
2020-01-01 00:21:30,12,6,6139,284,5855,9.37%,4.63%
2020-01-01 00:21:30,12,7,3527,98,3429,5.38%,2.78%
2020-01-01 00:21:30,12,8,1010,199,811,1.54%,19.70%
2020-01-01 00:21:30,12,9,21179,4011,17168,32.32%,18.94%
2020-01-01 00:21:30,12,10,3706,282,3424,5.65%,7.61%
2020-01-01 00:21:30,12,11,1211,203,1008,1.85%,16.76%
2020-01-01 00:21:30,12,12,6985,981,6004,10.66%,14.04%
2020-01-01 00:21:30,13,1,2103,37,2066,3.21%,1.76%
2020-01-01 00:21:30,13,2,2514,53,2461,3.84%,2.11%
2020-01-01 00:21:30,13,3,672,2,670,1.03%,0.30%
2020-01-01 00:21:30,13,4,4267,521,3746,6.51%,12.21%
2020-01-01 00:21:30,13,5,6942,826,6116,10.59%,11.90%
2020-01-01 00:21:30,13,6,5467,606,4861,8.34%,11.08%
2020-01-01 00:21:30,13,7,5125,192,4933,7.82%,3.75%
2020-01-01 00:21:30,13,8,7421,394,7027,11.32%,5.31%
2020-01-01 00:21:30,13,9,7166,852,6314,10.93%,11.89%
2020-01-01 00:21:30,13,10,27899,5740,22159,42.57%,20.57%
2020-01-01 00:21:30,13,11,17704,2441,15263,27.01%,13.79%
2020-01-01 00:21:30,13,12,9706,940,8766,14.81%,9.68%
2020-01-01 00:21:30,14,1,553,2,551,0.84%,0.36%
2020-01-01 00:21:30,14,2,2015,33,1982,3.07%,1.64%
2020-01-01 00:21:30,14,3,1195,14,1181,1.82%,1.17%
2020-01-01 00:21:30,14,4,3917,96,3821,5.98%,2.45%
2020-01-01 00:21:30,14,5,1266,15,1251,1.93%,1.18%
2020-01-01 00:21:30,14,6,4504,127,4377,6.87%,2.82%
2020-01-01 00:21:30,14,7,11623,926,10697,17.74%,7.97%
2020-01-01 00:21:30,14,8,13268,1224,12044,20.25%,9.23%
2020-01-01 00:21:30,14,9,1654,23,1631,2.52%,1.39%
2020-01-01 00:21:30,14,10,4130,142,3988,6.30%,3.44%
2020-01-01 00:21:30,14,11,25907,4513,21394,39.53%,17.42%
2020-01-01 00:21:30,14,12,8179,528,7651,12.48%,6.46%
2020-01-01 00:21:30,15,1,485,2,483,0.74%,0.41%
2020-01-01 00:21:30,15,2,133,0,133,0.20%,0.00%
2020-01-01 00:21:30,15,3,4096,153,3943,6.25%,3.74%
2020-01-01 00:21:30,15,4,4508,181,4327,6.88%,4.02%
2020-01-01 00:21:30,15,5,10408,828,9580,15.88%,7.96%
2020-01-01 00:21:30,15,6,4734,209,4525,7.22%,4.41%
2020-01-01 00:21:30,15,7,3457,92,3365,5.27%,2.66%
2020-01-01 00:21:30,15,8,5289,243,5046,8.07%,4.59%
2020-01-01 00:21:30,15,9,10626,862,9764,16.21%,8.11%
2020-01-01 00:21:30,15,10,4188,158,4030,6.39%,3.77%
2020-01-01 00:21:30,15,11,9589,720,8869,14.63%,7.51%
2020-01-01 00:21:30,15,12,25525,4622,20903,38.95%,18.11%
2020-01-01 00:21:30,16,1,437,0,437,0.67%,0.00%
2020-01-01 00:21:30,16,2,273,2,271,0.42%,0.73%
2020-01-01 00:21:30,16,3,1287,15,1272,1.96%,1.17%
2020-01-01 00:21:30,16,4,6500,339,6161,9.92%,5.22%
2020-01-01 00:21:30,16,5,10307,897,9410,15.73%,8.70%
2020-01-01 00:21:30,16,6,7499,425,7074,11.44%,5.67%
2020-01-01 00:21:30,16,7,3096,67,3029,4.72%,2.16%
2020-01-01 00:21:30,16,8,6749,345,6404,10.30%,5.11%
2020-01-01 00:21:30,16,9,10751,960,9791,16.40%,8.93%
2020-01-01 00:21:30,16,10,1759,24,1735,2.68%,1.36%
2020-01-01 00:21:30,16,11,8702,551,8151,13.28%,6.33%
2020-01-01 00:21:30,16,12,27868,5377,22491,42.52%,19.29%
2020-01-01 00:21:40,1,1,16011,1793,14218,24.43%,11.20%
2020-01-01 00:21:40,1,2,7238,393,6845,11.04%,5.43%
2020-01-01 00:21:40,1,3,287,1,286,0.44%,0.35%
2020-01-01 00:21:40,1,4,8400,536,7864,12.82%,6.38%
2020-01-01 00:21:40,1,5,8051,510,7541,12.28%,6.33%
2020-01-01 00:21:40,1,6,8006,502,7504,12.22%,6.27%
2020-01-01 00:21:40,1,7,6946,369,6577,10.60%,5.31%
2020-01-01 00:21:40,1,8,6461,315,6146,9.86%,4.88%
2020-01-01 00:21:40,1,9,7954,495,7459,12.14%,6.22%
2020-01-01 00:21:40,1,10,5829,264,5565,8.89%,4.53%
2020-01-01 00:21:40,1,11,5907,271,5636,9.01%,4.59%
2020-01-01 00:21:40,1,12,7929,493,7436,12.10%,6.22%
2020-01-01 00:21:40,2,1,1811,31,1780,2.76%,1.71%
2020-01-01 00:21:40,2,2,27410,5002,22408,41.82%,18.25%
2020-01-01 00:21:40,2,3,20636,2925,17711,31.49%,14.17%
2020-01-01 00:21:40,2,4,1762,29,1733,2.69%,1.65%
2020-01-01 00:21:40,2,5,12307,1055,11252,18.78%,8.57%
2020-01-01 00:21:40,2,6,23,0,23,0.04%,0.00%
2020-01-01 00:21:40,2,7,4954,164,4790,7.56%,3.31%
2020-01-01 00:21:40,2,8,3559,76,3483,5.43%,2.14%
2020-01-01 00:21:40,2,9,12242,1042,11200,18.68%,8.51%
2020-01-01 00:21:40,2,10,2651,45,2606,4.05%,1.70%
2020-01-01 00:21:40,2,11,2655,45,2610,4.05%,1.69%
2020-01-01 00:21:40,2,12,12044,1007,11037,18.38%,8.36%
2020-01-01 00:21:40,3,1,1340,13,1327,2.04%,0.97%
2020-01-01 00:21:40,3,2,23966,3897,20069,36.57%,16.26%
2020-01-01 00:21:40,3,3,76970,31629,45341,117.45%,41.09%
2020-01-01 00:21:40,3,4,13541,1310,12231,20.66%,9.67%
2020-01-01 00:21:40,3,5,49340,14693,34647,75.29%,29.78%
2020-01-01 00:21:40,3,6,14527,1491,13036,22.17%,10.26%
2020-01-01 00:21:40,3,7,20031,2759,17272,30.56%,13.77%
2020-01-01 00:21:40,3,8,15923,1775,14148,24.30%,11.15%
2020-01-01 00:21:40,3,9,34249,7597,26652,52.26%,22.18%
2020-01-01 00:21:40,3,10,4409,122,4287,6.73%,2.77%
2020-01-01 00:21:40,3,11,1984,28,1956,3.03%,1.41%
2020-01-01 00:21:40,3,12,25979,4509,21470,39.64%,17.36%
2020-01-01 00:21:40,4,1,465,2,463,0.71%,0.43%
2020-01-01 00:21:40,4,2,287,1,286,0.44%,0.35%
2020-01-01 00:21:40,4,3,684,2,682,1.04%,0.29%
2020-01-01 00:21:40,4,4,28046,5167,22879,42.79%,18.42%
2020-01-01 00:21:40,4,5,17671,2164,15507,26.96%,12.25%
2020-01-01 00:21:40,4,6,24491,3985,20506,37.37%,16.27%
2020-01-01 00:21:40,4,7,5586,234,5352,8.52%,4.19%
2020-01-01 00:21:40,4,8,3193,76,3117,4.87%,2.38%
2020-01-01 00:21:40,4,9,15527,1699,13828,23.69%,10.94%
2020-01-01 00:21:40,4,10,2136,32,2104,3.26%,1.50%
2020-01-01 00:21:40,4,11,135,0,135,0.21%,0.00%
2020-01-01 00:21:40,4,12,12479,1116,11363,19.04%,8.94%
2020-01-01 00:21:40,5,1,3495,97,3398,5.33%,2.78%
2020-01-01 00:21:40,5,2,1110,10,1100,1.69%,0.90%
2020-01-01 00:21:40,5,3,418,1,417,0.64%,0.24%
2020-01-01 00:21:40,5,4,23728,3827,19901,36.21%,16.13%
2020-01-01 00:21:40,5,5,9067,634,8433,13.84%,6.99%
2020-01-01 00:21:40,5,6,14580,1530,13050,22.25%,10.49%
2020-01-01 00:21:40,5,7,5055,182,4873,7.71%,3.60%
2020-01-01 00:21:40,5,8,3430,89,3341,5.23%,2.59%
2020-01-01 00:21:40,5,9,8257,536,7721,12.60%,6.49%
2020-01-01 00:21:40,5,10,1177,13,1164,1.80%,1.10%
2020-01-01 00:21:40,5,11,665,5,660,1.01%,0.75%
2020-01-01 00:21:40,5,12,6912,401,6511,10.55%,5.80%
2020-01-01 00:21:40,6,1,1100,9,1091,1.68%,0.82%
2020-01-01 00:21:40,6,2,1138,10,1128,1.74%,0.88%
2020-01-01 00:21:40,6,3,1808,24,1784,2.76%,1.33%
2020-01-01 00:21:40,6,4,1298,20,1278,1.98%,1.54%
2020-01-01 00:21:40,6,5,14159,1391,12768,21.60%,9.82%
2020-01-01 00:21:40,6,6,4238,133,4105,6.47%,3.14%
2020-01-01 00:21:40,6,7,2513,58,2455,3.83%,2.31%
2020-01-01 00:21:40,6,8,1959,40,1919,2.99%,2.04%
2020-01-01 00:21:40,6,9,7860,449,7411,11.99%,5.71%
2020-01-01 00:21:40,6,10,2214,34,2180,3.38%,1.54%
2020-01-01 00:21:40,6,11,459,0,459,0.70%,0.00%
2020-01-01 00:21:40,6,12,5559,235,5324,8.48%,4.23%
2020-01-01 00:21:40,7,1,388,4,384,0.59%,1.03%
2020-01-01 00:21:40,7,2,172,1,171,0.26%,0.58%
2020-01-01 00:21:40,7,3,789,8,781,1.20%,1.01%
2020-01-01 00:21:40,7,4,1335,10,1325,2.04%,0.75%
2020-01-01 00:21:40,7,5,8096,452,7644,12.35%,5.58%
2020-01-01 00:21:40,7,6,12859,1220,11639,19.62%,9.49%
2020-01-01 00:21:40,7,7,3397,123,3274,5.18%,3.62%
2020-01-01 00:21:40,7,8,1323,18,1305,2.02%,1.36%
2020-01-01 00:21:40,7,9,7244,346,6898,11.05%,4.78%
2020-01-01 00:21:40,7,10,1221,9,1212,1.86%,0.74%
2020-01-01 00:21:40,7,11,102,0,102,0.16%,0.00%
2020-01-01 00:21:40,7,12,6010,232,5778,9.17%,3.86%
2020-01-01 00:21:40,8,1,378,0,378,0.58%,0.00%
2020-01-01 00:21:40,8,2,137,0,137,0.21%,0.00%
2020-01-01 00:21:40,8,3,1656,24,1632,2.53%,1.45%
2020-01-01 00:21:40,8,4,2623,46,2577,4.00%,1.75%
2020-01-01 00:21:40,8,5,9003,585,8418,13.74%,6.50%
2020-01-01 00:21:40,8,6,16832,1946,14886,25.68%,11.56%
2020-01-01 00:21:40,8,7,5122,197,4925,7.82%,3.85%
2020-01-01 00:21:40,8,8,2188,49,2139,3.34%,2.24%
2020-01-01 00:21:40,8,9,7002,353,6649,10.68%,5.04%
2020-01-01 00:21:40,8,10,1652,15,1637,2.52%,0.91%
2020-01-01 00:21:40,8,11,139,0,139,0.21%,0.00%
2020-01-01 00:21:40,8,12,5323,207,5116,8.12%,3.89%
2020-01-01 00:21:40,9,1,1271,6,1265,1.94%,0.47%
2020-01-01 00:21:40,9,2,3438,89,3349,5.25%,2.59%
2020-01-01 00:21:40,9,3,1802,23,1779,2.75%,1.28%
2020-01-01 00:21:40,9,4,6636,301,6335,10.13%,4.54%
2020-01-01 00:21:40,9,5,181,0,181,0.28%,0.00%
2020-01-01 00:21:40,9,6,7433,373,7060,11.34%,5.02%
2020-01-01 00:21:40,9,7,28967,5563,23404,44.20%,19.20%
2020-01-01 00:21:40,9,8,9720,743,8977,14.83%,7.64%
2020-01-01 00:21:40,9,9,129,0,129,0.20%,0.00%
2020-01-01 00:21:40,9,10,3447,158,3289,5.26%,4.58%
2020-01-01 00:21:40,9,11,8409,583,7826,12.83%,6.93%
2020-01-01 00:21:40,9,12,4683,169,4514,7.15%,3.61%
2020-01-01 00:21:40,10,1,1121,181,940,1.71%,16.15%
2020-01-01 00:21:40,10,2,4679,324,4355,7.14%,6.92%
2020-01-01 00:21:40,10,3,3335,89,3246,5.09%,2.67%
2020-01-01 00:21:40,10,4,4990,755,4235,7.61%,15.13%
2020-01-01 00:21:40,10,5,1112,12,1100,1.70%,1.08%
2020-01-01 00:21:40,10,6,7267,948,6319,11.09%,13.05%
2020-01-01 00:21:40,10,7,13786,1975,11811,21.04%,14.33%
2020-01-01 00:21:40,10,8,30867,7736,23131,47.10%,25.06%
2020-01-01 00:21:40,10,9,869,9,860,1.33%,1.04%
2020-01-01 00:21:40,10,10,2352,33,2319,3.59%,1.40%
2020-01-01 00:21:40,10,11,13321,1654,11667,20.33%,12.42%
2020-01-01 00:21:40,10,12,10182,1149,9033,15.54%,11.28%
2020-01-01 00:21:40,11,1,2303,56,2247,3.51%,2.43%
2020-01-01 00:21:40,11,2,5086,230,4856,7.76%,4.52%
2020-01-01 00:21:40,11,3,2625,55,2570,4.01%,2.10%
2020-01-01 00:21:40,11,4,6400,309,6091,9.77%,4.83%
2020-01-01 00:21:40,11,5,181,1,180,0.28%,0.55%
2020-01-01 00:21:40,11,6,7247,389,6858,11.06%,5.37%
2020-01-01 00:21:40,11,7,13767,1388,12379,21.01%,10.08%
2020-01-01 00:21:40,11,8,26919,4884,22035,41.08%,18.14%
2020-01-01 00:21:40,11,9,166,2,164,0.25%,1.20%
2020-01-01 00:21:40,11,10,2988,65,2923,4.56%,2.18%
2020-01-01 00:21:40,11,11,9914,708,9206,15.13%,7.14%
2020-01-01 00:21:40,11,12,6538,313,6225,9.98%,4.79%
2020-01-01 00:21:40,12,1,43,0,43,0.07%,0.00%
2020-01-01 00:21:40,12,2,589,169,420,0.90%,28.69%
2020-01-01 00:21:40,12,3,2746,213,2533,4.19%,7.76%
2020-01-01 00:21:40,12,4,3244,72,3172,4.95%,2.22%
2020-01-01 00:21:40,12,5,9062,716,8346,13.83%,7.90%
2020-01-01 00:21:40,12,6,5367,202,5165,8.19%,3.76%
2020-01-01 00:21:40,12,7,1991,28,1963,3.04%,1.41%
2020-01-01 00:21:40,12,8,1282,248,1034,1.96%,19.34%
2020-01-01 00:21:40,12,9,21169,4045,17124,32.30%,19.11%
2020-01-01 00:21:40,12,10,4094,336,3758,6.25%,8.21%
2020-01-01 00:21:40,12,11,1695,250,1445,2.59%,14.75%
2020-01-01 00:21:40,12,12,7460,1094,6366,11.38%,14.66%
2020-01-01 00:21:40,13,1,2080,30,2050,3.17%,1.44%
2020-01-01 00:21:40,13,2,2411,41,2370,3.68%,1.70%
2020-01-01 00:21:40,13,3,711,0,711,1.08%,0.00%
2020-01-01 00:21:40,13,4,5309,708,4601,8.10%,13.34%
2020-01-01 00:21:40,13,5,7488,912,6576,11.43%,12.18%
2020-01-01 00:21:40,13,6,6029,751,5278,9.20%,12.46%
2020-01-01 00:21:40,13,7,4684,154,4530,7.15%,3.29%
2020-01-01 00:21:40,13,8,6907,361,6546,10.54%,5.23%
2020-01-01 00:21:40,13,9,7742,937,6805,11.81%,12.10%
2020-01-01 00:21:40,13,10,27302,5623,21679,41.66%,20.60%
2020-01-01 00:21:40,13,11,16403,2105,14298,25.03%,12.83%
2020-01-01 00:21:40,13,12,9021,818,8203,13.76%,9.07%
2020-01-01 00:21:40,14,1,168,0,168,0.26%,0.00%
2020-01-01 00:21:40,14,2,1458,16,1442,2.22%,1.10%
2020-01-01 00:21:40,14,3,1032,15,1017,1.57%,1.45%
2020-01-01 00:21:40,14,4,4680,141,4539,7.14%,3.01%
2020-01-01 00:21:40,14,5,1659,21,1638,2.53%,1.27%
2020-01-01 00:21:40,14,6,4991,162,4829,7.62%,3.25%
2020-01-01 00:21:40,14,7,12807,1165,11642,19.54%,9.10%
2020-01-01 00:21:40,14,8,14269,1412,12857,21.77%,9.90%
2020-01-01 00:21:40,14,9,1853,32,1821,2.83%,1.73%
2020-01-01 00:21:40,14,10,4583,160,4423,6.99%,3.49%
2020-01-01 00:21:40,14,11,27243,4853,22390,41.57%,17.81%
2020-01-01 00:21:40,14,12,8173,476,7697,12.47%,5.82%
2020-01-01 00:21:40,15,1,536,6,530,0.82%,1.12%
2020-01-01 00:21:40,15,2,228,1,227,0.35%,0.44%
2020-01-01 00:21:40,15,3,3931,120,3811,6.00%,3.05%
2020-01-01 00:21:40,15,4,5740,260,5480,8.76%,4.53%
2020-01-01 00:21:40,15,5,10445,805,9640,15.94%,7.71%
2020-01-01 00:21:40,15,6,6032,289,5743,9.20%,4.79%
2020-01-01 00:21:40,15,7,3804,169,3635,5.80%,4.44%
2020-01-01 00:21:40,15,8,5540,283,5257,8.45%,5.11%
2020-01-01 00:21:40,15,9,10659,839,9820,16.26%,7.87%
2020-01-01 00:21:40,15,10,4860,196,4664,7.42%,4.03%
2020-01-01 00:21:40,15,11,10552,875,9677,16.10%,8.29%
2020-01-01 00:21:40,15,12,27012,5249,21763,41.22%,19.43%
2020-01-01 00:21:40,16,1,453,1,452,0.69%,0.22%
2020-01-01 00:21:40,16,2,186,1,185,0.28%,0.54%
2020-01-01 00:21:40,16,3,1472,27,1445,2.25%,1.83%
2020-01-01 00:21:40,16,4,3914,129,3785,5.97%,3.30%
2020-01-01 00:21:40,16,5,7440,497,6943,11.35%,6.68%
2020-01-01 00:21:40,16,6,4565,179,4386,6.97%,3.92%
2020-01-01 00:21:40,16,7,3474,120,3354,5.30%,3.45%
2020-01-01 00:21:40,16,8,6927,519,6408,10.57%,7.49%
2020-01-01 00:21:40,16,9,7797,539,7258,11.90%,6.91%
2020-01-01 00:21:40,16,10,1807,24,1783,2.76%,1.33%
2020-01-01 00:21:40,16,11,8920,727,8193,13.61%,8.15%
2020-01-01 00:21:40,16,12,24395,4279,20116,37.22%,17.54%
2020-01-01 00:21:50,1,1,16483,1933,14550,25.15%,11.73%
2020-01-01 00:21:50,1,2,5937,247,5690,9.06%,4.16%
2020-01-01 00:21:50,1,3,423,1,422,0.65%,0.24%
2020-01-01 00:21:50,1,4,9993,715,9278,15.25%,7.16%
2020-01-01 00:21:50,1,5,7028,421,6607,10.72%,5.99%
2020-01-01 00:21:50,1,6,6927,405,6522,10.57%,5.85%
2020-01-01 00:21:50,1,7,5491,210,5281,8.38%,3.82%
2020-01-01 00:21:50,1,8,4082,119,3963,6.23%,2.92%
2020-01-01 00:21:50,1,9,6902,405,6497,10.53%,5.87%
2020-01-01 00:21:50,1,10,3160,69,3091,4.82%,2.18%
2020-01-01 00:21:50,1,11,3287,75,3212,5.02%,2.28%
2020-01-01 00:21:50,1,12,6867,404,6463,10.48%,5.88%
2020-01-01 00:21:50,2,1,1403,15,1388,2.14%,1.07%
2020-01-01 00:21:50,2,2,27165,4946,22219,41.45%,18.21%
2020-01-01 00:21:50,2,3,21868,3287,18581,33.37%,15.03%
2020-01-01 00:21:50,2,4,1316,13,1303,2.01%,0.99%
2020-01-01 00:21:50,2,5,11783,998,10785,17.98%,8.47%
2020-01-01 00:21:50,2,6,68,0,68,0.10%,0.00%
2020-01-01 00:21:50,2,7,3874,113,3761,5.91%,2.92%
2020-01-01 00:21:50,2,8,2919,59,2860,4.45%,2.02%
2020-01-01 00:21:50,2,9,11729,989,10740,17.90%,8.43%
2020-01-01 00:21:50,2,10,1972,33,1939,3.01%,1.67%
2020-01-01 00:21:50,2,11,2012,33,1979,3.07%,1.64%
2020-01-01 00:21:50,2,12,11563,958,10605,17.64%,8.29%
2020-01-01 00:21:50,3,1,2019,25,1994,3.08%,1.24%
2020-01-01 00:21:50,3,2,27927,5148,22779,42.61%,18.43%
2020-01-01 00:21:50,3,3,83868,36651,47217,127.97%,43.70%
2020-01-01 00:21:50,3,4,13112,1263,11849,20.01%,9.63%
2020-01-01 00:21:50,3,5,55057,17836,37221,84.01%,32.40%
2020-01-01 00:21:50,3,6,14795,1578,13217,22.58%,10.67%
2020-01-01 00:21:50,3,7,23706,3760,19946,36.17%,15.86%
2020-01-01 00:21:50,3,8,19117,2541,16576,29.17%,13.29%
2020-01-01 00:21:50,3,9,39910,10013,29897,60.90%,25.09%
2020-01-01 00:21:50,3,10,5304,192,5112,8.09%,3.62%
2020-01-01 00:21:50,3,11,2147,43,2104,3.28%,2.00%
2020-01-01 00:21:50,3,12,31882,6646,25236,48.65%,20.85%
2020-01-01 00:21:50,4,1,582,4,578,0.89%,0.69%
2020-01-01 00:21:50,4,2,371,2,369,0.57%,0.54%
2020-01-01 00:21:50,4,3,702,9,693,1.07%,1.28%
2020-01-01 00:21:50,4,4,27449,5031,22418,41.88%,18.33%
2020-01-01 00:21:50,4,5,16949,2031,14918,25.86%,11.98%
2020-01-01 00:21:50,4,6,23529,3762,19767,35.90%,15.99%
2020-01-01 00:21:50,4,7,5272,207,5065,8.04%,3.93%
2020-01-01 00:21:50,4,8,3408,86,3322,5.20%,2.52%
2020-01-01 00:21:50,4,9,15041,1606,13435,22.95%,10.68%
2020-01-01 00:21:50,4,10,2010,42,1968,3.07%,2.09%
2020-01-01 00:21:50,4,11,250,1,249,0.38%,0.40%
2020-01-01 00:21:50,4,12,11996,1017,10979,18.30%,8.48%
2020-01-01 00:21:50,5,1,2778,55,2723,4.24%,1.98%
2020-01-01 00:21:50,5,2,671,3,668,1.02%,0.45%
2020-01-01 00:21:50,5,3,512,3,509,0.78%,0.59%
2020-01-01 00:21:50,5,4,21355,3110,18245,32.59%,14.56%
2020-01-01 00:21:50,5,5,9155,612,8543,13.97%,6.68%
2020-01-01 00:21:50,5,6,13681,1321,12360,20.88%,9.66%
2020-01-01 00:21:50,5,7,4115,155,3960,6.28%,3.77%
2020-01-01 00:21:50,5,8,3062,92,2970,4.67%,3.00%
2020-01-01 00:21:50,5,9,8510,534,7976,12.99%,6.27%
2020-01-01 00:21:50,5,10,1325,17,1308,2.02%,1.28%
2020-01-01 00:21:50,5,11,449,0,449,0.69%,0.00%
2020-01-01 00:21:50,5,12,6912,364,6548,10.55%,5.27%
2020-01-01 00:21:50,6,1,1003,7,996,1.53%,0.70%
2020-01-01 00:21:50,6,2,1082,11,1071,1.65%,1.02%
2020-01-01 00:21:50,6,3,1906,26,1880,2.91%,1.36%
2020-01-01 00:21:50,6,4,1827,12,1815,2.79%,0.66%
2020-01-01 00:21:50,6,5,13787,1377,12410,21.04%,9.99%
2020-01-01 00:21:50,6,6,5873,231,5642,8.96%,3.93%
2020-01-01 00:21:50,6,7,3654,94,3560,5.58%,2.57%
2020-01-01 00:21:50,6,8,2777,59,2718,4.24%,2.12%
2020-01-01 00:21:50,6,9,5805,244,5561,8.86%,4.20%
2020-01-01 00:21:50,6,10,2358,39,2319,3.60%,1.65%
2020-01-01 00:21:50,6,11,456,2,454,0.70%,0.44%
2020-01-01 00:21:50,6,12,3400,86,3314,5.19%,2.53%
2020-01-01 00:21:50,7,1,623,5,618,0.95%,0.80%
2020-01-01 00:21:50,7,2,198,1,197,0.30%,0.51%
2020-01-01 00:21:50,7,3,631,3,628,0.96%,0.48%
2020-01-01 00:21:50,7,4,2567,54,2513,3.92%,2.10%
2020-01-01 00:21:50,7,5,8093,411,7682,12.35%,5.08%
2020-01-01 00:21:50,7,6,15010,1531,13479,22.90%,10.20%
2020-01-01 00:21:50,7,7,4315,115,4200,6.58%,2.67%
2020-01-01 00:21:50,7,8,2349,33,2316,3.58%,1.40%
2020-01-01 00:21:50,7,9,7057,314,6743,10.77%,4.45%
2020-01-01 00:21:50,7,10,1232,8,1224,1.88%,0.65%
2020-01-01 00:21:50,7,11,88,0,88,0.13%,0.00%
2020-01-01 00:21:50,7,12,5826,217,5609,8.89%,3.72%
2020-01-01 00:21:50,8,1,505,2,503,0.77%,0.40%
2020-01-01 00:21:50,8,2,130,0,130,0.20%,0.00%
2020-01-01 00:21:50,8,3,2577,61,2516,3.93%,2.37%
2020-01-01 00:21:50,8,4,2922,54,2868,4.46%,1.85%
2020-01-01 00:21:50,8,5,10564,818,9746,16.12%,7.74%
2020-01-01 00:21:50,8,6,18574,2391,16183,28.34%,12.87%
2020-01-01 00:21:50,8,7,5019,191,4828,7.66%,3.81%
2020-01-01 00:21:50,8,8,2193,43,2150,3.35%,1.96%
2020-01-01 00:21:50,8,9,7764,433,7331,11.85%,5.58%
2020-01-01 00:21:50,8,10,3383,76,3307,5.16%,2.25%
2020-01-01 00:21:50,8,11,152,0,152,0.23%,0.00%
2020-01-01 00:21:50,8,12,4376,131,4245,6.68%,2.99%
2020-01-01 00:21:50,9,1,563,1,562,0.86%,0.18%
2020-01-01 00:21:50,9,2,2553,30,2523,3.90%,1.18%
2020-01-01 00:21:50,9,3,1664,20,1644,2.54%,1.20%
2020-01-01 00:21:50,9,4,3592,96,3496,5.48%,2.67%
2020-01-01 00:21:50,9,5,312,2,310,0.48%,0.64%
2020-01-01 00:21:50,9,6,4627,158,4469,7.06%,3.41%
2020-01-01 00:21:50,9,7,27502,4926,22576,41.96%,17.91%
2020-01-01 00:21:50,9,8,13724,1314,12410,20.94%,9.57%
2020-01-01 00:21:50,9,9,202,1,201,0.31%,0.50%
2020-01-01 00:21:50,9,10,5623,257,5366,8.58%,4.57%
2020-01-01 00:21:50,9,11,12552,1104,11448,19.15%,8.80%
2020-01-01 00:21:50,9,12,6592,321,6271,10.06%,4.87%
2020-01-01 00:21:50,10,1,1548,271,1277,2.36%,17.51%
2020-01-01 00:21:50,10,2,3232,325,2907,4.93%,10.06%
2020-01-01 00:21:50,10,3,1502,25,1477,2.29%,1.66%
2020-01-01 00:21:50,10,4,3610,906,2704,5.51%,25.10%
2020-01-01 00:21:50,10,5,923,94,829,1.41%,10.18%
2020-01-01 00:21:50,10,6,5834,1131,4703,8.90%,19.39%
2020-01-01 00:21:50,10,7,10527,1868,8659,16.06%,17.74%
2020-01-01 00:21:50,10,8,29307,7501,21806,44.72%,25.59%
2020-01-01 00:21:50,10,9,604,2,602,0.92%,0.33%
2020-01-01 00:21:50,10,10,2203,40,2163,3.36%,1.82%
2020-01-01 00:21:50,10,11,14339,1945,12394,21.88%,13.56%
2020-01-01 00:21:50,10,12,11257,1420,9837,17.18%,12.61%
2020-01-01 00:21:50,11,1,2476,54,2422,3.78%,2.18%
2020-01-01 00:21:50,11,2,3790,126,3664,5.78%,3.32%
2020-01-01 00:21:50,11,3,1105,14,1091,1.69%,1.27%
2020-01-01 00:21:50,11,4,3158,80,3078,4.82%,2.53%
2020-01-01 00:21:50,11,5,200,1,199,0.31%,0.50%
2020-01-01 00:21:50,11,6,3987,120,3867,6.08%,3.01%
2020-01-01 00:21:50,11,7,9438,663,8775,14.40%,7.02%
2020-01-01 00:21:50,11,8,23720,3773,19947,36.19%,15.91%
2020-01-01 00:21:50,11,9,177,1,176,0.27%,0.56%
2020-01-01 00:21:50,11,10,2787,56,2731,4.25%,2.01%
2020-01-01 00:21:50,11,11,10476,795,9681,15.99%,7.59%
2020-01-01 00:21:50,11,12,7220,387,6833,11.02%,5.36%
2020-01-01 00:21:50,12,1,29,0,29,0.04%,0.00%
2020-01-01 00:21:50,12,2,647,163,484,0.99%,25.19%
2020-01-01 00:21:50,12,3,2217,201,2016,3.38%,9.07%
2020-01-01 00:21:50,12,4,2770,98,2672,4.23%,3.54%
2020-01-01 00:21:50,12,5,7538,654,6884,11.50%,8.68%
2020-01-01 00:21:50,12,6,4535,201,4334,6.92%,4.43%
2020-01-01 00:21:50,12,7,1613,28,1585,2.46%,1.74%
2020-01-01 00:21:50,12,8,1662,324,1338,2.54%,19.49%
2020-01-01 00:21:50,12,9,20515,3964,16551,31.30%,19.32%
2020-01-01 00:21:50,12,10,4887,493,4394,7.46%,10.09%
2020-01-01 00:21:50,12,11,1893,333,1560,2.89%,17.59%
2020-01-01 00:21:50,12,12,7677,1175,6502,11.71%,15.31%
2020-01-01 00:21:50,13,1,1843,25,1818,2.81%,1.36%
2020-01-01 00:21:50,13,2,2123,30,2093,3.24%,1.41%
2020-01-01 00:21:50,13,3,937,10,927,1.43%,1.07%
2020-01-01 00:21:50,13,4,4916,554,4362,7.50%,11.27%
2020-01-01 00:21:50,13,5,7262,853,6409,11.08%,11.75%
2020-01-01 00:21:50,13,6,5512,599,4913,8.41%,10.87%
2020-01-01 00:21:50,13,7,4289,133,4156,6.54%,3.10%
2020-01-01 00:21:50,13,8,7650,409,7241,11.67%,5.35%
2020-01-01 00:21:50,13,9,7542,885,6657,11.51%,11.73%
2020-01-01 00:21:50,13,10,27111,5513,21598,41.37%,20.33%
2020-01-01 00:21:50,13,11,16662,2237,14425,25.42%,13.43%
2020-01-01 00:21:50,13,12,8710,900,7810,13.29%,10.33%
2020-01-01 00:21:50,14,1,187,1,186,0.29%,0.53%
2020-01-01 00:21:50,14,2,1278,23,1255,1.95%,1.80%
2020-01-01 00:21:50,14,3,916,15,901,1.40%,1.64%
2020-01-01 00:21:50,14,4,3449,76,3373,5.26%,2.20%
2020-01-01 00:21:50,14,5,1366,15,1351,2.08%,1.10%
2020-01-01 00:21:50,14,6,3824,97,3727,5.83%,2.54%
2020-01-01 00:21:50,14,7,11314,875,10439,17.26%,7.73%
2020-01-01 00:21:50,14,8,12696,1125,11571,19.37%,8.86%
2020-01-01 00:21:50,14,9,1524,18,1506,2.33%,1.18%
2020-01-01 00:21:50,14,10,4267,124,4143,6.51%,2.91%
2020-01-01 00:21:50,14,11,26666,4712,21954,40.69%,17.67%
2020-01-01 00:21:50,14,12,9369,640,8729,14.30%,6.83%
2020-01-01 00:21:50,15,1,544,1,543,0.83%,0.18%
2020-01-01 00:21:50,15,2,179,1,178,0.27%,0.56%
2020-01-01 00:21:50,15,3,3226,81,3145,4.92%,2.51%
2020-01-01 00:21:50,15,4,5046,221,4825,7.70%,4.38%
2020-01-01 00:21:50,15,5,9227,649,8578,14.08%,7.03%
2020-01-01 00:21:50,15,6,5348,241,5107,8.16%,4.51%
2020-01-01 00:21:50,15,7,3494,125,3369,5.33%,3.58%
2020-01-01 00:21:50,15,8,5499,264,5235,8.39%,4.80%
2020-01-01 00:21:50,15,9,9431,677,8754,14.39%,7.18%
2020-01-01 00:21:50,15,10,5583,411,5172,8.52%,7.36%
2020-01-01 00:21:50,15,11,11220,1114,10106,17.12%,9.93%
2020-01-01 00:21:50,15,12,26628,5259,21369,40.63%,19.75%
2020-01-01 00:21:50,16,1,425,0,425,0.65%,0.00%
2020-01-01 00:21:50,16,2,294,0,294,0.45%,0.00%
2020-01-01 00:21:50,16,3,1499,12,1487,2.29%,0.80%
2020-01-01 00:21:50,16,4,4409,161,4248,6.73%,3.65%
2020-01-01 00:21:50,16,5,7639,478,7161,11.66%,6.26%
2020-01-01 00:21:50,16,6,5209,214,4995,7.95%,4.11%
2020-01-01 00:21:50,16,7,3790,121,3669,5.78%,3.19%
2020-01-01 00:21:50,16,8,7486,528,6958,11.42%,7.05%
2020-01-01 00:21:50,16,9,8136,530,7606,12.41%,6.51%
2020-01-01 00:21:50,16,10,1626,22,1604,2.48%,1.35%
2020-01-01 00:21:50,16,11,9288,726,8562,14.17%,7.82%
2020-01-01 00:21:50,16,12,24750,4220,20530,37.77%,17.05%
2020-01-01 00:22:00,1,1,20368,2842,17526,31.08%,13.95%
2020-01-01 00:22:00,1,2,7095,386,6709,10.83%,5.44%
2020-01-01 00:22:00,1,3,529,1,528,0.81%,0.19%
2020-01-01 00:22:00,1,4,12873,1175,11698,19.64%,9.13%
2020-01-01 00:22:00,1,5,11484,972,10512,17.52%,8.46%
2020-01-01 00:22:00,1,6,11488,968,10520,17.53%,8.43%
2020-01-01 00:22:00,1,7,6549,334,6215,9.99%,5.10%
2020-01-01 00:22:00,1,8,4691,161,4530,7.16%,3.43%
2020-01-01 00:22:00,1,9,11426,960,10466,17.43%,8.40%
2020-01-01 00:22:00,1,10,3859,110,3749,5.89%,2.85%
2020-01-01 00:22:00,1,11,3988,120,3868,6.09%,3.01%
2020-01-01 00:22:00,1,12,11404,957,10447,17.40%,8.39%
2020-01-01 00:22:00,2,1,431,3,428,0.66%,0.70%
2020-01-01 00:22:00,2,2,28074,5279,22795,42.84%,18.80%
2020-01-01 00:22:00,2,3,22804,3549,19255,34.80%,15.56%
2020-01-01 00:22:00,2,4,350,3,347,0.53%,0.86%
2020-01-01 00:22:00,2,5,15262,1671,13591,23.29%,10.95%
2020-01-01 00:22:00,2,6,56,0,56,0.09%,0.00%
2020-01-01 00:22:00,2,7,4830,188,4642,7.37%,3.89%
2020-01-01 00:22:00,2,8,3490,86,3404,5.33%,2.46%
2020-01-01 00:22:00,2,9,15184,1650,13534,23.17%,10.87%
2020-01-01 00:22:00,2,10,2634,56,2578,4.02%,2.13%
2020-01-01 00:22:00,2,11,2650,56,2594,4.04%,2.11%
2020-01-01 00:22:00,2,12,15063,1626,13437,22.98%,10.79%
2020-01-01 00:22:00,3,1,1819,21,1798,2.78%,1.15%
2020-01-01 00:22:00,3,2,22219,3325,18894,33.90%,14.96%
2020-01-01 00:22:00,3,3,64963,23767,41196,99.13%,36.59%
2020-01-01 00:22:00,3,4,6385,293,6092,9.74%,4.59%
2020-01-01 00:22:00,3,5,40940,10462,30478,62.47%,25.55%
2020-01-01 00:22:00,3,6,7767,459,7308,11.85%,5.91%
2020-01-01 00:22:00,3,7,18430,2341,16089,28.12%,12.70%
2020-01-01 00:22:00,3,8,15624,1722,13902,23.84%,11.02%
2020-01-01 00:22:00,3,9,32795,7035,25760,50.04%,21.45%
2020-01-01 00:22:00,3,10,5411,198,5213,8.26%,3.66%
2020-01-01 00:22:00,3,11,1787,23,1764,2.73%,1.29%
2020-01-01 00:22:00,3,12,24816,4146,20670,37.87%,16.71%
2020-01-01 00:22:00,4,1,597,4,593,0.91%,0.67%
2020-01-01 00:22:00,4,2,326,2,324,0.50%,0.61%
2020-01-01 00:22:00,4,3,743,2,741,1.13%,0.27%
2020-01-01 00:22:00,4,4,26872,4851,22021,41.00%,18.05%
2020-01-01 00:22:00,4,5,16785,1970,14815,25.61%,11.74%
2020-01-01 00:22:00,4,6,23513,3790,19723,35.88%,16.12%
2020-01-01 00:22:00,4,7,5426,209,5217,8.28%,3.85%
2020-01-01 00:22:00,4,8,3185,69,3116,4.86%,2.17%
2020-01-01 00:22:00,4,9,14653,1523,13130,22.36%,10.39%
2020-01-01 00:22:00,4,10,1917,42,1875,2.93%,2.19%
2020-01-01 00:22:00,4,11,223,1,222,0.34%,0.45%
2020-01-01 00:22:00,4,12,12112,1062,11050,18.48%,8.77%
2020-01-01 00:22:00,5,1,2908,66,2842,4.44%,2.27%
2020-01-01 00:22:00,5,2,920,9,911,1.40%,0.98%
2020-01-01 00:22:00,5,3,382,2,380,0.58%,0.52%
2020-01-01 00:22:00,5,4,22139,3408,18731,33.78%,15.39%
2020-01-01 00:22:00,5,5,9818,698,9120,14.98%,7.11%
2020-01-01 00:22:00,5,6,13836,1408,12428,21.11%,10.18%
2020-01-01 00:22:00,5,7,3711,117,3594,5.66%,3.15%
2020-01-01 00:22:00,5,8,3093,76,3017,4.72%,2.46%
2020-01-01 00:22:00,5,9,9281,626,8655,14.16%,6.74%
2020-01-01 00:22:00,5,10,1413,15,1398,2.16%,1.06%
2020-01-01 00:22:00,5,11,463,3,460,0.71%,0.65%
2020-01-01 00:22:00,5,12,7596,428,7168,11.59%,5.63%
2020-01-01 00:22:00,6,1,1032,12,1020,1.57%,1.16%
2020-01-01 00:22:00,6,2,1144,13,1131,1.75%,1.14%
2020-01-01 00:22:00,6,3,1634,18,1616,2.49%,1.10%
2020-01-01 00:22:00,6,4,1625,17,1608,2.48%,1.05%
2020-01-01 00:22:00,6,5,12909,1172,11737,19.70%,9.08%
2020-01-01 00:22:00,6,6,4997,186,4811,7.62%,3.72%
2020-01-01 00:22:00,6,7,2919,79,2840,4.45%,2.71%
2020-01-01 00:22:00,6,8,2386,62,2324,3.64%,2.60%
2020-01-01 00:22:00,6,9,6057,260,5797,9.24%,4.29%
2020-01-01 00:22:00,6,10,2031,30,2001,3.10%,1.48%
2020-01-01 00:22:00,6,11,436,1,435,0.67%,0.23%
2020-01-01 00:22:00,6,12,3984,104,3880,6.08%,2.61%
2020-01-01 00:22:00,7,1,517,5,512,0.79%,0.97%
2020-01-01 00:22:00,7,2,233,0,233,0.36%,0.00%
2020-01-01 00:22:00,7,3,760,0,760,1.16%,0.00%
2020-01-01 00:22:00,7,4,1961,37,1924,2.99%,1.89%
2020-01-01 00:22:00,7,5,6853,339,6514,10.46%,4.95%
2020-01-01 00:22:00,7,6,12770,1178,11592,19.49%,9.22%
2020-01-01 00:22:00,7,7,3918,121,3797,5.98%,3.09%
2020-01-01 00:22:00,7,8,1824,33,1791,2.78%,1.81%
2020-01-01 00:22:00,7,9,5960,270,5690,9.09%,4.53%
2020-01-01 00:22:00,7,10,1008,4,1004,1.54%,0.40%
2020-01-01 00:22:00,7,11,57,0,57,0.09%,0.00%
2020-01-01 00:22:00,7,12,4957,193,4764,7.56%,3.89%
2020-01-01 00:22:00,8,1,304,0,304,0.46%,0.00%
2020-01-01 00:22:00,8,2,98,1,97,0.15%,1.02%
2020-01-01 00:22:00,8,3,1952,33,1919,2.98%,1.69%
2020-01-01 00:22:00,8,4,2726,51,2675,4.16%,1.87%
2020-01-01 00:22:00,8,5,8799,550,8249,13.43%,6.25%
2020-01-01 00:22:00,8,6,15801,1742,14059,24.11%,11.02%
2020-01-01 00:22:00,8,7,4261,130,4131,6.50%,3.05%
2020-01-01 00:22:00,8,8,1683,18,1665,2.57%,1.07%
2020-01-01 00:22:00,8,9,6460,317,6143,9.86%,4.91%
2020-01-01 00:22:00,8,10,2062,29,2033,3.15%,1.41%
2020-01-01 00:22:00,8,11,226,0,226,0.34%,0.00%
2020-01-01 00:22:00,8,12,4383,152,4231,6.69%,3.47%
2020-01-01 00:22:00,9,1,296,0,296,0.45%,0.00%
2020-01-01 00:22:00,9,2,3799,124,3675,5.80%,3.26%
2020-01-01 00:22:00,9,3,2990,86,2904,4.56%,2.88%
2020-01-01 00:22:00,9,4,9890,750,9140,15.09%,7.58%
2020-01-01 00:22:00,9,5,609,2,607,0.93%,0.33%
2020-01-01 00:22:00,9,6,11382,967,10415,17.37%,8.50%
2020-01-01 00:22:00,9,7,32026,6803,25223,48.87%,21.24%
2020-01-01 00:22:00,9,8,10208,878,9330,15.58%,8.60%
2020-01-01 00:22:00,9,9,297,0,297,0.45%,0.00%
2020-01-01 00:22:00,9,10,3929,280,3649,6.00%,7.13%
2020-01-01 00:22:00,9,11,9052,730,8322,13.81%,8.06%
2020-01-01 00:22:00,9,12,4752,170,4582,7.25%,3.58%
2020-01-01 00:22:00,10,1,1243,271,972,1.90%,21.80%
2020-01-01 00:22:00,10,2,3458,327,3131,5.28%,9.46%
2020-01-01 00:22:00,10,3,2089,29,2060,3.19%,1.39%
2020-01-01 00:22:00,10,4,4105,1040,3065,6.26%,25.33%
2020-01-01 00:22:00,10,5,932,67,865,1.42%,7.19%
2020-01-01 00:22:00,10,6,6090,1217,4873,9.29%,19.98%
2020-01-01 00:22:00,10,7,11802,2048,9754,18.01%,17.35%
2020-01-01 00:22:00,10,8,28350,6952,21398,43.26%,24.52%
2020-01-01 00:22:00,10,9,517,0,517,0.79%,0.00%
2020-01-01 00:22:00,10,10,2077,40,2037,3.17%,1.93%
2020-01-01 00:22:00,10,11,12515,1517,10998,19.10%,12.12%
2020-01-01 00:22:00,10,12,9774,1096,8678,14.91%,11.21%
2020-01-01 00:22:00,11,1,2181,56,2125,3.33%,2.57%
2020-01-01 00:22:00,11,2,3244,112,3132,4.95%,3.45%
2020-01-01 00:22:00,11,3,899,10,889,1.37%,1.11%
2020-01-01 00:22:00,11,4,9259,633,8626,14.13%,6.84%
2020-01-01 00:22:00,11,5,312,2,310,0.48%,0.64%
2020-01-01 00:22:00,11,6,10066,743,9323,15.36%,7.38%
2020-01-01 00:22:00,11,7,14817,1542,13275,22.61%,10.41%
2020-01-01 00:22:00,11,8,30031,5966,24065,45.82%,19.87%
2020-01-01 00:22:00,11,9,325,0,325,0.50%,0.00%
2020-01-01 00:22:00,11,10,3225,76,3149,4.92%,2.36%
2020-01-01 00:22:00,11,11,10861,866,9995,16.57%,7.97%
2020-01-01 00:22:00,11,12,7256,411,6845,11.07%,5.66%
2020-01-01 00:22:00,12,1,54,0,54,0.08%,0.00%
2020-01-01 00:22:00,12,2,457,120,337,0.70%,26.26%
2020-01-01 00:22:00,12,3,2230,161,2069,3.40%,7.22%
2020-01-01 00:22:00,12,4,2847,74,2773,4.34%,2.60%
2020-01-01 00:22:00,12,5,7230,522,6708,11.03%,7.22%
2020-01-01 00:22:00,12,6,4374,146,4228,6.67%,3.34%
2020-01-01 00:22:00,12,7,1363,11,1352,2.08%,0.81%
2020-01-01 00:22:00,12,8,1291,234,1057,1.97%,18.13%
2020-01-01 00:22:00,12,9,19714,3541,16173,30.08%,17.96%
2020-01-01 00:22:00,12,10,4054,338,3716,6.19%,8.34%
2020-01-01 00:22:00,12,11,1450,239,1211,2.21%,16.48%
2020-01-01 00:22:00,12,12,7175,1026,6149,10.95%,14.30%
2020-01-01 00:22:00,13,1,1718,21,1697,2.62%,1.22%
2020-01-01 00:22:00,13,2,2125,30,2095,3.24%,1.41%
2020-01-01 00:22:00,13,3,593,5,588,0.90%,0.84%
2020-01-01 00:22:00,13,4,4822,583,4239,7.36%,12.09%
2020-01-01 00:22:00,13,5,6846,883,5963,10.45%,12.90%
2020-01-01 00:22:00,13,6,5230,610,4620,7.98%,11.66%
2020-01-01 00:22:00,13,7,4784,153,4631,7.30%,3.20%
2020-01-01 00:22:00,13,8,7684,422,7262,11.72%,5.49%
2020-01-01 00:22:00,13,9,7222,914,6308,11.02%,12.66%
2020-01-01 00:22:00,13,10,28456,5912,22544,43.42%,20.78%
2020-01-01 00:22:00,13,11,18334,2506,15828,27.98%,13.67%
2020-01-01 00:22:00,13,12,10282,960,9322,15.69%,9.34%
2020-01-01 00:22:00,14,1,289,2,287,0.44%,0.69%
2020-01-01 00:22:00,14,2,1633,17,1616,2.49%,1.04%
2020-01-01 00:22:00,14,3,1142,7,1135,1.74%,0.61%
2020-01-01 00:22:00,14,4,4138,137,4001,6.31%,3.31%
2020-01-01 00:22:00,14,5,1616,20,1596,2.47%,1.24%
2020-01-01 00:22:00,14,6,4414,155,4259,6.74%,3.51%
2020-01-01 00:22:00,14,7,11927,1045,10882,18.20%,8.76%
2020-01-01 00:22:00,14,8,13508,1335,12173,20.61%,9.88%
2020-01-01 00:22:00,14,9,1840,25,1815,2.81%,1.36%
2020-01-01 00:22:00,14,10,4214,141,4073,6.43%,3.35%
2020-01-01 00:22:00,14,11,28852,5514,23338,44.02%,19.11%
2020-01-01 00:22:00,14,12,10767,844,9923,16.43%,7.84%
2020-01-01 00:22:00,15,1,691,2,689,1.05%,0.29%
2020-01-01 00:22:00,15,2,170,1,169,0.26%,0.59%
2020-01-01 00:22:00,15,3,6192,276,5916,9.45%,4.46%
2020-01-01 00:22:00,15,4,4865,232,4633,7.42%,4.77%
2020-01-01 00:22:00,15,5,12495,1227,11268,19.07%,9.82%
2020-01-01 00:22:00,15,6,5162,307,4855,7.88%,5.95%
2020-01-01 00:22:00,15,7,3336,91,3245,5.09%,2.73%
2020-01-01 00:22:00,15,8,5463,257,5206,8.34%,4.70%
2020-01-01 00:22:00,15,9,12711,1271,11440,19.40%,10.00%
2020-01-01 00:22:00,15,10,8524,635,7889,13.01%,7.45%
2020-01-01 00:22:00,15,11,14173,1554,12619,21.63%,10.96%
2020-01-01 00:22:00,15,12,32411,7314,25097,49.46%,22.57%
2020-01-01 00:22:00,16,1,463,1,462,0.71%,0.22%
2020-01-01 00:22:00,16,2,251,0,251,0.38%,0.00%
2020-01-01 00:22:00,16,3,1181,9,1172,1.80%,0.76%
2020-01-01 00:22:00,16,4,4002,134,3868,6.11%,3.35%
2020-01-01 00:22:00,16,5,7579,460,7119,11.56%,6.07%
2020-01-01 00:22:00,16,6,4999,208,4791,7.63%,4.16%
2020-01-01 00:22:00,16,7,3155,74,3081,4.81%,2.35%
2020-01-01 00:22:00,16,8,6643,415,6228,10.14%,6.25%
2020-01-01 00:22:00,16,9,8030,505,7525,12.25%,6.29%
2020-01-01 00:22:00,16,10,2984,79,2905,4.55%,2.65%
2020-01-01 00:22:00,16,11,9808,807,9001,14.97%,8.23%
2020-01-01 00:22:00,16,12,26205,4673,21532,39.99%,17.83%
2020-01-01 00:22:10,1,1,17728,2231,15497,27.05%,12.58%
2020-01-01 00:22:10,1,2,8041,490,7551,12.27%,6.09%
2020-01-01 00:22:10,1,3,458,0,458,0.70%,0.00%
2020-01-01 00:22:10,1,4,9186,659,8527,14.02%,7.17%
2020-01-01 00:22:10,1,5,8887,619,8268,13.56%,6.97%
2020-01-01 00:22:10,1,6,8846,618,8228,13.50%,6.99%
2020-01-01 00:22:10,1,7,7558,445,7113,11.53%,5.89%
2020-01-01 00:22:10,1,8,5495,238,5257,8.38%,4.33%
2020-01-01 00:22:10,1,9,8804,615,8189,13.43%,6.99%
2020-01-01 00:22:10,1,10,4785,174,4611,7.30%,3.64%
2020-01-01 00:22:10,1,11,4878,179,4699,7.44%,3.67%
2020-01-01 00:22:10,1,12,8757,614,8143,13.36%,7.01%
2020-01-01 00:22:10,2,1,690,8,682,1.05%,1.16%
2020-01-01 00:22:10,2,2,25757,4517,21240,39.30%,17.54%
2020-01-01 00:22:10,2,3,19242,2607,16635,29.36%,13.55%
2020-01-01 00:22:10,2,4,630,6,624,0.96%,0.95%
2020-01-01 00:22:10,2,5,12516,1131,11385,19.10%,9.04%
2020-01-01 00:22:10,2,6,61,0,61,0.09%,0.00%
2020-01-01 00:22:10,2,7,5794,260,5534,8.84%,4.49%
2020-01-01 00:22:10,2,8,4438,160,4278,6.77%,3.61%
2020-01-01 00:22:10,2,9,12421,1118,11303,18.95%,9.00%
2020-01-01 00:22:10,2,10,3665,111,3554,5.59%,3.03%
2020-01-01 00:22:10,2,11,3684,111,3573,5.62%,3.01%
2020-01-01 00:22:10,2,12,12253,1100,11153,18.70%,8.98%
2020-01-01 00:22:10,3,1,1312,7,1305,2.00%,0.53%
2020-01-01 00:22:10,3,2,22755,3599,19156,34.72%,15.82%
2020-01-01 00:22:10,3,3,71690,28159,43531,109.39%,39.28%
2020-01-01 00:22:10,3,4,7682,428,7254,11.72%,5.57%
2020-01-01 00:22:10,3,5,44449,12147,32302,67.82%,27.33%
2020-01-01 00:22:10,3,6,8478,522,7956,12.94%,6.16%
2020-01-01 00:22:10,3,7,19416,2657,16759,29.63%,13.68%
2020-01-01 00:22:10,3,8,16211,1855,14356,24.74%,11.44%
2020-01-01 00:22:10,3,9,35532,8075,27457,54.22%,22.73%
2020-01-01 00:22:10,3,10,6763,351,6412,10.32%,5.19%
2020-01-01 00:22:10,3,11,1903,27,1876,2.90%,1.42%
2020-01-01 00:22:10,3,12,26439,4692,21747,40.34%,17.75%
2020-01-01 00:22:10,4,1,650,1,649,0.99%,0.15%
2020-01-01 00:22:10,4,2,379,0,379,0.58%,0.00%
2020-01-01 00:22:10,4,3,1204,13,1191,1.84%,1.08%
2020-01-01 00:22:10,4,4,29109,5556,23553,44.42%,19.09%
2020-01-01 00:22:10,4,5,17598,2146,15452,26.85%,12.19%
2020-01-01 00:22:10,4,6,24660,4099,20561,37.63%,16.62%
2020-01-01 00:22:10,4,7,5720,260,5460,8.73%,4.55%
2020-01-01 00:22:10,4,8,3450,96,3354,5.26%,2.78%
2020-01-01 00:22:10,4,9,15338,1668,13670,23.40%,10.87%
2020-01-01 00:22:10,4,10,2097,45,2052,3.20%,2.15%
2020-01-01 00:22:10,4,11,226,0,226,0.34%,0.00%
2020-01-01 00:22:10,4,12,12668,1130,11538,19.33%,8.92%
2020-01-01 00:22:10,5,1,2975,82,2893,4.54%,2.76%
2020-01-01 00:22:10,5,2,830,7,823,1.27%,0.84%
2020-01-01 00:22:10,5,3,416,2,414,0.63%,0.48%
2020-01-01 00:22:10,5,4,22056,3394,18662,33.65%,15.39%
2020-01-01 00:22:10,5,5,10008,753,9255,15.27%,7.52%
2020-01-01 00:22:10,5,6,14949,1580,13369,22.81%,10.57%
2020-01-01 00:22:10,5,7,4106,137,3969,6.27%,3.34%
2020-01-01 00:22:10,5,8,3260,79,3181,4.97%,2.42%
2020-01-01 00:22:10,5,9,9390,668,8722,14.33%,7.11%
2020-01-01 00:22:10,5,10,2004,24,1980,3.06%,1.20%
2020-01-01 00:22:10,5,11,587,4,583,0.90%,0.68%
2020-01-01 00:22:10,5,12,7190,377,6813,10.97%,5.24%
2020-01-01 00:22:10,6,1,1201,9,1192,1.83%,0.75%
2020-01-01 00:22:10,6,2,1275,10,1265,1.95%,0.78%
2020-01-01 00:22:10,6,3,1767,18,1749,2.70%,1.02%
2020-01-01 00:22:10,6,4,1357,11,1346,2.07%,0.81%
2020-01-01 00:22:10,6,5,13447,1320,12127,20.52%,9.82%
2020-01-01 00:22:10,6,6,4233,132,4101,6.46%,3.12%
2020-01-01 00:22:10,6,7,2299,41,2258,3.51%,1.78%
2020-01-01 00:22:10,6,8,1906,32,1874,2.91%,1.68%
2020-01-01 00:22:10,6,9,7191,387,6804,10.97%,5.38%
2020-01-01 00:22:10,6,10,1901,18,1883,2.90%,0.95%
2020-01-01 00:22:10,6,11,448,0,448,0.68%,0.00%
2020-01-01 00:22:10,6,12,5245,214,5031,8.00%,4.08%
2020-01-01 00:22:10,7,1,629,3,626,0.96%,0.48%
2020-01-01 00:22:10,7,2,365,1,364,0.56%,0.27%
2020-01-01 00:22:10,7,3,751,2,749,1.15%,0.27%
2020-01-01 00:22:10,7,4,2867,53,2814,4.37%,1.85%
2020-01-01 00:22:10,7,5,6482,344,6138,9.89%,5.31%
2020-01-01 00:22:10,7,6,13384,1400,11984,20.42%,10.46%
2020-01-01 00:22:10,7,7,4004,111,3893,6.11%,2.77%
2020-01-01 00:22:10,7,8,1712,20,1692,2.61%,1.17%
2020-01-01 00:22:10,7,9,5595,248,5347,8.54%,4.43%
2020-01-01 00:22:10,7,10,970,9,961,1.48%,0.93%
2020-01-01 00:22:10,7,11,272,0,272,0.42%,0.00%
2020-01-01 00:22:10,7,12,4745,170,4575,7.24%,3.58%
2020-01-01 00:22:10,8,1,621,3,618,0.95%,0.48%
2020-01-01 00:22:10,8,2,114,1,113,0.17%,0.88%
2020-01-01 00:22:10,8,3,1789,26,1763,2.73%,1.45%
2020-01-01 00:22:10,8,4,2795,60,2735,4.26%,2.15%
2020-01-01 00:22:10,8,5,8717,539,8178,13.30%,6.18%
2020-01-01 00:22:10,8,6,17038,2050,14988,26.00%,12.03%
2020-01-01 00:22:10,8,7,5406,237,5169,8.25%,4.38%
2020-01-01 00:22:10,8,8,2371,47,2324,3.62%,1.98%
2020-01-01 00:22:10,8,9,6671,309,6362,10.18%,4.63%
2020-01-01 00:22:10,8,10,1734,23,1711,2.65%,1.33%
2020-01-01 00:22:10,8,11,165,1,164,0.25%,0.61%
2020-01-01 00:22:10,8,12,4955,172,4783,7.56%,3.47%
2020-01-01 00:22:10,9,1,365,0,365,0.56%,0.00%
2020-01-01 00:22:10,9,2,1998,30,1968,3.05%,1.50%
2020-01-01 00:22:10,9,3,1312,10,1302,2.00%,0.76%
2020-01-01 00:22:10,9,4,6764,324,6440,10.32%,4.79%
2020-01-01 00:22:10,9,5,384,0,384,0.59%,0.00%
2020-01-01 00:22:10,9,6,8145,475,7670,12.43%,5.83%
2020-01-01 00:22:10,9,7,29812,5827,23985,45.49%,19.55%
2020-01-01 00:22:10,9,8,12159,1025,11134,18.55%,8.43%
2020-01-01 00:22:10,9,9,177,0,177,0.27%,0.00%
2020-01-01 00:22:10,9,10,3930,102,3828,6.00%,2.60%
2020-01-01 00:22:10,9,11,10936,837,10099,16.69%,7.65%
2020-01-01 00:22:10,9,12,6613,346,6267,10.09%,5.23%
2020-01-01 00:22:10,10,1,1661,289,1372,2.53%,17.40%
2020-01-01 00:22:10,10,2,4136,372,3764,6.31%,8.99%
2020-01-01 00:22:10,10,3,2300,40,2260,3.51%,1.74%
2020-01-01 00:22:10,10,4,4001,1080,2921,6.11%,26.99%
2020-01-01 00:22:10,10,5,1015,67,948,1.55%,6.60%
2020-01-01 00:22:10,10,6,5782,1258,4524,8.82%,21.76%
2020-01-01 00:22:10,10,7,11685,2121,9564,17.83%,18.15%
2020-01-01 00:22:10,10,8,30312,7824,22488,46.25%,25.81%
2020-01-01 00:22:10,10,9,555,2,553,0.85%,0.36%
2020-01-01 00:22:10,10,10,2522,43,2479,3.85%,1.70%
2020-01-01 00:22:10,10,11,13812,1729,12083,21.08%,12.52%
2020-01-01 00:22:10,10,12,10451,1182,9269,15.95%,11.31%
2020-01-01 00:22:10,11,1,2244,39,2205,3.42%,1.74%
2020-01-01 00:22:10,11,2,3516,83,3433,5.36%,2.36%
2020-01-01 00:22:10,11,3,980,9,971,1.50%,0.92%
2020-01-01 00:22:10,11,4,3558,98,3460,5.43%,2.75%
2020-01-01 00:22:10,11,5,235,2,233,0.36%,0.85%
2020-01-01 00:22:10,11,6,4476,161,4315,6.83%,3.60%
2020-01-01 00:22:10,11,7,9653,690,8963,14.73%,7.15%
2020-01-01 00:22:10,11,8,24871,4189,20682,37.95%,16.84%
2020-01-01 00:22:10,11,9,377,1,376,0.58%,0.27%
2020-01-01 00:22:10,11,10,3249,97,3152,4.96%,2.99%
2020-01-01 00:22:10,11,11,10454,836,9618,15.95%,8.00%
2020-01-01 00:22:10,11,12,6758,362,6396,10.31%,5.36%
2020-01-01 00:22:10,12,1,50,0,50,0.08%,0.00%
2020-01-01 00:22:10,12,2,513,112,401,0.78%,21.83%
2020-01-01 00:22:10,12,3,2846,158,2688,4.34%,5.55%
2020-01-01 00:22:10,12,4,2950,66,2884,4.50%,2.24%
2020-01-01 00:22:10,12,5,8032,530,7502,12.26%,6.60%
2020-01-01 00:22:10,12,6,4437,145,4292,6.77%,3.27%
2020-01-01 00:22:10,12,7,1363,18,1345,2.08%,1.32%
2020-01-01 00:22:10,12,8,1882,315,1567,2.87%,16.74%
2020-01-01 00:22:10,12,9,21830,4259,17571,33.31%,19.51%
2020-01-01 00:22:10,12,10,5387,490,4897,8.22%,9.10%
2020-01-01 00:22:10,12,11,2101,321,1780,3.21%,15.28%
2020-01-01 00:22:10,12,12,7637,1315,6322,11.65%,17.22%
2020-01-01 00:22:10,13,1,2016,28,1988,3.08%,1.39%
2020-01-01 00:22:10,13,2,2434,39,2395,3.71%,1.60%
2020-01-01 00:22:10,13,3,765,4,761,1.17%,0.52%
2020-01-01 00:22:10,13,4,4784,831,3953,7.30%,17.37%
2020-01-01 00:22:10,13,5,7062,1141,5921,10.78%,16.16%
2020-01-01 00:22:10,13,6,5260,844,4416,8.03%,16.05%
2020-01-01 00:22:10,13,7,4599,154,4445,7.02%,3.35%
2020-01-01 00:22:10,13,8,7348,389,6959,11.21%,5.29%
2020-01-01 00:22:10,13,9,7556,1190,6366,11.53%,15.75%
2020-01-01 00:22:10,13,10,30311,6672,23639,46.25%,22.01%
2020-01-01 00:22:10,13,11,19169,2791,16378,29.25%,14.56%
2020-01-01 00:22:10,13,12,11432,1207,10225,17.44%,10.56%
2020-01-01 00:22:10,14,1,350,0,350,0.53%,0.00%
2020-01-01 00:22:10,14,2,1488,14,1474,2.27%,0.94%
2020-01-01 00:22:10,14,3,992,7,985,1.51%,0.71%
2020-01-01 00:22:10,14,4,3610,113,3497,5.51%,3.13%
2020-01-01 00:22:10,14,5,1494,25,1469,2.28%,1.67%
2020-01-01 00:22:10,14,6,4280,142,4138,6.53%,3.32%
2020-01-01 00:22:10,14,7,11814,1038,10776,18.03%,8.79%
2020-01-01 00:22:10,14,8,13679,1377,12302,20.87%,10.07%
2020-01-01 00:22:10,14,9,1701,32,1669,2.60%,1.88%
2020-01-01 00:22:10,14,10,4444,147,4297,6.78%,3.31%
2020-01-01 00:22:10,14,11,26936,4842,22094,41.10%,17.98%
2020-01-01 00:22:10,14,12,8404,517,7887,12.82%,6.15%
2020-01-01 00:22:10,15,1,563,5,558,0.86%,0.89%
2020-01-01 00:22:10,15,2,167,2,165,0.25%,1.20%
2020-01-01 00:22:10,15,3,4329,133,4196,6.61%,3.07%
2020-01-01 00:22:10,15,4,5312,297,5015,8.11%,5.59%
2020-01-01 00:22:10,15,5,10561,925,9636,16.11%,8.76%
2020-01-01 00:22:10,15,6,5592,371,5221,8.53%,6.63%
2020-01-01 00:22:10,15,7,3169,87,3082,4.84%,2.75%
2020-01-01 00:22:10,15,8,5481,233,5248,8.36%,4.25%
2020-01-01 00:22:10,15,9,10749,952,9797,16.40%,8.86%
2020-01-01 00:22:10,15,10,6398,588,5810,9.76%,9.19%
2020-01-01 00:22:10,15,11,12241,1287,10954,18.68%,10.51%
2020-01-01 00:22:10,15,12,28743,6017,22726,43.86%,20.93%
2020-01-01 00:22:10,16,1,448,1,447,0.68%,0.22%
2020-01-01 00:22:10,16,2,253,2,251,0.39%,0.79%
2020-01-01 00:22:10,16,3,1313,17,1296,2.00%,1.29%
2020-01-01 00:22:10,16,4,4760,180,4580,7.26%,3.78%
2020-01-01 00:22:10,16,5,8702,648,8054,13.28%,7.45%
2020-01-01 00:22:10,16,6,5767,276,5491,8.80%,4.79%
2020-01-01 00:22:10,16,7,3543,92,3451,5.41%,2.60%
2020-01-01 00:22:10,16,8,7286,491,6795,11.12%,6.74%
2020-01-01 00:22:10,16,9,9195,722,8473,14.03%,7.85%
2020-01-01 00:22:10,16,10,2040,28,2012,3.11%,1.37%
2020-01-01 00:22:10,16,11,9515,742,8773,14.52%,7.80%
2020-01-01 00:22:10,16,12,26770,4943,21827,40.85%,18.46%
2020-01-01 00:22:20,1,1,17940,2247,15693,27.37%,12.53%
2020-01-01 00:22:20,1,2,8446,530,7916,12.89%,6.28%
2020-01-01 00:22:20,1,3,635,4,631,0.97%,0.63%
2020-01-01 00:22:20,1,4,9088,616,8472,13.87%,6.78%
2020-01-01 00:22:20,1,5,8770,583,8187,13.38%,6.65%
2020-01-01 00:22:20,1,6,8716,573,8143,13.30%,6.57%
2020-01-01 00:22:20,1,7,7794,455,7339,11.89%,5.84%
2020-01-01 00:22:20,1,8,7082,358,6724,10.81%,5.06%
2020-01-01 00:22:20,1,9,8692,571,8121,13.26%,6.57%
2020-01-01 00:22:20,1,10,6463,297,6166,9.86%,4.60%
2020-01-01 00:22:20,1,11,6524,306,6218,9.95%,4.69%
2020-01-01 00:22:20,1,12,8674,566,8108,13.24%,6.53%
2020-01-01 00:22:20,2,1,2096,27,2069,3.20%,1.29%
2020-01-01 00:22:20,2,2,25843,4399,21444,39.43%,17.02%
2020-01-01 00:22:20,2,3,19532,2591,16941,29.80%,13.27%
2020-01-01 00:22:20,2,4,1981,27,1954,3.02%,1.36%
2020-01-01 00:22:20,2,5,11187,847,10340,17.07%,7.57%
2020-01-01 00:22:20,2,6,44,0,44,0.07%,0.00%
2020-01-01 00:22:20,2,7,4200,116,4084,6.41%,2.76%
2020-01-01 00:22:20,2,8,3028,67,2961,4.62%,2.21%
2020-01-01 00:22:20,2,9,11126,839,10287,16.98%,7.54%
2020-01-01 00:22:20,2,10,2134,38,2096,3.26%,1.78%
2020-01-01 00:22:20,2,11,2142,38,2104,3.27%,1.77%
2020-01-01 00:22:20,2,12,10972,825,10147,16.74%,7.52%
2020-01-01 00:22:20,3,1,1601,15,1586,2.44%,0.94%
2020-01-01 00:22:20,3,2,23672,3787,19885,36.12%,16.00%
2020-01-01 00:22:20,3,3,66217,24637,41580,101.04%,37.21%
2020-01-01 00:22:20,3,4,7147,354,6793,10.91%,4.95%
2020-01-01 00:22:20,3,5,41460,10874,30586,63.26%,26.23%
2020-01-01 00:22:20,3,6,8130,465,7665,12.41%,5.72%
2020-01-01 00:22:20,3,7,20382,2877,17505,31.10%,14.12%
2020-01-01 00:22:20,3,8,15545,1697,13848,23.72%,10.92%
2020-01-01 00:22:20,3,9,32923,7135,25788,50.24%,21.67%
2020-01-01 00:22:20,3,10,4845,192,4653,7.39%,3.96%
2020-01-01 00:22:20,3,11,2327,50,2277,3.55%,2.15%
2020-01-01 00:22:20,3,12,24348,4051,20297,37.15%,16.64%
2020-01-01 00:22:20,4,1,526,2,524,0.80%,0.38%
2020-01-01 00:22:20,4,2,312,1,311,0.48%,0.32%
2020-01-01 00:22:20,4,3,1079,6,1073,1.65%,0.56%
2020-01-01 00:22:20,4,4,29187,5590,23597,44.54%,19.15%
2020-01-01 00:22:20,4,5,18329,2383,15946,27.97%,13.00%
2020-01-01 00:22:20,4,6,25400,4352,21048,38.76%,17.13%
2020-01-01 00:22:20,4,7,5834,244,5590,8.90%,4.18%
2020-01-01 00:22:20,4,8,2824,55,2769,4.31%,1.95%
2020-01-01 00:22:20,4,9,16015,1832,14183,24.44%,11.44%
2020-01-01 00:22:20,4,10,2114,32,2082,3.23%,1.51%
2020-01-01 00:22:20,4,11,178,0,178,0.27%,0.00%
2020-01-01 00:22:20,4,12,13306,1279,12027,20.30%,9.61%
2020-01-01 00:22:20,5,1,2817,62,2755,4.30%,2.20%
2020-01-01 00:22:20,5,2,713,3,710,1.09%,0.42%
2020-01-01 00:22:20,5,3,536,1,535,0.82%,0.19%
2020-01-01 00:22:20,5,4,25692,4500,21192,39.20%,17.52%
2020-01-01 00:22:20,5,5,10415,810,9605,15.89%,7.78%
2020-01-01 00:22:20,5,6,15601,1730,13871,23.81%,11.09%
2020-01-01 00:22:20,5,7,4574,141,4433,6.98%,3.08%
2020-01-01 00:22:20,5,8,3627,90,3537,5.53%,2.48%
2020-01-01 00:22:20,5,9,9728,714,9014,14.84%,7.34%
2020-01-01 00:22:20,5,10,1119,16,1103,1.71%,1.43%
2020-01-01 00:22:20,5,11,770,5,765,1.17%,0.65%
2020-01-01 00:22:20,5,12,8193,494,7699,12.50%,6.03%
2020-01-01 00:22:20,6,1,1239,17,1222,1.89%,1.37%
2020-01-01 00:22:20,6,2,1340,18,1322,2.04%,1.34%
2020-01-01 00:22:20,6,3,1932,27,1905,2.95%,1.40%
2020-01-01 00:22:20,6,4,1441,9,1432,2.20%,0.62%
2020-01-01 00:22:20,6,5,15018,1601,13417,22.92%,10.66%
2020-01-01 00:22:20,6,6,5632,241,5391,8.59%,4.28%
2020-01-01 00:22:20,6,7,3600,107,3493,5.49%,2.97%
2020-01-01 00:22:20,6,8,3117,77,3040,4.76%,2.47%
2020-01-01 00:22:20,6,9,7221,394,6827,11.02%,5.46%
2020-01-01 00:22:20,6,10,2013,28,1985,3.07%,1.39%
2020-01-01 00:22:20,6,11,509,3,506,0.78%,0.59%
2020-01-01 00:22:20,6,12,5127,203,4924,7.82%,3.96%
2020-01-01 00:22:20,7,1,459,8,451,0.70%,1.74%
2020-01-01 00:22:20,7,2,128,0,128,0.20%,0.00%
2020-01-01 00:22:20,7,3,1020,18,1002,1.56%,1.76%
2020-01-01 00:22:20,7,4,2053,27,2026,3.13%,1.32%
2020-01-01 00:22:20,7,5,8227,498,7729,12.55%,6.05%
2020-01-01 00:22:20,7,6,14148,1479,12669,21.59%,10.45%
2020-01-01 00:22:20,7,7,3802,87,3715,5.80%,2.29%
2020-01-01 00:22:20,7,8,1431,14,1417,2.18%,0.98%
2020-01-01 00:22:20,7,9,7107,353,6754,10.84%,4.97%
2020-01-01 00:22:20,7,10,1453,17,1436,2.22%,1.17%
2020-01-01 00:22:20,7,11,175,0,175,0.27%,0.00%
2020-01-01 00:22:20,7,12,5674,235,5439,8.66%,4.14%
2020-01-01 00:22:20,8,1,510,3,507,0.78%,0.59%
2020-01-01 00:22:20,8,2,98,0,98,0.15%,0.00%
2020-01-01 00:22:20,8,3,1476,18,1458,2.25%,1.22%
2020-01-01 00:22:20,8,4,2988,89,2899,4.56%,2.98%
2020-01-01 00:22:20,8,5,7826,416,7410,11.94%,5.32%
2020-01-01 00:22:20,8,6,17642,2234,15408,26.92%,12.66%
2020-01-01 00:22:20,8,7,6766,348,6418,10.32%,5.14%
2020-01-01 00:22:20,8,8,3331,101,3230,5.08%,3.03%
2020-01-01 00:22:20,8,9,6140,268,5872,9.37%,4.36%
2020-01-01 00:22:20,8,10,1895,26,1869,2.89%,1.37%
2020-01-01 00:22:20,8,11,193,0,193,0.29%,0.00%
2020-01-01 00:22:20,8,12,4226,146,4080,6.45%,3.45%
2020-01-01 00:22:20,9,1,270,0,270,0.41%,0.00%
2020-01-01 00:22:20,9,2,2355,51,2304,3.59%,2.17%
2020-01-01 00:22:20,9,3,1688,25,1663,2.58%,1.48%
2020-01-01 00:22:20,9,4,6118,269,5849,9.34%,4.40%
2020-01-01 00:22:20,9,5,331,1,330,0.51%,0.30%
2020-01-01 00:22:20,9,6,7059,358,6701,10.77%,5.07%
2020-01-01 00:22:20,9,7,31865,6568,25297,48.62%,20.61%
2020-01-01 00:22:20,9,8,15925,1800,14125,24.30%,11.30%
2020-01-01 00:22:20,9,9,157,0,157,0.24%,0.00%
2020-01-01 00:22:20,9,10,7068,346,6722,10.78%,4.90%
2020-01-01 00:22:20,9,11,14566,1502,13064,22.23%,10.31%
2020-01-01 00:22:20,9,12,6941,348,6593,10.59%,5.01%
2020-01-01 00:22:20,10,1,1287,205,1082,1.96%,15.93%
2020-01-01 00:22:20,10,2,2791,253,2538,4.26%,9.06%
2020-01-01 00:22:20,10,3,1326,19,1307,2.02%,1.43%
2020-01-01 00:22:20,10,4,3837,985,2852,5.85%,25.67%
2020-01-01 00:22:20,10,5,861,21,840,1.31%,2.44%
2020-01-01 00:22:20,10,6,5611,1116,4495,8.56%,19.89%
2020-01-01 00:22:20,10,7,9944,1730,8214,15.17%,17.40%
2020-01-01 00:22:20,10,8,28211,7130,21081,43.05%,25.27%
2020-01-01 00:22:20,10,9,539,4,535,0.82%,0.74%
2020-01-01 00:22:20,10,10,2333,49,2284,3.56%,2.10%
2020-01-01 00:22:20,10,11,13841,1897,11944,21.12%,13.71%
2020-01-01 00:22:20,10,12,10956,1436,9520,16.72%,13.11%
2020-01-01 00:22:20,11,1,2462,55,2407,3.76%,2.23%
2020-01-01 00:22:20,11,2,3599,112,3487,5.49%,3.11%
2020-01-01 00:22:20,11,3,974,10,964,1.49%,1.03%
2020-01-01 00:22:20,11,4,2868,76,2792,4.38%,2.65%
2020-01-01 00:22:20,11,5,182,0,182,0.28%,0.00%
2020-01-01 00:22:20,11,6,3788,125,3663,5.78%,3.30%
2020-01-01 00:22:20,11,7,9464,662,8802,14.44%,6.99%
2020-01-01 00:22:20,11,8,24468,4103,20365,37.34%,16.77%
2020-01-01 00:22:20,11,9,255,1,254,0.39%,0.39%
2020-01-01 00:22:20,11,10,2931,75,2856,4.47%,2.56%
2020-01-01 00:22:20,11,11,10513,808,9705,16.04%,7.69%
2020-01-01 00:22:20,11,12,7239,389,6850,11.05%,5.37%
2020-01-01 00:22:20,12,1,80,0,80,0.12%,0.00%
2020-01-01 00:22:20,12,2,819,187,632,1.25%,22.83%
2020-01-01 00:22:20,12,3,2998,244,2754,4.57%,8.14%
2020-01-01 00:22:20,12,4,2550,78,2472,3.89%,3.06%
2020-01-01 00:22:20,12,5,8859,786,8073,13.52%,8.87%
2020-01-01 00:22:20,12,6,5019,204,4815,7.66%,4.06%
2020-01-01 00:22:20,12,7,2272,34,2238,3.47%,1.50%
2020-01-01 00:22:20,12,8,1503,300,1203,2.29%,19.96%
2020-01-01 00:22:20,12,9,22380,4536,17844,34.15%,20.27%
2020-01-01 00:22:20,12,10,4936,445,4491,7.53%,9.02%
2020-01-01 00:22:20,12,11,1759,305,1454,2.68%,17.34%
2020-01-01 00:22:20,12,12,7877,1258,6619,12.02%,15.97%
2020-01-01 00:22:20,13,1,2339,48,2291,3.57%,2.05%
2020-01-01 00:22:20,13,2,2715,71,2644,4.14%,2.62%
2020-01-01 00:22:20,13,3,594,21,573,0.91%,3.54%
2020-01-01 00:22:20,13,4,5065,568,4497,7.73%,11.21%
2020-01-01 00:22:20,13,5,7617,903,6714,11.62%,11.86%
2020-01-01 00:22:20,13,6,5715,617,5098,8.72%,10.80%
2020-01-01 00:22:20,13,7,5302,239,5063,8.09%,4.51%
2020-01-01 00:22:20,13,8,7917,488,7429,12.08%,6.16%
2020-01-01 00:22:20,13,9,7877,937,6940,12.02%,11.90%
2020-01-01 00:22:20,13,10,30850,6885,23965,47.07%,22.32%
2020-01-01 00:22:20,13,11,19128,2911,16217,29.19%,15.22%
2020-01-01 00:22:20,13,12,10735,1239,9496,16.38%,11.54%
2020-01-01 00:22:20,14,1,260,1,259,0.40%,0.38%
2020-01-01 00:22:20,14,2,1250,9,1241,1.91%,0.72%
2020-01-01 00:22:20,14,3,822,5,817,1.25%,0.61%
2020-01-01 00:22:20,14,4,3803,119,3684,5.80%,3.13%
2020-01-01 00:22:20,14,5,1218,8,1210,1.86%,0.66%
2020-01-01 00:22:20,14,6,4013,130,3883,6.12%,3.24%
2020-01-01 00:22:20,14,7,11513,998,10515,17.57%,8.67%
2020-01-01 00:22:20,14,8,13397,1348,12049,20.44%,10.06%
2020-01-01 00:22:20,14,9,1488,11,1477,2.27%,0.74%
2020-01-01 00:22:20,14,10,4137,144,3993,6.31%,3.48%
2020-01-01 00:22:20,14,11,26127,4732,21395,39.87%,18.11%
2020-01-01 00:22:20,14,12,8273,525,7748,12.62%,6.35%
2020-01-01 00:22:20,15,1,624,3,621,0.95%,0.48%
2020-01-01 00:22:20,15,2,123,0,123,0.19%,0.00%
2020-01-01 00:22:20,15,3,3833,108,3725,5.85%,2.82%
2020-01-01 00:22:20,15,4,5298,266,5032,8.08%,5.02%
2020-01-01 00:22:20,15,5,10588,1065,9523,16.16%,10.06%
2020-01-01 00:22:20,15,6,5590,302,5288,8.53%,5.40%
2020-01-01 00:22:20,15,7,3801,122,3679,5.80%,3.21%
2020-01-01 00:22:20,15,8,5701,266,5435,8.70%,4.67%
2020-01-01 00:22:20,15,9,10762,1095,9667,16.42%,10.17%
2020-01-01 00:22:20,15,10,4012,300,3712,6.12%,7.48%
2020-01-01 00:22:20,15,11,9947,882,9065,15.18%,8.87%
2020-01-01 00:22:20,15,12,26600,5398,21202,40.59%,20.29%
2020-01-01 00:22:20,16,1,449,3,446,0.69%,0.67%
2020-01-01 00:22:20,16,2,295,1,294,0.45%,0.34%
2020-01-01 00:22:20,16,3,1489,14,1475,2.27%,0.94%
2020-01-01 00:22:20,16,4,6603,327,6276,10.08%,4.95%
2020-01-01 00:22:20,16,5,9934,778,9156,15.16%,7.83%
2020-01-01 00:22:20,16,6,7424,407,7017,11.33%,5.48%
2020-01-01 00:22:20,16,7,3519,88,3431,5.37%,2.50%
2020-01-01 00:22:20,16,8,7147,400,6747,10.91%,5.60%
2020-01-01 00:22:20,16,9,10333,832,9501,15.77%,8.05%
2020-01-01 00:22:20,16,10,2107,27,2080,3.22%,1.28%
2020-01-01 00:22:20,16,11,9730,695,9035,14.85%,7.14%
2020-01-01 00:22:20,16,12,27735,5136,22599,42.32%,18.52%
2020-01-01 00:22:30,1,1,14766,1590,13176,22.53%,10.77%
2020-01-01 00:22:30,1,2,5655,230,5425,8.63%,4.07%
2020-01-01 00:22:30,1,3,1038,10,1028,1.58%,0.96%
2020-01-01 00:22:30,1,4,8628,589,8039,13.17%,6.83%
2020-01-01 00:22:30,1,5,8397,562,7835,12.81%,6.69%
2020-01-01 00:22:30,1,6,8236,542,7694,12.57%,6.58%
2020-01-01 00:22:30,1,7,4613,158,4455,7.04%,3.43%
2020-01-01 00:22:30,1,8,3711,111,3600,5.66%,2.99%
2020-01-01 00:22:30,1,9,8202,537,7665,12.52%,6.55%
2020-01-01 00:22:30,1,10,3153,82,3071,4.81%,2.60%
2020-01-01 00:22:30,1,11,3221,86,3135,4.91%,2.67%
2020-01-01 00:22:30,1,12,8176,535,7641,12.48%,6.54%
2020-01-01 00:22:30,2,1,503,8,495,0.77%,1.59%
2020-01-01 00:22:30,2,2,28508,5486,23022,43.50%,19.24%
2020-01-01 00:22:30,2,3,23909,3944,19965,36.48%,16.50%
2020-01-01 00:22:30,2,4,446,7,439,0.68%,1.57%
2020-01-01 00:22:30,2,5,14059,1387,12672,21.45%,9.87%
2020-01-01 00:22:30,2,6,36,0,36,0.05%,0.00%
2020-01-01 00:22:30,2,7,4083,130,3953,6.23%,3.18%
2020-01-01 00:22:30,2,8,2747,57,2690,4.19%,2.07%
2020-01-01 00:22:30,2,9,13978,1348,12630,21.33%,9.64%
2020-01-01 00:22:30,2,10,1787,20,1767,2.73%,1.12%
2020-01-01 00:22:30,2,11,1801,20,1781,2.75%,1.11%
2020-01-01 00:22:30,2,12,13815,1319,12496,21.08%,9.55%
2020-01-01 00:22:30,3,1,1531,22,1509,2.34%,1.44%
2020-01-01 00:22:30,3,2,21856,3297,18559,33.35%,15.09%
2020-01-01 00:22:30,3,3,71781,28166,43615,109.53%,39.24%
2020-01-01 00:22:30,3,4,5264,174,5090,8.03%,3.31%
2020-01-01 00:22:30,3,5,48680,14374,34306,74.28%,29.53%
2020-01-01 00:22:30,3,6,6539,280,6259,9.98%,4.28%
2020-01-01 00:22:30,3,7,18578,2420,16158,28.35%,13.03%
2020-01-01 00:22:30,3,8,15625,1766,13859,23.84%,11.30%
2020-01-01 00:22:30,3,9,41680,10891,30789,63.60%,26.13%
2020-01-01 00:22:30,3,10,8072,471,7601,12.32%,5.83%
2020-01-01 00:22:30,3,11,1856,22,1834,2.83%,1.19%
2020-01-01 00:22:30,3,12,29468,5711,23757,44.96%,19.38%
2020-01-01 00:22:30,4,1,504,6,498,0.77%,1.19%
2020-01-01 00:22:30,4,2,322,2,320,0.49%,0.62%
2020-01-01 00:22:30,4,3,999,3,996,1.52%,0.30%
2020-01-01 00:22:30,4,4,28435,5375,23060,43.39%,18.90%
2020-01-01 00:22:30,4,5,17542,2148,15394,26.77%,12.24%
2020-01-01 00:22:30,4,6,24587,4095,20492,37.52%,16.66%
2020-01-01 00:22:30,4,7,5700,241,5459,8.70%,4.23%
2020-01-01 00:22:30,4,8,3100,78,3022,4.73%,2.52%
2020-01-01 00:22:30,4,9,14996,1596,13400,22.88%,10.64%
2020-01-01 00:22:30,4,10,1940,22,1918,2.96%,1.13%
2020-01-01 00:22:30,4,11,177,0,177,0.27%,0.00%
2020-01-01 00:22:30,4,12,12477,1093,11384,19.04%,8.76%
2020-01-01 00:22:30,5,1,2533,50,2483,3.87%,1.97%
2020-01-01 00:22:30,5,2,659,3,656,1.01%,0.46%
2020-01-01 00:22:30,5,3,577,2,575,0.88%,0.35%
2020-01-01 00:22:30,5,4,25206,4210,20996,38.46%,16.70%
2020-01-01 00:22:30,5,5,9742,709,9033,14.87%,7.28%
2020-01-01 00:22:30,5,6,14629,1505,13124,22.32%,10.29%
2020-01-01 00:22:30,5,7,4480,140,4340,6.84%,3.12%
2020-01-01 00:22:30,5,8,3415,85,3330,5.21%,2.49%
2020-01-01 00:22:30,5,9,8943,621,8322,13.65%,6.94%
2020-01-01 00:22:30,5,10,1275,11,1264,1.95%,0.86%
2020-01-01 00:22:30,5,11,667,1,666,1.02%,0.15%
2020-01-01 00:22:30,5,12,7367,430,6937,11.24%,5.84%
2020-01-01 00:22:30,6,1,1256,24,1232,1.92%,1.91%
2020-01-01 00:22:30,6,2,1368,28,1340,2.09%,2.05%
2020-01-01 00:22:30,6,3,2102,55,2047,3.21%,2.62%
2020-01-01 00:22:30,6,4,1863,13,1850,2.84%,0.70%
2020-01-01 00:22:30,6,5,15050,1558,13492,22.96%,10.35%
2020-01-01 00:22:30,6,6,5528,187,5341,8.44%,3.38%
2020-01-01 00:22:30,6,7,3115,76,3039,4.75%,2.44%
2020-01-01 00:22:30,6,8,2158,33,2125,3.29%,1.53%
2020-01-01 00:22:30,6,9,7157,384,6773,10.92%,5.37%
2020-01-01 00:22:30,6,10,2040,31,2009,3.11%,1.52%
2020-01-01 00:22:30,6,11,506,1,505,0.77%,0.20%
2020-01-01 00:22:30,6,12,5064,187,4877,7.73%,3.69%
2020-01-01 00:22:30,7,1,536,1,535,0.82%,0.19%
2020-01-01 00:22:30,7,2,122,0,122,0.19%,0.00%
2020-01-01 00:22:30,7,3,841,4,837,1.28%,0.48%
2020-01-01 00:22:30,7,4,2452,34,2418,3.74%,1.39%
2020-01-01 00:22:30,7,5,7765,475,7290,11.85%,6.12%
2020-01-01 00:22:30,7,6,13915,1404,12511,21.23%,10.09%
2020-01-01 00:22:30,7,7,3629,128,3501,5.54%,3.53%
2020-01-01 00:22:30,7,8,1575,19,1556,2.40%,1.21%
2020-01-01 00:22:30,7,9,6681,356,6325,10.19%,5.33%
2020-01-01 00:22:30,7,10,1282,19,1263,1.96%,1.48%
2020-01-01 00:22:30,7,11,100,0,100,0.15%,0.00%
2020-01-01 00:22:30,7,12,5391,253,5138,8.23%,4.69%
2020-01-01 00:22:30,8,1,772,2,770,1.18%,0.26%
2020-01-01 00:22:30,8,2,70,0,70,0.11%,0.00%
2020-01-01 00:22:30,8,3,2180,35,2145,3.33%,1.61%
2020-01-01 00:22:30,8,4,2825,53,2772,4.31%,1.88%
2020-01-01 00:22:30,8,5,9258,636,8622,14.13%,6.87%
2020-01-01 00:22:30,8,6,16981,2100,14881,25.91%,12.37%
2020-01-01 00:22:30,8,7,4806,192,4614,7.33%,4.00%
2020-01-01 00:22:30,8,8,1979,40,1939,3.02%,2.02%
2020-01-01 00:22:30,8,9,6632,327,6305,10.12%,4.93%
2020-01-01 00:22:30,8,10,1962,22,1940,2.99%,1.12%
2020-01-01 00:22:30,8,11,180,1,179,0.27%,0.56%
2020-01-01 00:22:30,8,12,4736,165,4571,7.23%,3.48%
2020-01-01 00:22:30,9,1,453,0,453,0.69%,0.00%
2020-01-01 00:22:30,9,2,2856,64,2792,4.36%,2.24%
2020-01-01 00:22:30,9,3,1886,27,1859,2.88%,1.43%
2020-01-01 00:22:30,9,4,4342,148,4194,6.63%,3.41%
2020-01-01 00:22:30,9,5,490,0,490,0.75%,0.00%
2020-01-01 00:22:30,9,6,5482,229,5253,8.36%,4.18%
2020-01-01 00:22:30,9,7,28344,5405,22939,43.25%,19.07%
2020-01-01 00:22:30,9,8,13634,1384,12250,20.80%,10.15%
2020-01-01 00:22:30,9,9,156,0,156,0.24%,0.00%
2020-01-01 00:22:30,9,10,4815,187,4628,7.35%,3.88%
2020-01-01 00:22:30,9,11,11853,1064,10789,18.09%,8.98%
2020-01-01 00:22:30,9,12,6691,345,6346,10.21%,5.16%
2020-01-01 00:22:30,10,1,1381,247,1134,2.11%,17.89%
2020-01-01 00:22:30,10,2,3223,291,2932,4.92%,9.03%
2020-01-01 00:22:30,10,3,1714,17,1697,2.62%,0.99%
2020-01-01 00:22:30,10,4,3707,948,2759,5.66%,25.57%
2020-01-01 00:22:30,10,5,963,75,888,1.47%,7.79%
2020-01-01 00:22:30,10,6,6112,1142,4970,9.33%,18.68%
2020-01-01 00:22:30,10,7,10842,1827,9015,16.54%,16.85%
2020-01-01 00:22:30,10,8,30468,7878,22590,46.49%,25.86%
2020-01-01 00:22:30,10,9,773,4,769,1.18%,0.52%
2020-01-01 00:22:30,10,10,3389,95,3294,5.17%,2.80%
2020-01-01 00:22:30,10,11,15006,2016,12990,22.90%,13.43%
2020-01-01 00:22:30,10,12,10806,1262,9544,16.49%,11.68%
2020-01-01 00:22:30,11,1,2709,53,2656,4.13%,1.96%
2020-01-01 00:22:30,11,2,3724,98,3626,5.68%,2.63%
2020-01-01 00:22:30,11,3,857,10,847,1.31%,1.17%
2020-01-01 00:22:30,11,4,3035,86,2949,4.63%,2.83%
2020-01-01 00:22:30,11,5,225,0,225,0.34%,0.00%
2020-01-01 00:22:30,11,6,4051,148,3903,6.18%,3.65%
2020-01-01 00:22:30,11,7,9626,666,8960,14.69%,6.92%
2020-01-01 00:22:30,11,8,24503,4008,20495,37.39%,16.36%
2020-01-01 00:22:30,11,9,130,0,130,0.20%,0.00%
2020-01-01 00:22:30,11,10,2955,78,2877,4.51%,2.64%
2020-01-01 00:22:30,11,11,10718,876,9842,16.35%,8.17%
2020-01-01 00:22:30,11,12,7194,404,6790,10.98%,5.62%
2020-01-01 00:22:30,12,1,56,0,56,0.09%,0.00%
2020-01-01 00:22:30,12,2,647,150,497,0.99%,23.18%
2020-01-01 00:22:30,12,3,2752,204,2548,4.20%,7.41%
2020-01-01 00:22:30,12,4,2832,84,2748,4.32%,2.97%
2020-01-01 00:22:30,12,5,9431,760,8671,14.39%,8.06%
2020-01-01 00:22:30,12,6,4854,181,4673,7.41%,3.73%
2020-01-01 00:22:30,12,7,1859,25,1834,2.84%,1.34%
2020-01-01 00:22:30,12,8,1640,319,1321,2.50%,19.45%
2020-01-01 00:22:30,12,9,22539,4444,18095,34.39%,19.72%
2020-01-01 00:22:30,12,10,4721,441,4280,7.20%,9.34%
2020-01-01 00:22:30,12,11,1857,323,1534,2.83%,17.39%
2020-01-01 00:22:30,12,12,7856,1180,6676,11.99%,15.02%
2020-01-01 00:22:30,13,1,2694,54,2640,4.11%,2.00%
2020-01-01 00:22:30,13,2,3046,72,2974,4.65%,2.36%
2020-01-01 00:22:30,13,3,816,23,793,1.25%,2.82%
2020-01-01 00:22:30,13,4,5007,536,4471,7.64%,10.71%
2020-01-01 00:22:30,13,5,7425,858,6567,11.33%,11.56%
2020-01-01 00:22:30,13,6,5620,580,5040,8.58%,10.32%
2020-01-01 00:22:30,13,7,5306,214,5092,8.10%,4.03%
2020-01-01 00:22:30,13,8,8475,510,7965,12.93%,6.02%
2020-01-01 00:22:30,13,9,7688,883,6805,11.73%,11.49%
2020-01-01 00:22:30,13,10,30286,6564,23722,46.21%,21.67%
2020-01-01 00:22:30,13,11,19161,2799,16362,29.24%,14.61%
2020-01-01 00:22:30,13,12,10361,1097,9264,15.81%,10.59%
2020-01-01 00:22:30,14,1,157,0,157,0.24%,0.00%
2020-01-01 00:22:30,14,2,1634,19,1615,2.49%,1.16%
2020-01-01 00:22:30,14,3,1276,9,1267,1.95%,0.71%
2020-01-01 00:22:30,14,4,3228,64,3164,4.93%,1.98%
2020-01-01 00:22:30,14,5,1089,14,1075,1.66%,1.29%
2020-01-01 00:22:30,14,6,3482,79,3403,5.31%,2.27%
2020-01-01 00:22:30,14,7,11522,971,10551,17.58%,8.43%
2020-01-01 00:22:30,14,8,13382,1300,12082,20.42%,9.71%
2020-01-01 00:22:30,14,9,1245,17,1228,1.90%,1.37%
2020-01-01 00:22:30,14,10,4088,117,3971,6.24%,2.86%
2020-01-01 00:22:30,14,11,27418,5090,22328,41.84%,18.56%
2020-01-01 00:22:30,14,12,9633,696,8937,14.70%,7.23%
2020-01-01 00:22:30,15,1,557,2,555,0.85%,0.36%
2020-01-01 00:22:30,15,2,123,0,123,0.19%,0.00%
2020-01-01 00:22:30,15,3,3872,120,3752,5.91%,3.10%
2020-01-01 00:22:30,15,4,5252,245,5007,8.01%,4.66%
2020-01-01 00:22:30,15,5,10226,888,9338,15.60%,8.68%
2020-01-01 00:22:30,15,6,5519,267,5252,8.42%,4.84%
2020-01-01 00:22:30,15,7,4032,131,3901,6.15%,3.25%
2020-01-01 00:22:30,15,8,5632,257,5375,8.59%,4.56%
2020-01-01 00:22:30,15,9,10417,914,9503,15.90%,8.77%
2020-01-01 00:22:30,15,10,4470,311,4159,6.82%,6.96%
2020-01-01 00:22:30,15,11,10204,918,9286,15.57%,9.00%
2020-01-01 00:22:30,15,12,26166,5116,21050,39.93%,19.55%
2020-01-01 00:22:30,16,1,338,1,337,0.52%,0.30%
2020-01-01 00:22:30,16,2,305,3,302,0.47%,0.98%
2020-01-01 00:22:30,16,3,1307,12,1295,1.99%,0.92%
2020-01-01 00:22:30,16,4,4922,205,4717,7.51%,4.16%
2020-01-01 00:22:30,16,5,8106,541,7565,12.37%,6.67%
2020-01-01 00:22:30,16,6,5815,273,5542,8.87%,4.69%
2020-01-01 00:22:30,16,7,3457,85,3372,5.27%,2.46%
2020-01-01 00:22:30,16,8,7216,461,6755,11.01%,6.39%
2020-01-01 00:22:30,16,9,8562,593,7969,13.06%,6.93%
2020-01-01 00:22:30,16,10,1629,24,1605,2.49%,1.47%
2020-01-01 00:22:30,16,11,9068,655,8413,13.84%,7.22%
2020-01-01 00:22:30,16,12,25484,4464,21020,38.89%,17.52%
2020-01-01 00:22:40,1,1,19110,2467,16643,29.16%,12.91%
2020-01-01 00:22:40,1,2,6991,366,6625,10.67%,5.24%
2020-01-01 00:22:40,1,3,573,2,571,0.87%,0.35%
2020-01-01 00:22:40,1,4,11530,915,10615,17.59%,7.94%
2020-01-01 00:22:40,1,5,11111,860,10251,16.95%,7.74%
2020-01-01 00:22:40,1,6,11063,848,10215,16.88%,7.67%
2020-01-01 00:22:40,1,7,6411,319,6092,9.78%,4.98%
2020-01-01 00:22:40,1,8,4089,120,3969,6.24%,2.93%
2020-01-01 00:22:40,1,9,11035,845,10190,16.84%,7.66%
2020-01-01 00:22:40,1,10,3530,90,3440,5.39%,2.55%
2020-01-01 00:22:40,1,11,3635,93,3542,5.55%,2.56%
2020-01-01 00:22:40,1,12,11005,838,10167,16.79%,7.61%
2020-01-01 00:22:40,2,1,402,0,402,0.61%,0.00%
2020-01-01 00:22:40,2,2,25636,4462,21174,39.12%,17.41%
2020-01-01 00:22:40,2,3,21942,3337,18605,33.48%,15.21%
2020-01-01 00:22:40,2,4,375,0,375,0.57%,0.00%
2020-01-01 00:22:40,2,5,13620,1346,12274,20.78%,9.88%
2020-01-01 00:22:40,2,6,36,0,36,0.05%,0.00%
2020-01-01 00:22:40,2,7,3282,61,3221,5.01%,1.86%
2020-01-01 00:22:40,2,8,2464,31,2433,3.76%,1.26%
2020-01-01 00:22:40,2,9,13542,1331,12211,20.66%,9.83%
2020-01-01 00:22:40,2,10,1721,11,1710,2.63%,0.64%
2020-01-01 00:22:40,2,11,1747,12,1735,2.67%,0.69%
2020-01-01 00:22:40,2,12,13372,1295,12077,20.40%,9.68%
2020-01-01 00:22:40,3,1,1427,12,1415,2.18%,0.84%
2020-01-01 00:22:40,3,2,22960,3636,19324,35.03%,15.84%
2020-01-01 00:22:40,3,3,71967,28287,43680,109.81%,39.31%
2020-01-01 00:22:40,3,4,7383,386,6997,11.27%,5.23%
2020-01-01 00:22:40,3,5,47768,13844,33924,72.89%,28.98%
2020-01-01 00:22:40,3,6,8659,531,8128,13.21%,6.13%
2020-01-01 00:22:40,3,7,19515,2683,16832,29.78%,13.75%
2020-01-01 00:22:40,3,8,15836,1753,14083,24.16%,11.07%
2020-01-01 00:22:40,3,9,38760,9550,29210,59.14%,24.64%
2020-01-01 00:22:40,3,10,5424,206,5218,8.28%,3.80%
2020-01-01 00:22:40,3,11,2193,26,2167,3.35%,1.19%
2020-01-01 00:22:40,3,12,28963,5613,23350,44.19%,19.38%
2020-01-01 00:22:40,4,1,558,8,550,0.85%,1.43%
2020-01-01 00:22:40,4,2,357,2,355,0.54%,0.56%
2020-01-01 00:22:40,4,3,815,2,813,1.24%,0.25%
2020-01-01 00:22:40,4,4,28279,5416,22863,43.15%,19.15%
2020-01-01 00:22:40,4,5,17327,2115,15212,26.44%,12.21%
2020-01-01 00:22:40,4,6,24421,4128,20293,37.26%,16.90%
2020-01-01 00:22:40,4,7,5660,244,5416,8.64%,4.31%
2020-01-01 00:22:40,4,8,3305,87,3218,5.04%,2.63%
2020-01-01 00:22:40,4,9,14921,1597,13324,22.77%,10.70%
2020-01-01 00:22:40,4,10,2061,48,2013,3.14%,2.33%
2020-01-01 00:22:40,4,11,231,0,231,0.35%,0.00%
2020-01-01 00:22:40,4,12,12294,1073,11221,18.76%,8.73%
2020-01-01 00:22:40,5,1,2425,39,2386,3.70%,1.61%
2020-01-01 00:22:40,5,2,656,2,654,1.00%,0.30%
2020-01-01 00:22:40,5,3,560,3,557,0.85%,0.54%
2020-01-01 00:22:40,5,4,21664,3101,18563,33.06%,14.31%
2020-01-01 00:22:40,5,5,8800,567,8233,13.43%,6.44%
2020-01-01 00:22:40,5,6,13536,1259,12277,20.65%,9.30%
2020-01-01 00:22:40,5,7,4294,140,4154,6.55%,3.26%
2020-01-01 00:22:40,5,8,3261,80,3181,4.98%,2.45%
2020-01-01 00:22:40,5,9,8090,481,7609,12.34%,5.95%
2020-01-01 00:22:40,5,10,795,8,787,1.21%,1.01%
2020-01-01 00:22:40,5,11,686,2,684,1.05%,0.29%
2020-01-01 00:22:40,5,12,6936,349,6587,10.58%,5.03%
2020-01-01 00:22:40,6,1,1250,13,1237,1.91%,1.04%
2020-01-01 00:22:40,6,2,1351,14,1337,2.06%,1.04%
2020-01-01 00:22:40,6,3,2058,21,2037,3.14%,1.02%
2020-01-01 00:22:40,6,4,1543,76,1467,2.35%,4.93%
2020-01-01 00:22:40,6,5,14067,1453,12614,21.46%,10.33%
2020-01-01 00:22:40,6,6,5669,298,5371,8.65%,5.26%
2020-01-01 00:22:40,6,7,3621,123,3498,5.53%,3.40%
2020-01-01 00:22:40,6,8,2463,61,2402,3.76%,2.48%
2020-01-01 00:22:40,6,9,6113,260,5853,9.33%,4.25%
2020-01-01 00:22:40,6,10,1969,38,1931,3.00%,1.93%
2020-01-01 00:22:40,6,11,489,3,486,0.75%,0.61%
2020-01-01 00:22:40,6,12,4078,117,3961,6.22%,2.87%
2020-01-01 00:22:40,7,1,484,1,483,0.74%,0.21%
2020-01-01 00:22:40,7,2,120,0,120,0.18%,0.00%
2020-01-01 00:22:40,7,3,521,1,520,0.79%,0.19%
2020-01-01 00:22:40,7,4,2590,46,2544,3.95%,1.78%
2020-01-01 00:22:40,7,5,6775,335,6440,10.34%,4.94%
2020-01-01 00:22:40,7,6,12678,1118,11560,19.35%,8.82%
2020-01-01 00:22:40,7,7,3228,90,3138,4.93%,2.79%
2020-01-01 00:22:40,7,8,1426,23,1403,2.18%,1.61%
2020-01-01 00:22:40,7,9,6118,279,5839,9.34%,4.56%
2020-01-01 00:22:40,7,10,843,8,835,1.29%,0.95%
2020-01-01 00:22:40,7,11,94,0,94,0.14%,0.00%
2020-01-01 00:22:40,7,12,5279,211,5068,8.06%,4.00%
2020-01-01 00:22:40,8,1,723,6,717,1.10%,0.83%
2020-01-01 00:22:40,8,2,86,0,86,0.13%,0.00%
2020-01-01 00:22:40,8,3,2375,55,2320,3.62%,2.32%
2020-01-01 00:22:40,8,4,2675,59,2616,4.08%,2.21%
2020-01-01 00:22:40,8,5,9111,651,8460,13.90%,7.15%
2020-01-01 00:22:40,8,6,17132,2078,15054,26.14%,12.13%
2020-01-01 00:22:40,8,7,5019,182,4837,7.66%,3.63%
2020-01-01 00:22:40,8,8,2222,32,2190,3.39%,1.44%
2020-01-01 00:22:40,8,9,6162,299,5863,9.40%,4.85%
2020-01-01 00:22:40,8,10,1704,19,1685,2.60%,1.12%
2020-01-01 00:22:40,8,11,111,0,111,0.17%,0.00%
2020-01-01 00:22:40,8,12,4464,179,4285,6.81%,4.01%
2020-01-01 00:22:40,9,1,645,1,644,0.98%,0.16%
2020-01-01 00:22:40,9,2,2174,39,2135,3.32%,1.79%
2020-01-01 00:22:40,9,3,1091,11,1080,1.66%,1.01%
2020-01-01 00:22:40,9,4,5063,187,4876,7.73%,3.69%
2020-01-01 00:22:40,9,5,430,2,428,0.66%,0.47%
2020-01-01 00:22:40,9,6,6163,289,5874,9.40%,4.69%
2020-01-01 00:22:40,9,7,25111,4266,20845,38.32%,16.99%
2020-01-01 00:22:40,9,8,10908,883,10025,16.64%,8.09%
2020-01-01 00:22:40,9,9,167,0,167,0.25%,0.00%
2020-01-01 00:22:40,9,10,2725,67,2658,4.16%,2.46%
2020-01-01 00:22:40,9,11,9616,688,8928,14.67%,7.15%
2020-01-01 00:22:40,9,12,6589,320,6269,10.05%,4.86%
2020-01-01 00:22:40,10,1,1649,296,1353,2.52%,17.95%
2020-01-01 00:22:40,10,2,5081,482,4599,7.75%,9.49%
2020-01-01 00:22:40,10,3,3279,76,3203,5.00%,2.32%
2020-01-01 00:22:40,10,4,4184,967,3217,6.38%,23.11%
2020-01-01 00:22:40,10,5,915,116,799,1.40%,12.68%
2020-01-01 00:22:40,10,6,6777,1241,5536,10.34%,18.31%
2020-01-01 00:22:40,10,7,14033,2451,11582,21.41%,17.47%
2020-01-01 00:22:40,10,8,34300,9383,24917,52.34%,27.36%
2020-01-01 00:22:40,10,9,635,2,633,0.97%,0.31%
2020-01-01 00:22:40,10,10,3462,96,3366,5.28%,2.77%
2020-01-01 00:22:40,10,11,15999,2096,13903,24.41%,13.10%
2020-01-01 00:22:40,10,12,11605,1273,10332,17.71%,10.97%
2020-01-01 00:22:40,11,1,2914,66,2848,4.45%,2.26%
2020-01-01 00:22:40,11,2,3690,110,3580,5.63%,2.98%
2020-01-01 00:22:40,11,3,582,2,580,0.89%,0.34%
2020-01-01 00:22:40,11,4,5515,218,5297,8.42%,3.95%
2020-01-01 00:22:40,11,5,197,2,195,0.30%,1.02%
2020-01-01 00:22:40,11,6,6456,296,6160,9.85%,4.58%
2020-01-01 00:22:40,11,7,11756,1013,10743,17.94%,8.62%
2020-01-01 00:22:40,11,8,26169,4607,21562,39.93%,17.60%
2020-01-01 00:22:40,11,9,226,0,226,0.34%,0.00%
2020-01-01 00:22:40,11,10,2812,63,2749,4.29%,2.24%
2020-01-01 00:22:40,11,11,10169,745,9424,15.52%,7.33%
2020-01-01 00:22:40,11,12,6865,339,6526,10.48%,4.94%
2020-01-01 00:22:40,12,1,47,0,47,0.07%,0.00%
2020-01-01 00:22:40,12,2,494,109,385,0.75%,22.06%
2020-01-01 00:22:40,12,3,3059,167,2892,4.67%,5.46%
2020-01-01 00:22:40,12,4,3567,69,3498,5.44%,1.93%
2020-01-01 00:22:40,12,5,9610,736,8874,14.66%,7.66%
2020-01-01 00:22:40,12,6,5202,163,5039,7.94%,3.13%
2020-01-01 00:22:40,12,7,1522,28,1494,2.32%,1.84%
2020-01-01 00:22:40,12,8,1479,310,1169,2.26%,20.96%
2020-01-01 00:22:40,12,9,24075,4745,19330,36.74%,19.71%
2020-01-01 00:22:40,12,10,4456,448,4008,6.80%,10.05%
2020-01-01 00:22:40,12,11,1691,316,1375,2.58%,18.69%
2020-01-01 00:22:40,12,12,9490,1363,8127,14.48%,14.36%
2020-01-01 00:22:40,13,1,2105,33,2072,3.21%,1.57%
2020-01-01 00:22:40,13,2,2394,41,2353,3.65%,1.71%
2020-01-01 00:22:40,13,3,1014,18,996,1.55%,1.78%
2020-01-01 00:22:40,13,4,4708,622,4086,7.18%,13.21%
2020-01-01 00:22:40,13,5,7228,936,6292,11.03%,12.95%
2020-01-01 00:22:40,13,6,5236,657,4579,7.99%,12.55%
2020-01-01 00:22:40,13,7,4442,171,4271,6.78%,3.85%
2020-01-01 00:22:40,13,8,8342,542,7800,12.73%,6.50%
2020-01-01 00:22:40,13,9,7517,960,6557,11.47%,12.77%
2020-01-01 00:22:40,13,10,28337,5947,22390,43.24%,20.99%
2020-01-01 00:22:40,13,11,18054,2557,15497,27.55%,14.16%
2020-01-01 00:22:40,13,12,9398,959,8439,14.34%,10.20%
2020-01-01 00:22:40,14,1,142,2,140,0.22%,1.41%
2020-01-01 00:22:40,14,2,1677,16,1661,2.56%,0.95%
2020-01-01 00:22:40,14,3,1235,8,1227,1.88%,0.65%
2020-01-01 00:22:40,14,4,3387,78,3309,5.17%,2.30%
2020-01-01 00:22:40,14,5,962,5,957,1.47%,0.52%
2020-01-01 00:22:40,14,6,3722,95,3627,5.68%,2.55%
2020-01-01 00:22:40,14,7,11142,853,10289,17.00%,7.66%
2020-01-01 00:22:40,14,8,13226,1241,11985,20.18%,9.38%
2020-01-01 00:22:40,14,9,1140,8,1132,1.74%,0.70%
2020-01-01 00:22:40,14,10,3724,95,3629,5.68%,2.55%
2020-01-01 00:22:40,14,11,25569,4483,21086,39.02%,17.53%
2020-01-01 00:22:40,14,12,8279,512,7767,12.63%,6.18%
2020-01-01 00:22:40,15,1,592,7,585,0.90%,1.18%
2020-01-01 00:22:40,15,2,158,0,158,0.24%,0.00%
2020-01-01 00:22:40,15,3,4050,133,3917,6.18%,3.28%
2020-01-01 00:22:40,15,4,6276,354,5922,9.58%,5.64%
2020-01-01 00:22:40,15,5,11242,958,10284,17.15%,8.52%
2020-01-01 00:22:40,15,6,6521,372,6149,9.95%,5.70%
2020-01-01 00:22:40,15,7,4025,145,3880,6.14%,3.60%
2020-01-01 00:22:40,15,8,7231,398,6833,11.03%,5.50%
2020-01-01 00:22:40,15,9,11411,989,10422,17.41%,8.67%
2020-01-01 00:22:40,15,10,4192,345,3847,6.40%,8.23%
2020-01-01 00:22:40,15,11,11507,1152,10355,17.56%,10.01%
2020-01-01 00:22:40,15,12,28323,5845,22478,43.22%,20.64%
2020-01-01 00:22:40,16,1,437,2,435,0.67%,0.46%
2020-01-01 00:22:40,16,2,318,0,318,0.49%,0.00%
2020-01-01 00:22:40,16,3,1343,18,1325,2.05%,1.34%
2020-01-01 00:22:40,16,4,5424,232,5192,8.28%,4.28%
2020-01-01 00:22:40,16,5,8652,600,8052,13.20%,6.93%
2020-01-01 00:22:40,16,6,6298,292,6006,9.61%,4.64%
2020-01-01 00:22:40,16,7,3254,119,3135,4.97%,3.66%
2020-01-01 00:22:40,16,8,7731,511,7220,11.80%,6.61%
2020-01-01 00:22:40,16,9,9330,696,8634,14.24%,7.46%
2020-01-01 00:22:40,16,10,2394,37,2357,3.65%,1.55%
2020-01-01 00:22:40,16,11,10381,850,9531,15.84%,8.19%
2020-01-01 00:22:40,16,12,27516,5057,22459,41.99%,18.38%
2020-01-01 00:22:50,1,1,21726,3273,18453,33.15%,15.06%
2020-01-01 00:22:50,1,2,10332,812,9520,15.77%,7.86%
2020-01-01 00:22:50,1,3,700,9,691,1.07%,1.29%
2020-01-01 00:22:50,1,4,10858,843,10015,16.57%,7.76%
2020-01-01 00:22:50,1,5,10393,763,9630,15.86%,7.34%
2020-01-01 00:22:50,1,6,10329,755,9574,15.76%,7.31%
2020-01-01 00:22:50,1,7,9610,702,8908,14.66%,7.30%
2020-01-01 00:22:50,1,8,6791,342,6449,10.36%,5.04%
2020-01-01 00:22:50,1,9,10295,750,9545,15.71%,7.29%
2020-01-01 00:22:50,1,10,6225,296,5929,9.50%,4.76%
2020-01-01 00:22:50,1,11,6315,304,6011,9.64%,4.81%
2020-01-01 00:22:50,1,12,10197,741,9456,15.56%,7.27%
2020-01-01 00:22:50,2,1,380,0,380,0.58%,0.00%
2020-01-01 00:22:50,2,2,29801,5796,24005,45.47%,19.45%
2020-01-01 00:22:50,2,3,25419,4300,21119,38.79%,16.92%
2020-01-01 00:22:50,2,4,315,0,315,0.48%,0.00%
2020-01-01 00:22:50,2,5,17227,2079,15148,26.29%,12.07%
2020-01-01 00:22:50,2,6,34,0,34,0.05%,0.00%
2020-01-01 00:22:50,2,7,3985,119,3866,6.08%,2.99%
2020-01-01 00:22:50,2,8,2585,47,2538,3.94%,1.82%
2020-01-01 00:22:50,2,9,17179,2074,15105,26.21%,12.07%
2020-01-01 00:22:50,2,10,1806,20,1786,2.76%,1.11%
2020-01-01 00:22:50,2,11,1816,20,1796,2.77%,1.10%
2020-01-01 00:22:50,2,12,17035,2041,14994,25.99%,11.98%
2020-01-01 00:22:50,3,1,2513,41,2472,3.83%,1.63%
2020-01-01 00:22:50,3,2,22739,3509,19230,34.70%,15.43%
2020-01-01 00:22:50,3,3,68045,25611,42434,103.83%,37.64%
2020-01-01 00:22:50,3,4,6957,351,6606,10.62%,5.05%
2020-01-01 00:22:50,3,5,40670,10337,30333,62.06%,25.42%
2020-01-01 00:22:50,3,6,8120,480,7640,12.39%,5.91%
2020-01-01 00:22:50,3,7,18546,2403,16143,28.30%,12.96%
2020-01-01 00:22:50,3,8,15488,1693,13795,23.63%,10.93%
2020-01-01 00:22:50,3,9,32185,6749,25436,49.11%,20.97%
2020-01-01 00:22:50,3,10,4442,120,4322,6.78%,2.70%
2020-01-01 00:22:50,3,11,1843,22,1821,2.81%,1.19%
2020-01-01 00:22:50,3,12,23313,3662,19651,35.57%,15.71%
2020-01-01 00:22:50,4,1,592,5,587,0.90%,0.84%
2020-01-01 00:22:50,4,2,386,1,385,0.59%,0.26%
2020-01-01 00:22:50,4,3,654,5,649,1.00%,0.76%
2020-01-01 00:22:50,4,4,28358,5480,22878,43.27%,19.32%
2020-01-01 00:22:50,4,5,16993,2082,14911,25.93%,12.25%
2020-01-01 00:22:50,4,6,24216,4121,20095,36.95%,17.02%
2020-01-01 00:22:50,4,7,5882,261,5621,8.98%,4.44%
2020-01-01 00:22:50,4,8,3290,73,3217,5.02%,2.22%
2020-01-01 00:22:50,4,9,15172,1671,13501,23.15%,11.01%
2020-01-01 00:22:50,4,10,2056,43,2013,3.14%,2.09%
2020-01-01 00:22:50,4,11,189,0,189,0.29%,0.00%
2020-01-01 00:22:50,4,12,12083,1082,11001,18.44%,8.95%
2020-01-01 00:22:50,5,1,2693,62,2631,4.11%,2.30%
2020-01-01 00:22:50,5,2,702,8,694,1.07%,1.14%
2020-01-01 00:22:50,5,3,515,2,513,0.79%,0.39%
2020-01-01 00:22:50,5,4,22811,3597,19214,34.81%,15.77%
2020-01-01 00:22:50,5,5,8327,517,7810,12.71%,6.21%
2020-01-01 00:22:50,5,6,13515,1318,12197,20.62%,9.75%
2020-01-01 00:22:50,5,7,4722,154,4568,7.21%,3.26%
2020-01-01 00:22:50,5,8,3688,78,3610,5.63%,2.11%
2020-01-01 00:22:50,5,9,7612,425,7187,11.61%,5.58%
2020-01-01 00:22:50,5,10,841,7,834,1.28%,0.83%
2020-01-01 00:22:50,5,11,599,1,598,0.91%,0.17%
2020-01-01 00:22:50,5,12,6601,326,6275,10.07%,4.94%
2020-01-01 00:22:50,6,1,974,10,964,1.49%,1.03%
2020-01-01 00:22:50,6,2,1033,10,1023,1.58%,0.97%
2020-01-01 00:22:50,6,3,1443,20,1423,2.20%,1.39%
2020-01-01 00:22:50,6,4,1298,8,1290,1.98%,0.62%
2020-01-01 00:22:50,6,5,14158,1393,12765,21.60%,9.84%
2020-01-01 00:22:50,6,6,6035,270,5765,9.21%,4.47%
2020-01-01 00:22:50,6,7,4217,148,4069,6.43%,3.51%
2020-01-01 00:22:50,6,8,3317,88,3229,5.06%,2.65%
2020-01-01 00:22:50,6,9,6451,275,6176,9.84%,4.26%
2020-01-01 00:22:50,6,10,2054,35,2019,3.13%,1.70%
2020-01-01 00:22:50,6,11,503,1,502,0.77%,0.20%
2020-01-01 00:22:50,6,12,4349,116,4233,6.64%,2.67%
2020-01-01 00:22:50,7,1,512,0,512,0.78%,0.00%
2020-01-01 00:22:50,7,2,148,0,148,0.23%,0.00%
2020-01-01 00:22:50,7,3,670,6,664,1.02%,0.90%
2020-01-01 00:22:50,7,4,1984,40,1944,3.03%,2.02%
2020-01-01 00:22:50,7,5,6879,387,6492,10.50%,5.63%
2020-01-01 00:22:50,7,6,12368,1120,11248,18.87%,9.06%
2020-01-01 00:22:50,7,7,3466,91,3375,5.29%,2.63%
2020-01-01 00:22:50,7,8,1305,17,1288,1.99%,1.30%
2020-01-01 00:22:50,7,9,6067,312,5755,9.26%,5.14%
2020-01-01 00:22:50,7,10,1048,7,1041,1.60%,0.67%
2020-01-01 00:22:50,7,11,127,0,127,0.19%,0.00%
2020-01-01 00:22:50,7,12,4997,227,4770,7.62%,4.54%
2020-01-01 00:22:50,8,1,585,1,584,0.89%,0.17%
2020-01-01 00:22:50,8,2,98,0,98,0.15%,0.00%
2020-01-01 00:22:50,8,3,1990,23,1967,3.04%,1.16%
2020-01-01 00:22:50,8,4,3167,78,3089,4.83%,2.46%
2020-01-01 00:22:50,8,5,8227,507,7720,12.55%,6.16%
2020-01-01 00:22:50,8,6,16208,1833,14375,24.73%,11.31%
2020-01-01 00:22:50,8,7,4615,148,4467,7.04%,3.21%
2020-01-01 00:22:50,8,8,1803,26,1777,2.75%,1.44%
2020-01-01 00:22:50,8,9,5916,290,5626,9.03%,4.90%
2020-01-01 00:22:50,8,10,1647,16,1631,2.51%,0.97%
2020-01-01 00:22:50,8,11,121,0,121,0.18%,0.00%
2020-01-01 00:22:50,8,12,4260,166,4094,6.50%,3.90%
2020-01-01 00:22:50,9,1,1351,8,1343,2.06%,0.59%
2020-01-01 00:22:50,9,2,4206,137,4069,6.42%,3.26%
2020-01-01 00:22:50,9,3,2504,50,2454,3.82%,2.00%
2020-01-01 00:22:50,9,4,10210,734,9476,15.58%,7.19%
2020-01-01 00:22:50,9,5,364,0,364,0.56%,0.00%
2020-01-01 00:22:50,9,6,11156,874,10282,17.02%,7.83%
2020-01-01 00:22:50,9,7,32893,7081,25812,50.19%,21.53%
2020-01-01 00:22:50,9,8,10966,875,10091,16.73%,7.98%
2020-01-01 00:22:50,9,9,136,0,136,0.21%,0.00%
2020-01-01 00:22:50,9,10,4055,103,3952,6.19%,2.54%
2020-01-01 00:22:50,9,11,9807,721,9086,14.96%,7.35%
2020-01-01 00:22:50,9,12,5356,229,5127,8.17%,4.28%
2020-01-01 00:22:50,10,1,1251,220,1031,1.91%,17.59%
2020-01-01 00:22:50,10,2,3239,274,2965,4.94%,8.46%
2020-01-01 00:22:50,10,3,1824,17,1807,2.78%,0.93%
2020-01-01 00:22:50,10,4,4324,1071,3253,6.60%,24.77%
2020-01-01 00:22:50,10,5,810,81,729,1.24%,10.00%
2020-01-01 00:22:50,10,6,6276,1287,4989,9.58%,20.51%
2020-01-01 00:22:50,10,7,11794,2058,9736,18.00%,17.45%
2020-01-01 00:22:50,10,8,29105,7188,21917,44.41%,24.70%
2020-01-01 00:22:50,10,9,740,2,738,1.13%,0.27%
2020-01-01 00:22:50,10,10,2548,47,2501,3.89%,1.84%
2020-01-01 00:22:50,10,11,13579,1646,11933,20.72%,12.12%
2020-01-01 00:22:50,10,12,10430,1167,9263,15.91%,11.19%
2020-01-01 00:22:50,11,1,2781,55,2726,4.24%,1.98%
2020-01-01 00:22:50,11,2,3619,114,3505,5.52%,3.15%
2020-01-01 00:22:50,11,3,700,6,694,1.07%,0.86%
2020-01-01 00:22:50,11,4,4615,163,4452,7.04%,3.53%
2020-01-01 00:22:50,11,5,226,2,224,0.34%,0.88%
2020-01-01 00:22:50,11,6,5812,240,5572,8.87%,4.13%
2020-01-01 00:22:50,11,7,11408,962,10446,17.41%,8.43%
2020-01-01 00:22:50,11,8,25131,4328,20803,38.35%,17.22%
2020-01-01 00:22:50,11,9,140,0,140,0.21%,0.00%
2020-01-01 00:22:50,11,10,2937,73,2864,4.48%,2.49%
2020-01-01 00:22:50,11,11,10106,754,9352,15.42%,7.46%
2020-01-01 00:22:50,11,12,6754,375,6379,10.31%,5.55%
2020-01-01 00:22:50,12,1,82,0,82,0.13%,0.00%
2020-01-01 00:22:50,12,2,598,142,456,0.91%,23.75%
2020-01-01 00:22:50,12,3,2506,183,2323,3.82%,7.30%
2020-01-01 00:22:50,12,4,3314,113,3201,5.06%,3.41%
2020-01-01 00:22:50,12,5,8467,638,7829,12.92%,7.54%
2020-01-01 00:22:50,12,6,5166,215,4951,7.88%,4.16%
2020-01-01 00:22:50,12,7,1696,25,1671,2.59%,1.47%
2020-01-01 00:22:50,12,8,1277,283,994,1.95%,22.16%
2020-01-01 00:22:50,12,9,21397,3958,17439,32.65%,18.50%
2020-01-01 00:22:50,12,10,4351,410,3941,6.64%,9.42%
2020-01-01 00:22:50,12,11,1430,285,1145,2.18%,19.93%
2020-01-01 00:22:50,12,12,7993,1068,6925,12.20%,13.36%
2020-01-01 00:22:50,13,1,2252,50,2202,3.44%,2.22%
2020-01-01 00:22:50,13,2,2579,56,2523,3.94%,2.17%
2020-01-01 00:22:50,13,3,1129,9,1120,1.72%,0.80%
2020-01-01 00:22:50,13,4,5261,626,4635,8.03%,11.90%
2020-01-01 00:22:50,13,5,7749,935,6814,11.82%,12.07%
2020-01-01 00:22:50,13,6,5820,668,5152,8.88%,11.48%
2020-01-01 00:22:50,13,7,4714,179,4535,7.19%,3.80%
2020-01-01 00:22:50,13,8,7838,457,7381,11.96%,5.83%
2020-01-01 00:22:50,13,9,8050,960,7090,12.28%,11.93%
2020-01-01 00:22:50,13,10,28117,5969,22148,42.90%,21.23%
2020-01-01 00:22:50,13,11,17526,2583,14943,26.74%,14.74%
2020-01-01 00:22:50,13,12,9320,1107,8213,14.22%,11.88%
2020-01-01 00:22:50,14,1,205,0,205,0.31%,0.00%
2020-01-01 00:22:50,14,2,1223,11,1212,1.87%,0.90%
2020-01-01 00:22:50,14,3,855,7,848,1.30%,0.82%
2020-01-01 00:22:50,14,4,4127,142,3985,6.30%,3.44%
2020-01-01 00:22:50,14,5,1087,7,1080,1.66%,0.64%
2020-01-01 00:22:50,14,6,4434,166,4268,6.77%,3.74%
2020-01-01 00:22:50,14,7,11581,947,10634,17.67%,8.18%
2020-01-01 00:22:50,14,8,13231,1259,11972,20.19%,9.52%
2020-01-01 00:22:50,14,9,1239,7,1232,1.89%,0.56%
2020-01-01 00:22:50,14,10,3742,101,3641,5.71%,2.70%
2020-01-01 00:22:50,14,11,25539,4382,21157,38.97%,17.16%
2020-01-01 00:22:50,14,12,8299,514,7785,12.66%,6.19%
2020-01-01 00:22:50,15,1,545,3,542,0.83%,0.55%
2020-01-01 00:22:50,15,2,126,0,126,0.19%,0.00%
2020-01-01 00:22:50,15,3,4375,163,4212,6.68%,3.73%
2020-01-01 00:22:50,15,4,4834,189,4645,7.38%,3.91%
2020-01-01 00:22:50,15,5,10011,753,9258,15.28%,7.52%
2020-01-01 00:22:50,15,6,5076,210,4866,7.75%,4.14%
2020-01-01 00:22:50,15,7,3433,70,3363,5.24%,2.04%
2020-01-01 00:22:50,15,8,5307,208,5099,8.10%,3.92%
2020-01-01 00:22:50,15,9,10225,785,9440,15.60%,7.68%
2020-01-01 00:22:50,15,10,5709,315,5394,8.71%,5.52%
2020-01-01 00:22:50,15,11,11111,964,10147,16.95%,8.68%
2020-01-01 00:22:50,15,12,26780,5170,21610,40.86%,19.31%
2020-01-01 00:22:50,16,1,507,3,504,0.77%,0.59%
2020-01-01 00:22:50,16,2,317,6,311,0.48%,1.89%
2020-01-01 00:22:50,16,3,1337,27,1310,2.04%,2.02%
2020-01-01 00:22:50,16,4,6469,325,6144,9.87%,5.02%
2020-01-01 00:22:50,16,5,9578,732,8846,14.61%,7.64%
2020-01-01 00:22:50,16,6,7165,390,6775,10.93%,5.44%
2020-01-01 00:22:50,16,7,3535,117,3418,5.39%,3.31%
2020-01-01 00:22:50,16,8,7635,518,7117,11.65%,6.78%
2020-01-01 00:22:50,16,9,10185,815,9370,15.54%,8.00%
2020-01-01 00:22:50,16,10,1420,14,1406,2.17%,0.99%
2020-01-01 00:22:50,16,11,9271,727,8544,14.15%,7.84%
2020-01-01 00:22:50,16,12,27508,5184,22324,41.97%,18.85%
2020-01-01 00:23:00,1,1,16413,1988,14425,25.04%,12.11%
2020-01-01 00:23:00,1,2,8249,488,7761,12.59%,5.92%
2020-01-01 00:23:00,1,3,504,3,501,0.77%,0.60%
2020-01-01 00:23:00,1,4,7733,494,7239,11.80%,6.39%
2020-01-01 00:23:00,1,5,7408,464,6944,11.30%,6.26%
2020-01-01 00:23:00,1,6,7294,447,6847,11.13%,6.13%
2020-01-01 00:23:00,1,7,7730,425,7305,11.80%,5.50%
2020-01-01 00:23:00,1,8,7000,332,6668,10.68%,4.74%
2020-01-01 00:23:00,1,9,7271,445,6826,11.09%,6.12%
2020-01-01 00:23:00,1,10,6325,278,6047,9.65%,4.40%
2020-01-01 00:23:00,1,11,6419,287,6132,9.79%,4.47%
2020-01-01 00:23:00,1,12,7201,438,6763,10.99%,6.08%
2020-01-01 00:23:00,2,1,958,7,951,1.46%,0.73%
2020-01-01 00:23:00,2,2,26406,4580,21826,40.29%,17.34%
2020-01-01 00:23:00,2,3,21822,3208,18614,33.30%,14.70%
2020-01-01 00:23:00,2,4,910,7,903,1.39%,0.77%
2020-01-01 00:23:00,2,5,12863,1111,11752,19.63%,8.64%
2020-01-01 00:23:00,2,6,50,0,50,0.08%,0.00%
2020-01-01 00:23:00,2,7,3588,100,3488,5.47%,2.79%
2020-01-01 00:23:00,2,8,2703,57,2646,4.12%,2.11%
2020-01-01 00:23:00,2,9,12715,1090,11625,19.40%,8.57%
2020-01-01 00:23:00,2,10,2040,32,2008,3.11%,1.57%
2020-01-01 00:23:00,2,11,2046,32,2014,3.12%,1.56%
2020-01-01 00:23:00,2,12,12542,1060,11482,19.14%,8.45%
2020-01-01 00:23:00,3,1,1781,16,1765,2.72%,0.90%
2020-01-01 00:23:00,3,2,22217,3419,18798,33.90%,15.39%
2020-01-01 00:23:00,3,3,69371,26386,42985,105.85%,38.04%
2020-01-01 00:23:00,3,4,6360,310,6050,9.70%,4.87%
2020-01-01 00:23:00,3,5,43591,11622,31969,66.51%,26.66%
2020-01-01 00:23:00,3,6,7729,436,7293,11.79%,5.64%
2020-01-01 00:23:00,3,7,18753,2492,16261,28.61%,13.29%
2020-01-01 00:23:00,3,8,14665,1544,13121,22.38%,10.53%
2020-01-01 00:23:00,3,9,35463,7901,27562,54.11%,22.28%
2020-01-01 00:23:00,3,10,6152,343,5809,9.39%,5.58%
2020-01-01 00:23:00,3,11,1456,18,1438,2.22%,1.24%
2020-01-01 00:23:00,3,12,25722,4240,21482,39.25%,16.48%
2020-01-01 00:23:00,4,1,545,3,542,0.83%,0.55%
2020-01-01 00:23:00,4,2,349,1,348,0.53%,0.29%
2020-01-01 00:23:00,4,3,706,2,704,1.08%,0.28%
2020-01-01 00:23:00,4,4,27449,4961,22488,41.88%,18.07%
2020-01-01 00:23:00,4,5,17100,2004,15096,26.09%,11.72%
2020-01-01 00:23:00,4,6,23786,3787,19999,36.29%,15.92%
2020-01-01 00:23:00,4,7,5423,224,5199,8.27%,4.13%
2020-01-01 00:23:00,4,8,3050,77,2973,4.65%,2.52%
2020-01-01 00:23:00,4,9,15273,1634,13639,23.30%,10.70%
2020-01-01 00:23:00,4,10,1855,21,1834,2.83%,1.13%
2020-01-01 00:23:00,4,11,168,0,168,0.26%,0.00%
2020-01-01 00:23:00,4,12,12441,1119,11322,18.98%,8.99%
2020-01-01 00:23:00,5,1,3575,86,3489,5.46%,2.41%
2020-01-01 00:23:00,5,2,668,2,666,1.02%,0.30%
2020-01-01 00:23:00,5,3,492,0,492,0.75%,0.00%
2020-01-01 00:23:00,5,4,28136,5221,22915,42.93%,18.56%
2020-01-01 00:23:00,5,5,9741,668,9073,14.86%,6.86%
2020-01-01 00:23:00,5,6,15748,1730,14018,24.03%,10.99%
2020-01-01 00:23:00,5,7,5403,209,5194,8.24%,3.87%
2020-01-01 00:23:00,5,8,4349,137,4212,6.64%,3.15%
2020-01-01 00:23:00,5,9,8765,542,8223,13.37%,6.18%
2020-01-01 00:23:00,5,10,770,5,765,1.17%,0.65%
2020-01-01 00:23:00,5,11,659,9,650,1.01%,1.37%
2020-01-01 00:23:00,5,12,7745,424,7321,11.82%,5.47%
2020-01-01 00:23:00,6,1,921,3,918,1.41%,0.33%
2020-01-01 00:23:00,6,2,1001,4,997,1.53%,0.40%
2020-01-01 00:23:00,6,3,1534,17,1517,2.34%,1.11%
2020-01-01 00:23:00,6,4,993,13,980,1.52%,1.31%
2020-01-01 00:23:00,6,5,14479,1509,12970,22.09%,10.42%
2020-01-01 00:23:00,6,6,4482,171,4311,6.84%,3.82%
2020-01-01 00:23:00,6,7,2960,69,2891,4.52%,2.33%
2020-01-01 00:23:00,6,8,2208,39,2169,3.37%,1.77%
2020-01-01 00:23:00,6,9,8141,482,7659,12.42%,5.92%
2020-01-01 00:23:00,6,10,2076,31,2045,3.17%,1.49%
2020-01-01 00:23:00,6,11,416,6,410,0.63%,1.44%
2020-01-01 00:23:00,6,12,5991,273,5718,9.14%,4.56%
2020-01-01 00:23:00,7,1,608,6,602,0.93%,0.99%
2020-01-01 00:23:00,7,2,120,0,120,0.18%,0.00%
2020-01-01 00:23:00,7,3,650,3,647,0.99%,0.46%
2020-01-01 00:23:00,7,4,1700,27,1673,2.59%,1.59%
2020-01-01 00:23:00,7,5,7210,418,6792,11.00%,5.80%
2020-01-01 00:23:00,7,6,12589,1178,11411,19.21%,9.36%
2020-01-01 00:23:00,7,7,3632,107,3525,5.54%,2.95%
2020-01-01 00:23:00,7,8,1241,25,1216,1.89%,2.01%
2020-01-01 00:23:00,7,9,6491,339,6152,9.90%,5.22%
2020-01-01 00:23:00,7,10,1623,28,1595,2.48%,1.73%
2020-01-01 00:23:00,7,11,119,0,119,0.18%,0.00%
2020-01-01 00:23:00,7,12,4868,204,4664,7.43%,4.19%
2020-01-01 00:23:00,8,1,379,1,378,0.58%,0.26%
2020-01-01 00:23:00,8,2,91,0,91,0.14%,0.00%
2020-01-01 00:23:00,8,3,1446,13,1433,2.21%,0.90%
2020-01-01 00:23:00,8,4,3074,85,2989,4.69%,2.77%
2020-01-01 00:23:00,8,5,7985,490,7495,12.18%,6.14%
2020-01-01 00:23:00,8,6,20172,2972,17200,30.78%,14.73%
2020-01-01 00:23:00,8,7,9019,618,8401,13.76%,6.85%
2020-01-01 00:23:00,8,8,5657,246,5411,8.63%,4.35%
2020-01-01 00:23:00,8,9,6280,304,5976,9.58%,4.84%
2020-01-01 00:23:00,8,10,1970,25,1945,3.01%,1.27%
2020-01-01 00:23:00,8,11,256,1,255,0.39%,0.39%
2020-01-01 00:23:00,8,12,4299,136,4163,6.56%,3.16%
2020-01-01 00:23:00,9,1,615,0,615,0.94%,0.00%
2020-01-01 00:23:00,9,2,4575,168,4407,6.98%,3.67%
2020-01-01 00:23:00,9,3,3619,119,3500,5.52%,3.29%
2020-01-01 00:23:00,9,4,7258,363,6895,11.07%,5.00%
2020-01-01 00:23:00,9,5,527,1,526,0.80%,0.19%
2020-01-01 00:23:00,9,6,8426,491,7935,12.86%,5.83%
2020-01-01 00:23:00,9,7,33186,7051,26135,50.64%,21.25%
2020-01-01 00:23:00,9,8,12937,1189,11748,19.74%,9.19%
2020-01-01 00:23:00,9,9,448,1,447,0.68%,0.22%
2020-01-01 00:23:00,9,10,5919,233,5686,9.03%,3.94%
2020-01-01 00:23:00,9,11,11733,1011,10722,17.90%,8.62%
2020-01-01 00:23:00,9,12,5477,236,5241,8.36%,4.31%
2020-01-01 00:23:00,10,1,1162,254,908,1.77%,21.86%
2020-01-01 00:23:00,10,2,3884,369,3515,5.93%,9.50%
2020-01-01 00:23:00,10,3,2537,68,2469,3.87%,2.68%
2020-01-01 00:23:00,10,4,4203,989,3214,6.41%,23.53%
2020-01-01 00:23:00,10,5,546,31,515,0.83%,5.68%
2020-01-01 00:23:00,10,6,6496,1174,5322,9.91%,18.07%
2020-01-01 00:23:00,10,7,12357,2068,10289,18.86%,16.74%
2020-01-01 00:23:00,10,8,29008,7181,21827,44.26%,24.76%
2020-01-01 00:23:00,10,9,730,0,730,1.11%,0.00%
2020-01-01 00:23:00,10,10,2999,67,2932,4.58%,2.23%
2020-01-01 00:23:00,10,11,13254,1723,11531,20.22%,13.00%
2020-01-01 00:23:00,10,12,9571,1190,8381,14.60%,12.43%
2020-01-01 00:23:00,11,1,2928,64,2864,4.47%,2.19%
2020-01-01 00:23:00,11,2,4209,133,4076,6.42%,3.16%
2020-01-01 00:23:00,11,3,1128,11,1117,1.72%,0.98%
2020-01-01 00:23:00,11,4,3306,98,3208,5.04%,2.96%
2020-01-01 00:23:00,11,5,150,4,146,0.23%,2.67%
2020-01-01 00:23:00,11,6,4208,161,4047,6.42%,3.83%
2020-01-01 00:23:00,11,7,10560,813,9747,16.11%,7.70%
2020-01-01 00:23:00,11,8,24940,4192,20748,38.06%,16.81%
2020-01-01 00:23:00,11,9,230,1,229,0.35%,0.43%
2020-01-01 00:23:00,11,10,3248,73,3175,4.96%,2.25%
2020-01-01 00:23:00,11,11,10622,815,9807,16.21%,7.67%
2020-01-01 00:23:00,11,12,6943,390,6553,10.59%,5.62%
2020-01-01 00:23:00,12,1,50,0,50,0.08%,0.00%
2020-01-01 00:23:00,12,2,730,197,533,1.11%,26.99%
2020-01-01 00:23:00,12,3,2216,219,1997,3.38%,9.88%
2020-01-01 00:23:00,12,4,3782,106,3676,5.77%,2.80%
2020-01-01 00:23:00,12,5,8924,718,8206,13.62%,8.05%
2020-01-01 00:23:00,12,6,5881,218,5663,8.97%,3.71%
2020-01-01 00:23:00,12,7,1933,24,1909,2.95%,1.24%
2020-01-01 00:23:00,12,8,1432,177,1255,2.19%,12.36%
2020-01-01 00:23:00,12,9,22308,4220,18088,34.04%,18.92%
2020-01-01 00:23:00,12,10,4331,316,4015,6.61%,7.30%
2020-01-01 00:23:00,12,11,1693,186,1507,2.58%,10.99%
2020-01-01 00:23:00,12,12,8410,1071,7339,12.83%,12.73%
2020-01-01 00:23:00,13,1,2296,34,2262,3.50%,1.48%
2020-01-01 00:23:00,13,2,2573,40,2533,3.93%,1.55%
2020-01-01 00:23:00,13,3,563,1,562,0.86%,0.18%
2020-01-01 00:23:00,13,4,4737,509,4228,7.23%,10.75%
2020-01-01 00:23:00,13,5,6744,747,5997,10.29%,11.08%
2020-01-01 00:23:00,13,6,5560,568,4992,8.48%,10.22%
2020-01-01 00:23:00,13,7,5077,180,4897,7.75%,3.55%
2020-01-01 00:23:00,13,8,7714,431,7283,11.77%,5.59%
2020-01-01 00:23:00,13,9,7071,774,6297,10.79%,10.95%
2020-01-01 00:23:00,13,10,27078,5519,21559,41.32%,20.38%
2020-01-01 00:23:00,13,11,17404,2534,14870,26.56%,14.56%
2020-01-01 00:23:00,13,12,9167,1120,8047,13.99%,12.22%
2020-01-01 00:23:00,14,1,193,0,193,0.29%,0.00%
2020-01-01 00:23:00,14,2,1281,17,1264,1.95%,1.33%
2020-01-01 00:23:00,14,3,937,6,931,1.43%,0.64%
2020-01-01 00:23:00,14,4,4139,129,4010,6.32%,3.12%
2020-01-01 00:23:00,14,5,1337,16,1321,2.04%,1.20%
2020-01-01 00:23:00,14,6,4398,152,4246,6.71%,3.46%
2020-01-01 00:23:00,14,7,11592,985,10607,17.69%,8.50%
2020-01-01 00:23:00,14,8,13012,1214,11798,19.85%,9.33%
2020-01-01 00:23:00,14,9,1629,25,1604,2.49%,1.53%
2020-01-01 00:23:00,14,10,4194,128,4066,6.40%,3.05%
2020-01-01 00:23:00,14,11,25279,4382,20897,38.57%,17.33%
2020-01-01 00:23:00,14,12,7848,480,7368,11.98%,6.12%
2020-01-01 00:23:00,15,1,524,5,519,0.80%,0.95%
2020-01-01 00:23:00,15,2,163,1,162,0.25%,0.61%
2020-01-01 00:23:00,15,3,3944,132,3812,6.02%,3.35%
2020-01-01 00:23:00,15,4,6763,377,6386,10.32%,5.57%
2020-01-01 00:23:00,15,5,11305,969,10336,17.25%,8.57%
2020-01-01 00:23:00,15,6,7009,397,6612,10.69%,5.66%
2020-01-01 00:23:00,15,7,3670,103,3567,5.60%,2.81%
2020-01-01 00:23:00,15,8,5279,225,5054,8.06%,4.26%
2020-01-01 00:23:00,15,9,11578,1018,10560,17.67%,8.79%
2020-01-01 00:23:00,15,10,4128,112,4016,6.30%,2.71%
2020-01-01 00:23:00,15,11,9509,651,8858,14.51%,6.85%
2020-01-01 00:23:00,15,12,26784,5093,21691,40.87%,19.02%
2020-01-01 00:23:00,16,1,482,2,480,0.74%,0.41%
2020-01-01 00:23:00,16,2,315,0,315,0.48%,0.00%
2020-01-01 00:23:00,16,3,1205,8,1197,1.84%,0.66%
2020-01-01 00:23:00,16,4,4696,170,4526,7.17%,3.62%
2020-01-01 00:23:00,16,5,7771,517,7254,11.86%,6.65%
2020-01-01 00:23:00,16,6,5358,215,5143,8.18%,4.01%
2020-01-01 00:23:00,16,7,4118,138,3980,6.28%,3.35%
2020-01-01 00:23:00,16,8,7875,523,7352,12.02%,6.64%
2020-01-01 00:23:00,16,9,8226,566,7660,12.55%,6.88%
2020-01-01 00:23:00,16,10,1839,35,1804,2.81%,1.90%
2020-01-01 00:23:00,16,11,9910,785,9125,15.12%,7.92%
2020-01-01 00:23:00,16,12,26306,4788,21518,40.14%,18.20%
2020-01-01 00:23:10,1,1,20664,2975,17689,31.53%,14.40%
2020-01-01 00:23:10,1,2,7914,456,7458,12.08%,5.76%
2020-01-01 00:23:10,1,3,550,5,545,0.84%,0.91%
2020-01-01 00:23:10,1,4,12453,1164,11289,19.00%,9.35%
2020-01-01 00:23:10,1,5,12113,1113,11000,18.48%,9.19%
2020-01-01 00:23:10,1,6,12047,1100,10947,18.38%,9.13%
2020-01-01 00:23:10,1,7,7337,395,6942,11.20%,5.38%
2020-01-01 00:23:10,1,8,6683,317,6366,10.20%,4.74%
2020-01-01 00:23:10,1,9,11938,1080,10858,18.22%,9.05%
2020-01-01 00:23:10,1,10,5994,259,5735,9.15%,4.32%
2020-01-01 00:23:10,1,11,6059,265,5794,9.25%,4.37%
2020-01-01 00:23:10,1,12,11910,1078,10832,18.17%,9.05%
2020-01-01 00:23:10,2,1,786,4,782,1.20%,0.51%
2020-01-01 00:23:10,2,2,28288,5445,22843,43.16%,19.25%
2020-01-01 00:23:10,2,3,23260,3789,19471,35.49%,16.29%
2020-01-01 00:23:10,2,4,742,3,739,1.13%,0.40%
2020-01-01 00:23:10,2,5,15020,1663,13357,22.92%,11.07%
2020-01-01 00:23:10,2,6,40,0,40,0.06%,0.00%
2020-01-01 00:23:10,2,7,4217,145,4072,6.43%,3.44%
2020-01-01 00:23:10,2,8,3258,89,3169,4.97%,2.73%
2020-01-01 00:23:10,2,9,14954,1653,13301,22.82%,11.05%
2020-01-01 00:23:10,2,10,2491,52,2439,3.80%,2.09%
2020-01-01 00:23:10,2,11,2496,53,2443,3.81%,2.12%
2020-01-01 00:23:10,2,12,14767,1616,13151,22.53%,10.94%
2020-01-01 00:23:10,3,1,1578,13,1565,2.41%,0.82%
2020-01-01 00:23:10,3,2,25946,4375,21571,39.59%,16.86%
2020-01-01 00:23:10,3,3,70903,27407,43496,108.19%,38.65%
2020-01-01 00:23:10,3,4,8042,460,7582,12.27%,5.72%
2020-01-01 00:23:10,3,5,43319,11522,31797,66.10%,26.60%
2020-01-01 00:23:10,3,6,9516,653,8863,14.52%,6.86%
2020-01-01 00:23:10,3,7,22520,3348,19172,34.36%,14.87%
2020-01-01 00:23:10,3,8,16988,1937,15051,25.92%,11.40%
2020-01-01 00:23:10,3,9,33461,7178,26283,51.06%,21.45%
2020-01-01 00:23:10,3,10,6737,320,6417,10.28%,4.75%
2020-01-01 00:23:10,3,11,1566,14,1552,2.39%,0.89%
2020-01-01 00:23:10,3,12,24070,3876,20194,36.73%,16.10%
2020-01-01 00:23:10,4,1,462,1,461,0.70%,0.22%
2020-01-01 00:23:10,4,2,266,1,265,0.41%,0.38%
2020-01-01 00:23:10,4,3,755,10,745,1.15%,1.32%
2020-01-01 00:23:10,4,4,26459,4688,21771,40.37%,17.72%
2020-01-01 00:23:10,4,5,16405,1886,14519,25.03%,11.50%
2020-01-01 00:23:10,4,6,22958,3584,19374,35.03%,15.61%
2020-01-01 00:23:10,4,7,5304,207,5097,8.09%,3.90%
2020-01-01 00:23:10,4,8,3054,75,2979,4.66%,2.46%
2020-01-01 00:23:10,4,9,14641,1513,13128,22.34%,10.33%
2020-01-01 00:23:10,4,10,1946,19,1927,2.97%,0.98%
2020-01-01 00:23:10,4,11,106,0,106,0.16%,0.00%
2020-01-01 00:23:10,4,12,12108,1075,11033,18.48%,8.88%
2020-01-01 00:23:10,5,1,2883,57,2826,4.40%,1.98%
2020-01-01 00:23:10,5,2,899,10,889,1.37%,1.11%
2020-01-01 00:23:10,5,3,1037,8,1029,1.58%,0.77%
2020-01-01 00:23:10,5,4,28624,5448,23176,43.68%,19.03%
2020-01-01 00:23:10,5,5,10463,802,9661,15.97%,7.67%
2020-01-01 00:23:10,5,6,15942,1814,14128,24.33%,11.38%
2020-01-01 00:23:10,5,7,5003,196,4807,7.63%,3.92%
2020-01-01 00:23:10,5,8,3514,96,3418,5.36%,2.73%
2020-01-01 00:23:10,5,9,9141,625,8516,13.95%,6.84%
2020-01-01 00:23:10,5,10,924,10,914,1.41%,1.08%
2020-01-01 00:23:10,5,11,761,6,755,1.16%,0.79%
2020-01-01 00:23:10,5,12,7909,499,7410,12.07%,6.31%
2020-01-01 00:23:10,6,1,1076,5,1071,1.64%,0.46%
2020-01-01 00:23:10,6,2,1194,7,1187,1.82%,0.59%
2020-01-01 00:23:10,6,3,1599,15,1584,2.44%,0.94%
2020-01-01 00:23:10,6,4,1063,9,1054,1.62%,0.85%
2020-01-01 00:23:10,6,5,16042,1854,14188,24.48%,11.56%
2020-01-01 00:23:10,6,6,4438,171,4267,6.77%,3.85%
2020-01-01 00:23:10,6,7,2776,68,2708,4.24%,2.45%
2020-01-01 00:23:10,6,8,2237,41,2196,3.41%,1.83%
2020-01-01 00:23:10,6,9,9617,670,8947,14.67%,6.97%
2020-01-01 00:23:10,6,10,2285,35,2250,3.49%,1.53%
2020-01-01 00:23:10,6,11,404,3,401,0.62%,0.74%
2020-01-01 00:23:10,6,12,7270,401,6869,11.09%,5.52%
2020-01-01 00:23:10,7,1,466,1,465,0.71%,0.21%
2020-01-01 00:23:10,7,2,105,0,105,0.16%,0.00%
2020-01-01 00:23:10,7,3,691,4,687,1.05%,0.58%
2020-01-01 00:23:10,7,4,2012,24,1988,3.07%,1.19%
2020-01-01 00:23:10,7,5,7304,352,6952,11.15%,4.82%
2020-01-01 00:23:10,7,6,12348,1037,11311,18.84%,8.40%
2020-01-01 00:23:10,7,7,2979,71,2908,4.55%,2.38%
2020-01-01 00:23:10,7,8,1059,13,1046,1.62%,1.23%
2020-01-01 00:23:10,7,9,6484,281,6203,9.89%,4.33%
2020-01-01 00:23:10,7,10,1153,7,1146,1.76%,0.61%
2020-01-01 00:23:10,7,11,82,0,82,0.13%,0.00%
2020-01-01 00:23:10,7,12,5334,198,5136,8.14%,3.71%
2020-01-01 00:23:10,8,1,535,3,532,0.82%,0.56%
2020-01-01 00:23:10,8,2,101,0,101,0.15%,0.00%
2020-01-01 00:23:10,8,3,1547,10,1537,2.36%,0.65%
2020-01-01 00:23:10,8,4,2735,60,2675,4.17%,2.19%
2020-01-01 00:23:10,8,5,7521,416,7105,11.48%,5.53%
2020-01-01 00:23:10,8,6,16004,1788,14216,24.42%,11.17%
2020-01-01 00:23:10,8,7,5675,221,5454,8.66%,3.89%
2020-01-01 00:23:10,8,8,2058,35,2023,3.14%,1.70%
2020-01-01 00:23:10,8,9,5708,253,5455,8.71%,4.43%
2020-01-01 00:23:10,8,10,1667,24,1643,2.54%,1.44%
2020-01-01 00:23:10,8,11,298,1,297,0.45%,0.34%
2020-01-01 00:23:10,8,12,4056,132,3924,6.19%,3.25%
2020-01-01 00:23:10,9,1,343,1,342,0.52%,0.29%
2020-01-01 00:23:10,9,2,2730,65,2665,4.17%,2.38%
2020-01-01 00:23:10,9,3,2050,38,2012,3.13%,1.85%
2020-01-01 00:23:10,9,4,6335,294,6041,9.67%,4.64%
2020-01-01 00:23:10,9,5,562,2,560,0.86%,0.36%
2020-01-01 00:23:10,9,6,7529,428,7101,11.49%,5.68%
2020-01-01 00:23:10,9,7,27604,5040,22564,42.12%,18.26%
2020-01-01 00:23:10,9,8,10494,726,9768,16.01%,6.92%
2020-01-01 00:23:10,9,9,460,1,459,0.70%,0.22%
2020-01-01 00:23:10,9,10,2927,45,2882,4.47%,1.54%
2020-01-01 00:23:10,9,11,8075,433,7642,12.32%,5.36%
2020-01-01 00:23:10,9,12,4907,167,4740,7.49%,3.40%
2020-01-01 00:23:10,10,1,1279,251,1028,1.95%,19.62%
2020-01-01 00:23:10,10,2,2849,291,2558,4.35%,10.21%
2020-01-01 00:23:10,10,3,1370,12,1358,2.09%,0.88%
2020-01-01 00:23:10,10,4,5313,752,4561,8.11%,14.15%
2020-01-01 00:23:10,10,5,580,4,576,0.89%,0.69%
2020-01-01 00:23:10,10,6,7295,933,6362,11.13%,12.79%
2020-01-01 00:23:10,10,7,12183,1778,10405,18.59%,14.59%
2020-01-01 00:23:10,10,8,29613,7348,22265,45.19%,24.81%
2020-01-01 00:23:10,10,9,596,4,592,0.91%,0.67%
2020-01-01 00:23:10,10,10,2602,46,2556,3.97%,1.77%
2020-01-01 00:23:10,10,11,13431,1738,11693,20.49%,12.94%
2020-01-01 00:23:10,10,12,10221,1251,8970,15.60%,12.24%
2020-01-01 00:23:10,11,1,2599,69,2530,3.97%,2.65%
2020-01-01 00:23:10,11,2,3662,114,3548,5.59%,3.11%
2020-01-01 00:23:10,11,3,954,5,949,1.46%,0.52%
2020-01-01 00:23:10,11,4,5901,253,5648,9.00%,4.29%
2020-01-01 00:23:10,11,5,153,0,153,0.23%,0.00%
2020-01-01 00:23:10,11,6,6702,330,6372,10.23%,4.92%
2020-01-01 00:23:10,11,7,12417,1139,11278,18.95%,9.17%
2020-01-01 00:23:10,11,8,25739,4460,21279,39.27%,17.33%
2020-01-01 00:23:10,11,9,316,2,314,0.48%,0.63%
2020-01-01 00:23:10,11,10,3021,76,2945,4.61%,2.52%
2020-01-01 00:23:10,11,11,10235,793,9442,15.62%,7.75%
2020-01-01 00:23:10,11,12,6799,355,6444,10.37%,5.22%
2020-01-01 00:23:10,12,1,87,0,87,0.13%,0.00%
2020-01-01 00:23:10,12,2,743,215,528,1.13%,28.94%
2020-01-01 00:23:10,12,3,2478,246,2232,3.78%,9.93%
2020-01-01 00:23:10,12,4,4213,155,4058,6.43%,3.68%
2020-01-01 00:23:10,12,5,10060,924,9136,15.35%,9.18%
2020-01-01 00:23:10,12,6,6687,363,6324,10.20%,5.43%
2020-01-01 00:23:10,12,7,2349,52,2297,3.58%,2.21%
2020-01-01 00:23:10,12,8,1332,231,1101,2.03%,17.34%
2020-01-01 00:23:10,12,9,22596,4585,18011,34.48%,20.29%
2020-01-01 00:23:10,12,10,4000,341,3659,6.10%,8.53%
2020-01-01 00:23:10,12,11,1494,237,1257,2.28%,15.86%
2020-01-01 00:23:10,12,12,7955,1252,6703,12.14%,15.74%
2020-01-01 00:23:10,13,1,2712,47,2665,4.14%,1.73%
2020-01-01 00:23:10,13,2,3041,61,2980,4.64%,2.01%
2020-01-01 00:23:10,13,3,585,1,584,0.89%,0.17%
2020-01-01 00:23:10,13,4,4771,378,4393,7.28%,7.92%
2020-01-01 00:23:10,13,5,6880,604,6276,10.50%,8.78%
2020-01-01 00:23:10,13,6,5566,428,5138,8.49%,7.69%
2020-01-01 00:23:10,13,7,5848,272,5576,8.92%,4.65%
2020-01-01 00:23:10,13,8,8145,511,7634,12.43%,6.27%
2020-01-01 00:23:10,13,9,7160,638,6522,10.93%,8.91%
2020-01-01 00:23:10,13,10,27098,5491,21607,41.35%,20.26%
2020-01-01 00:23:10,13,11,17467,2553,14914,26.65%,14.62%
2020-01-01 00:23:10,13,12,8893,1049,7844,13.57%,11.80%
2020-01-01 00:23:10,14,1,364,1,363,0.56%,0.27%
2020-01-01 00:23:10,14,2,1646,30,1616,2.51%,1.82%
2020-01-01 00:23:10,14,3,1080,12,1068,1.65%,1.11%
2020-01-01 00:23:10,14,4,4255,137,4118,6.49%,3.22%
2020-01-01 00:23:10,14,5,1513,16,1497,2.31%,1.06%
2020-01-01 00:23:10,14,6,4443,152,4291,6.78%,3.42%
2020-01-01 00:23:10,14,7,11930,1084,10846,18.20%,9.09%
2020-01-01 00:23:10,14,8,13380,1327,12053,20.42%,9.92%
2020-01-01 00:23:10,14,9,1691,19,1672,2.58%,1.12%
2020-01-01 00:23:10,14,10,3956,125,3831,6.04%,3.16%
2020-01-01 00:23:10,14,11,25174,4382,20792,38.41%,17.41%
2020-01-01 00:23:10,14,12,7534,446,7088,11.50%,5.92%
2020-01-01 00:23:10,15,1,619,3,616,0.94%,0.48%
2020-01-01 00:23:10,15,2,215,2,213,0.33%,0.93%
2020-01-01 00:23:10,15,3,4094,120,3974,6.25%,2.93%
2020-01-01 00:23:10,15,4,4790,228,4562,7.31%,4.76%
2020-01-01 00:23:10,15,5,10112,788,9324,15.43%,7.79%
2020-01-01 00:23:10,15,6,5036,244,4792,7.68%,4.85%
2020-01-01 00:23:10,15,7,3860,115,3745,5.89%,2.98%
2020-01-01 00:23:10,15,8,5304,210,5094,8.09%,3.96%
2020-01-01 00:23:10,15,9,10346,821,9525,15.79%,7.94%
2020-01-01 00:23:10,15,10,5905,257,5648,9.01%,4.35%
2020-01-01 00:23:10,15,11,11335,951,10384,17.30%,8.39%
2020-01-01 00:23:10,15,12,27520,5313,22207,41.99%,19.31%
2020-01-01 00:23:10,16,1,379,2,377,0.58%,0.53%
2020-01-01 00:23:10,16,2,282,0,282,0.43%,0.00%
2020-01-01 00:23:10,16,3,1143,9,1134,1.74%,0.79%
2020-01-01 00:23:10,16,4,4576,146,4430,6.98%,3.19%
2020-01-01 00:23:10,16,5,7868,518,7350,12.01%,6.58%
2020-01-01 00:23:10,16,6,5489,215,5274,8.38%,3.92%
2020-01-01 00:23:10,16,7,3313,70,3243,5.06%,2.11%
2020-01-01 00:23:10,16,8,7322,515,6807,11.17%,7.03%
2020-01-01 00:23:10,16,9,8214,550,7664,12.53%,6.70%
2020-01-01 00:23:10,16,10,1550,9,1541,2.37%,0.58%
2020-01-01 00:23:10,16,11,9026,736,8290,13.77%,8.15%
2020-01-01 00:23:10,16,12,25223,4536,20687,38.49%,17.98%
2020-01-01 00:23:20,1,1,19651,2684,16967,29.99%,13.66%
2020-01-01 00:23:20,1,2,7181,362,6819,10.96%,5.04%
2020-01-01 00:23:20,1,3,468,0,468,0.71%,0.00%
2020-01-01 00:23:20,1,4,12118,1116,11002,18.49%,9.21%
2020-01-01 00:23:20,1,5,11817,1064,10753,18.03%,9.00%
2020-01-01 00:23:20,1,6,11730,1045,10685,17.90%,8.91%
2020-01-01 00:23:20,1,7,6695,318,6377,10.22%,4.75%
2020-01-01 00:23:20,1,8,5393,215,5178,8.23%,3.99%
2020-01-01 00:23:20,1,9,11687,1036,10651,17.83%,8.86%
2020-01-01 00:23:20,1,10,4593,158,4435,7.01%,3.44%
2020-01-01 00:23:20,1,11,4651,161,4490,7.10%,3.46%
2020-01-01 00:23:20,1,12,11630,1025,10605,17.75%,8.81%
2020-01-01 00:23:20,2,1,749,4,745,1.14%,0.53%
2020-01-01 00:23:20,2,2,26277,4546,21731,40.10%,17.30%
2020-01-01 00:23:20,2,3,21076,3043,18033,32.16%,14.44%
2020-01-01 00:23:20,2,4,641,3,638,0.98%,0.47%
2020-01-01 00:23:20,2,5,12199,1100,11099,18.61%,9.02%
2020-01-01 00:23:20,2,6,32,0,32,0.05%,0.00%
2020-01-01 00:23:20,2,7,4422,142,4280,6.75%,3.21%
2020-01-01 00:23:20,2,8,3244,76,3168,4.95%,2.34%
2020-01-01 00:23:20,2,9,12144,1096,11048,18.53%,9.03%
2020-01-01 00:23:20,2,10,2433,38,2395,3.71%,1.56%
2020-01-01 00:23:20,2,11,2442,39,2403,3.73%,1.60%
2020-01-01 00:23:20,2,12,11935,1066,10869,18.21%,8.93%
2020-01-01 00:23:20,3,1,1535,28,1507,2.34%,1.82%
2020-01-01 00:23:20,3,2,25953,4557,21396,39.60%,17.56%
2020-01-01 00:23:20,3,3,72494,28617,43877,110.62%,39.47%
2020-01-01 00:23:20,3,4,8732,542,8190,13.32%,6.21%
2020-01-01 00:23:20,3,5,45224,12527,32697,69.01%,27.70%
2020-01-01 00:23:20,3,6,10266,765,9501,15.66%,7.45%
2020-01-01 00:23:20,3,7,22729,3526,19203,34.68%,15.51%
2020-01-01 00:23:20,3,8,18198,2327,15871,27.77%,12.79%
2020-01-01 00:23:20,3,9,34595,7649,26946,52.79%,22.11%
2020-01-01 00:23:20,3,10,4854,170,4684,7.41%,3.50%
2020-01-01 00:23:20,3,11,1972,31,1941,3.01%,1.57%
2020-01-01 00:23:20,3,12,26441,4655,21786,40.35%,17.61%
2020-01-01 00:23:20,4,1,414,1,413,0.63%,0.24%
2020-01-01 00:23:20,4,2,238,0,238,0.36%,0.00%
2020-01-01 00:23:20,4,3,775,3,772,1.18%,0.39%
2020-01-01 00:23:20,4,4,27057,4950,22107,41.29%,18.29%
2020-01-01 00:23:20,4,5,17550,2233,15317,26.78%,12.72%
2020-01-01 00:23:20,4,6,23562,3860,19702,35.95%,16.38%
2020-01-01 00:23:20,4,7,4584,156,4428,6.99%,3.40%
2020-01-01 00:23:20,4,8,2715,46,2669,4.14%,1.69%
2020-01-01 00:23:20,4,9,15692,1810,13882,23.94%,11.53%
2020-01-01 00:23:20,4,10,1811,31,1780,2.76%,1.71%
2020-01-01 00:23:20,4,11,128,0,128,0.20%,0.00%
2020-01-01 00:23:20,4,12,13118,1300,11818,20.02%,9.91%
2020-01-01 00:23:20,5,1,2733,54,2679,4.17%,1.98%
2020-01-01 00:23:20,5,2,969,9,960,1.48%,0.93%
2020-01-01 00:23:20,5,3,717,6,711,1.09%,0.84%
2020-01-01 00:23:20,5,4,25401,4369,21032,38.76%,17.20%
2020-01-01 00:23:20,5,5,11243,930,10313,17.16%,8.27%
2020-01-01 00:23:20,5,6,17330,2171,15159,26.44%,12.53%
2020-01-01 00:23:20,5,7,5644,253,5391,8.61%,4.48%
2020-01-01 00:23:20,5,8,4230,145,4085,6.45%,3.43%
2020-01-01 00:23:20,5,9,9781,714,9067,14.92%,7.30%
2020-01-01 00:23:20,5,10,1084,10,1074,1.65%,0.92%
2020-01-01 00:23:20,5,11,991,11,980,1.51%,1.11%
2020-01-01 00:23:20,5,12,8296,520,7776,12.66%,6.27%
2020-01-01 00:23:20,6,1,1103,8,1095,1.68%,0.73%
2020-01-01 00:23:20,6,2,1206,10,1196,1.84%,0.83%
2020-01-01 00:23:20,6,3,1849,21,1828,2.82%,1.14%
2020-01-01 00:23:20,6,4,1065,8,1057,1.63%,0.75%
2020-01-01 00:23:20,6,5,15244,1672,13572,23.26%,10.97%
2020-01-01 00:23:20,6,6,3586,92,3494,5.47%,2.57%
2020-01-01 00:23:20,6,7,1910,33,1877,2.91%,1.73%
2020-01-01 00:23:20,6,8,1251,20,1231,1.91%,1.60%
2020-01-01 00:23:20,6,9,9414,663,8751,14.36%,7.04%
2020-01-01 00:23:20,6,10,2126,32,2094,3.24%,1.51%
2020-01-01 00:23:20,6,11,363,0,363,0.55%,0.00%
2020-01-01 00:23:20,6,12,7238,414,6824,11.04%,5.72%
2020-01-01 00:23:20,7,1,524,2,522,0.80%,0.38%
2020-01-01 00:23:20,7,2,94,0,94,0.14%,0.00%
2020-01-01 00:23:20,7,3,994,3,991,1.52%,0.30%
2020-01-01 00:23:20,7,4,1898,16,1882,2.90%,0.84%
2020-01-01 00:23:20,7,5,8045,456,7589,12.28%,5.67%
2020-01-01 00:23:20,7,6,13104,1262,11842,20.00%,9.63%
2020-01-01 00:23:20,7,7,3100,83,3017,4.73%,2.68%
2020-01-01 00:23:20,7,8,1010,9,1001,1.54%,0.89%
2020-01-01 00:23:20,7,9,6910,356,6554,10.54%,5.15%
2020-01-01 00:23:20,7,10,1629,19,1610,2.49%,1.17%
2020-01-01 00:23:20,7,11,91,0,91,0.14%,0.00%
2020-01-01 00:23:20,7,12,5251,208,5043,8.01%,3.96%
2020-01-01 00:23:20,8,1,373,0,373,0.57%,0.00%
2020-01-01 00:23:20,8,2,80,0,80,0.12%,0.00%
2020-01-01 00:23:20,8,3,1583,29,1554,2.42%,1.83%
2020-01-01 00:23:20,8,4,2833,50,2783,4.32%,1.76%
2020-01-01 00:23:20,8,5,7626,435,7191,11.64%,5.70%
2020-01-01 00:23:20,8,6,15579,1785,13794,23.77%,11.46%
2020-01-01 00:23:20,8,7,5041,208,4833,7.69%,4.13%
2020-01-01 00:23:20,8,8,1663,24,1639,2.54%,1.44%
2020-01-01 00:23:20,8,9,5792,259,5533,8.84%,4.47%
2020-01-01 00:23:20,8,10,1775,34,1741,2.71%,1.92%
2020-01-01 00:23:20,8,11,251,0,251,0.38%,0.00%
2020-01-01 00:23:20,8,12,4025,112,3913,6.14%,2.78%
2020-01-01 00:23:20,9,1,299,1,298,0.46%,0.33%
2020-01-01 00:23:20,9,2,5201,184,5017,7.94%,3.54%
2020-01-01 00:23:20,9,3,4501,143,4358,6.87%,3.18%
2020-01-01 00:23:20,9,4,5256,205,5051,8.02%,3.90%
2020-01-01 00:23:20,9,5,221,0,221,0.34%,0.00%
2020-01-01 00:23:20,9,6,5978,263,5715,9.12%,4.40%
2020-01-01 00:23:20,9,7,28361,5278,23083,43.28%,18.61%
2020-01-01 00:23:20,9,8,11695,969,10726,17.85%,8.29%
2020-01-01 00:23:20,9,9,173,0,173,0.26%,0.00%
2020-01-01 00:23:20,9,10,3520,75,3445,5.37%,2.13%
2020-01-01 00:23:20,9,11,10360,762,9598,15.81%,7.36%
2020-01-01 00:23:20,9,12,6562,347,6215,10.01%,5.29%
2020-01-01 00:23:20,10,1,1396,252,1144,2.13%,18.05%
2020-01-01 00:23:20,10,2,2945,298,2647,4.49%,10.12%
2020-01-01 00:23:20,10,3,1322,18,1304,2.02%,1.36%
2020-01-01 00:23:20,10,4,4093,894,3199,6.25%,21.84%
2020-01-01 00:23:20,10,5,658,4,654,1.00%,0.61%
2020-01-01 00:23:20,10,6,5675,990,4685,8.66%,17.44%
2020-01-01 00:23:20,10,7,10531,1737,8794,16.07%,16.49%
2020-01-01 00:23:20,10,8,28133,6929,21204,42.93%,24.63%
2020-01-01 00:23:20,10,9,670,5,665,1.02%,0.75%
2020-01-01 00:23:20,10,10,2486,40,2446,3.79%,1.61%
2020-01-01 00:23:20,10,11,13736,1770,11966,20.96%,12.89%
2020-01-01 00:23:20,10,12,10713,1280,9433,16.35%,11.95%
2020-01-01 00:23:20,11,1,2334,44,2290,3.56%,1.89%
2020-01-01 00:23:20,11,2,3514,101,3413,5.36%,2.87%
2020-01-01 00:23:20,11,3,1058,9,1049,1.61%,0.85%
2020-01-01 00:23:20,11,4,4278,154,4124,6.53%,3.60%
2020-01-01 00:23:20,11,5,578,1,577,0.88%,0.17%
2020-01-01 00:23:20,11,6,5442,232,5210,8.30%,4.26%
2020-01-01 00:23:20,11,7,10897,877,10020,16.63%,8.05%
2020-01-01 00:23:20,11,8,26956,4873,22083,41.13%,18.08%
2020-01-01 00:23:20,11,9,262,1,261,0.40%,0.38%
2020-01-01 00:23:20,11,10,3041,61,2980,4.64%,2.01%
2020-01-01 00:23:20,11,11,12632,1148,11484,19.27%,9.09%
2020-01-01 00:23:20,11,12,9242,632,8610,14.10%,6.84%
2020-01-01 00:23:20,12,1,66,0,66,0.10%,0.00%
2020-01-01 00:23:20,12,2,771,244,527,1.18%,31.65%
2020-01-01 00:23:20,12,3,2769,291,2478,4.23%,10.51%
2020-01-01 00:23:20,12,4,3781,102,3679,5.77%,2.70%
2020-01-01 00:23:20,12,5,10174,997,9177,15.52%,9.80%
2020-01-01 00:23:20,12,6,6507,371,6136,9.93%,5.70%
2020-01-01 00:23:20,12,7,2620,41,2579,4.00%,1.56%
2020-01-01 00:23:20,12,8,1110,326,784,1.69%,29.37%
2020-01-01 00:23:20,12,9,22393,4577,17816,34.17%,20.44%
2020-01-01 00:23:20,12,10,3449,393,3056,5.26%,11.39%
2020-01-01 00:23:20,12,11,1358,329,1029,2.07%,24.23%
2020-01-01 00:23:20,12,12,7772,1180,6592,11.86%,15.18%
2020-01-01 00:23:20,13,1,2574,52,2522,3.93%,2.02%
2020-01-01 00:23:20,13,2,2898,64,2834,4.42%,2.21%
2020-01-01 00:23:20,13,3,831,9,822,1.27%,1.08%
2020-01-01 00:23:20,13,4,5605,506,5099,8.55%,9.03%
2020-01-01 00:23:20,13,5,7839,794,7045,11.96%,10.13%
2020-01-01 00:23:20,13,6,6277,563,5714,9.58%,8.97%
2020-01-01 00:23:20,13,7,5326,227,5099,8.13%,4.26%
2020-01-01 00:23:20,13,8,7305,424,6881,11.15%,5.80%
2020-01-01 00:23:20,13,9,8167,828,7339,12.46%,10.14%
2020-01-01 00:23:20,13,10,27918,5828,22090,42.60%,20.88%
2020-01-01 00:23:20,13,11,17402,2462,14940,26.55%,14.15%
2020-01-01 00:23:20,13,12,9651,1084,8567,14.73%,11.23%
2020-01-01 00:23:20,14,1,498,0,498,0.76%,0.00%
2020-01-01 00:23:20,14,2,1786,25,1761,2.73%,1.40%
2020-01-01 00:23:20,14,3,1035,12,1023,1.58%,1.16%
2020-01-01 00:23:20,14,4,4506,160,4346,6.88%,3.55%
2020-01-01 00:23:20,14,5,1458,15,1443,2.22%,1.03%
2020-01-01 00:23:20,14,6,4839,184,4655,7.38%,3.80%
2020-01-01 00:23:20,14,7,11879,1023,10856,18.13%,8.61%
2020-01-01 00:23:20,14,8,13731,1362,12369,20.95%,9.92%
2020-01-01 00:23:20,14,9,1659,19,1640,2.53%,1.15%
2020-01-01 00:23:20,14,10,4308,121,4187,6.57%,2.81%
2020-01-01 00:23:20,14,11,26098,4598,21500,39.82%,17.62%
2020-01-01 00:23:20,14,12,7818,433,7385,11.93%,5.54%
2020-01-01 00:23:20,15,1,464,1,463,0.71%,0.22%
2020-01-01 00:23:20,15,2,168,0,168,0.26%,0.00%
2020-01-01 00:23:20,15,3,3905,122,3783,5.96%,3.12%
2020-01-01 00:23:20,15,4,4980,210,4770,7.60%,4.22%
2020-01-01 00:23:20,15,5,11031,870,10161,16.83%,7.89%
2020-01-01 00:23:20,15,6,5226,225,5001,7.97%,4.31%
2020-01-01 00:23:20,15,7,3669,89,3580,5.60%,2.43%
2020-01-01 00:23:20,15,8,5842,266,5576,8.91%,4.55%
2020-01-01 00:23:20,15,9,11224,899,10325,17.13%,8.01%
2020-01-01 00:23:20,15,10,6412,350,6062,9.78%,5.46%
2020-01-01 00:23:20,15,11,12359,1212,11147,18.86%,9.81%
2020-01-01 00:23:20,15,12,29049,5775,23274,44.33%,19.88%
2020-01-01 00:23:20,16,1,410,0,410,0.63%,0.00%
2020-01-01 00:23:20,16,2,268,0,268,0.41%,0.00%
2020-01-01 00:23:20,16,3,1396,27,1369,2.13%,1.93%
2020-01-01 00:23:20,16,4,3870,91,3779,5.91%,2.35%
2020-01-01 00:23:20,16,5,7524,499,7025,11.48%,6.63%
2020-01-01 00:23:20,16,6,4790,150,4640,7.31%,3.13%
2020-01-01 00:23:20,16,7,3204,58,3146,4.89%,1.81%
2020-01-01 00:23:20,16,8,7692,478,7214,11.74%,6.21%
2020-01-01 00:23:20,16,9,7925,540,7385,12.09%,6.81%
2020-01-01 00:23:20,16,10,1706,33,1673,2.60%,1.93%
2020-01-01 00:23:20,16,11,9607,726,8881,14.66%,7.56%
2020-01-01 00:23:20,16,12,26231,4726,21505,40.03%,18.02%
2020-01-01 00:23:30,1,1,19296,2568,16728,29.44%,13.31%
2020-01-01 00:23:30,1,2,4522,136,4386,6.90%,3.01%
2020-01-01 00:23:30,1,3,420,3,417,0.64%,0.71%
2020-01-01 00:23:30,1,4,14288,1453,12835,21.80%,10.17%
2020-01-01 00:23:30,1,5,13983,1391,12592,21.34%,9.95%
2020-01-01 00:23:30,1,6,13967,1388,12579,21.31%,9.94%
2020-01-01 00:23:30,1,7,4079,106,3973,6.22%,2.60%
2020-01-01 00:23:30,1,8,2815,48,2767,4.30%,1.71%
2020-01-01 00:23:30,1,9,13899,1375,12524,21.21%,9.89%
2020-01-01 00:23:30,1,10,2134,25,2109,3.26%,1.17%
2020-01-01 00:23:30,1,11,2202,29,2173,3.36%,1.32%
2020-01-01 00:23:30,1,12,13847,1367,12480,21.13%,9.87%
2020-01-01 00:23:30,2,1,782,0,782,1.19%,0.00%
2020-01-01 00:23:30,2,2,25507,4424,21083,38.92%,17.34%
2020-01-01 00:23:30,2,3,20460,2929,17531,31.22%,14.32%
2020-01-01 00:23:30,2,4,664,0,664,1.01%,0.00%
2020-01-01 00:23:30,2,5,10398,784,9614,15.87%,7.54%
2020-01-01 00:23:30,2,6,69,0,69,0.11%,0.00%
2020-01-01 00:23:30,2,7,4245,147,4098,6.48%,3.46%
2020-01-01 00:23:30,2,8,3067,87,2980,4.68%,2.84%
2020-01-01 00:23:30,2,9,10321,773,9548,15.75%,7.49%
2020-01-01 00:23:30,2,10,2281,48,2233,3.48%,2.10%
2020-01-01 00:23:30,2,11,2301,48,2253,3.51%,2.09%
2020-01-01 00:23:30,2,12,10135,758,9377,15.46%,7.48%
2020-01-01 00:23:30,3,1,1362,22,1340,2.08%,1.62%
2020-01-01 00:23:30,3,2,22692,3478,19214,34.63%,15.33%
2020-01-01 00:23:30,3,3,74646,30046,44600,113.90%,40.25%
2020-01-01 00:23:30,3,4,11395,982,10413,17.39%,8.62%
2020-01-01 00:23:30,3,5,49545,14730,34815,75.60%,29.73%
2020-01-01 00:23:30,3,6,12562,1165,11397,19.17%,9.27%
2020-01-01 00:23:30,3,7,19719,2659,17060,30.09%,13.48%
2020-01-01 00:23:30,3,8,16669,1956,14713,25.43%,11.73%
2020-01-01 00:23:30,3,9,36480,8453,28027,55.66%,23.17%
2020-01-01 00:23:30,3,10,6393,290,6103,9.75%,4.54%
2020-01-01 00:23:30,3,11,2116,27,2089,3.23%,1.28%
2020-01-01 00:23:30,3,12,27322,4998,22324,41.69%,18.29%
2020-01-01 00:23:30,4,1,473,0,473,0.72%,0.00%
2020-01-01 00:23:30,4,2,244,0,244,0.37%,0.00%
2020-01-01 00:23:30,4,3,858,14,844,1.31%,1.63%
2020-01-01 00:23:30,4,4,27072,4878,22194,41.31%,18.02%
2020-01-01 00:23:30,4,5,17364,2085,15279,26.50%,12.01%
2020-01-01 00:23:30,4,6,23633,3716,19917,36.06%,15.72%
2020-01-01 00:23:30,4,7,4721,134,4587,7.20%,2.84%
2020-01-01 00:23:30,4,8,2811,47,2764,4.29%,1.67%
2020-01-01 00:23:30,4,9,15380,1657,13723,23.47%,10.77%
2020-01-01 00:23:30,4,10,1778,29,1749,2.71%,1.63%
2020-01-01 00:23:30,4,11,137,0,137,0.21%,0.00%
2020-01-01 00:23:30,4,12,12821,1154,11667,19.56%,9.00%
2020-01-01 00:23:30,5,1,2602,54,2548,3.97%,2.08%
2020-01-01 00:23:30,5,2,878,1,877,1.34%,0.11%
2020-01-01 00:23:30,5,3,1064,11,1053,1.62%,1.03%
2020-01-01 00:23:30,5,4,22781,3536,19245,34.76%,15.52%
2020-01-01 00:23:30,5,5,11196,916,10280,17.08%,8.18%
2020-01-01 00:23:30,5,6,16259,1856,14403,24.81%,11.42%
2020-01-01 00:23:30,5,7,4525,174,4351,6.90%,3.85%
2020-01-01 00:23:30,5,8,3605,117,3488,5.50%,3.25%
2020-01-01 00:23:30,5,9,10013,754,9259,15.28%,7.53%
2020-01-01 00:23:30,5,10,1115,9,1106,1.70%,0.81%
2020-01-01 00:23:30,5,11,1023,20,1003,1.56%,1.96%
2020-01-01 00:23:30,5,12,8498,533,7965,12.97%,6.27%
2020-01-01 00:23:30,6,1,996,13,983,1.52%,1.31%
2020-01-01 00:23:30,6,2,1143,17,1126,1.74%,1.49%
2020-01-01 00:23:30,6,3,1619,28,1591,2.47%,1.73%
2020-01-01 00:23:30,6,4,1040,4,1036,1.59%,0.38%
2020-01-01 00:23:30,6,5,14439,1465,12974,22.03%,10.15%
2020-01-01 00:23:30,6,6,3812,105,3707,5.82%,2.75%
2020-01-01 00:23:30,6,7,2276,49,2227,3.47%,2.15%
2020-01-01 00:23:30,6,8,1687,22,1665,2.57%,1.30%
2020-01-01 00:23:30,6,9,8638,523,8115,13.18%,6.05%
2020-01-01 00:23:30,6,10,2258,45,2213,3.45%,1.99%
2020-01-01 00:23:30,6,11,377,3,374,0.58%,0.80%
2020-01-01 00:23:30,6,12,6302,277,6025,9.62%,4.40%
2020-01-01 00:23:30,7,1,527,4,523,0.80%,0.76%
2020-01-01 00:23:30,7,2,103,0,103,0.16%,0.00%
2020-01-01 00:23:30,7,3,1496,18,1478,2.28%,1.20%
2020-01-01 00:23:30,7,4,1687,18,1669,2.57%,1.07%
2020-01-01 00:23:30,7,5,7092,368,6724,10.82%,5.19%
2020-01-01 00:23:30,7,6,11999,1022,10977,18.31%,8.52%
2020-01-01 00:23:30,7,7,3179,98,3081,4.85%,3.08%
2020-01-01 00:23:30,7,8,1242,17,1225,1.90%,1.37%
2020-01-01 00:23:30,7,9,5480,215,5265,8.36%,3.92%
2020-01-01 00:23:30,7,10,1118,4,1114,1.71%,0.36%
2020-01-01 00:23:30,7,11,84,0,84,0.13%,0.00%
2020-01-01 00:23:30,7,12,4365,151,4214,6.66%,3.46%
2020-01-01 00:23:30,8,1,395,0,395,0.60%,0.00%
2020-01-01 00:23:30,8,2,101,0,101,0.15%,0.00%
2020-01-01 00:23:30,8,3,1665,24,1641,2.54%,1.44%
2020-01-01 00:23:30,8,4,2875,81,2794,4.39%,2.82%
2020-01-01 00:23:30,8,5,8162,514,7648,12.45%,6.30%
2020-01-01 00:23:30,8,6,16152,1880,14272,24.65%,11.64%
2020-01-01 00:23:30,8,7,5051,202,4849,7.71%,4.00%
2020-01-01 00:23:30,8,8,1958,47,1911,2.99%,2.40%
2020-01-01 00:23:30,8,9,6224,276,5948,9.50%,4.43%
2020-01-01 00:23:30,8,10,1861,30,1831,2.84%,1.61%
2020-01-01 00:23:30,8,11,242,0,242,0.37%,0.00%
2020-01-01 00:23:30,8,12,4299,136,4163,6.56%,3.16%
2020-01-01 00:23:30,9,1,299,0,299,0.46%,0.00%
2020-01-01 00:23:30,9,2,2357,40,2317,3.60%,1.70%
2020-01-01 00:23:30,9,3,1643,27,1616,2.51%,1.64%
2020-01-01 00:23:30,9,4,13002,1190,11812,19.84%,9.15%
2020-01-01 00:23:30,9,5,214,0,214,0.33%,0.00%
2020-01-01 00:23:30,9,6,13711,1323,12388,20.92%,9.65%
2020-01-01 00:23:30,9,7,36415,8373,28042,55.56%,22.99%
2020-01-01 00:23:30,9,8,14756,1471,13285,22.52%,9.97%
2020-01-01 00:23:30,9,9,183,0,183,0.28%,0.00%
2020-01-01 00:23:30,9,10,5325,168,5157,8.13%,3.15%
2020-01-01 00:23:30,9,11,12312,1021,11291,18.79%,8.29%
2020-01-01 00:23:30,9,12,6696,300,6396,10.22%,4.48%
2020-01-01 00:23:30,10,1,1061,256,805,1.62%,24.13%
2020-01-01 00:23:30,10,2,2563,292,2271,3.91%,11.39%
2020-01-01 00:23:30,10,3,1306,18,1288,1.99%,1.38%
2020-01-01 00:23:30,10,4,5612,1071,4541,8.56%,19.08%
2020-01-01 00:23:30,10,5,642,1,641,0.98%,0.16%
2020-01-01 00:23:30,10,6,7220,1204,6016,11.02%,16.68%
2020-01-01 00:23:30,10,7,11449,1955,9494,17.47%,17.08%
2020-01-01 00:23:30,10,8,27534,6760,20774,42.01%,24.55%
2020-01-01 00:23:30,10,9,751,5,746,1.15%,0.67%
2020-01-01 00:23:30,10,10,2256,41,2215,3.44%,1.82%
2020-01-01 00:23:30,10,11,12396,1504,10892,18.91%,12.13%
2020-01-01 00:23:30,10,12,9473,1089,8384,14.45%,11.50%
2020-01-01 00:23:30,11,1,2429,48,2381,3.71%,1.98%
2020-01-01 00:23:30,11,2,3780,121,3659,5.77%,3.20%
2020-01-01 00:23:30,11,3,1149,14,1135,1.75%,1.22%
2020-01-01 00:23:30,11,4,4600,175,4425,7.02%,3.80%
2020-01-01 00:23:30,11,5,208,0,208,0.32%,0.00%
2020-01-01 00:23:30,11,6,5384,233,5151,8.22%,4.33%
2020-01-01 00:23:30,11,7,10885,900,9985,16.61%,8.27%
2020-01-01 00:23:30,11,8,27676,5119,22557,42.23%,18.50%
2020-01-01 00:23:30,11,9,313,2,311,0.48%,0.64%
2020-01-01 00:23:30,11,10,3077,71,3006,4.70%,2.31%
2020-01-01 00:23:30,11,11,13276,1251,12025,20.26%,9.42%
2020-01-01 00:23:30,11,12,9980,729,9251,15.23%,7.30%
2020-01-01 00:23:30,12,1,70,0,70,0.11%,0.00%
2020-01-01 00:23:30,12,2,703,250,453,1.07%,35.56%
2020-01-01 00:23:30,12,3,2544,281,2263,3.88%,11.05%
2020-01-01 00:23:30,12,4,2652,43,2609,4.05%,1.62%
2020-01-01 00:23:30,12,5,8708,772,7936,13.29%,8.87%
2020-01-01 00:23:30,12,6,5271,223,5048,8.04%,4.23%
2020-01-01 00:23:30,12,7,2498,54,2444,3.81%,2.16%
2020-01-01 00:23:30,12,8,1073,321,752,1.64%,29.92%
2020-01-01 00:23:30,12,9,21258,4199,17059,32.44%,19.75%
2020-01-01 00:23:30,12,10,3758,394,3364,5.73%,10.48%
2020-01-01 00:23:30,12,11,1329,322,1007,2.03%,24.23%
2020-01-01 00:23:30,12,12,8041,1221,6820,12.27%,15.18%
2020-01-01 00:23:30,13,1,2103,29,2074,3.21%,1.38%
2020-01-01 00:23:30,13,2,2412,36,2376,3.68%,1.49%
2020-01-01 00:23:30,13,3,886,6,880,1.35%,0.68%
2020-01-01 00:23:30,13,4,4720,449,4271,7.20%,9.51%
2020-01-01 00:23:30,13,5,6977,742,6235,10.65%,10.63%
2020-01-01 00:23:30,13,6,5378,511,4867,8.21%,9.50%
2020-01-01 00:23:30,13,7,4737,171,4566,7.23%,3.61%
2020-01-01 00:23:30,13,8,6659,323,6336,10.16%,4.85%
2020-01-01 00:23:30,13,9,7308,769,6539,11.15%,10.52%
2020-01-01 00:23:30,13,10,26442,5184,21258,40.35%,19.61%
2020-01-01 00:23:30,13,11,16535,2220,14315,25.23%,13.43%
2020-01-01 00:23:30,13,12,9379,952,8427,14.31%,10.15%
2020-01-01 00:23:30,14,1,368,1,367,0.56%,0.27%
2020-01-01 00:23:30,14,2,1697,22,1675,2.59%,1.30%
2020-01-01 00:23:30,14,3,1135,9,1126,1.73%,0.79%
2020-01-01 00:23:30,14,4,4245,121,4124,6.48%,2.85%
2020-01-01 00:23:30,14,5,2066,31,2035,3.15%,1.50%
2020-01-01 00:23:30,14,6,4607,140,4467,7.03%,3.04%
2020-01-01 00:23:30,14,7,11430,915,10515,17.44%,8.01%
2020-01-01 00:23:30,14,8,13889,1331,12558,21.19%,9.58%
2020-01-01 00:23:30,14,9,2326,37,2289,3.55%,1.59%
2020-01-01 00:23:30,14,10,4949,208,4741,7.55%,4.20%
2020-01-01 00:23:30,14,11,26434,4636,21798,40.34%,17.54%
2020-01-01 00:23:30,14,12,7310,357,6953,11.15%,4.88%
2020-01-01 00:23:30,15,1,538,4,534,0.82%,0.74%
2020-01-01 00:23:30,15,2,179,0,179,0.27%,0.00%
2020-01-01 00:23:30,15,3,3690,111,3579,5.63%,3.01%
2020-01-01 00:23:30,15,4,5080,231,4849,7.75%,4.55%
2020-01-01 00:23:30,15,5,10823,879,9944,16.51%,8.12%
2020-01-01 00:23:30,15,6,5390,262,5128,8.22%,4.86%
2020-01-01 00:23:30,15,7,3816,97,3719,5.82%,2.54%
2020-01-01 00:23:30,15,8,5824,259,5565,8.89%,4.45%
2020-01-01 00:23:30,15,9,10992,903,10089,16.77%,8.22%
2020-01-01 00:23:30,15,10,4583,203,4380,6.99%,4.43%
2020-01-01 00:23:30,15,11,10506,838,9668,16.03%,7.98%
2020-01-01 00:23:30,15,12,27218,5202,22016,41.53%,19.11%
2020-01-01 00:23:30,16,1,446,2,444,0.68%,0.45%
2020-01-01 00:23:30,16,2,241,0,241,0.37%,0.00%
2020-01-01 00:23:30,16,3,1297,19,1278,1.98%,1.46%
2020-01-01 00:23:30,16,4,4040,120,3920,6.16%,2.97%
2020-01-01 00:23:30,16,5,7211,441,6770,11.00%,6.12%
2020-01-01 00:23:30,16,6,4854,171,4683,7.41%,3.52%
2020-01-01 00:23:30,16,7,3131,75,3056,4.78%,2.40%
2020-01-01 00:23:30,16,8,7273,412,6861,11.10%,5.66%
2020-01-01 00:23:30,16,9,7561,471,7090,11.54%,6.23%
2020-01-01 00:23:30,16,10,1711,21,1690,2.61%,1.23%
2020-01-01 00:23:30,16,11,9224,675,8549,14.07%,7.32%
2020-01-01 00:23:30,16,12,25072,4373,20699,38.26%,17.44%
2020-01-01 00:23:40,1,1,20299,2810,17489,30.97%,13.84%
2020-01-01 00:23:40,1,2,7130,360,6770,10.88%,5.05%
2020-01-01 00:23:40,1,3,507,3,504,0.77%,0.59%
2020-01-01 00:23:40,1,4,12781,1207,11574,19.50%,9.44%
2020-01-01 00:23:40,1,5,12631,1166,11465,19.27%,9.23%
2020-01-01 00:23:40,1,6,12558,1160,11398,19.16%,9.24%
2020-01-01 00:23:40,1,7,6605,304,6301,10.08%,4.60%
2020-01-01 00:23:40,1,8,4907,165,4742,7.49%,3.36%
2020-01-01 00:23:40,1,9,12508,1150,11358,19.09%,9.19%
2020-01-01 00:23:40,1,10,4303,118,4185,6.57%,2.74%
2020-01-01 00:23:40,1,11,4366,124,4242,6.66%,2.84%
2020-01-01 00:23:40,1,12,12478,1144,11334,19.04%,9.17%
2020-01-01 00:23:40,2,1,809,4,805,1.23%,0.49%
2020-01-01 00:23:40,2,2,30711,6197,24514,46.86%,20.18%
2020-01-01 00:23:40,2,3,25382,4348,21034,38.73%,17.13%
2020-01-01 00:23:40,2,4,705,4,701,1.08%,0.57%
2020-01-01 00:23:40,2,5,12062,1006,11056,18.41%,8.34%
2020-01-01 00:23:40,2,6,41,0,41,0.06%,0.00%
2020-01-01 00:23:40,2,7,4494,146,4348,6.86%,3.25%
2020-01-01 00:23:40,2,8,3455,80,3375,5.27%,2.32%
2020-01-01 00:23:40,2,9,11987,988,10999,18.29%,8.24%
2020-01-01 00:23:40,2,10,2732,50,2682,4.17%,1.83%
2020-01-01 00:23:40,2,11,2748,51,2697,4.19%,1.86%
2020-01-01 00:23:40,2,12,11843,971,10872,18.07%,8.20%
2020-01-01 00:23:40,3,1,1322,19,1303,2.02%,1.44%
2020-01-01 00:23:40,3,2,22870,3492,19378,34.90%,15.27%
2020-01-01 00:23:40,3,3,75966,30940,45026,115.91%,40.73%
2020-01-01 00:23:40,3,4,7398,426,6972,11.29%,5.76%
2020-01-01 00:23:40,3,5,50888,15450,35438,77.65%,30.36%
2020-01-01 00:23:40,3,6,8676,555,8121,13.24%,6.40%
2020-01-01 00:23:40,3,7,19763,2675,17088,30.16%,13.54%
2020-01-01 00:23:40,3,8,15179,1585,13594,23.16%,10.44%
2020-01-01 00:23:40,3,9,41905,10969,30936,63.94%,26.18%
2020-01-01 00:23:40,3,10,10925,884,10041,16.67%,8.09%
2020-01-01 00:23:40,3,11,1328,8,1320,2.03%,0.60%
2020-01-01 00:23:40,3,12,28555,5437,23118,43.57%,19.04%
2020-01-01 00:23:40,4,1,441,2,439,0.67%,0.45%
2020-01-01 00:23:40,4,2,223,1,222,0.34%,0.45%
2020-01-01 00:23:40,4,3,951,2,949,1.45%,0.21%
2020-01-01 00:23:40,4,4,27811,5166,22645,42.44%,18.58%
2020-01-01 00:23:40,4,5,17109,2028,15081,26.11%,11.85%
2020-01-01 00:23:40,4,6,24161,3972,20189,36.87%,16.44%
2020-01-01 00:23:40,4,7,5378,233,5145,8.21%,4.33%
2020-01-01 00:23:40,4,8,2971,67,2904,4.53%,2.26%
2020-01-01 00:23:40,4,9,15035,1577,13458,22.94%,10.49%
2020-01-01 00:23:40,4,10,1892,23,1869,2.89%,1.22%
2020-01-01 00:23:40,4,11,150,0,150,0.23%,0.00%
2020-01-01 00:23:40,4,12,12487,1096,11391,19.05%,8.78%
2020-01-01 00:23:40,5,1,2379,47,2332,3.63%,1.98%
2020-01-01 00:23:40,5,2,873,7,866,1.33%,0.80%
2020-01-01 00:23:40,5,3,466,3,463,0.71%,0.64%
2020-01-01 00:23:40,5,4,22861,3566,19295,34.88%,15.60%
2020-01-01 00:23:40,5,5,11097,882,10215,16.93%,7.95%
2020-01-01 00:23:40,5,6,16003,1798,14205,24.42%,11.24%
2020-01-01 00:23:40,5,7,4430,149,4281,6.76%,3.36%
2020-01-01 00:23:40,5,8,3321,88,3233,5.07%,2.65%
2020-01-01 00:23:40,5,9,10473,794,9679,15.98%,7.58%
2020-01-01 00:23:40,5,10,1163,10,1153,1.77%,0.86%
2020-01-01 00:23:40,5,11,770,3,767,1.17%,0.39%
2020-01-01 00:23:40,5,12,8828,561,8267,13.47%,6.35%
2020-01-01 00:23:40,6,1,1160,8,1152,1.77%,0.69%
2020-01-01 00:23:40,6,2,1284,12,1272,1.96%,0.93%
2020-01-01 00:23:40,6,3,1598,20,1578,2.44%,1.25%
2020-01-01 00:23:40,6,4,1325,25,1300,2.02%,1.89%
2020-01-01 00:23:40,6,5,14776,1555,13221,22.55%,10.52%
2020-01-01 00:23:40,6,6,4070,145,3925,6.21%,3.56%
2020-01-01 00:23:40,6,7,2367,53,2314,3.61%,2.24%
2020-01-01 00:23:40,6,8,1856,38,1818,2.83%,2.05%
2020-01-01 00:23:40,6,9,8718,565,8153,13.30%,6.48%
2020-01-01 00:23:40,6,10,2353,54,2299,3.59%,2.29%
2020-01-01 00:23:40,6,11,442,0,442,0.67%,0.00%
2020-01-01 00:23:40,6,12,6307,299,6008,9.62%,4.74%
2020-01-01 00:23:40,7,1,417,4,413,0.64%,0.96%
2020-01-01 00:23:40,7,2,131,0,131,0.20%,0.00%
2020-01-01 00:23:40,7,3,1289,14,1275,1.97%,1.09%
2020-01-01 00:23:40,7,4,1573,24,1549,2.40%,1.53%
2020-01-01 00:23:40,7,5,7466,398,7068,11.39%,5.33%
2020-01-01 00:23:40,7,6,12072,1028,11044,18.42%,8.52%
2020-01-01 00:23:40,7,7,2990,84,2906,4.56%,2.81%
2020-01-01 00:23:40,7,8,1076,13,1063,1.64%,1.21%
2020-01-01 00:23:40,7,9,6049,242,5807,9.23%,4.00%
2020-01-01 00:23:40,7,10,988,6,982,1.51%,0.61%
2020-01-01 00:23:40,7,11,85,0,85,0.13%,0.00%
2020-01-01 00:23:40,7,12,5049,180,4869,7.70%,3.57%
2020-01-01 00:23:40,8,1,551,4,547,0.84%,0.73%
2020-01-01 00:23:40,8,2,145,0,145,0.22%,0.00%
2020-01-01 00:23:40,8,3,1429,13,1416,2.18%,0.91%
2020-01-01 00:23:40,8,4,2922,75,2847,4.46%,2.57%
2020-01-01 00:23:40,8,5,7993,461,7532,12.20%,5.77%
2020-01-01 00:23:40,8,6,16593,1915,14678,25.32%,11.54%
2020-01-01 00:23:40,8,7,5627,223,5404,8.59%,3.96%
2020-01-01 00:23:40,8,8,2334,31,2303,3.56%,1.33%
2020-01-01 00:23:40,8,9,6282,275,6007,9.59%,4.38%
2020-01-01 00:23:40,8,10,1652,16,1636,2.52%,0.97%
2020-01-01 00:23:40,8,11,251,1,250,0.38%,0.40%
2020-01-01 00:23:40,8,12,4515,157,4358,6.89%,3.48%
2020-01-01 00:23:40,9,1,1074,4,1070,1.64%,0.37%
2020-01-01 00:23:40,9,2,2400,33,2367,3.66%,1.38%
2020-01-01 00:23:40,9,3,930,10,920,1.42%,1.08%
2020-01-01 00:23:40,9,4,7588,403,7185,11.58%,5.31%
2020-01-01 00:23:40,9,5,208,0,208,0.32%,0.00%
2020-01-01 00:23:40,9,6,8408,507,7901,12.83%,6.03%
2020-01-01 00:23:40,9,7,29479,5694,23785,44.98%,19.32%
2020-01-01 00:23:40,9,8,10834,876,9958,16.53%,8.09%
2020-01-01 00:23:40,9,9,141,0,141,0.22%,0.00%
2020-01-01 00:23:40,9,10,3649,64,3585,5.57%,1.75%
2020-01-01 00:23:40,9,11,9292,647,8645,14.18%,6.96%
2020-01-01 00:23:40,9,12,5348,233,5115,8.16%,4.36%
2020-01-01 00:23:40,10,1,1046,208,838,1.60%,19.89%
2020-01-01 00:23:40,10,2,2453,241,2212,3.74%,9.82%
2020-01-01 00:23:40,10,3,1224,15,1209,1.87%,1.23%
2020-01-01 00:23:40,10,4,3959,738,3221,6.04%,18.64%
2020-01-01 00:23:40,10,5,790,9,781,1.21%,1.14%
2020-01-01 00:23:40,10,6,5965,887,5078,9.10%,14.87%
2020-01-01 00:23:40,10,7,10252,1526,8726,15.64%,14.88%
2020-01-01 00:23:40,10,8,27593,6622,20971,42.10%,24.00%
2020-01-01 00:23:40,10,9,465,1,464,0.71%,0.22%
2020-01-01 00:23:40,10,10,2406,54,2352,3.67%,2.24%
2020-01-01 00:23:40,10,11,13290,1687,11603,20.28%,12.69%
2020-01-01 00:23:40,10,12,10344,1216,9128,15.78%,11.76%
2020-01-01 00:23:40,11,1,2155,45,2110,3.29%,2.09%
2020-01-01 00:23:40,11,2,3259,79,3180,4.97%,2.42%
2020-01-01 00:23:40,11,3,930,5,925,1.42%,0.54%
2020-01-01 00:23:40,11,4,4350,163,4187,6.64%,3.75%
2020-01-01 00:23:40,11,5,354,1,353,0.54%,0.28%
2020-01-01 00:23:40,11,6,5240,220,5020,8.00%,4.20%
2020-01-01 00:23:40,11,7,10423,816,9607,15.90%,7.83%
2020-01-01 00:23:40,11,8,23030,3677,19353,35.14%,15.97%
2020-01-01 00:23:40,11,9,195,1,194,0.30%,0.51%
2020-01-01 00:23:40,11,10,2784,85,2699,4.25%,3.05%
2020-01-01 00:23:40,11,11,9407,686,8721,14.35%,7.29%
2020-01-01 00:23:40,11,12,6348,335,6013,9.69%,5.28%
2020-01-01 00:23:40,12,1,141,0,141,0.22%,0.00%
2020-01-01 00:23:40,12,2,677,237,440,1.03%,35.01%
2020-01-01 00:23:40,12,3,2438,268,2170,3.72%,10.99%
2020-01-01 00:23:40,12,4,2697,51,2646,4.12%,1.89%
2020-01-01 00:23:40,12,5,8528,690,7838,13.01%,8.09%
2020-01-01 00:23:40,12,6,5231,193,5038,7.98%,3.69%
2020-01-01 00:23:40,12,7,2427,41,2386,3.70%,1.69%
2020-01-01 00:23:40,12,8,1119,259,860,1.71%,23.15%
2020-01-01 00:23:40,12,9,21467,4211,17256,32.76%,19.62%
2020-01-01 00:23:40,12,10,3721,338,3383,5.68%,9.08%
2020-01-01 00:23:40,12,11,1314,262,1052,2.01%,19.94%
2020-01-01 00:23:40,12,12,7746,1187,6559,11.82%,15.32%
2020-01-01 00:23:40,13,1,2666,63,2603,4.07%,2.36%
2020-01-01 00:23:40,13,2,2996,79,2917,4.57%,2.64%
2020-01-01 00:23:40,13,3,635,4,631,0.97%,0.63%
2020-01-01 00:23:40,13,4,3935,416,3519,6.00%,10.57%
2020-01-01 00:23:40,13,5,6299,699,5600,9.61%,11.10%
2020-01-01 00:23:40,13,6,4863,488,4375,7.42%,10.03%
2020-01-01 00:23:40,13,7,5926,286,5640,9.04%,4.83%
2020-01-01 00:23:40,13,8,8046,495,7551,12.28%,6.15%
2020-01-01 00:23:40,13,9,6709,738,5971,10.24%,11.00%
2020-01-01 00:23:40,13,10,29377,6261,23116,44.83%,21.31%
2020-01-01 00:23:40,13,11,19070,2873,16197,29.10%,15.07%
2020-01-01 00:23:40,13,12,10470,1175,9295,15.98%,11.22%
2020-01-01 00:23:40,14,1,374,0,374,0.57%,0.00%
2020-01-01 00:23:40,14,2,1311,22,1289,2.00%,1.68%
2020-01-01 00:23:40,14,3,765,10,755,1.17%,1.31%
2020-01-01 00:23:40,14,4,4662,199,4463,7.11%,4.27%
2020-01-01 00:23:40,14,5,1732,31,1701,2.64%,1.79%
2020-01-01 00:23:40,14,6,5025,225,4800,7.67%,4.48%
2020-01-01 00:23:40,14,7,11602,1012,10590,17.70%,8.72%
2020-01-01 00:23:40,14,8,13117,1278,11839,20.01%,9.74%
2020-01-01 00:23:40,14,9,1994,40,1954,3.04%,2.01%
2020-01-01 00:23:40,14,10,4497,166,4331,6.86%,3.69%
2020-01-01 00:23:40,14,11,26054,4664,21390,39.76%,17.90%
2020-01-01 00:23:40,14,12,8235,489,7746,12.57%,5.94%
2020-01-01 00:23:40,15,1,500,3,497,0.76%,0.60%
2020-01-01 00:23:40,15,2,212,0,212,0.32%,0.00%
2020-01-01 00:23:40,15,3,3754,90,3664,5.73%,2.40%
2020-01-01 00:23:40,15,4,4512,176,4336,6.88%,3.90%
2020-01-01 00:23:40,15,5,9751,715,9036,14.88%,7.33%
2020-01-01 00:23:40,15,6,4819,190,4629,7.35%,3.94%
2020-01-01 00:23:40,15,7,4001,139,3862,6.11%,3.47%
2020-01-01 00:23:40,15,8,5723,283,5440,8.73%,4.94%
2020-01-01 00:23:40,15,9,9957,748,9209,15.19%,7.51%
2020-01-01 00:23:40,15,10,5374,211,5163,8.20%,3.93%
2020-01-01 00:23:40,15,11,11265,968,10297,17.19%,8.59%
2020-01-01 00:23:40,15,12,26999,5187,21812,41.20%,19.21%
2020-01-01 00:23:40,16,1,399,3,396,0.61%,0.75%
2020-01-01 00:23:40,16,2,234,0,234,0.36%,0.00%
2020-01-01 00:23:40,16,3,1184,12,1172,1.81%,1.01%
2020-01-01 00:23:40,16,4,4626,139,4487,7.06%,3.00%
2020-01-01 00:23:40,16,5,7738,467,7271,11.81%,6.04%
2020-01-01 00:23:40,16,6,5396,197,5199,8.23%,3.65%
2020-01-01 00:23:40,16,7,3386,96,3290,5.17%,2.84%
2020-01-01 00:23:40,16,8,7127,445,6682,10.87%,6.24%
2020-01-01 00:23:40,16,9,8107,517,7590,12.37%,6.38%
2020-01-01 00:23:40,16,10,1706,20,1686,2.60%,1.17%
2020-01-01 00:23:40,16,11,9032,677,8355,13.78%,7.50%
2020-01-01 00:23:40,16,12,24865,4332,20533,37.94%,17.42%
2020-01-01 00:23:50,1,1,18795,2539,16256,28.68%,13.51%
2020-01-01 00:23:50,1,2,10045,759,9286,15.33%,7.56%
2020-01-01 00:23:50,1,3,685,1,684,1.05%,0.15%
2020-01-01 00:23:50,1,4,8308,551,7757,12.68%,6.63%
2020-01-01 00:23:50,1,5,8030,507,7523,12.25%,6.31%
2020-01-01 00:23:50,1,6,7949,506,7443,12.13%,6.37%
2020-01-01 00:23:50,1,7,9342,663,8679,14.25%,7.10%
2020-01-01 00:23:50,1,8,8292,531,7761,12.65%,6.40%
2020-01-01 00:23:50,1,9,7895,499,7396,12.05%,6.32%
2020-01-01 00:23:50,1,10,7398,433,6965,11.29%,5.85%
2020-01-01 00:23:50,1,11,7510,444,7066,11.46%,5.91%
2020-01-01 00:23:50,1,12,7843,495,7348,11.97%,6.31%
2020-01-01 00:23:50,2,1,1136,29,1107,1.73%,2.55%
2020-01-01 00:23:50,2,2,28120,5306,22814,42.91%,18.87%
2020-01-01 00:23:50,2,3,21226,3118,18108,32.39%,14.69%
2020-01-01 00:23:50,2,4,1060,28,1032,1.62%,2.64%
2020-01-01 00:23:50,2,5,12821,1212,11609,19.56%,9.45%
2020-01-01 00:23:50,2,6,42,0,42,0.06%,0.00%
2020-01-01 00:23:50,2,7,5743,262,5481,8.76%,4.56%
2020-01-01 00:23:50,2,8,4299,143,4156,6.56%,3.33%
2020-01-01 00:23:50,2,9,12684,1184,11500,19.35%,9.33%
2020-01-01 00:23:50,2,10,3589,98,3491,5.48%,2.73%
2020-01-01 00:23:50,2,11,3604,101,3503,5.50%,2.80%
2020-01-01 00:23:50,2,12,12508,1157,11351,19.09%,9.25%
2020-01-01 00:23:50,3,1,1362,10,1352,2.08%,0.73%
2020-01-01 00:23:50,3,2,24498,4047,20451,37.38%,16.52%
2020-01-01 00:23:50,3,3,73456,29326,44130,112.08%,39.92%
2020-01-01 00:23:50,3,4,7926,453,7473,12.09%,5.72%
2020-01-01 00:23:50,3,5,47507,13771,33736,72.49%,28.99%
2020-01-01 00:23:50,3,6,9125,615,8510,13.92%,6.74%
2020-01-01 00:23:50,3,7,21285,3069,18216,32.48%,14.42%
2020-01-01 00:23:50,3,8,17542,2134,15408,26.77%,12.17%
2020-01-01 00:23:50,3,9,37992,9201,28791,57.97%,24.22%
2020-01-01 00:23:50,3,10,8126,509,7617,12.40%,6.26%
2020-01-01 00:23:50,3,11,1797,30,1767,2.74%,1.67%
2020-01-01 00:23:50,3,12,27961,5195,22766,42.67%,18.58%
2020-01-01 00:23:50,4,1,441,3,438,0.67%,0.68%
2020-01-01 00:23:50,4,2,285,0,285,0.43%,0.00%
2020-01-01 00:23:50,4,3,1146,22,1124,1.75%,1.92%
2020-01-01 00:23:50,4,4,29067,5800,23267,44.35%,19.95%
2020-01-01 00:23:50,4,5,18287,2429,15858,27.90%,13.28%
2020-01-01 00:23:50,4,6,25309,4453,20856,38.62%,17.59%
2020-01-01 00:23:50,4,7,5673,240,5433,8.66%,4.23%
2020-01-01 00:23:50,4,8,3030,77,2953,4.62%,2.54%
2020-01-01 00:23:50,4,9,15826,1791,14035,24.15%,11.32%
2020-01-01 00:23:50,4,10,1897,23,1874,2.89%,1.21%
2020-01-01 00:23:50,4,11,182,1,181,0.28%,0.55%
2020-01-01 00:23:50,4,12,13029,1232,11797,19.88%,9.46%
2020-01-01 00:23:50,5,1,2372,40,2332,3.62%,1.69%
2020-01-01 00:23:50,5,2,626,3,623,0.96%,0.48%
2020-01-01 00:23:50,5,3,978,5,973,1.49%,0.51%
2020-01-01 00:23:50,5,4,24519,4066,20453,37.41%,16.58%
2020-01-01 00:23:50,5,5,10551,780,9771,16.10%,7.39%
2020-01-01 00:23:50,5,6,17221,2019,15202,26.28%,11.72%
2020-01-01 00:23:50,5,7,6287,317,5970,9.59%,5.04%
2020-01-01 00:23:50,5,8,3724,109,3615,5.68%,2.93%
2020-01-01 00:23:50,5,9,8849,555,8294,13.50%,6.27%
2020-01-01 00:23:50,5,10,1031,13,1018,1.57%,1.26%
2020-01-01 00:23:50,5,11,650,8,642,0.99%,1.23%
2020-01-01 00:23:50,5,12,7275,381,6894,11.10%,5.24%
2020-01-01 00:23:50,6,1,1043,7,1036,1.59%,0.67%
2020-01-01 00:23:50,6,2,1127,8,1119,1.72%,0.71%
2020-01-01 00:23:50,6,3,1636,23,1613,2.50%,1.41%
2020-01-01 00:23:50,6,4,1498,10,1488,2.29%,0.67%
2020-01-01 00:23:50,6,5,15635,1737,13898,23.86%,11.11%
2020-01-01 00:23:50,6,6,4609,139,4470,7.03%,3.02%
2020-01-01 00:23:50,6,7,2659,39,2620,4.06%,1.47%
2020-01-01 00:23:50,6,8,2096,22,2074,3.20%,1.05%
2020-01-01 00:23:50,6,9,9174,618,8556,14.00%,6.74%
2020-01-01 00:23:50,6,10,1987,37,1950,3.03%,1.86%
2020-01-01 00:23:50,6,11,427,3,424,0.65%,0.70%
2020-01-01 00:23:50,6,12,7103,357,6746,10.84%,5.03%
2020-01-01 00:23:50,7,1,424,4,420,0.65%,0.94%
2020-01-01 00:23:50,7,2,193,0,193,0.29%,0.00%
2020-01-01 00:23:50,7,3,1010,5,1005,1.54%,0.50%
2020-01-01 00:23:50,7,4,1383,18,1365,2.11%,1.30%
2020-01-01 00:23:50,7,5,7694,411,7283,11.74%,5.34%
2020-01-01 00:23:50,7,6,12826,1150,11676,19.57%,8.97%
2020-01-01 00:23:50,7,7,3720,96,3624,5.68%,2.58%
2020-01-01 00:23:50,7,8,1352,11,1341,2.06%,0.81%
2020-01-01 00:23:50,7,9,6631,314,6317,10.12%,4.74%
2020-01-01 00:23:50,7,10,1492,16,1476,2.28%,1.07%
2020-01-01 00:23:50,7,11,144,0,144,0.22%,0.00%
2020-01-01 00:23:50,7,12,5077,195,4882,7.75%,3.84%
2020-01-01 00:23:50,8,1,549,1,548,0.84%,0.18%
2020-01-01 00:23:50,8,2,140,0,140,0.21%,0.00%
2020-01-01 00:23:50,8,3,1558,20,1538,2.38%,1.28%
2020-01-01 00:23:50,8,4,3077,69,3008,4.70%,2.24%
2020-01-01 00:23:50,8,5,8717,572,8145,13.30%,6.56%
2020-01-01 00:23:50,8,6,17038,2039,14999,26.00%,11.97%
2020-01-01 00:23:50,8,7,5168,211,4957,7.89%,4.08%
2020-01-01 00:23:50,8,8,1739,30,1709,2.65%,1.73%
2020-01-01 00:23:50,8,9,6899,358,6541,10.53%,5.19%
2020-01-01 00:23:50,8,10,1839,28,1811,2.81%,1.52%
2020-01-01 00:23:50,8,11,182,1,181,0.28%,0.55%
2020-01-01 00:23:50,8,12,4928,185,4743,7.52%,3.75%
2020-01-01 00:23:50,9,1,424,1,423,0.65%,0.24%
2020-01-01 00:23:50,9,2,1882,29,1853,2.87%,1.54%
2020-01-01 00:23:50,9,3,898,6,892,1.37%,0.67%
2020-01-01 00:23:50,9,4,5473,250,5223,8.35%,4.57%
2020-01-01 00:23:50,9,5,243,0,243,0.37%,0.00%
2020-01-01 00:23:50,9,6,6574,324,6250,10.03%,4.93%
2020-01-01 00:23:50,9,7,32586,6947,25639,49.72%,21.32%
2020-01-01 00:23:50,9,8,13393,1307,12086,20.44%,9.76%
2020-01-01 00:23:50,9,9,205,0,205,0.31%,0.00%
2020-01-01 00:23:50,9,10,6629,284,6345,10.12%,4.28%
2020-01-01 00:23:50,9,11,11974,1062,10912,18.27%,8.87%
2020-01-01 00:23:50,9,12,5114,205,4909,7.80%,4.01%
2020-01-01 00:23:50,10,1,1454,245,1209,2.22%,16.85%
2020-01-01 00:23:50,10,2,3160,311,2849,4.82%,9.84%
2020-01-01 00:23:50,10,3,1556,30,1526,2.37%,1.93%
2020-01-01 00:23:50,10,4,4219,945,3274,6.44%,22.40%
2020-01-01 00:23:50,10,5,744,28,716,1.14%,3.76%
2020-01-01 00:23:50,10,6,6128,1077,5051,9.35%,17.58%
2020-01-01 00:23:50,10,7,11636,1922,9714,17.76%,16.52%
2020-01-01 00:23:50,10,8,28710,7219,21491,43.81%,25.14%
2020-01-01 00:23:50,10,9,710,3,707,1.08%,0.42%
2020-01-01 00:23:50,10,10,2568,44,2524,3.92%,1.71%
2020-01-01 00:23:50,10,11,12888,1584,11304,19.67%,12.29%
2020-01-01 00:23:50,10,12,9633,1076,8557,14.70%,11.17%
2020-01-01 00:23:50,11,1,2247,54,2193,3.43%,2.40%
2020-01-01 00:23:50,11,2,3395,103,3292,5.18%,3.03%
2020-01-01 00:23:50,11,3,1038,8,1030,1.58%,0.77%
2020-01-01 00:23:50,11,4,4000,99,3901,6.10%,2.48%
2020-01-01 00:23:50,11,5,604,2,602,0.92%,0.33%
2020-01-01 00:23:50,11,6,5270,203,5067,8.04%,3.85%
2020-01-01 00:23:50,11,7,10458,805,9653,15.96%,7.70%
2020-01-01 00:23:50,11,8,23818,3856,19962,36.34%,16.19%
2020-01-01 00:23:50,11,9,229,1,228,0.35%,0.44%
2020-01-01 00:23:50,11,10,2946,64,2882,4.50%,2.17%
2020-01-01 00:23:50,11,11,9748,665,9083,14.87%,6.82%
2020-01-01 00:23:50,11,12,6529,319,6210,9.96%,4.89%
2020-01-01 00:23:50,12,1,67,0,67,0.10%,0.00%
2020-01-01 00:23:50,12,2,721,238,483,1.10%,33.01%
2020-01-01 00:23:50,12,3,2746,280,2466,4.19%,10.20%
2020-01-01 00:23:50,12,4,2820,58,2762,4.30%,2.06%
2020-01-01 00:23:50,12,5,9047,750,8297,13.80%,8.29%
2020-01-01 00:23:50,12,6,5418,173,5245,8.27%,3.19%
2020-01-01 00:23:50,12,7,2452,29,2423,3.74%,1.18%
2020-01-01 00:23:50,12,8,1020,229,791,1.56%,22.45%
2020-01-01 00:23:50,12,9,21604,4207,17397,32.97%,19.47%
2020-01-01 00:23:50,12,10,3486,311,3175,5.32%,8.92%
2020-01-01 00:23:50,12,11,1176,232,944,1.79%,19.73%
2020-01-01 00:23:50,12,12,7724,1144,6580,11.79%,14.81%
2020-01-01 00:23:50,13,1,2183,31,2152,3.33%,1.42%
2020-01-01 00:23:50,13,2,2514,47,2467,3.84%,1.87%
2020-01-01 00:23:50,13,3,721,3,718,1.10%,0.42%
2020-01-01 00:23:50,13,4,4942,498,4444,7.54%,10.08%
2020-01-01 00:23:50,13,5,7794,847,6947,11.89%,10.87%
2020-01-01 00:23:50,13,6,6030,583,5447,9.20%,9.67%
2020-01-01 00:23:50,13,7,5092,202,4890,7.77%,3.97%
2020-01-01 00:23:50,13,8,6954,367,6587,10.61%,5.28%
2020-01-01 00:23:50,13,9,8276,899,7377,12.63%,10.86%
2020-01-01 00:23:50,13,10,27995,5940,22055,42.72%,21.22%
2020-01-01 00:23:50,13,11,16760,2369,14391,25.57%,14.13%
2020-01-01 00:23:50,13,12,9142,1012,8130,13.95%,11.07%
2020-01-01 00:23:50,14,1,280,0,280,0.43%,0.00%
2020-01-01 00:23:50,14,2,1478,17,1461,2.26%,1.15%
2020-01-01 00:23:50,14,3,943,10,933,1.44%,1.06%
2020-01-01 00:23:50,14,4,4179,135,4044,6.38%,3.23%
2020-01-01 00:23:50,14,5,1498,27,1471,2.29%,1.80%
2020-01-01 00:23:50,14,6,4574,169,4405,6.98%,3.69%
2020-01-01 00:23:50,14,7,11779,1002,10777,17.97%,8.51%
2020-01-01 00:23:50,14,8,13307,1278,12029,20.30%,9.60%
2020-01-01 00:23:50,14,9,1746,31,1715,2.66%,1.78%
2020-01-01 00:23:50,14,10,4085,122,3963,6.23%,2.99%
2020-01-01 00:23:50,14,11,24961,4255,20706,38.09%,17.05%
2020-01-01 00:23:50,14,12,7370,427,6943,11.25%,5.79%
2020-01-01 00:23:50,15,1,422,1,421,0.64%,0.24%
2020-01-01 00:23:50,15,2,174,0,174,0.27%,0.00%
2020-01-01 00:23:50,15,3,3628,121,3507,5.54%,3.34%
2020-01-01 00:23:50,15,4,4227,126,4101,6.45%,2.98%
2020-01-01 00:23:50,15,5,9189,613,8576,14.02%,6.67%
2020-01-01 00:23:50,15,6,4434,140,4294,6.77%,3.16%
2020-01-01 00:23:50,15,7,3685,105,3580,5.62%,2.85%
2020-01-01 00:23:50,15,8,5867,253,5614,8.95%,4.31%
2020-01-01 00:23:50,15,9,9364,639,8725,14.29%,6.82%
2020-01-01 00:23:50,15,10,4845,163,4682,7.39%,3.36%
2020-01-01 00:23:50,15,11,10872,823,10049,16.59%,7.57%
2020-01-01 00:23:50,15,12,26477,4931,21546,40.40%,18.62%
2020-01-01 00:23:50,16,1,393,2,391,0.60%,0.51%
2020-01-01 00:23:50,16,2,243,1,242,0.37%,0.41%
2020-01-01 00:23:50,16,3,1028,9,1019,1.57%,0.88%
2020-01-01 00:23:50,16,4,4010,123,3887,6.12%,3.07%
2020-01-01 00:23:50,16,5,7355,433,6922,11.22%,5.89%
2020-01-01 00:23:50,16,6,4856,169,4687,7.41%,3.48%
2020-01-01 00:23:50,16,7,3276,76,3200,5.00%,2.32%
2020-01-01 00:23:50,16,8,6848,381,6467,10.45%,5.56%
2020-01-01 00:23:50,16,9,7744,477,7267,11.82%,6.16%
2020-01-01 00:23:50,16,10,1317,14,1303,2.01%,1.06%
2020-01-01 00:23:50,16,11,8440,560,7880,12.88%,6.64%
2020-01-01 00:23:50,16,12,24344,4122,20222,37.15%,16.93%
2020-01-01 00:24:00,1,1,19553,2703,16850,29.84%,13.82%
2020-01-01 00:24:00,1,2,8596,571,8025,13.12%,6.64%
2020-01-01 00:24:00,1,3,824,5,819,1.26%,0.61%
2020-01-01 00:24:00,1,4,10516,812,9704,16.05%,7.72%
2020-01-01 00:24:00,1,5,10248,773,9475,15.64%,7.54%
2020-01-01 00:24:00,1,6,10146,757,9389,15.48%,7.46%
2020-01-01 00:24:00,1,7,7763,489,7274,11.85%,6.30%
2020-01-01 00:24:00,1,8,6194,307,5887,9.45%,4.96%
2020-01-01 00:24:00,1,9,10109,751,9358,15.43%,7.43%
2020-01-01 00:24:00,1,10,5140,212,4928,7.84%,4.12%
2020-01-01 00:24:00,1,11,5256,226,5030,8.02%,4.30%
2020-01-01 00:24:00,1,12,9879,721,9158,15.07%,7.30%
2020-01-01 00:24:00,2,1,284,0,284,0.43%,0.00%
2020-01-01 00:24:00,2,2,26116,4494,21622,39.85%,17.21%
2020-01-01 00:24:00,2,3,21435,3094,18341,32.71%,14.43%
2020-01-01 00:24:00,2,4,232,0,232,0.35%,0.00%
2020-01-01 00:24:00,2,5,13105,1236,11869,20.00%,9.43%
2020-01-01 00:24:00,2,6,34,0,34,0.05%,0.00%
2020-01-01 00:24:00,2,7,4369,154,4215,6.67%,3.52%
2020-01-01 00:24:00,2,8,2955,63,2892,4.51%,2.13%
2020-01-01 00:24:00,2,9,12998,1213,11785,19.83%,9.33%
2020-01-01 00:24:00,2,10,1970,31,1939,3.01%,1.57%
2020-01-01 00:24:00,2,11,1986,31,1955,3.03%,1.56%
2020-01-01 00:24:00,2,12,12825,1189,11636,19.57%,9.27%
2020-01-01 00:24:00,3,1,2717,54,2663,4.15%,1.99%
2020-01-01 00:24:00,3,2,26097,4586,21511,39.82%,17.57%
2020-01-01 00:24:00,3,3,69274,26571,42703,105.70%,38.36%
2020-01-01 00:24:00,3,4,5317,219,5098,8.11%,4.12%
2020-01-01 00:24:00,3,5,42161,11059,31102,64.33%,26.23%
2020-01-01 00:24:00,3,6,6172,287,5885,9.42%,4.65%
2020-01-01 00:24:00,3,7,21342,3114,18228,32.57%,14.59%
2020-01-01 00:24:00,3,8,15368,1685,13683,23.45%,10.96%
2020-01-01 00:24:00,3,9,35562,8060,27502,54.26%,22.66%
2020-01-01 00:24:00,3,10,5119,186,4933,7.81%,3.63%
2020-01-01 00:24:00,3,11,1681,21,1660,2.57%,1.25%
2020-01-01 00:24:00,3,12,26924,4772,22152,41.08%,17.72%
2020-01-01 00:24:00,4,1,620,3,617,0.95%,0.48%
2020-01-01 00:24:00,4,2,362,1,361,0.55%,0.28%
2020-01-01 00:24:00,4,3,786,10,776,1.20%,1.27%
2020-01-01 00:24:00,4,4,28695,5496,23199,43.79%,19.15%
2020-01-01 00:24:00,4,5,18069,2295,15774,27.57%,12.70%
2020-01-01 00:24:00,4,6,24646,4185,20461,37.61%,16.98%
2020-01-01 00:24:00,4,7,5288,223,5065,8.07%,4.22%
2020-01-01 00:24:00,4,8,2844,74,2770,4.34%,2.60%
2020-01-01 00:24:00,4,9,15937,1802,14135,24.32%,11.31%
2020-01-01 00:24:00,4,10,1973,31,1942,3.01%,1.57%
2020-01-01 00:24:00,4,11,191,2,189,0.29%,1.05%
2020-01-01 00:24:00,4,12,12520,1129,11391,19.10%,9.02%
2020-01-01 00:24:00,5,1,2793,50,2743,4.26%,1.79%
2020-01-01 00:24:00,5,2,897,1,896,1.37%,0.11%
2020-01-01 00:24:00,5,3,789,5,784,1.20%,0.63%
2020-01-01 00:24:00,5,4,29176,5592,23584,44.52%,19.17%
2020-01-01 00:24:00,5,5,9266,645,8621,14.14%,6.96%
2020-01-01 00:24:00,5,6,21330,3111,18219,32.55%,14.59%
2020-01-01 00:24:00,5,7,11596,949,10647,17.69%,8.18%
2020-01-01 00:24:00,5,8,3519,90,3429,5.37%,2.56%
2020-01-01 00:24:00,5,9,8321,520,7801,12.70%,6.25%
2020-01-01 00:24:00,5,10,986,10,976,1.50%,1.01%
2020-01-01 00:24:00,5,11,425,5,420,0.65%,1.18%
2020-01-01 00:24:00,5,12,7158,395,6763,10.92%,5.52%
2020-01-01 00:24:00,6,1,1085,11,1074,1.66%,1.01%
2020-01-01 00:24:00,6,2,1212,16,1196,1.85%,1.32%
2020-01-01 00:24:00,6,3,1886,33,1853,2.88%,1.75%
2020-01-01 00:24:00,6,4,1497,19,1478,2.28%,1.27%
2020-01-01 00:24:00,6,5,14306,1474,12832,21.83%,10.30%
2020-01-01 00:24:00,6,6,5727,249,5478,8.74%,4.35%
2020-01-01 00:24:00,6,7,3768,112,3656,5.75%,2.97%
2020-01-01 00:24:00,6,8,3115,80,3035,4.75%,2.57%
2020-01-01 00:24:00,6,9,6402,321,6081,9.77%,5.01%
2020-01-01 00:24:00,6,10,1677,21,1656,2.56%,1.25%
2020-01-01 00:24:00,6,11,434,2,432,0.66%,0.46%
2020-01-01 00:24:00,6,12,4647,174,4473,7.09%,3.74%
2020-01-01 00:24:00,7,1,537,2,535,0.82%,0.37%
2020-01-01 00:24:00,7,2,164,2,162,0.25%,1.22%
2020-01-01 00:24:00,7,3,895,5,890,1.37%,0.56%
2020-01-01 00:24:00,7,4,1832,23,1809,2.80%,1.26%
2020-01-01 00:24:00,7,5,8187,533,7654,12.49%,6.51%
2020-01-01 00:24:00,7,6,13509,1354,12155,20.61%,10.02%
2020-01-01 00:24:00,7,7,3425,96,3329,5.23%,2.80%
2020-01-01 00:24:00,7,8,1460,12,1448,2.23%,0.82%
2020-01-01 00:24:00,7,9,7220,425,6795,11.02%,5.89%
2020-01-01 00:24:00,7,10,1946,40,1906,2.97%,2.06%
2020-01-01 00:24:00,7,11,144,0,144,0.22%,0.00%
2020-01-01 00:24:00,7,12,5038,211,4827,7.69%,4.19%
2020-01-01 00:24:00,8,1,448,1,447,0.68%,0.22%
2020-01-01 00:24:00,8,2,227,0,227,0.35%,0.00%
2020-01-01 00:24:00,8,3,1779,20,1759,2.71%,1.12%
2020-01-01 00:24:00,8,4,3181,71,3110,4.85%,2.23%
2020-01-01 00:24:00,8,5,8723,584,8139,13.31%,6.69%
2020-01-01 00:24:00,8,6,17050,2096,14954,26.02%,12.29%
2020-01-01 00:24:00,8,7,5037,188,4849,7.69%,3.73%
2020-01-01 00:24:00,8,8,2322,48,2274,3.54%,2.07%
2020-01-01 00:24:00,8,9,6693,342,6351,10.21%,5.11%
2020-01-01 00:24:00,8,10,1797,23,1774,2.74%,1.28%
2020-01-01 00:24:00,8,11,201,1,200,0.31%,0.50%
2020-01-01 00:24:00,8,12,4880,178,4702,7.45%,3.65%
2020-01-01 00:24:00,9,1,322,1,321,0.49%,0.31%
2020-01-01 00:24:00,9,2,2955,77,2878,4.51%,2.61%
2020-01-01 00:24:00,9,3,2267,41,2226,3.46%,1.81%
2020-01-01 00:24:00,9,4,4779,173,4606,7.29%,3.62%
2020-01-01 00:24:00,9,5,293,1,292,0.45%,0.34%
2020-01-01 00:24:00,9,6,5667,234,5433,8.65%,4.13%
2020-01-01 00:24:00,9,7,24057,4015,20042,36.71%,16.69%
2020-01-01 00:24:00,9,8,9918,770,9148,15.13%,7.76%
2020-01-01 00:24:00,9,9,215,1,214,0.33%,0.47%
2020-01-01 00:24:00,9,10,3122,69,3053,4.76%,2.21%
2020-01-01 00:24:00,9,11,9014,621,8393,13.75%,6.89%
2020-01-01 00:24:00,9,12,5587,246,5341,8.53%,4.40%
2020-01-01 00:24:00,10,1,1343,233,1110,2.05%,17.35%
2020-01-01 00:24:00,10,2,3139,295,2844,4.79%,9.40%
2020-01-01 00:24:00,10,3,1638,21,1617,2.50%,1.28%
2020-01-01 00:24:00,10,4,4227,1080,3147,6.45%,25.55%
2020-01-01 00:24:00,10,5,740,64,676,1.13%,8.65%
2020-01-01 00:24:00,10,6,5850,1231,4619,8.93%,21.04%
2020-01-01 00:24:00,10,7,10889,1916,8973,16.62%,17.60%
2020-01-01 00:24:00,10,8,30011,7740,22271,45.79%,25.79%
2020-01-01 00:24:00,10,9,995,10,985,1.52%,1.01%
2020-01-01 00:24:00,10,10,2551,62,2489,3.89%,2.43%
2020-01-01 00:24:00,10,11,14882,2064,12818,22.71%,13.87%
2020-01-01 00:24:00,10,12,11741,1500,10241,17.92%,12.78%
2020-01-01 00:24:00,11,1,2534,57,2477,3.87%,2.25%
2020-01-01 00:24:00,11,2,3444,96,3348,5.26%,2.79%
2020-01-01 00:24:00,11,3,744,4,740,1.14%,0.54%
2020-01-01 00:24:00,11,4,5637,265,5372,8.60%,4.70%
2020-01-01 00:24:00,11,5,523,2,521,0.80%,0.38%
2020-01-01 00:24:00,11,6,7038,387,6651,10.74%,5.50%
2020-01-01 00:24:00,11,7,12403,1119,11284,18.93%,9.02%
2020-01-01 00:24:00,11,8,26970,4864,22106,41.15%,18.03%
2020-01-01 00:24:00,11,9,202,1,201,0.31%,0.50%
2020-01-01 00:24:00,11,10,2958,63,2895,4.51%,2.13%
2020-01-01 00:24:00,11,11,10420,793,9627,15.90%,7.61%
2020-01-01 00:24:00,11,12,7022,363,6659,10.71%,5.17%
2020-01-01 00:24:00,12,1,60,0,60,0.09%,0.00%
2020-01-01 00:24:00,12,2,533,164,369,0.81%,30.77%
2020-01-01 00:24:00,12,3,2535,223,2312,3.87%,8.80%
2020-01-01 00:24:00,12,4,2913,96,2817,4.44%,3.30%
2020-01-01 00:24:00,12,5,8624,722,7902,13.16%,8.37%
2020-01-01 00:24:00,12,6,5291,224,5067,8.07%,4.23%
2020-01-01 00:24:00,12,7,2189,28,2161,3.34%,1.28%
2020-01-01 00:24:00,12,8,1290,241,1049,1.97%,18.68%
2020-01-01 00:24:00,12,9,22257,4097,18160,33.96%,18.41%
2020-01-01 00:24:00,12,10,4212,387,3825,6.43%,9.19%
2020-01-01 00:24:00,12,11,1474,244,1230,2.25%,16.55%
2020-01-01 00:24:00,12,12,8832,1063,7769,13.48%,12.04%
2020-01-01 00:24:00,13,1,2260,38,2222,3.45%,1.68%
2020-01-01 00:24:00,13,2,2577,57,2520,3.93%,2.21%
2020-01-01 00:24:00,13,3,625,3,622,0.95%,0.48%
2020-01-01 00:24:00,13,4,4925,609,4316,7.51%,12.37%
2020-01-01 00:24:00,13,5,6856,821,6035,10.46%,11.97%
2020-01-01 00:24:00,13,6,5575,649,4926,8.51%,11.64%
2020-01-01 00:24:00,13,7,5120,197,4923,7.81%,3.85%
2020-01-01 00:24:00,13,8,7158,397,6761,10.92%,5.55%
2020-01-01 00:24:00,13,9,7416,870,6546,11.32%,11.73%
2020-01-01 00:24:00,13,10,27726,5768,21958,42.31%,20.80%
2020-01-01 00:24:00,13,11,17389,2534,14855,26.53%,14.57%
2020-01-01 00:24:00,13,12,9804,1147,8657,14.96%,11.70%
2020-01-01 00:24:00,14,1,459,2,457,0.70%,0.44%
2020-01-01 00:24:00,14,2,1304,10,1294,1.99%,0.77%
2020-01-01 00:24:00,14,3,714,2,712,1.09%,0.28%
2020-01-01 00:24:00,14,4,4812,166,4646,7.34%,3.45%
2020-01-01 00:24:00,14,5,1450,22,1428,2.21%,1.52%
2020-01-01 00:24:00,14,6,5073,180,4893,7.74%,3.55%
2020-01-01 00:24:00,14,7,13002,1249,11753,19.84%,9.61%
2020-01-01 00:24:00,14,8,14370,1495,12875,21.93%,10.40%
2020-01-01 00:24:00,14,9,1628,28,1600,2.48%,1.72%
2020-01-01 00:24:00,14,10,3992,120,3872,6.09%,3.01%
2020-01-01 00:24:00,14,11,27626,5092,22534,42.15%,18.43%
2020-01-01 00:24:00,14,12,9065,598,8467,13.83%,6.60%
2020-01-01 00:24:00,15,1,445,2,443,0.68%,0.45%
2020-01-01 00:24:00,15,2,169,1,168,0.26%,0.59%
2020-01-01 00:24:00,15,3,6294,291,6003,9.60%,4.62%
2020-01-01 00:24:00,15,4,4566,169,4397,6.97%,3.70%
2020-01-01 00:24:00,15,5,11723,989,10734,17.89%,8.44%
2020-01-01 00:24:00,15,6,4865,205,4660,7.42%,4.21%
2020-01-01 00:24:00,15,7,3943,127,3816,6.02%,3.22%
2020-01-01 00:24:00,15,8,6503,320,6183,9.92%,4.92%
2020-01-01 00:24:00,15,9,11912,1014,10898,18.18%,8.51%
2020-01-01 00:24:00,15,10,4545,207,4338,6.94%,4.55%
2020-01-01 00:24:00,15,11,11187,967,10220,17.07%,8.64%
2020-01-01 00:24:00,15,12,29322,6156,23166,44.74%,20.99%
2020-01-01 00:24:00,16,1,501,1,500,0.76%,0.20%
2020-01-01 00:24:00,16,2,238,1,237,0.36%,0.42%
2020-01-01 00:24:00,16,3,1125,10,1115,1.72%,0.89%
2020-01-01 00:24:00,16,4,3839,124,3715,5.86%,3.23%
2020-01-01 00:24:00,16,5,7312,434,6878,11.16%,5.94%
2020-01-01 00:24:00,16,6,4587,179,4408,7.00%,3.90%
2020-01-01 00:24:00,16,7,3226,89,3137,4.92%,2.76%
2020-01-01 00:24:00,16,8,6853,441,6412,10.46%,6.44%
2020-01-01 00:24:00,16,9,7767,479,7288,11.85%,6.17%
2020-01-01 00:24:00,16,10,1777,22,1755,2.71%,1.24%
2020-01-01 00:24:00,16,11,8872,672,8200,13.54%,7.57%
2020-01-01 00:24:00,16,12,24273,4072,20201,37.04%,16.78%
2020-01-01 00:24:10,1,1,17499,2179,15320,26.70%,12.45%
2020-01-01 00:24:10,1,2,8925,611,8314,13.62%,6.85%
2020-01-01 00:24:10,1,3,648,9,639,0.99%,1.39%
2020-01-01 00:24:10,1,4,8248,547,7701,12.59%,6.63%
2020-01-01 00:24:10,1,5,8035,518,7517,12.26%,6.45%
2020-01-01 00:24:10,1,6,7955,511,7444,12.14%,6.42%
2020-01-01 00:24:10,1,7,8256,514,7742,12.60%,6.23%
2020-01-01 00:24:10,1,8,5567,252,5315,8.49%,4.53%
2020-01-01 00:24:10,1,9,7924,509,7415,12.09%,6.42%
2020-01-01 00:24:10,1,10,4747,171,4576,7.24%,3.60%
2020-01-01 00:24:10,1,11,4856,183,4673,7.41%,3.77%
2020-01-01 00:24:10,1,12,7512,468,7044,11.46%,6.23%
2020-01-01 00:24:10,2,1,482,1,481,0.74%,0.21%
2020-01-01 00:24:10,2,2,23400,3668,19732,35.71%,15.68%
2020-01-01 00:24:10,2,3,18237,2253,15984,27.83%,12.35%
2020-01-01 00:24:10,2,4,301,1,300,0.46%,0.33%
2020-01-01 00:24:10,2,5,11399,896,10503,17.39%,7.86%
2020-01-01 00:24:10,2,6,99,0,99,0.15%,0.00%
2020-01-01 00:24:10,2,7,4652,166,4486,7.10%,3.57%
2020-01-01 00:24:10,2,8,3571,103,3468,5.45%,2.88%
2020-01-01 00:24:10,2,9,11335,882,10453,17.30%,7.78%
2020-01-01 00:24:10,2,10,2789,62,2727,4.26%,2.22%
2020-01-01 00:24:10,2,11,2803,64,2739,4.28%,2.28%
2020-01-01 00:24:10,2,12,11193,857,10336,17.08%,7.66%
2020-01-01 00:24:10,3,1,1304,10,1294,1.99%,0.77%
2020-01-01 00:24:10,3,2,25140,4295,20845,38.36%,17.08%
2020-01-01 00:24:10,3,3,76494,31360,45134,116.72%,41.00%
2020-01-01 00:24:10,3,4,13835,1392,12443,21.11%,10.06%
2020-01-01 00:24:10,3,5,49034,14429,34605,74.82%,29.43%
2020-01-01 00:24:10,3,6,14539,1524,13015,22.18%,10.48%
2020-01-01 00:24:10,3,7,21203,3116,18087,32.35%,14.70%
2020-01-01 00:24:10,3,8,18431,2356,16075,28.12%,12.78%
2020-01-01 00:24:10,3,9,34117,7461,26656,52.06%,21.87%
2020-01-01 00:24:10,3,10,6220,280,5940,9.49%,4.50%
2020-01-01 00:24:10,3,11,1789,24,1765,2.73%,1.34%
2020-01-01 00:24:10,3,12,24181,3976,20205,36.90%,16.44%
2020-01-01 00:24:10,4,1,615,3,612,0.94%,0.49%
2020-01-01 00:24:10,4,2,326,1,325,0.50%,0.31%
2020-01-01 00:24:10,4,3,863,13,850,1.32%,1.51%
2020-01-01 00:24:10,4,4,28549,5576,22973,43.56%,19.53%
2020-01-01 00:24:10,4,5,17734,2240,15494,27.06%,12.63%
2020-01-01 00:24:10,4,6,24563,4193,20370,37.48%,17.07%
2020-01-01 00:24:10,4,7,5386,247,5139,8.22%,4.59%
2020-01-01 00:24:10,4,8,3148,85,3063,4.80%,2.70%
2020-01-01 00:24:10,4,9,15832,1796,14036,24.16%,11.34%
2020-01-01 00:24:10,4,10,2257,29,2228,3.44%,1.28%
2020-01-01 00:24:10,4,11,207,0,207,0.32%,0.00%
2020-01-01 00:24:10,4,12,12413,1117,11296,18.94%,9.00%
2020-01-01 00:24:10,5,1,2912,69,2843,4.44%,2.37%
2020-01-01 00:24:10,5,2,1190,9,1181,1.82%,0.76%
2020-01-01 00:24:10,5,3,495,2,493,0.76%,0.40%
2020-01-01 00:24:10,5,4,28893,5497,23396,44.09%,19.03%
2020-01-01 00:24:10,5,5,9309,609,8700,14.20%,6.54%
2020-01-01 00:24:10,5,6,20811,2927,17884,31.76%,14.06%
2020-01-01 00:24:10,5,7,11071,914,10157,16.89%,8.26%
2020-01-01 00:24:10,5,8,3060,100,2960,4.67%,3.27%
2020-01-01 00:24:10,5,9,8520,520,8000,13.00%,6.10%
2020-01-01 00:24:10,5,10,939,5,934,1.43%,0.53%
2020-01-01 00:24:10,5,11,492,4,488,0.75%,0.81%
2020-01-01 00:24:10,5,12,7282,376,6906,11.11%,5.16%
2020-01-01 00:24:10,6,1,1091,11,1080,1.66%,1.01%
2020-01-01 00:24:10,6,2,1202,13,1189,1.83%,1.08%
2020-01-01 00:24:10,6,3,1826,36,1790,2.79%,1.97%
2020-01-01 00:24:10,6,4,1262,6,1256,1.93%,0.48%
2020-01-01 00:24:10,6,5,11843,970,10873,18.07%,8.19%
2020-01-01 00:24:10,6,6,4437,135,4302,6.77%,3.04%
2020-01-01 00:24:10,6,7,2467,40,2427,3.76%,1.62%
2020-01-01 00:24:10,6,8,1935,28,1907,2.95%,1.45%
2020-01-01 00:24:10,6,9,5334,192,5142,8.14%,3.60%
2020-01-01 00:24:10,6,10,1561,13,1548,2.38%,0.83%
2020-01-01 00:24:10,6,11,401,0,401,0.61%,0.00%
2020-01-01 00:24:10,6,12,3735,99,3636,5.70%,2.65%
2020-01-01 00:24:10,7,1,513,4,509,0.78%,0.78%
2020-01-01 00:24:10,7,2,184,0,184,0.28%,0.00%
2020-01-01 00:24:10,7,3,910,11,899,1.39%,1.21%
2020-01-01 00:24:10,7,4,2394,42,2352,3.65%,1.75%
2020-01-01 00:24:10,7,5,7634,429,7205,11.65%,5.62%
2020-01-01 00:24:10,7,6,14029,1436,12593,21.41%,10.24%
2020-01-01 00:24:10,7,7,3956,132,3824,6.04%,3.34%
2020-01-01 00:24:10,7,8,1738,28,1710,2.65%,1.61%
2020-01-01 00:24:10,7,9,6682,333,6349,10.20%,4.98%
2020-01-01 00:24:10,7,10,1525,8,1517,2.33%,0.52%
2020-01-01 00:24:10,7,11,49,0,49,0.07%,0.00%
2020-01-01 00:24:10,7,12,5174,198,4976,7.89%,3.83%
2020-01-01 00:24:10,8,1,457,1,456,0.70%,0.22%
2020-01-01 00:24:10,8,2,208,0,208,0.32%,0.00%
2020-01-01 00:24:10,8,3,1809,18,1791,2.76%,1.00%
2020-01-01 00:24:10,8,4,3161,58,3103,4.82%,1.83%
2020-01-01 00:24:10,8,5,8846,632,8214,13.50%,7.14%
2020-01-01 00:24:10,8,6,17314,2111,15203,26.42%,12.19%
2020-01-01 00:24:10,8,7,5182,201,4981,7.91%,3.88%
2020-01-01 00:24:10,8,8,2026,24,2002,3.09%,1.18%
2020-01-01 00:24:10,8,9,6751,365,6386,10.30%,5.41%
2020-01-01 00:24:10,8,10,1779,22,1757,2.71%,1.24%
2020-01-01 00:24:10,8,11,117,0,117,0.18%,0.00%
2020-01-01 00:24:10,8,12,4972,197,4775,7.59%,3.96%
2020-01-01 00:24:10,9,1,386,0,386,0.59%,0.00%
2020-01-01 00:24:10,9,2,5094,184,4910,7.77%,3.61%
2020-01-01 00:24:10,9,3,4325,135,4190,6.60%,3.12%
2020-01-01 00:24:10,9,4,2888,60,2828,4.41%,2.08%
2020-01-01 00:24:10,9,5,555,0,555,0.85%,0.00%
2020-01-01 00:24:10,9,6,3973,104,3869,6.06%,2.62%
2020-01-01 00:24:10,9,7,24863,4113,20750,37.94%,16.54%
2020-01-01 00:24:10,9,8,10411,798,9613,15.89%,7.66%
2020-01-01 00:24:10,9,9,265,0,265,0.40%,0.00%
2020-01-01 00:24:10,9,10,3207,64,3143,4.89%,2.00%
2020-01-01 00:24:10,9,11,9385,649,8736,14.32%,6.92%
2020-01-01 00:24:10,9,12,5887,266,5621,8.98%,4.52%
2020-01-01 00:24:10,10,1,1465,339,1126,2.24%,23.14%
2020-01-01 00:24:10,10,2,3338,397,2941,5.09%,11.89%
2020-01-01 00:24:10,10,3,1699,17,1682,2.59%,1.00%
2020-01-01 00:24:10,10,4,4758,1188,3570,7.26%,24.97%
2020-01-01 00:24:10,10,5,893,61,832,1.36%,6.83%
2020-01-01 00:24:10,10,6,6696,1376,5320,10.22%,20.55%
2020-01-01 00:24:10,10,7,11890,2245,9645,18.14%,18.88%
2020-01-01 00:24:10,10,8,29174,7521,21653,44.52%,25.78%
2020-01-01 00:24:10,10,9,696,4,692,1.06%,0.57%
2020-01-01 00:24:10,10,10,2413,39,2374,3.68%,1.62%
2020-01-01 00:24:10,10,11,13282,1700,11582,20.27%,12.80%
2020-01-01 00:24:10,10,12,10225,1231,8994,15.60%,12.04%
2020-01-01 00:24:10,11,1,2318,74,2244,3.54%,3.19%
2020-01-01 00:24:10,11,2,3057,90,2967,4.66%,2.94%
2020-01-01 00:24:10,11,3,545,1,544,0.83%,0.18%
2020-01-01 00:24:10,11,4,4675,173,4502,7.13%,3.70%
2020-01-01 00:24:10,11,5,166,1,165,0.25%,0.60%
2020-01-01 00:24:10,11,6,5422,230,5192,8.27%,4.24%
2020-01-01 00:24:10,11,7,10280,798,9482,15.69%,7.76%
2020-01-01 00:24:10,11,8,24808,4217,20591,37.85%,17.00%
2020-01-01 00:24:10,11,9,190,0,190,0.29%,0.00%
2020-01-01 00:24:10,11,10,2826,72,2754,4.31%,2.55%
2020-01-01 00:24:10,11,11,10691,854,9837,16.31%,7.99%
2020-01-01 00:24:10,11,12,7197,401,6796,10.98%,5.57%
2020-01-01 00:24:10,12,1,61,0,61,0.09%,0.00%
2020-01-01 00:24:10,12,2,516,161,355,0.79%,31.20%
2020-01-01 00:24:10,12,3,2292,188,2104,3.50%,8.20%
2020-01-01 00:24:10,12,4,2970,69,2901,4.53%,2.32%
2020-01-01 00:24:10,12,5,7786,604,7182,11.88%,7.76%
2020-01-01 00:24:10,12,6,4646,173,4473,7.09%,3.72%
2020-01-01 00:24:10,12,7,1491,17,1474,2.28%,1.14%
2020-01-01 00:24:10,12,8,1545,245,1300,2.36%,15.86%
2020-01-01 00:24:10,12,9,21669,3973,17696,33.06%,18.33%
2020-01-01 00:24:10,12,10,4289,365,3924,6.54%,8.51%
2020-01-01 00:24:10,12,11,1775,247,1528,2.71%,13.92%
2020-01-01 00:24:10,12,12,8561,1055,7506,13.06%,12.32%
2020-01-01 00:24:10,13,1,1998,37,1961,3.05%,1.85%
2020-01-01 00:24:10,13,2,2323,53,2270,3.54%,2.28%
2020-01-01 00:24:10,13,3,585,2,583,0.89%,0.34%
2020-01-01 00:24:10,13,4,5221,663,4558,7.97%,12.70%
2020-01-01 00:24:10,13,5,7529,956,6573,11.49%,12.70%
2020-01-01 00:24:10,13,6,5991,726,5265,9.14%,12.12%
2020-01-01 00:24:10,13,7,4632,166,4466,7.07%,3.58%
2020-01-01 00:24:10,13,8,7387,412,6975,11.27%,5.58%
2020-01-01 00:24:10,13,9,7790,984,6806,11.89%,12.63%
2020-01-01 00:24:10,13,10,28177,5983,22194,42.99%,21.23%
2020-01-01 00:24:10,13,11,17783,2574,15209,27.13%,14.47%
2020-01-01 00:24:10,13,12,9942,1137,8805,15.17%,11.44%
2020-01-01 00:24:10,14,1,361,0,361,0.55%,0.00%
2020-01-01 00:24:10,14,2,1100,11,1089,1.68%,1.00%
2020-01-01 00:24:10,14,3,527,0,527,0.80%,0.00%
2020-01-01 00:24:10,14,4,5395,243,5152,8.23%,4.50%
2020-01-01 00:24:10,14,5,1463,25,1438,2.23%,1.71%
2020-01-01 00:24:10,14,6,5677,264,5413,8.66%,4.65%
2020-01-01 00:24:10,14,7,13072,1277,11795,19.95%,9.77%
2020-01-01 00:24:10,14,8,14654,1572,13082,22.36%,10.73%
2020-01-01 00:24:10,14,9,1779,29,1750,2.71%,1.63%
2020-01-01 00:24:10,14,10,4919,185,4734,7.51%,3.76%
2020-01-01 00:24:10,14,11,28603,5487,23116,43.64%,19.18%
2020-01-01 00:24:10,14,12,8661,550,8111,13.22%,6.35%
2020-01-01 00:24:10,15,1,529,3,526,0.81%,0.57%
2020-01-01 00:24:10,15,2,183,0,183,0.28%,0.00%
2020-01-01 00:24:10,15,3,6991,400,6591,10.67%,5.72%
2020-01-01 00:24:10,15,4,4995,230,4765,7.62%,4.60%
2020-01-01 00:24:10,15,5,13199,1348,11851,20.14%,10.21%
2020-01-01 00:24:10,15,6,5335,298,5037,8.14%,5.59%
2020-01-01 00:24:10,15,7,3407,84,3323,5.20%,2.47%
2020-01-01 00:24:10,15,8,5719,251,5468,8.73%,4.39%
2020-01-01 00:24:10,15,9,13367,1385,11982,20.40%,10.36%
2020-01-01 00:24:10,15,10,5322,350,4972,8.12%,6.58%
2020-01-01 00:24:10,15,11,11257,1054,10203,17.18%,9.36%
2020-01-01 00:24:10,15,12,30054,6450,23604,45.86%,21.46%
2020-01-01 00:24:10,16,1,381,3,378,0.58%,0.79%
2020-01-01 00:24:10,16,2,313,0,313,0.48%,0.00%
2020-01-01 00:24:10,16,3,1291,10,1281,1.97%,0.77%
2020-01-01 00:24:10,16,4,4100,115,3985,6.26%,2.80%
2020-01-01 00:24:10,16,5,7539,483,7056,11.50%,6.41%
2020-01-01 00:24:10,16,6,5144,191,4953,7.85%,3.71%
2020-01-01 00:24:10,16,7,3001,63,2938,4.58%,2.10%
2020-01-01 00:24:10,16,8,6749,348,6401,10.30%,5.16%
2020-01-01 00:24:10,16,9,7960,538,7422,12.15%,6.76%
2020-01-01 00:24:10,16,10,1998,31,1967,3.05%,1.55%
2020-01-01 00:24:10,16,11,8959,620,8339,13.67%,6.92%
2020-01-01 00:24:10,16,12,24513,4065,20448,37.40%,16.58%
2020-01-01 00:24:20,1,1,15987,1799,14188,24.39%,11.25%
2020-01-01 00:24:20,1,2,5925,274,5651,9.04%,4.62%
2020-01-01 00:24:20,1,3,440,2,438,0.67%,0.45%
2020-01-01 00:24:20,1,4,9535,668,8867,14.55%,7.01%
2020-01-01 00:24:20,1,5,9306,622,8684,14.20%,6.68%
2020-01-01 00:24:20,1,6,9184,609,8575,14.01%,6.63%
2020-01-01 00:24:20,1,7,5467,221,5246,8.34%,4.04%
2020-01-01 00:24:20,1,8,3842,112,3730,5.86%,2.92%
2020-01-01 00:24:20,1,9,9161,605,8556,13.98%,6.60%
2020-01-01 00:24:20,1,10,2710,52,2658,4.14%,1.92%
2020-01-01 00:24:20,1,11,2801,53,2748,4.27%,1.89%
2020-01-01 00:24:20,1,12,9149,603,8546,13.96%,6.59%
2020-01-01 00:24:20,2,1,581,3,578,0.89%,0.52%
2020-01-01 00:24:20,2,2,27276,5055,22221,41.62%,18.53%
2020-01-01 00:24:20,2,3,22020,3356,18664,33.60%,15.24%
2020-01-01 00:24:20,2,4,510,3,507,0.78%,0.59%
2020-01-01 00:24:20,2,5,13750,1366,12384,20.98%,9.93%
2020-01-01 00:24:20,2,6,41,0,41,0.06%,0.00%
2020-01-01 00:24:20,2,7,4654,168,4486,7.10%,3.61%
2020-01-01 00:24:20,2,8,3284,80,3204,5.01%,2.44%
2020-01-01 00:24:20,2,9,13660,1344,12316,20.84%,9.84%
2020-01-01 00:24:20,2,10,2440,43,2397,3.72%,1.76%
2020-01-01 00:24:20,2,11,2457,44,2413,3.75%,1.79%
2020-01-01 00:24:20,2,12,13521,1315,12206,20.63%,9.73%
2020-01-01 00:24:20,3,1,2111,40,2071,3.22%,1.89%
2020-01-01 00:24:20,3,2,29178,5611,23567,44.52%,19.23%
2020-01-01 00:24:20,3,3,72527,28606,43921,110.67%,39.44%
2020-01-01 00:24:20,3,4,9831,683,9148,15.00%,6.95%
2020-01-01 00:24:20,3,5,42452,11171,31281,64.78%,26.31%
2020-01-01 00:24:20,3,6,10622,806,9816,16.21%,7.59%
2020-01-01 00:24:20,3,7,22871,3529,19342,34.90%,15.43%
2020-01-01 00:24:20,3,8,19098,2485,16613,29.14%,13.01%
2020-01-01 00:24:20,3,9,31546,6448,25098,48.14%,20.44%
2020-01-01 00:24:20,3,10,4371,150,4221,6.67%,3.43%
2020-01-01 00:24:20,3,11,2619,53,2566,4.00%,2.02%
2020-01-01 00:24:20,3,12,22736,3485,19251,34.69%,15.33%
2020-01-01 00:24:20,4,1,500,3,497,0.76%,0.60%
2020-01-01 00:24:20,4,2,332,2,330,0.51%,0.60%
2020-01-01 00:24:20,4,3,830,2,828,1.27%,0.24%
2020-01-01 00:24:20,4,4,29417,5784,23633,44.89%,19.66%
2020-01-01 00:24:20,4,5,18189,2382,15807,27.75%,13.10%
2020-01-01 00:24:20,4,6,25103,4316,20787,38.30%,17.19%
2020-01-01 00:24:20,4,7,5503,238,5265,8.40%,4.32%
2020-01-01 00:24:20,4,8,3094,63,3031,4.72%,2.04%
2020-01-01 00:24:20,4,9,16198,1914,14284,24.72%,11.82%
2020-01-01 00:24:20,4,10,2095,40,2055,3.20%,1.91%
2020-01-01 00:24:20,4,11,245,0,245,0.37%,0.00%
2020-01-01 00:24:20,4,12,12649,1186,11463,19.30%,9.38%
2020-01-01 00:24:20,5,1,3016,67,2949,4.60%,2.22%
2020-01-01 00:24:20,5,2,730,9,721,1.11%,1.23%
2020-01-01 00:24:20,5,3,1594,19,1575,2.43%,1.19%
2020-01-01 00:24:20,5,4,22900,3653,19247,34.94%,15.95%
2020-01-01 00:24:20,5,5,10088,775,9313,15.39%,7.68%
2020-01-01 00:24:20,5,6,15893,1833,14060,24.25%,11.53%
2020-01-01 00:24:20,5,7,5327,236,5091,8.13%,4.43%
2020-01-01 00:24:20,5,8,3853,128,3725,5.88%,3.32%
2020-01-01 00:24:20,5,9,8386,554,7832,12.80%,6.61%
2020-01-01 00:24:20,5,10,1299,19,1280,1.98%,1.46%
2020-01-01 00:24:20,5,11,679,9,670,1.04%,1.33%
2020-01-01 00:24:20,5,12,6835,381,6454,10.43%,5.57%
2020-01-01 00:24:20,6,1,1027,12,1015,1.57%,1.17%
2020-01-01 00:24:20,6,2,1102,12,1090,1.68%,1.09%
2020-01-01 00:24:20,6,3,1700,19,1681,2.59%,1.12%
2020-01-01 00:24:20,6,4,2758,43,2715,4.21%,1.56%
2020-01-01 00:24:20,6,5,14636,1478,13158,22.33%,10.10%
2020-01-01 00:24:20,6,6,6322,281,6041,9.65%,4.44%
2020-01-01 00:24:20,6,7,2824,75,2749,4.31%,2.66%
2020-01-01 00:24:20,6,8,2097,38,2059,3.20%,1.81%
2020-01-01 00:24:20,6,9,6328,326,6002,9.66%,5.15%
2020-01-01 00:24:20,6,10,2395,36,2359,3.65%,1.50%
2020-01-01 00:24:20,6,11,462,1,461,0.70%,0.22%
2020-01-01 00:24:20,6,12,3882,138,3744,5.92%,3.55%
2020-01-01 00:24:20,7,1,539,3,536,0.82%,0.56%
2020-01-01 00:24:20,7,2,222,0,222,0.34%,0.00%
2020-01-01 00:24:20,7,3,586,1,585,0.89%,0.17%
2020-01-01 00:24:20,7,4,2589,56,2533,3.95%,2.16%
2020-01-01 00:24:20,7,5,7654,438,7216,11.68%,5.72%
2020-01-01 00:24:20,7,6,13919,1416,12503,21.24%,10.17%
2020-01-01 00:24:20,7,7,3595,100,3495,5.49%,2.78%
2020-01-01 00:24:20,7,8,1550,19,1531,2.37%,1.23%
2020-01-01 00:24:20,7,9,6911,368,6543,10.55%,5.32%
2020-01-01 00:24:20,7,10,1778,25,1753,2.71%,1.41%
2020-01-01 00:24:20,7,11,78,0,78,0.12%,0.00%
2020-01-01 00:24:20,7,12,5130,212,4918,7.83%,4.13%
2020-01-01 00:24:20,8,1,631,2,629,0.96%,0.32%
2020-01-01 00:24:20,8,2,122,0,122,0.19%,0.00%
2020-01-01 00:24:20,8,3,1659,19,1640,2.53%,1.15%
2020-01-01 00:24:20,8,4,3493,91,3402,5.33%,2.61%
2020-01-01 00:24:20,8,5,8205,519,7686,12.52%,6.33%
2020-01-01 00:24:20,8,6,16472,1890,14582,25.13%,11.47%
2020-01-01 00:24:20,8,7,4653,159,4494,7.10%,3.42%
2020-01-01 00:24:20,8,8,1518,12,1506,2.32%,0.79%
2020-01-01 00:24:20,8,9,6271,326,5945,9.57%,5.20%
2020-01-01 00:24:20,8,10,1817,23,1794,2.77%,1.27%
2020-01-01 00:24:20,8,11,179,0,179,0.27%,0.00%
2020-01-01 00:24:20,8,12,4544,169,4375,6.93%,3.72%
2020-01-01 00:24:20,9,1,722,4,718,1.10%,0.55%
2020-01-01 00:24:20,9,2,2606,61,2545,3.98%,2.34%
2020-01-01 00:24:20,9,3,1532,18,1514,2.34%,1.17%
2020-01-01 00:24:20,9,4,5993,240,5753,9.14%,4.00%
2020-01-01 00:24:20,9,5,482,3,479,0.74%,0.62%
2020-01-01 00:24:20,9,6,7355,378,6977,11.22%,5.14%
2020-01-01 00:24:20,9,7,28410,5337,23073,43.35%,18.79%
2020-01-01 00:24:20,9,8,10988,846,10142,16.77%,7.70%
2020-01-01 00:24:20,9,9,124,0,124,0.19%,0.00%
2020-01-01 00:24:20,9,10,4203,136,4067,6.41%,3.24%
2020-01-01 00:24:20,9,11,10042,701,9341,15.32%,6.98%
2020-01-01 00:24:20,9,12,5490,222,5268,8.38%,4.04%
2020-01-01 00:24:20,10,1,1632,247,1385,2.49%,15.13%
2020-01-01 00:24:20,10,2,3411,305,3106,5.20%,8.94%
2020-01-01 00:24:20,10,3,1624,22,1602,2.48%,1.35%
2020-01-01 00:24:20,10,4,4277,1367,2910,6.53%,31.96%
2020-01-01 00:24:20,10,5,689,56,633,1.05%,8.13%
2020-01-01 00:24:20,10,6,5936,1515,4421,9.06%,25.52%
2020-01-01 00:24:20,10,7,11293,2220,9073,17.23%,19.66%
2020-01-01 00:24:20,10,8,30056,7879,22177,45.86%,26.21%
2020-01-01 00:24:20,10,9,816,8,808,1.25%,0.98%
2020-01-01 00:24:20,10,10,2479,55,2424,3.78%,2.22%
2020-01-01 00:24:20,10,11,14489,1798,12691,22.11%,12.41%
2020-01-01 00:24:20,10,12,11174,1196,9978,17.05%,10.70%
2020-01-01 00:24:20,11,1,2660,63,2597,4.06%,2.37%
2020-01-01 00:24:20,11,2,3482,103,3379,5.31%,2.96%
2020-01-01 00:24:20,11,3,685,5,680,1.05%,0.73%
2020-01-01 00:24:20,11,4,6143,260,5883,9.37%,4.23%
2020-01-01 00:24:20,11,5,195,2,193,0.30%,1.03%
2020-01-01 00:24:20,11,6,7156,371,6785,10.92%,5.18%
2020-01-01 00:24:20,11,7,12521,1131,11390,19.11%,9.03%
2020-01-01 00:24:20,11,8,26698,4765,21933,40.74%,17.85%
2020-01-01 00:24:20,11,9,158,1,157,0.24%,0.63%
2020-01-01 00:24:20,11,10,2870,51,2819,4.38%,1.78%
2020-01-01 00:24:20,11,11,10369,789,9580,15.82%,7.61%
2020-01-01 00:24:20,11,12,7060,367,6693,10.77%,5.20%
2020-01-01 00:24:20,12,1,45,0,45,0.07%,0.00%
2020-01-01 00:24:20,12,2,604,152,452,0.92%,25.17%
2020-01-01 00:24:20,12,3,2382,180,2202,3.63%,7.56%
2020-01-01 00:24:20,12,4,2968,83,2885,4.53%,2.80%
2020-01-01 00:24:20,12,5,8079,607,7472,12.33%,7.51%
2020-01-01 00:24:20,12,6,4729,168,4561,7.22%,3.55%
2020-01-01 00:24:20,12,7,1596,21,1575,2.44%,1.32%
2020-01-01 00:24:20,12,8,1524,328,1196,2.33%,21.52%
2020-01-01 00:24:20,12,9,20428,3833,16595,31.17%,18.76%
2020-01-01 00:24:20,12,10,4514,471,4043,6.89%,10.43%
2020-01-01 00:24:20,12,11,1655,329,1326,2.53%,19.88%
2020-01-01 00:24:20,12,12,7266,1002,6264,11.09%,13.79%
2020-01-01 00:24:20,13,1,2420,55,2365,3.69%,2.27%
2020-01-01 00:24:20,13,2,2723,69,2654,4.15%,2.53%
2020-01-01 00:24:20,13,3,877,5,872,1.34%,0.57%
2020-01-01 00:24:20,13,4,4739,527,4212,7.23%,11.12%
2020-01-01 00:24:20,13,5,7977,948,7029,12.17%,11.88%
2020-01-01 00:24:20,13,6,5831,602,5229,8.90%,10.32%
2020-01-01 00:24:20,13,7,5362,218,5144,8.18%,4.07%
2020-01-01 00:24:20,13,8,7765,441,7324,11.85%,5.68%
2020-01-01 00:24:20,13,9,8346,983,7363,12.73%,11.78%
2020-01-01 00:24:20,13,10,29110,6238,22872,44.42%,21.43%
2020-01-01 00:24:20,13,11,17430,2493,14937,26.60%,14.30%
2020-01-01 00:24:20,13,12,9227,1032,8195,14.08%,11.18%
2020-01-01 00:24:20,14,1,424,1,423,0.65%,0.24%
2020-01-01 00:24:20,14,2,1261,9,1252,1.92%,0.71%
2020-01-01 00:24:20,14,3,564,0,564,0.86%,0.00%
2020-01-01 00:24:20,14,4,3818,94,3724,5.83%,2.46%
2020-01-01 00:24:20,14,5,1351,20,1331,2.06%,1.48%
2020-01-01 00:24:20,14,6,4253,126,4127,6.49%,2.96%
2020-01-01 00:24:20,14,7,12328,1063,11265,18.81%,8.62%
2020-01-01 00:24:20,14,8,14066,1357,12709,21.46%,9.65%
2020-01-01 00:24:20,14,9,1548,24,1524,2.36%,1.55%
2020-01-01 00:24:20,14,10,4310,136,4174,6.58%,3.16%
2020-01-01 00:24:20,14,11,26978,4761,22217,41.17%,17.65%
2020-01-01 00:24:20,14,12,8148,470,7678,12.43%,5.77%
2020-01-01 00:24:20,15,1,520,2,518,0.79%,0.38%
2020-01-01 00:24:20,15,2,177,4,173,0.27%,2.26%
2020-01-01 00:24:20,15,3,6475,308,6167,9.88%,4.76%
2020-01-01 00:24:20,15,4,5955,271,5684,9.09%,4.55%
2020-01-01 00:24:20,15,5,13306,1272,12034,20.30%,9.56%
2020-01-01 00:24:20,15,6,6172,303,5869,9.42%,4.91%
2020-01-01 00:24:20,15,7,3643,146,3497,5.56%,4.01%
2020-01-01 00:24:20,15,8,5589,291,5298,8.53%,5.21%
2020-01-01 00:24:20,15,9,13483,1305,12178,20.57%,9.68%
2020-01-01 00:24:20,15,10,4366,343,4023,6.66%,7.86%
2020-01-01 00:24:20,15,11,10216,1013,9203,15.59%,9.92%
2020-01-01 00:24:20,15,12,28779,6030,22749,43.91%,20.95%
2020-01-01 00:24:20,16,1,431,6,425,0.66%,1.39%
2020-01-01 00:24:20,16,2,284,2,282,0.43%,0.70%
2020-01-01 00:24:20,16,3,1521,14,1507,2.32%,0.92%
2020-01-01 00:24:20,16,4,4524,188,4336,6.90%,4.16%
2020-01-01 00:24:20,16,5,7913,559,7354,12.07%,7.06%
2020-01-01 00:24:20,16,6,5280,243,5037,8.06%,4.60%
2020-01-01 00:24:20,16,7,3356,91,3265,5.12%,2.71%
2020-01-01 00:24:20,16,8,7181,498,6683,10.96%,6.93%
2020-01-01 00:24:20,16,9,8314,607,7707,12.69%,7.30%
2020-01-01 00:24:20,16,10,2583,64,2519,3.94%,2.48%
2020-01-01 00:24:20,16,11,10077,870,9207,15.38%,8.63%
2020-01-01 00:24:20,16,12,26244,4727,21517,40.05%,18.01%
2020-01-01 00:24:30,1,1,19937,2847,17090,30.42%,14.28%
2020-01-01 00:24:30,1,2,9370,695,8675,14.30%,7.42%
2020-01-01 00:24:30,1,3,450,1,449,0.69%,0.22%
2020-01-01 00:24:30,1,4,10015,782,9233,15.28%,7.81%
2020-01-01 00:24:30,1,5,9632,725,8907,14.70%,7.53%
2020-01-01 00:24:30,1,6,9529,717,8812,14.54%,7.52%
2020-01-01 00:24:30,1,7,8904,626,8278,13.59%,7.03%
2020-01-01 00:24:30,1,8,7957,501,7456,12.14%,6.30%
2020-01-01 00:24:30,1,9,9483,707,8776,14.47%,7.46%
2020-01-01 00:24:30,1,10,7249,412,6837,11.06%,5.68%
2020-01-01 00:24:30,1,11,7368,425,6943,11.24%,5.77%
2020-01-01 00:24:30,1,12,9417,700,8717,14.37%,7.43%
2020-01-01 00:24:30,2,1,643,6,637,0.98%,0.93%
2020-01-01 00:24:30,2,2,22121,3345,18776,33.75%,15.12%
2020-01-01 00:24:30,2,3,17015,2061,14954,25.96%,12.11%
2020-01-01 00:24:30,2,4,584,6,578,0.89%,1.03%
2020-01-01 00:24:30,2,5,11205,927,10278,17.10%,8.27%
2020-01-01 00:24:30,2,6,79,1,78,0.12%,1.27%
2020-01-01 00:24:30,2,7,4428,144,4284,6.76%,3.25%
2020-01-01 00:24:30,2,8,2925,71,2854,4.46%,2.43%
2020-01-01 00:24:30,2,9,11141,913,10228,17.00%,8.19%
2020-01-01 00:24:30,2,10,2165,40,2125,3.30%,1.85%
2020-01-01 00:24:30,2,11,2183,40,2143,3.33%,1.83%
2020-01-01 00:24:30,2,12,10994,888,10106,16.78%,8.08%
2020-01-01 00:24:30,3,1,1590,18,1572,2.43%,1.13%
2020-01-01 00:24:30,3,2,24221,3994,20227,36.96%,16.49%
2020-01-01 00:24:30,3,3,70146,26951,43195,107.03%,38.42%
2020-01-01 00:24:30,3,4,8674,554,8120,13.24%,6.39%
2020-01-01 00:24:30,3,5,44853,12350,32503,68.44%,27.53%
2020-01-01 00:24:30,3,6,9658,683,8975,14.74%,7.07%
2020-01-01 00:24:30,3,7,20855,3032,17823,31.82%,14.54%
2020-01-01 00:24:30,3,8,18214,2341,15873,27.79%,12.85%
2020-01-01 00:24:30,3,9,34791,7803,26988,53.09%,22.43%
2020-01-01 00:24:30,3,10,8063,532,7531,12.30%,6.60%
2020-01-01 00:24:30,3,11,2366,50,2316,3.61%,2.11%
2020-01-01 00:24:30,3,12,22321,3401,18920,34.06%,15.24%
2020-01-01 00:24:30,4,1,632,4,628,0.96%,0.63%
2020-01-01 00:24:30,4,2,428,0,428,0.65%,0.00%
2020-01-01 00:24:30,4,3,984,7,977,1.50%,0.71%
2020-01-01 00:24:30,4,4,28997,5536,23461,44.25%,19.09%
2020-01-01 00:24:30,4,5,17689,2156,15533,26.99%,12.19%
2020-01-01 00:24:30,4,6,24671,4072,20599,37.64%,16.51%
2020-01-01 00:24:30,4,7,5631,227,5404,8.59%,4.03%
2020-01-01 00:24:30,4,8,3325,70,3255,5.07%,2.11%
2020-01-01 00:24:30,4,9,15629,1684,13945,23.85%,10.77%
2020-01-01 00:24:30,4,10,2042,42,2000,3.12%,2.06%
2020-01-01 00:24:30,4,11,272,0,272,0.42%,0.00%
2020-01-01 00:24:30,4,12,12962,1158,11804,19.78%,8.93%
2020-01-01 00:24:30,5,1,2869,52,2817,4.38%,1.81%
2020-01-01 00:24:30,5,2,895,4,891,1.37%,0.45%
2020-01-01 00:24:30,5,3,586,3,583,0.89%,0.51%
2020-01-01 00:24:30,5,4,21561,3201,18360,32.90%,14.85%
2020-01-01 00:24:30,5,5,9388,612,8776,14.32%,6.52%
2020-01-01 00:24:30,5,6,15104,1602,13502,23.05%,10.61%
2020-01-01 00:24:30,5,7,4969,183,4786,7.58%,3.68%
2020-01-01 00:24:30,5,8,3513,85,3428,5.36%,2.42%
2020-01-01 00:24:30,5,9,8568,529,8039,13.07%,6.17%
2020-01-01 00:24:30,5,10,1596,19,1577,2.44%,1.19%
2020-01-01 00:24:30,5,11,504,3,501,0.77%,0.60%
2020-01-01 00:24:30,5,12,6876,356,6520,10.49%,5.18%
2020-01-01 00:24:30,6,1,1024,10,1014,1.56%,0.98%
2020-01-01 00:24:30,6,2,1247,15,1232,1.90%,1.20%
2020-01-01 00:24:30,6,3,1738,20,1718,2.65%,1.15%
2020-01-01 00:24:30,6,4,1226,7,1219,1.87%,0.57%
2020-01-01 00:24:30,6,5,11547,953,10594,17.62%,8.25%
2020-01-01 00:24:30,6,6,3897,117,3780,5.95%,3.00%
2020-01-01 00:24:30,6,7,2249,52,2197,3.43%,2.31%
2020-01-01 00:24:30,6,8,1710,39,1671,2.61%,2.28%
2020-01-01 00:24:30,6,9,5595,230,5365,8.54%,4.11%
2020-01-01 00:24:30,6,10,1750,20,1730,2.67%,1.14%
2020-01-01 00:24:30,6,11,481,4,477,0.73%,0.83%
2020-01-01 00:24:30,6,12,3791,108,3683,5.78%,2.85%
2020-01-01 00:24:30,7,1,492,2,490,0.75%,0.41%
2020-01-01 00:24:30,7,2,232,2,230,0.35%,0.86%
2020-01-01 00:24:30,7,3,507,0,507,0.77%,0.00%
2020-01-01 00:24:30,7,4,2429,39,2390,3.71%,1.61%
2020-01-01 00:24:30,7,5,7629,445,7184,11.64%,5.83%
2020-01-01 00:24:30,7,6,14345,1508,12837,21.89%,10.51%
2020-01-01 00:24:30,7,7,4232,138,4094,6.46%,3.26%
2020-01-01 00:24:30,7,8,1840,16,1824,2.81%,0.87%
2020-01-01 00:24:30,7,9,6636,330,6306,10.13%,4.97%
2020-01-01 00:24:30,7,10,1243,14,1229,1.90%,1.13%
2020-01-01 00:24:30,7,11,71,0,71,0.11%,0.00%
2020-01-01 00:24:30,7,12,5345,194,5151,8.16%,3.63%
2020-01-01 00:24:30,8,1,735,3,732,1.12%,0.41%
2020-01-01 00:24:30,8,2,190,0,190,0.29%,0.00%
2020-01-01 00:24:30,8,3,1814,24,1790,2.77%,1.32%
2020-01-01 00:24:30,8,4,3967,132,3835,6.05%,3.33%
2020-01-01 00:24:30,8,5,8613,562,8051,13.14%,6.53%
2020-01-01 00:24:30,8,6,17428,2124,15304,26.59%,12.19%
2020-01-01 00:24:30,8,7,4784,179,4605,7.30%,3.74%
2020-01-01 00:24:30,8,8,1876,25,1851,2.86%,1.33%
2020-01-01 00:24:30,8,9,6577,339,6238,10.04%,5.15%
2020-01-01 00:24:30,8,10,1712,31,1681,2.61%,1.81%
2020-01-01 00:24:30,8,11,205,0,205,0.31%,0.00%
2020-01-01 00:24:30,8,12,4858,183,4675,7.41%,3.77%
2020-01-01 00:24:30,9,1,1133,6,1127,1.73%,0.53%
2020-01-01 00:24:30,9,2,3705,98,3607,5.65%,2.65%
2020-01-01 00:24:30,9,3,2241,39,2202,3.42%,1.74%
2020-01-01 00:24:30,9,4,7792,432,7360,11.89%,5.54%
2020-01-01 00:24:30,9,5,453,0,453,0.69%,0.00%
2020-01-01 00:24:30,9,6,9403,644,8759,14.35%,6.85%
2020-01-01 00:24:30,9,7,31468,6656,24812,48.02%,21.15%
2020-01-01 00:24:30,9,8,12341,1124,11217,18.83%,9.11%
2020-01-01 00:24:30,9,9,132,0,132,0.20%,0.00%
2020-01-01 00:24:30,9,10,5209,186,5023,7.95%,3.57%
2020-01-01 00:24:30,9,11,11318,915,10403,17.27%,8.08%
2020-01-01 00:24:30,9,12,5666,232,5434,8.65%,4.09%
2020-01-01 00:24:30,10,1,1588,279,1309,2.42%,17.57%
2020-01-01 00:24:30,10,2,3341,336,3005,5.10%,10.06%
2020-01-01 00:24:30,10,3,1612,16,1596,2.46%,0.99%
2020-01-01 00:24:30,10,4,3653,1006,2647,5.57%,27.54%
2020-01-01 00:24:30,10,5,948,51,897,1.45%,5.38%
2020-01-01 00:24:30,10,6,5291,1132,4159,8.07%,21.39%
2020-01-01 00:24:30,10,7,9915,1796,8119,15.13%,18.11%
2020-01-01 00:24:30,10,8,29088,7471,21617,44.38%,25.68%
2020-01-01 00:24:30,10,9,580,1,579,0.89%,0.17%
2020-01-01 00:24:30,10,10,2196,50,2146,3.35%,2.28%
2020-01-01 00:24:30,10,11,15076,1999,13077,23.00%,13.26%
2020-01-01 00:24:30,10,12,11998,1423,10575,18.31%,11.86%
2020-01-01 00:24:30,11,1,2510,65,2445,3.83%,2.59%
2020-01-01 00:24:30,11,2,3738,128,3610,5.70%,3.42%
2020-01-01 00:24:30,11,3,1049,15,1034,1.60%,1.43%
2020-01-01 00:24:30,11,4,4715,185,4530,7.19%,3.92%
2020-01-01 00:24:30,11,5,149,0,149,0.23%,0.00%
2020-01-01 00:24:30,11,6,5485,231,5254,8.37%,4.21%
2020-01-01 00:24:30,11,7,11272,968,10304,17.20%,8.59%
2020-01-01 00:24:30,11,8,25986,4685,21301,39.65%,18.03%
2020-01-01 00:24:30,11,9,192,1,191,0.29%,0.52%
2020-01-01 00:24:30,11,10,2943,62,2881,4.49%,2.11%
2020-01-01 00:24:30,11,11,9810,699,9111,14.97%,7.13%
2020-01-01 00:24:30,11,12,6459,318,6141,9.86%,4.92%
2020-01-01 00:24:30,12,1,25,0,25,0.04%,0.00%
2020-01-01 00:24:30,12,2,509,134,375,0.78%,26.33%
2020-01-01 00:24:30,12,3,3223,235,2988,4.92%,7.29%
2020-01-01 00:24:30,12,4,3207,55,3152,4.89%,1.71%
2020-01-01 00:24:30,12,5,8675,661,8014,13.24%,7.62%
2020-01-01 00:24:30,12,6,4704,134,4570,7.18%,2.85%
2020-01-01 00:24:30,12,7,1377,13,1364,2.10%,0.94%
2020-01-01 00:24:30,12,8,1699,386,1313,2.59%,22.72%
2020-01-01 00:24:30,12,9,23572,4777,18795,35.97%,20.27%
2020-01-01 00:24:30,12,10,5166,538,4628,7.88%,10.41%
2020-01-01 00:24:30,12,11,2077,392,1685,3.17%,18.87%
2020-01-01 00:24:30,12,12,9159,1455,7704,13.98%,15.89%
2020-01-01 00:24:30,13,1,2071,38,2033,3.16%,1.83%
2020-01-01 00:24:30,13,2,2532,52,2480,3.86%,2.05%
2020-01-01 00:24:30,13,3,985,4,981,1.50%,0.41%
2020-01-01 00:24:30,13,4,4960,760,4200,7.57%,15.32%
2020-01-01 00:24:30,13,5,7564,1112,6452,11.54%,14.70%
2020-01-01 00:24:30,13,6,5558,799,4759,8.48%,14.38%
2020-01-01 00:24:30,13,7,4784,186,4598,7.30%,3.89%
2020-01-01 00:24:30,13,8,7454,423,7031,11.37%,5.67%
2020-01-01 00:24:30,13,9,7897,1153,6744,12.05%,14.60%
2020-01-01 00:24:30,13,10,30239,6705,23534,46.14%,22.17%
2020-01-01 00:24:30,13,11,18488,2636,15852,28.21%,14.26%
2020-01-01 00:24:30,13,12,10620,1084,9536,16.20%,10.21%
2020-01-01 00:24:30,14,1,398,1,397,0.61%,0.25%
2020-01-01 00:24:30,14,2,1574,13,1561,2.40%,0.83%
2020-01-01 00:24:30,14,3,1016,3,1013,1.55%,0.30%
2020-01-01 00:24:30,14,4,3834,101,3733,5.85%,2.63%
2020-01-01 00:24:30,14,5,1256,12,1244,1.92%,0.96%
2020-01-01 00:24:30,14,6,4296,129,4167,6.56%,3.00%
2020-01-01 00:24:30,14,7,12488,1099,11389,19.06%,8.80%
2020-01-01 00:24:30,14,8,14240,1414,12826,21.73%,9.93%
2020-01-01 00:24:30,14,9,1384,15,1369,2.11%,1.08%
2020-01-01 00:24:30,14,10,4467,149,4318,6.82%,3.34%
2020-01-01 00:24:30,14,11,27279,4910,22369,41.62%,18.00%
2020-01-01 00:24:30,14,12,8173,468,7705,12.47%,5.73%
2020-01-01 00:24:30,15,1,691,2,689,1.05%,0.29%
2020-01-01 00:24:30,15,2,214,0,214,0.33%,0.00%
2020-01-01 00:24:30,15,3,7755,463,7292,11.83%,5.97%
2020-01-01 00:24:30,15,4,4960,223,4737,7.57%,4.50%
2020-01-01 00:24:30,15,5,13714,1440,12274,20.93%,10.50%
2020-01-01 00:24:30,15,6,5270,282,4988,8.04%,5.35%
2020-01-01 00:24:30,15,7,3322,102,3220,5.07%,3.07%
2020-01-01 00:24:30,15,8,5449,241,5208,8.31%,4.42%
2020-01-01 00:24:30,15,9,13895,1476,12419,21.20%,10.62%
2020-01-01 00:24:30,15,10,4432,329,4103,6.76%,7.42%
2020-01-01 00:24:30,15,11,10090,979,9111,15.40%,9.70%
2020-01-01 00:24:30,15,12,29535,6330,23205,45.07%,21.43%
2020-01-01 00:24:30,16,1,409,3,406,0.62%,0.73%
2020-01-01 00:24:30,16,2,246,0,246,0.38%,0.00%
2020-01-01 00:24:30,16,3,2020,28,1992,3.08%,1.39%
2020-01-01 00:24:30,16,4,3767,108,3659,5.75%,2.87%
2020-01-01 00:24:30,16,5,8607,542,8065,13.13%,6.30%
2020-01-01 00:24:30,16,6,4730,169,4561,7.22%,3.57%
2020-01-01 00:24:30,16,7,3476,87,3389,5.30%,2.50%
2020-01-01 00:24:30,16,8,7610,513,7097,11.61%,6.74%
2020-01-01 00:24:30,16,9,9018,586,8432,13.76%,6.50%
2020-01-01 00:24:30,16,10,2235,31,2204,3.41%,1.39%
2020-01-01 00:24:30,16,11,10053,785,9268,15.34%,7.81%
2020-01-01 00:24:30,16,12,26679,4674,22005,40.71%,17.52%
2020-01-01 00:24:40,1,1,16694,1988,14706,25.47%,11.91%
2020-01-01 00:24:40,1,2,6853,323,6530,10.46%,4.71%
2020-01-01 00:24:40,1,3,1174,9,1165,1.79%,0.77%
2020-01-01 00:24:40,1,4,9374,687,8687,14.30%,7.33%
2020-01-01 00:24:40,1,5,9068,661,8407,13.84%,7.29%
2020-01-01 00:24:40,1,6,8971,648,8323,13.69%,7.22%
2020-01-01 00:24:40,1,7,5656,225,5431,8.63%,3.98%
2020-01-01 00:24:40,1,8,5010,170,4840,7.64%,3.39%
2020-01-01 00:24:40,1,9,8940,644,8296,13.64%,7.20%
2020-01-01 00:24:40,1,10,4510,139,4371,6.88%,3.08%
2020-01-01 00:24:40,1,11,4551,142,4409,6.94%,3.12%
2020-01-01 00:24:40,1,12,8543,595,7948,13.04%,6.96%
2020-01-01 00:24:40,2,1,603,4,599,0.92%,0.66%
2020-01-01 00:24:40,2,2,29615,5792,23823,45.19%,19.56%
2020-01-01 00:24:40,2,3,23845,3895,19950,36.38%,16.33%
2020-01-01 00:24:40,2,4,573,4,569,0.87%,0.70%
2020-01-01 00:24:40,2,5,13113,1272,11841,20.01%,9.70%
2020-01-01 00:24:40,2,6,11,0,11,0.02%,0.00%
2020-01-01 00:24:40,2,7,5152,221,4931,7.86%,4.29%
2020-01-01 00:24:40,2,8,4182,152,4030,6.38%,3.63%
2020-01-01 00:24:40,2,9,13067,1257,11810,19.94%,9.62%
2020-01-01 00:24:40,2,10,3497,105,3392,5.34%,3.00%
2020-01-01 00:24:40,2,11,3511,106,3405,5.36%,3.02%
2020-01-01 00:24:40,2,12,12876,1219,11657,19.65%,9.47%
2020-01-01 00:24:40,3,1,1327,19,1308,2.02%,1.43%
2020-01-01 00:24:40,3,2,26647,4658,21989,40.66%,17.48%
2020-01-01 00:24:40,3,3,75920,31024,44896,115.84%,40.86%
2020-01-01 00:24:40,3,4,13254,1291,11963,20.22%,9.74%
2020-01-01 00:24:40,3,5,45932,13021,32911,70.09%,28.35%
2020-01-01 00:24:40,3,6,14560,1533,13027,22.22%,10.53%
2020-01-01 00:24:40,3,7,23244,3574,19670,35.47%,15.38%
2020-01-01 00:24:40,3,8,19144,2480,16664,29.21%,12.95%
2020-01-01 00:24:40,3,9,31077,6368,24709,47.42%,20.49%
2020-01-01 00:24:40,3,10,2707,50,2657,4.13%,1.85%
2020-01-01 00:24:40,3,11,1955,24,1931,2.98%,1.23%
2020-01-01 00:24:40,3,12,24491,4096,20395,37.37%,16.72%
2020-01-01 00:24:40,4,1,520,1,519,0.79%,0.19%
2020-01-01 00:24:40,4,2,345,0,345,0.53%,0.00%
2020-01-01 00:24:40,4,3,749,5,744,1.14%,0.67%
2020-01-01 00:24:40,4,4,27617,5058,22559,42.14%,18.31%
2020-01-01 00:24:40,4,5,17098,2058,15040,26.09%,12.04%
2020-01-01 00:24:40,4,6,24112,3888,20224,36.79%,16.12%
2020-01-01 00:24:40,4,7,5567,232,5335,8.49%,4.17%
2020-01-01 00:24:40,4,8,3315,74,3241,5.06%,2.23%
2020-01-01 00:24:40,4,9,15323,1640,13683,23.38%,10.70%
2020-01-01 00:24:40,4,10,2195,36,2159,3.35%,1.64%
2020-01-01 00:24:40,4,11,91,0,91,0.14%,0.00%
2020-01-01 00:24:40,4,12,12375,1090,11285,18.88%,8.81%
2020-01-01 00:24:40,5,1,3958,115,3843,6.04%,2.91%
2020-01-01 00:24:40,5,2,1651,23,1628,2.52%,1.39%
2020-01-01 00:24:40,5,3,571,4,567,0.87%,0.70%
2020-01-01 00:24:40,5,4,24280,4074,20206,37.05%,16.78%
2020-01-01 00:24:40,5,5,10099,805,9294,15.41%,7.97%
2020-01-01 00:24:40,5,6,15456,1789,13667,23.58%,11.57%
2020-01-01 00:24:40,5,7,4894,192,4702,7.47%,3.92%
2020-01-01 00:24:40,5,8,3495,87,3408,5.33%,2.49%
2020-01-01 00:24:40,5,9,9344,686,8658,14.26%,7.34%
2020-01-01 00:24:40,5,10,1425,15,1410,2.17%,1.05%
2020-01-01 00:24:40,5,11,610,4,606,0.93%,0.66%
2020-01-01 00:24:40,5,12,7640,465,7175,11.66%,6.09%
2020-01-01 00:24:40,6,1,1107,10,1097,1.69%,0.90%
2020-01-01 00:24:40,6,2,1153,12,1141,1.76%,1.04%
2020-01-01 00:24:40,6,3,1836,30,1806,2.80%,1.63%
2020-01-01 00:24:40,6,4,1339,28,1311,2.04%,2.09%
2020-01-01 00:24:40,6,5,13891,1436,12455,21.20%,10.34%
2020-01-01 00:24:40,6,6,4174,168,4006,6.37%,4.02%
2020-01-01 00:24:40,6,7,2345,49,2296,3.58%,2.09%
2020-01-01 00:24:40,6,8,1872,33,1839,2.86%,1.76%
2020-01-01 00:24:40,6,9,7580,433,7147,11.57%,5.71%
2020-01-01 00:24:40,6,10,2343,51,2292,3.58%,2.18%
2020-01-01 00:24:40,6,11,477,3,474,0.73%,0.63%
2020-01-01 00:24:40,6,12,5169,193,4976,7.89%,3.73%
2020-01-01 00:24:40,7,1,558,11,547,0.85%,1.97%
2020-01-01 00:24:40,7,2,163,2,161,0.25%,1.23%
2020-01-01 00:24:40,7,3,810,4,806,1.24%,0.49%
2020-01-01 00:24:40,7,4,1858,42,1816,2.84%,2.26%
2020-01-01 00:24:40,7,5,9132,598,8534,13.93%,6.55%
2020-01-01 00:24:40,7,6,14586,1526,13060,22.26%,10.46%
2020-01-01 00:24:40,7,7,3563,118,3445,5.44%,3.31%
2020-01-01 00:24:40,7,8,1454,19,1435,2.22%,1.31%
2020-01-01 00:24:40,7,9,8237,504,7733,12.57%,6.12%
2020-01-01 00:24:40,7,10,1610,24,1586,2.46%,1.49%
2020-01-01 00:24:40,7,11,111,0,111,0.17%,0.00%
2020-01-01 00:24:40,7,12,6659,332,6327,10.16%,4.99%
2020-01-01 00:24:40,8,1,428,1,427,0.65%,0.23%
2020-01-01 00:24:40,8,2,74,0,74,0.11%,0.00%
2020-01-01 00:24:40,8,3,1710,35,1675,2.61%,2.05%
2020-01-01 00:24:40,8,4,3065,71,2994,4.68%,2.32%
2020-01-01 00:24:40,8,5,8232,521,7711,12.56%,6.33%
2020-01-01 00:24:40,8,6,15754,1841,13913,24.04%,11.69%
2020-01-01 00:24:40,8,7,4424,140,4284,6.75%,3.16%
2020-01-01 00:24:40,8,8,1869,24,1845,2.85%,1.28%
2020-01-01 00:24:40,8,9,6298,293,6005,9.61%,4.65%
2020-01-01 00:24:40,8,10,1459,11,1448,2.23%,0.75%
2020-01-01 00:24:40,8,11,245,0,245,0.37%,0.00%
2020-01-01 00:24:40,8,12,4782,178,4604,7.30%,3.72%
2020-01-01 00:24:40,9,1,422,2,420,0.64%,0.47%
2020-01-01 00:24:40,9,2,1953,40,1913,2.98%,2.05%
2020-01-01 00:24:40,9,3,1129,8,1121,1.72%,0.71%
2020-01-01 00:24:40,9,4,7720,427,7293,11.78%,5.53%
2020-01-01 00:24:40,9,5,201,1,200,0.31%,0.50%
2020-01-01 00:24:40,9,6,8762,542,8220,13.37%,6.19%
2020-01-01 00:24:40,9,7,27918,5205,22713,42.60%,18.64%
2020-01-01 00:24:40,9,8,11197,911,10286,17.09%,8.14%
2020-01-01 00:24:40,9,9,153,1,152,0.23%,0.65%
2020-01-01 00:24:40,9,10,4081,107,3974,6.23%,2.62%
2020-01-01 00:24:40,9,11,10133,755,9378,15.46%,7.45%
2020-01-01 00:24:40,9,12,5770,246,5524,8.80%,4.26%
2020-01-01 00:24:40,10,1,1492,172,1320,2.28%,11.53%
2020-01-01 00:24:40,10,2,3169,218,2951,4.84%,6.88%
2020-01-01 00:24:40,10,3,1499,11,1488,2.29%,0.73%
2020-01-01 00:24:40,10,4,3966,820,3146,6.05%,20.68%
2020-01-01 00:24:40,10,5,1159,20,1139,1.77%,1.73%
2020-01-01 00:24:40,10,6,6304,987,5317,9.62%,15.66%
2020-01-01 00:24:40,10,7,11588,1740,9848,17.68%,15.02%
2020-01-01 00:24:40,10,8,29400,7051,22349,44.86%,23.98%
2020-01-01 00:24:40,10,9,848,3,845,1.29%,0.35%
2020-01-01 00:24:40,10,10,2722,49,2673,4.15%,1.80%
2020-01-01 00:24:40,10,11,14506,1905,12601,22.13%,13.13%
2020-01-01 00:24:40,10,12,10922,1288,9634,16.67%,11.79%
2020-01-01 00:24:40,11,1,2556,55,2501,3.90%,2.15%
2020-01-01 00:24:40,11,2,4779,159,4620,7.29%,3.33%
2020-01-01 00:24:40,11,3,2061,31,2030,3.14%,1.50%
2020-01-01 00:24:40,11,4,3641,145,3496,5.56%,3.98%
2020-01-01 00:24:40,11,5,219,1,218,0.33%,0.46%
2020-01-01 00:24:40,11,6,4431,190,4241,6.76%,4.29%
2020-01-01 00:24:40,11,7,11065,906,10159,16.88%,8.19%
2020-01-01 00:24:40,11,8,24517,4037,20480,37.41%,16.47%
2020-01-01 00:24:40,11,9,221,0,221,0.34%,0.00%
2020-01-01 00:24:40,11,10,3448,95,3353,5.26%,2.76%
2020-01-01 00:24:40,11,11,10179,742,9437,15.53%,7.29%
2020-01-01 00:24:40,11,12,6401,303,6098,9.77%,4.73%
2020-01-01 00:24:40,12,1,52,0,52,0.08%,0.00%
2020-01-01 00:24:40,12,2,589,211,378,0.90%,35.82%
2020-01-01 00:24:40,12,3,2663,280,2383,4.06%,10.51%
2020-01-01 00:24:40,12,4,2640,66,2574,4.03%,2.50%
2020-01-01 00:24:40,12,5,9009,800,8209,13.75%,8.88%
2020-01-01 00:24:40,12,6,5328,242,5086,8.13%,4.54%
2020-01-01 00:24:40,12,7,2541,48,2493,3.88%,1.89%
2020-01-01 00:24:40,12,8,1414,271,1143,2.16%,19.17%
2020-01-01 00:24:40,12,9,21225,4249,16976,32.39%,20.02%
2020-01-01 00:24:40,12,10,3939,396,3543,6.01%,10.05%
2020-01-01 00:24:40,12,11,1763,283,1480,2.69%,16.05%
2020-01-01 00:24:40,12,12,7550,1100,6450,11.52%,14.57%
2020-01-01 00:24:40,13,1,2280,41,2239,3.48%,1.80%
2020-01-01 00:24:40,13,2,2523,53,2470,3.85%,2.10%
2020-01-01 00:24:40,13,3,769,3,766,1.17%,0.39%
2020-01-01 00:24:40,13,4,4945,531,4414,7.55%,10.74%
2020-01-01 00:24:40,13,5,7107,747,6360,10.84%,10.51%
2020-01-01 00:24:40,13,6,5624,579,5045,8.58%,10.30%
2020-01-01 00:24:40,13,7,5004,185,4819,7.64%,3.70%
2020-01-01 00:24:40,13,8,7686,430,7256,11.73%,5.59%
2020-01-01 00:24:40,13,9,7334,772,6562,11.19%,10.53%
2020-01-01 00:24:40,13,10,27448,5604,21844,41.88%,20.42%
2020-01-01 00:24:40,13,11,17309,2390,14919,26.41%,13.81%
2020-01-01 00:24:40,13,12,9165,967,8198,13.98%,10.55%
2020-01-01 00:24:40,14,1,227,0,227,0.35%,0.00%
2020-01-01 00:24:40,14,2,1473,14,1459,2.25%,0.95%
2020-01-01 00:24:40,14,3,1078,7,1071,1.64%,0.65%
2020-01-01 00:24:40,14,4,4924,158,4766,7.51%,3.21%
2020-01-01 00:24:40,14,5,1563,15,1548,2.38%,0.96%
2020-01-01 00:24:40,14,6,5312,185,5127,8.11%,3.48%
2020-01-01 00:24:40,14,7,13148,1230,11918,20.06%,9.36%
2020-01-01 00:24:40,14,8,14584,1483,13101,22.25%,10.17%
2020-01-01 00:24:40,14,9,1749,19,1730,2.67%,1.09%
2020-01-01 00:24:40,14,10,4095,121,3974,6.25%,2.95%
2020-01-01 00:24:40,14,11,28574,5301,23273,43.60%,18.55%
2020-01-01 00:24:40,14,12,9683,678,9005,14.78%,7.00%
2020-01-01 00:24:40,15,1,631,8,623,0.96%,1.27%
2020-01-01 00:24:40,15,2,181,1,180,0.28%,0.55%
2020-01-01 00:24:40,15,3,4144,139,4005,6.32%,3.35%
2020-01-01 00:24:40,15,4,5166,192,4974,7.88%,3.72%
2020-01-01 00:24:40,15,5,10850,848,10002,16.56%,7.82%
2020-01-01 00:24:40,15,6,5396,210,5186,8.23%,3.89%
2020-01-01 00:24:40,15,7,3983,157,3826,6.08%,3.94%
2020-01-01 00:24:40,15,8,5940,307,5633,9.06%,5.17%
2020-01-01 00:24:40,15,9,11038,868,10170,16.84%,7.86%
2020-01-01 00:24:40,15,10,3448,103,3345,5.26%,2.99%
2020-01-01 00:24:40,15,11,9522,686,8836,14.53%,7.20%
2020-01-01 00:24:40,15,12,25764,4770,20994,39.31%,18.51%
2020-01-01 00:24:40,16,1,425,1,424,0.65%,0.24%
2020-01-01 00:24:40,16,2,231,0,231,0.35%,0.00%
2020-01-01 00:24:40,16,3,1426,11,1415,2.18%,0.77%
2020-01-01 00:24:40,16,4,3789,111,3678,5.78%,2.93%
2020-01-01 00:24:40,16,5,7570,450,7120,11.55%,5.94%
2020-01-01 00:24:40,16,6,4621,165,4456,7.05%,3.57%
2020-01-01 00:24:40,16,7,3655,107,3548,5.58%,2.93%
2020-01-01 00:24:40,16,8,9159,688,8471,13.98%,7.51%
2020-01-01 00:24:40,16,9,7943,483,7460,12.12%,6.08%
2020-01-01 00:24:40,16,10,1413,11,1402,2.16%,0.78%
2020-01-01 00:24:40,16,11,10755,867,9888,16.41%,8.06%
2020-01-01 00:24:40,16,12,26716,4963,21753,40.77%,18.58%
2020-01-01 00:24:50,1,1,16063,1895,14168,24.51%,11.80%
2020-01-01 00:24:50,1,2,7141,412,6729,10.90%,5.77%
2020-01-01 00:24:50,1,3,1387,10,1377,2.12%,0.72%
2020-01-01 00:24:50,1,4,8548,602,7946,13.04%,7.04%
2020-01-01 00:24:50,1,5,7959,510,7449,12.14%,6.41%
2020-01-01 00:24:50,1,6,7848,501,7347,11.98%,6.38%
2020-01-01 00:24:50,1,7,5748,267,5481,8.77%,4.65%
2020-01-01 00:24:50,1,8,4791,172,4619,7.31%,3.59%
2020-01-01 00:24:50,1,9,7809,495,7314,11.92%,6.34%
2020-01-01 00:24:50,1,10,4230,135,4095,6.45%,3.19%
2020-01-01 00:24:50,1,11,4292,138,4154,6.55%,3.22%
2020-01-01 00:24:50,1,12,7784,488,7296,11.88%,6.27%
2020-01-01 00:24:50,2,1,743,3,740,1.13%,0.40%
2020-01-01 00:24:50,2,2,31323,6405,24918,47.80%,20.45%
2020-01-01 00:24:50,2,3,23821,3867,19954,36.35%,16.23%
2020-01-01 00:24:50,2,4,676,3,673,1.03%,0.44%
2020-01-01 00:24:50,2,5,14132,1442,12690,21.56%,10.20%
2020-01-01 00:24:50,2,6,28,0,28,0.04%,0.00%
2020-01-01 00:24:50,2,7,6746,319,6427,10.29%,4.73%
2020-01-01 00:24:50,2,8,5408,209,5199,8.25%,3.86%
2020-01-01 00:24:50,2,9,14030,1386,12644,21.41%,9.88%
2020-01-01 00:24:50,2,10,4627,163,4464,7.06%,3.52%
2020-01-01 00:24:50,2,11,4637,163,4474,7.08%,3.52%
2020-01-01 00:24:50,2,12,13868,1359,12509,21.16%,9.80%
2020-01-01 00:24:50,3,1,1765,30,1735,2.69%,1.70%
2020-01-01 00:24:50,3,2,23351,3777,19574,35.63%,16.17%
2020-01-01 00:24:50,3,3,64293,23253,41040,98.10%,36.17%
2020-01-01 00:24:50,3,4,6908,348,6560,10.54%,5.04%
2020-01-01 00:24:50,3,5,39895,9985,29910,60.87%,25.03%
2020-01-01 00:24:50,3,6,8201,475,7726,12.51%,5.79%
2020-01-01 00:24:50,3,7,19655,2723,16932,29.99%,13.85%
2020-01-01 00:24:50,3,8,15262,1660,13602,23.29%,10.88%
2020-01-01 00:24:50,3,9,31390,6466,24924,47.90%,20.60%
2020-01-01 00:24:50,3,10,4004,111,3893,6.11%,2.77%
2020-01-01 00:24:50,3,11,1827,33,1794,2.79%,1.81%
2020-01-01 00:24:50,3,12,24844,4136,20708,37.91%,16.65%
2020-01-01 00:24:50,4,1,502,3,499,0.77%,0.60%
2020-01-01 00:24:50,4,2,278,1,277,0.42%,0.36%
2020-01-01 00:24:50,4,3,795,3,792,1.21%,0.38%
2020-01-01 00:24:50,4,4,29200,5589,23611,44.56%,19.14%
2020-01-01 00:24:50,4,5,18020,2305,15715,27.50%,12.79%
2020-01-01 00:24:50,4,6,25360,4289,21071,38.70%,16.91%
2020-01-01 00:24:50,4,7,5905,239,5666,9.01%,4.05%
2020-01-01 00:24:50,4,8,3230,88,3142,4.93%,2.72%
2020-01-01 00:24:50,4,9,15977,1846,14131,24.38%,11.55%
2020-01-01 00:24:50,4,10,2439,40,2399,3.72%,1.64%
2020-01-01 00:24:50,4,11,125,0,125,0.19%,0.00%
2020-01-01 00:24:50,4,12,12756,1192,11564,19.46%,9.34%
2020-01-01 00:24:50,5,1,3355,73,3282,5.12%,2.18%
2020-01-01 00:24:50,5,2,1025,9,1016,1.56%,0.88%
2020-01-01 00:24:50,5,3,405,3,402,0.62%,0.74%
2020-01-01 00:24:50,5,4,25319,4377,20942,38.63%,17.29%
2020-01-01 00:24:50,5,5,9823,740,9083,14.99%,7.53%
2020-01-01 00:24:50,5,6,15026,1656,13370,22.93%,11.02%
2020-01-01 00:24:50,5,7,4681,186,4495,7.14%,3.97%
2020-01-01 00:24:50,5,8,3724,107,3617,5.68%,2.87%
2020-01-01 00:24:50,5,9,9252,664,8588,14.12%,7.18%
2020-01-01 00:24:50,5,10,1077,16,1061,1.64%,1.49%
2020-01-01 00:24:50,5,11,632,4,628,0.96%,0.63%
2020-01-01 00:24:50,5,12,8027,499,7528,12.25%,6.22%
2020-01-01 00:24:50,6,1,1218,9,1209,1.86%,0.74%
2020-01-01 00:24:50,6,2,1276,9,1267,1.95%,0.71%
2020-01-01 00:24:50,6,3,1869,19,1850,2.85%,1.02%
2020-01-01 00:24:50,6,4,1388,9,1379,2.12%,0.65%
2020-01-01 00:24:50,6,5,14984,1574,13410,22.86%,10.50%
2020-01-01 00:24:50,6,6,3980,104,3876,6.07%,2.61%
2020-01-01 00:24:50,6,7,2173,38,2135,3.32%,1.75%
2020-01-01 00:24:50,6,8,1716,23,1693,2.62%,1.34%
2020-01-01 00:24:50,6,9,8823,576,8247,13.46%,6.53%
2020-01-01 00:24:50,6,10,3042,51,2991,4.64%,1.68%
2020-01-01 00:24:50,6,11,421,1,420,0.64%,0.24%
2020-01-01 00:24:50,6,12,5681,256,5425,8.67%,4.51%
2020-01-01 00:24:50,7,1,344,2,342,0.52%,0.58%
2020-01-01 00:24:50,7,2,180,0,180,0.27%,0.00%
2020-01-01 00:24:50,7,3,1024,6,1018,1.56%,0.59%
2020-01-01 00:24:50,7,4,1541,17,1524,2.35%,1.10%
2020-01-01 00:24:50,7,5,9028,618,8410,13.78%,6.85%
2020-01-01 00:24:50,7,6,14095,1422,12673,21.51%,10.09%
2020-01-01 00:24:50,7,7,3492,80,3412,5.33%,2.29%
2020-01-01 00:24:50,7,8,1160,9,1151,1.77%,0.78%
2020-01-01 00:24:50,7,9,7922,478,7444,12.09%,6.03%
2020-01-01 00:24:50,7,10,1444,18,1426,2.20%,1.25%
2020-01-01 00:24:50,7,11,97,0,97,0.15%,0.00%
2020-01-01 00:24:50,7,12,6523,333,6190,9.95%,5.11%
2020-01-01 00:24:50,8,1,370,1,369,0.56%,0.27%
2020-01-01 00:24:50,8,2,204,2,202,0.31%,0.98%
2020-01-01 00:24:50,8,3,1834,21,1813,2.80%,1.15%
2020-01-01 00:24:50,8,4,2909,62,2847,4.44%,2.13%
2020-01-01 00:24:50,8,5,8778,553,8225,13.39%,6.30%
2020-01-01 00:24:50,8,6,16698,1974,14724,25.48%,11.82%
2020-01-01 00:24:50,8,7,4899,180,4719,7.48%,3.67%
2020-01-01 00:24:50,8,8,1671,30,1641,2.55%,1.80%
2020-01-01 00:24:50,8,9,6623,317,6306,10.11%,4.79%
2020-01-01 00:24:50,8,10,1641,19,1622,2.50%,1.16%
2020-01-01 00:24:50,8,11,226,0,226,0.34%,0.00%
2020-01-01 00:24:50,8,12,4893,177,4716,7.47%,3.62%
2020-01-01 00:24:50,9,1,452,0,452,0.69%,0.00%
2020-01-01 00:24:50,9,2,4100,118,3982,6.26%,2.88%
2020-01-01 00:24:50,9,3,3144,70,3074,4.80%,2.23%
2020-01-01 00:24:50,9,4,5535,217,5318,8.45%,3.92%
2020-01-01 00:24:50,9,5,287,0,287,0.44%,0.00%
2020-01-01 00:24:50,9,6,6229,268,5961,9.50%,4.30%
2020-01-01 00:24:50,9,7,29556,5697,23859,45.10%,19.28%
2020-01-01 00:24:50,9,8,12561,1120,11441,19.17%,8.92%
2020-01-01 00:24:50,9,9,183,0,183,0.28%,0.00%
2020-01-01 00:24:50,9,10,4520,141,4379,6.90%,3.12%
2020-01-01 00:24:50,9,11,11122,887,10235,16.97%,7.98%
2020-01-01 00:24:50,9,12,6273,312,5961,9.57%,4.97%
2020-01-01 00:24:50,10,1,1188,190,998,1.81%,15.99%
2020-01-01 00:24:50,10,2,3820,273,3547,5.83%,7.15%
2020-01-01 00:24:50,10,3,2445,37,2408,3.73%,1.51%
2020-01-01 00:24:50,10,4,5586,834,4752,8.52%,14.93%
2020-01-01 00:24:50,10,5,1085,18,1067,1.66%,1.66%
2020-01-01 00:24:50,10,6,7873,1042,6831,12.01%,13.24%
2020-01-01 00:24:50,10,7,13516,1942,11574,20.62%,14.37%
2020-01-01 00:24:50,10,8,32185,7934,24251,49.11%,24.65%
2020-01-01 00:24:50,10,9,948,6,942,1.45%,0.63%
2020-01-01 00:24:50,10,10,2882,70,2812,4.40%,2.43%
2020-01-01 00:24:50,10,11,14588,1851,12737,22.26%,12.69%
2020-01-01 00:24:50,10,12,10747,1198,9549,16.40%,11.15%
2020-01-01 00:24:50,11,1,2185,39,2146,3.33%,1.78%
2020-01-01 00:24:50,11,2,3237,81,3156,4.94%,2.50%
2020-01-01 00:24:50,11,3,859,3,856,1.31%,0.35%
2020-01-01 00:24:50,11,4,5766,261,5505,8.80%,4.53%
2020-01-01 00:24:50,11,5,265,1,264,0.40%,0.38%
2020-01-01 00:24:50,11,6,6602,339,6263,10.07%,5.13%
2020-01-01 00:24:50,11,7,11487,984,10503,17.53%,8.57%
2020-01-01 00:24:50,11,8,25735,4481,21254,39.27%,17.41%
2020-01-01 00:24:50,11,9,165,0,165,0.25%,0.00%
2020-01-01 00:24:50,11,10,3162,70,3092,4.82%,2.21%
2020-01-01 00:24:50,11,11,10206,743,9463,15.57%,7.28%
2020-01-01 00:24:50,11,12,6530,299,6231,9.96%,4.58%
2020-01-01 00:24:50,12,1,54,0,54,0.08%,0.00%
2020-01-01 00:24:50,12,2,560,176,384,0.85%,31.43%
2020-01-01 00:24:50,12,3,2449,207,2242,3.74%,8.45%
2020-01-01 00:24:50,12,4,3080,111,2969,4.70%,3.60%
2020-01-01 00:24:50,12,5,10752,1079,9673,16.41%,10.04%
2020-01-01 00:24:50,12,6,7330,485,6845,11.18%,6.62%
2020-01-01 00:24:50,12,7,4078,134,3944,6.22%,3.29%
2020-01-01 00:24:50,12,8,1505,274,1231,2.30%,18.21%
2020-01-01 00:24:50,12,9,23311,4803,18508,35.57%,20.60%
2020-01-01 00:24:50,12,10,4170,394,3776,6.36%,9.45%
2020-01-01 00:24:50,12,11,1984,280,1704,3.03%,14.11%
2020-01-01 00:24:50,12,12,7722,1136,6586,11.78%,14.71%
2020-01-01 00:24:50,13,1,2749,61,2688,4.19%,2.22%
2020-01-01 00:24:50,13,2,3016,69,2947,4.60%,2.29%
2020-01-01 00:24:50,13,3,879,6,873,1.34%,0.68%
2020-01-01 00:24:50,13,4,5329,574,4755,8.13%,10.77%
2020-01-01 00:24:50,13,5,8266,893,7373,12.61%,10.80%
2020-01-01 00:24:50,13,6,6611,679,5932,10.09%,10.27%
2020-01-01 00:24:50,13,7,5226,209,5017,7.97%,4.00%
2020-01-01 00:24:50,13,8,7281,408,6873,11.11%,5.60%
2020-01-01 00:24:50,13,9,8504,912,7592,12.98%,10.72%
2020-01-01 00:24:50,13,10,28527,5906,22621,43.53%,20.70%
2020-01-01 00:24:50,13,11,17169,2356,14813,26.20%,13.72%
2020-01-01 00:24:50,13,12,9436,1015,8421,14.40%,10.76%
2020-01-01 00:24:50,14,1,256,0,256,0.39%,0.00%
2020-01-01 00:24:50,14,2,1828,30,1798,2.79%,1.64%
2020-01-01 00:24:50,14,3,1361,21,1340,2.08%,1.54%
2020-01-01 00:24:50,14,4,3974,163,3811,6.06%,4.10%
2020-01-01 00:24:50,14,5,1355,11,1344,2.07%,0.81%
2020-01-01 00:24:50,14,6,4304,188,4116,6.57%,4.37%
2020-01-01 00:24:50,14,7,12731,1179,11552,19.43%,9.26%
2020-01-01 00:24:50,14,8,14170,1481,12689,21.62%,10.45%
2020-01-01 00:24:50,14,9,1562,14,1548,2.38%,0.90%
2020-01-01 00:24:50,14,10,3966,117,3849,6.05%,2.95%
2020-01-01 00:24:50,14,11,26128,4580,21548,39.87%,17.53%
2020-01-01 00:24:50,14,12,7816,427,7389,11.93%,5.46%
2020-01-01 00:24:50,15,1,603,4,599,0.92%,0.66%
2020-01-01 00:24:50,15,2,204,0,204,0.31%,0.00%
2020-01-01 00:24:50,15,3,4068,117,3951,6.21%,2.88%
2020-01-01 00:24:50,15,4,6633,326,6307,10.12%,4.91%
2020-01-01 00:24:50,15,5,12220,1057,11163,18.65%,8.65%
2020-01-01 00:24:50,15,6,6927,351,6576,10.57%,5.07%
2020-01-01 00:24:50,15,7,3989,113,3876,6.09%,2.83%
2020-01-01 00:24:50,15,8,5955,251,5704,9.09%,4.21%
2020-01-01 00:24:50,15,9,12434,1088,11346,18.97%,8.75%
2020-01-01 00:24:50,15,10,3866,126,3740,5.90%,3.26%
2020-01-01 00:24:50,15,11,10065,751,9314,15.36%,7.46%
2020-01-01 00:24:50,15,12,27483,5239,22244,41.94%,19.06%
2020-01-01 00:24:50,16,1,393,1,392,0.60%,0.25%
2020-01-01 00:24:50,16,2,261,0,261,0.40%,0.00%
2020-01-01 00:24:50,16,3,1398,29,1369,2.13%,2.07%
2020-01-01 00:24:50,16,4,4183,136,4047,6.38%,3.25%
2020-01-01 00:24:50,16,5,7938,511,7427,12.11%,6.44%
2020-01-01 00:24:50,16,6,5065,190,4875,7.73%,3.75%
2020-01-01 00:24:50,16,7,3531,80,3451,5.39%,2.27%
2020-01-01 00:24:50,16,8,7102,429,6673,10.84%,6.04%
2020-01-01 00:24:50,16,9,8314,554,7760,12.69%,6.66%
2020-01-01 00:24:50,16,10,1552,16,1536,2.37%,1.03%
2020-01-01 00:24:50,16,11,8859,626,8233,13.52%,7.07%
2020-01-01 00:24:50,16,12,24991,4400,20591,38.13%,17.61%
2020-01-01 00:25:00,1,1,22574,3495,19079,34.45%,15.48%
2020-01-01 00:25:00,1,2,10905,819,10086,16.64%,7.51%
2020-01-01 00:25:00,1,3,1382,12,1370,2.11%,0.87%
2020-01-01 00:25:00,1,4,11320,992,10328,17.27%,8.76%
2020-01-01 00:25:00,1,5,11115,953,10162,16.96%,8.57%
2020-01-01 00:25:00,1,6,11061,944,10117,16.88%,8.53%
2020-01-01 00:25:00,1,7,9513,635,8878,14.52%,6.68%
2020-01-01 00:25:00,1,8,8270,478,7792,12.62%,5.78%
2020-01-01 00:25:00,1,9,11029,937,10092,16.83%,8.50%
2020-01-01 00:25:00,1,10,7651,402,7249,11.67%,5.25%
2020-01-01 00:25:00,1,11,7723,414,7309,11.78%,5.36%
2020-01-01 00:25:00,1,12,10998,932,10066,16.78%,8.47%
2020-01-01 00:25:00,2,1,1479,4,1475,2.26%,0.27%
2020-01-01 00:25:00,2,2,25247,4217,21030,38.52%,16.70%
2020-01-01 00:25:00,2,3,19232,2573,16659,29.35%,13.38%
2020-01-01 00:25:00,2,4,1415,3,1412,2.16%,0.21%
2020-01-01 00:25:00,2,5,12913,1222,11691,19.70%,9.46%
2020-01-01 00:25:00,2,6,50,0,50,0.08%,0.00%
2020-01-01 00:25:00,2,7,4520,164,4356,6.90%,3.63%
2020-01-01 00:25:00,2,8,2888,70,2818,4.41%,2.42%
2020-01-01 00:25:00,2,9,12825,1206,11619,19.57%,9.40%
2020-01-01 00:25:00,2,10,2100,43,2057,3.20%,2.05%
2020-01-01 00:25:00,2,11,2111,44,2067,3.22%,2.08%
2020-01-01 00:25:00,2,12,12654,1175,11479,19.31%,9.29%
2020-01-01 00:25:00,3,1,1569,15,1554,2.39%,0.96%
2020-01-01 00:25:00,3,2,26151,4599,21552,39.90%,17.59%
2020-01-01 00:25:00,3,3,76662,31390,45272,116.98%,40.95%
2020-01-01 00:25:00,3,4,10536,844,9692,16.08%,8.01%
2020-01-01 00:25:00,3,5,49280,14593,34687,75.20%,29.61%
2020-01-01 00:25:00,3,6,12203,1121,11082,18.62%,9.19%
2020-01-01 00:25:00,3,7,23086,3673,19413,35.23%,15.91%
2020-01-01 00:25:00,3,8,20645,2991,17654,31.50%,14.49%
2020-01-01 00:25:00,3,9,36753,8685,28068,56.08%,23.63%
2020-01-01 00:25:00,3,10,8976,581,8395,13.70%,6.47%
2020-01-01 00:25:00,3,11,1945,26,1919,2.97%,1.34%
2020-01-01 00:25:00,3,12,25974,4604,21370,39.63%,17.73%
2020-01-01 00:25:00,4,1,445,2,443,0.68%,0.45%
2020-01-01 00:25:00,4,2,315,2,313,0.48%,0.63%
2020-01-01 00:25:00,4,3,1275,6,1269,1.95%,0.47%
2020-01-01 00:25:00,4,4,29828,5902,23926,45.51%,19.79%
2020-01-01 00:25:00,4,5,17975,2285,15690,27.43%,12.71%
2020-01-01 00:25:00,4,6,25170,4346,20824,38.41%,17.27%
2020-01-01 00:25:00,4,7,5756,264,5492,8.78%,4.59%
2020-01-01 00:25:00,4,8,2971,68,2903,4.53%,2.29%
2020-01-01 00:25:00,4,9,15508,1730,13778,23.66%,11.16%
2020-01-01 00:25:00,4,10,1972,52,1920,3.01%,2.64%
2020-01-01 00:25:00,4,11,135,0,135,0.21%,0.00%
2020-01-01 00:25:00,4,12,12852,1209,11643,19.61%,9.41%
2020-01-01 00:25:00,5,1,2207,37,2170,3.37%,1.68%
2020-01-01 00:25:00,5,2,696,1,695,1.06%,0.14%
2020-01-01 00:25:00,5,3,506,4,502,0.77%,0.79%
2020-01-01 00:25:00,5,4,22253,3288,18965,33.96%,14.78%
2020-01-01 00:25:00,5,5,8718,555,8163,13.30%,6.37%
2020-01-01 00:25:00,5,6,16040,1805,14235,24.48%,11.25%
2020-01-01 00:25:00,5,7,6831,340,6491,10.42%,4.98%
2020-01-01 00:25:00,5,8,3784,119,3665,5.77%,3.14%
2020-01-01 00:25:00,5,9,8012,462,7550,12.23%,5.77%
2020-01-01 00:25:00,5,10,1153,12,1141,1.76%,1.04%
2020-01-01 00:25:00,5,11,885,12,873,1.35%,1.36%
2020-01-01 00:25:00,5,12,6591,330,6261,10.06%,5.01%
2020-01-01 00:25:00,6,1,974,7,967,1.49%,0.72%
2020-01-01 00:25:00,6,2,1098,8,1090,1.68%,0.73%
2020-01-01 00:25:00,6,3,1871,26,1845,2.85%,1.39%
2020-01-01 00:25:00,6,4,1180,11,1169,1.80%,0.93%
2020-01-01 00:25:00,6,5,16480,1839,14641,25.15%,11.16%
2020-01-01 00:25:00,6,6,3975,106,3869,6.07%,2.67%
2020-01-01 00:25:00,6,7,2494,47,2447,3.81%,1.88%
2020-01-01 00:25:00,6,8,1957,33,1924,2.99%,1.69%
2020-01-01 00:25:00,6,9,10327,747,9580,15.76%,7.23%
2020-01-01 00:25:00,6,10,2026,33,1993,3.09%,1.63%
2020-01-01 00:25:00,6,11,330,0,330,0.50%,0.00%
2020-01-01 00:25:00,6,12,8254,454,7800,12.59%,5.50%
2020-01-01 00:25:00,7,1,427,0,427,0.65%,0.00%
2020-01-01 00:25:00,7,2,192,0,192,0.29%,0.00%
2020-01-01 00:25:00,7,3,1589,12,1577,2.42%,0.76%
2020-01-01 00:25:00,7,4,1891,33,1858,2.89%,1.75%
2020-01-01 00:25:00,7,5,8853,554,8299,13.51%,6.26%
2020-01-01 00:25:00,7,6,14118,1370,12748,21.54%,9.70%
2020-01-01 00:25:00,7,7,3340,79,3261,5.10%,2.37%
2020-01-01 00:25:00,7,8,1054,8,1046,1.61%,0.76%
2020-01-01 00:25:00,7,9,6612,332,6280,10.09%,5.02%
2020-01-01 00:25:00,7,10,1469,9,1460,2.24%,0.61%
2020-01-01 00:25:00,7,11,93,0,93,0.14%,0.00%
2020-01-01 00:25:00,7,12,5145,219,4926,7.85%,4.26%
2020-01-01 00:25:00,8,1,323,2,321,0.49%,0.62%
2020-01-01 00:25:00,8,2,75,0,75,0.11%,0.00%
2020-01-01 00:25:00,8,3,1466,16,1450,2.24%,1.09%
2020-01-01 00:25:00,8,4,2714,49,2665,4.14%,1.81%
2020-01-01 00:25:00,8,5,8598,509,8089,13.12%,5.92%
2020-01-01 00:25:00,8,6,16723,1896,14827,25.52%,11.34%
2020-01-01 00:25:00,8,7,5362,202,5160,8.18%,3.77%
2020-01-01 00:25:00,8,8,2517,35,2482,3.84%,1.39%
2020-01-01 00:25:00,8,9,6967,337,6630,10.63%,4.84%
2020-01-01 00:25:00,8,10,1860,24,1836,2.84%,1.29%
2020-01-01 00:25:00,8,11,248,0,248,0.38%,0.00%
2020-01-01 00:25:00,8,12,4955,175,4780,7.56%,3.53%
2020-01-01 00:25:00,9,1,240,0,240,0.37%,0.00%
2020-01-01 00:25:00,9,2,2074,43,2031,3.16%,2.07%
2020-01-01 00:25:00,9,3,1412,15,1397,2.15%,1.06%
2020-01-01 00:25:00,9,4,8824,515,8309,13.46%,5.84%
2020-01-01 00:25:00,9,5,166,1,165,0.25%,0.60%
2020-01-01 00:25:00,9,6,9416,599,8817,14.37%,6.36%
2020-01-01 00:25:00,9,7,29784,5722,24062,45.45%,19.21%
2020-01-01 00:25:00,9,8,13113,1178,11935,20.01%,8.98%
2020-01-01 00:25:00,9,9,144,1,143,0.22%,0.69%
2020-01-01 00:25:00,9,10,5887,231,5656,8.98%,3.92%
2020-01-01 00:25:00,9,11,11676,922,10754,17.82%,7.90%
2020-01-01 00:25:00,9,12,5527,224,5303,8.43%,4.05%
2020-01-01 00:25:00,10,1,1274,269,1005,1.94%,21.11%
2020-01-01 00:25:00,10,2,2839,306,2533,4.33%,10.78%
2020-01-01 00:25:00,10,3,1405,13,1392,2.14%,0.93%
2020-01-01 00:25:00,10,4,4032,957,3075,6.15%,23.74%
2020-01-01 00:25:00,10,5,558,4,554,0.85%,0.72%
2020-01-01 00:25:00,10,6,5785,1063,4722,8.83%,18.38%
2020-01-01 00:25:00,10,7,10172,1711,8461,15.52%,16.82%
2020-01-01 00:25:00,10,8,26356,6422,19934,40.22%,24.37%
2020-01-01 00:25:00,10,9,435,0,435,0.66%,0.00%
2020-01-01 00:25:00,10,10,2409,37,2372,3.68%,1.54%
2020-01-01 00:25:00,10,11,12156,1573,10583,18.55%,12.94%
2020-01-01 00:25:00,10,12,9228,1146,8082,14.08%,12.42%
2020-01-01 00:25:00,11,1,2157,43,2114,3.29%,1.99%
2020-01-01 00:25:00,11,2,3732,114,3618,5.69%,3.05%
2020-01-01 00:25:00,11,3,1353,14,1339,2.06%,1.03%
2020-01-01 00:25:00,11,4,5230,204,5026,7.98%,3.90%
2020-01-01 00:25:00,11,5,345,0,345,0.53%,0.00%
2020-01-01 00:25:00,11,6,6061,264,5797,9.25%,4.36%
2020-01-01 00:25:00,11,7,11299,913,10386,17.24%,8.08%
2020-01-01 00:25:00,11,8,25386,4372,21014,38.74%,17.22%
2020-01-01 00:25:00,11,9,219,0,219,0.33%,0.00%
2020-01-01 00:25:00,11,10,3193,90,3103,4.87%,2.82%
2020-01-01 00:25:00,11,11,10156,752,9404,15.50%,7.40%
2020-01-01 00:25:00,11,12,6629,340,6289,10.12%,5.13%
2020-01-01 00:25:00,12,1,35,0,35,0.05%,0.00%
2020-01-01 00:25:00,12,2,695,269,426,1.06%,38.71%
2020-01-01 00:25:00,12,3,3262,343,2919,4.98%,10.52%
2020-01-01 00:25:00,12,4,2300,25,2275,3.51%,1.09%
2020-01-01 00:25:00,12,5,9498,1041,8457,14.49%,10.96%
2020-01-01 00:25:00,12,6,5419,371,5048,8.27%,6.85%
2020-01-01 00:25:00,12,7,3009,229,2780,4.59%,7.61%
2020-01-01 00:25:00,12,8,957,257,700,1.46%,26.85%
2020-01-01 00:25:00,12,9,22708,4733,17975,34.65%,20.84%
2020-01-01 00:25:00,12,10,3876,338,3538,5.91%,8.72%
2020-01-01 00:25:00,12,11,1155,260,895,1.76%,22.51%
2020-01-01 00:25:00,12,12,7482,1103,6379,11.42%,14.74%
2020-01-01 00:25:00,13,1,2061,30,2031,3.14%,1.46%
2020-01-01 00:25:00,13,2,2506,49,2457,3.82%,1.96%
2020-01-01 00:25:00,13,3,839,7,832,1.28%,0.83%
2020-01-01 00:25:00,13,4,3695,330,3365,5.64%,8.93%
2020-01-01 00:25:00,13,5,6057,570,5487,9.24%,9.41%
2020-01-01 00:25:00,13,6,4403,359,4044,6.72%,8.15%
2020-01-01 00:25:00,13,7,4727,166,4561,7.21%,3.51%
2020-01-01 00:25:00,13,8,6538,297,6241,9.98%,4.54%
2020-01-01 00:25:00,13,9,6294,593,5701,9.60%,9.42%
2020-01-01 00:25:00,13,10,24833,4662,20171,37.89%,18.77%
2020-01-01 00:25:00,13,11,16564,2227,14337,25.27%,13.44%
2020-01-01 00:25:00,13,12,9585,986,8599,14.63%,10.29%
2020-01-01 00:25:00,14,1,427,1,426,0.65%,0.23%
2020-01-01 00:25:00,14,2,1582,16,1566,2.41%,1.01%
2020-01-01 00:25:00,14,3,975,4,971,1.49%,0.41%
2020-01-01 00:25:00,14,4,3459,85,3374,5.28%,2.46%
2020-01-01 00:25:00,14,5,1136,14,1122,1.73%,1.23%
2020-01-01 00:25:00,14,6,3678,97,3581,5.61%,2.64%
2020-01-01 00:25:00,14,7,10367,792,9575,15.82%,7.64%
2020-01-01 00:25:00,14,8,11835,1016,10819,18.06%,8.58%
2020-01-01 00:25:00,14,9,1389,18,1371,2.12%,1.30%
2020-01-01 00:25:00,14,10,3737,96,3641,5.70%,2.57%
2020-01-01 00:25:00,14,11,23336,3709,19627,35.61%,15.89%
2020-01-01 00:25:00,14,12,7223,412,6811,11.02%,5.70%
2020-01-01 00:25:00,15,1,515,3,512,0.79%,0.58%
2020-01-01 00:25:00,15,2,183,0,183,0.28%,0.00%
2020-01-01 00:25:00,15,3,3670,117,3553,5.60%,3.19%
2020-01-01 00:25:00,15,4,5059,193,4866,7.72%,3.81%
2020-01-01 00:25:00,15,5,10466,775,9691,15.97%,7.40%
2020-01-01 00:25:00,15,6,5238,206,5032,7.99%,3.93%
2020-01-01 00:25:00,15,7,3431,103,3328,5.24%,3.00%
2020-01-01 00:25:00,15,8,6265,341,5924,9.56%,5.44%
2020-01-01 00:25:00,15,9,10640,811,9829,16.24%,7.62%
2020-01-01 00:25:00,15,10,4621,265,4356,7.05%,5.73%
2020-01-01 00:25:00,15,11,11022,984,10038,16.82%,8.93%
2020-01-01 00:25:00,15,12,26808,5164,21644,40.91%,19.26%
2020-01-01 00:25:00,16,1,386,2,384,0.59%,0.52%
2020-01-01 00:25:00,16,2,311,1,310,0.47%,0.32%
2020-01-01 00:25:00,16,3,2892,81,2811,4.41%,2.80%
2020-01-01 00:25:00,16,4,4401,157,4244,6.72%,3.57%
2020-01-01 00:25:00,16,5,9483,742,8741,14.47%,7.82%
2020-01-01 00:25:00,16,6,5446,242,5204,8.31%,4.44%
2020-01-01 00:25:00,16,7,3365,80,3285,5.13%,2.38%
2020-01-01 00:25:00,16,8,6924,328,6596,10.57%,4.74%
2020-01-01 00:25:00,16,9,9879,800,9079,15.07%,8.10%
2020-01-01 00:25:00,16,10,1540,24,1516,2.35%,1.56%
2020-01-01 00:25:00,16,11,8692,531,8161,13.26%,6.11%
2020-01-01 00:25:00,16,12,26871,4821,22050,41.00%,17.94%
2020-01-01 00:25:10,1,1,16676,2011,14665,25.45%,12.06%
2020-01-01 00:25:10,1,2,8659,616,8043,13.21%,7.11%
2020-01-01 00:25:10,1,3,629,3,626,0.96%,0.48%
2020-01-01 00:25:10,1,4,7639,479,7160,11.66%,6.27%
2020-01-01 00:25:10,1,5,7315,433,6882,11.16%,5.92%
2020-01-01 00:25:10,1,6,7272,438,6834,11.10%,6.02%
2020-01-01 00:25:10,1,7,8013,529,7484,12.23%,6.60%
2020-01-01 00:25:10,1,8,5666,253,5413,8.65%,4.47%
2020-01-01 00:25:10,1,9,7235,429,6806,11.04%,5.93%
2020-01-01 00:25:10,1,10,4995,206,4789,7.62%,4.12%
2020-01-01 00:25:10,1,11,5072,208,4864,7.74%,4.10%
2020-01-01 00:25:10,1,12,7213,427,6786,11.01%,5.92%
2020-01-01 00:25:10,2,1,1118,3,1115,1.71%,0.27%
2020-01-01 00:25:10,2,2,26466,4783,21683,40.38%,18.07%
2020-01-01 00:25:10,2,3,20208,2859,17349,30.83%,14.15%
2020-01-01 00:25:10,2,4,988,1,987,1.51%,0.10%
2020-01-01 00:25:10,2,5,11974,1093,10881,18.27%,9.13%
2020-01-01 00:25:10,2,6,32,0,32,0.05%,0.00%
2020-01-01 00:25:10,2,7,5104,183,4921,7.79%,3.59%
2020-01-01 00:25:10,2,8,3592,94,3498,5.48%,2.62%
2020-01-01 00:25:10,2,9,11886,1078,10808,18.14%,9.07%
2020-01-01 00:25:10,2,10,2620,57,2563,4.00%,2.18%
2020-01-01 00:25:10,2,11,2625,57,2568,4.01%,2.17%
2020-01-01 00:25:10,2,12,11719,1049,10670,17.88%,8.95%
2020-01-01 00:25:10,3,1,1522,10,1512,2.32%,0.66%
2020-01-01 00:25:10,3,2,25459,4339,21120,38.85%,17.04%
2020-01-01 00:25:10,3,3,69554,26737,42817,106.13%,38.44%
2020-01-01 00:25:10,3,4,8348,510,7838,12.74%,6.11%
2020-01-01 00:25:10,3,5,42158,11121,31037,64.33%,26.38%
2020-01-01 00:25:10,3,6,10657,806,9851,16.26%,7.56%
2020-01-01 00:25:10,3,7,21725,3240,18485,33.15%,14.91%
2020-01-01 00:25:10,3,8,16887,2044,14843,25.77%,12.10%
2020-01-01 00:25:10,3,9,31025,6323,24702,47.34%,20.38%
2020-01-01 00:25:10,3,10,5945,258,5687,9.07%,4.34%
2020-01-01 00:25:10,3,11,2345,43,2302,3.58%,1.83%
2020-01-01 00:25:10,3,12,21573,3243,18330,32.92%,15.03%
2020-01-01 00:25:10,4,1,571,7,564,0.87%,1.23%
2020-01-01 00:25:10,4,2,336,1,335,0.51%,0.30%
2020-01-01 00:25:10,4,3,866,5,861,1.32%,0.58%
2020-01-01 00:25:10,4,4,30008,5918,24090,45.79%,19.72%
2020-01-01 00:25:10,4,5,18716,2420,16296,28.56%,12.93%
2020-01-01 00:25:10,4,6,25893,4489,21404,39.51%,17.34%
2020-01-01 00:25:10,4,7,5683,247,5436,8.67%,4.35%
2020-01-01 00:25:10,4,8,3043,85,2958,4.64%,2.79%
2020-01-01 00:25:10,4,9,16745,1949,14796,25.55%,11.64%
2020-01-01 00:25:10,4,10,2356,42,2314,3.59%,1.78%
2020-01-01 00:25:10,4,11,164,0,164,0.25%,0.00%
2020-01-01 00:25:10,4,12,13591,1314,12277,20.74%,9.67%
2020-01-01 00:25:10,5,1,2943,72,2871,4.49%,2.45%
2020-01-01 00:25:10,5,2,1526,20,1506,2.33%,1.31%
2020-01-01 00:25:10,5,3,966,6,960,1.47%,0.62%
2020-01-01 00:25:10,5,4,24060,3933,20127,36.71%,16.35%
2020-01-01 00:25:10,5,5,11276,930,10346,17.21%,8.25%
2020-01-01 00:25:10,5,6,15969,1816,14153,24.37%,11.37%
2020-01-01 00:25:10,5,7,4279,170,4109,6.53%,3.97%
2020-01-01 00:25:10,5,8,3142,84,3058,4.79%,2.67%
2020-01-01 00:25:10,5,9,10109,741,9368,15.43%,7.33%
2020-01-01 00:25:10,5,10,1074,5,1069,1.64%,0.47%
2020-01-01 00:25:10,5,11,580,1,579,0.89%,0.17%
2020-01-01 00:25:10,5,12,8803,556,8247,13.43%,6.32%
2020-01-01 00:25:10,6,1,1121,9,1112,1.71%,0.80%
2020-01-01 00:25:10,6,2,1208,12,1196,1.84%,0.99%
2020-01-01 00:25:10,6,3,1557,17,1540,2.38%,1.09%
2020-01-01 00:25:10,6,4,885,5,880,1.35%,0.56%
2020-01-01 00:25:10,6,5,13162,1219,11943,20.08%,9.26%
2020-01-01 00:25:10,6,6,4133,139,3994,6.31%,3.36%
2020-01-01 00:25:10,6,7,2740,67,2673,4.18%,2.45%
2020-01-01 00:25:10,6,8,1887,33,1854,2.88%,1.75%
2020-01-01 00:25:10,6,9,7047,348,6699,10.75%,4.94%
2020-01-01 00:25:10,6,10,2511,45,2466,3.83%,1.79%
2020-01-01 00:25:10,6,11,503,1,502,0.77%,0.20%
2020-01-01 00:25:10,6,12,4482,147,4335,6.84%,3.28%
2020-01-01 00:25:10,7,1,408,3,405,0.62%,0.74%
2020-01-01 00:25:10,7,2,130,0,130,0.20%,0.00%
2020-01-01 00:25:10,7,3,795,1,794,1.21%,0.13%
2020-01-01 00:25:10,7,4,1377,31,1346,2.10%,2.25%
2020-01-01 00:25:10,7,5,7393,373,7020,11.28%,5.05%
2020-01-01 00:25:10,7,6,12169,1064,11105,18.57%,8.74%
2020-01-01 00:25:10,7,7,3350,89,3261,5.11%,2.66%
2020-01-01 00:25:10,7,8,1200,21,1179,1.83%,1.75%
2020-01-01 00:25:10,7,9,6556,301,6255,10.00%,4.59%
2020-01-01 00:25:10,7,10,948,9,939,1.45%,0.95%
2020-01-01 00:25:10,7,11,171,1,170,0.26%,0.58%
2020-01-01 00:25:10,7,12,5573,217,5356,8.50%,3.89%
2020-01-01 00:25:10,8,1,375,0,375,0.57%,0.00%
2020-01-01 00:25:10,8,2,157,1,156,0.24%,0.64%
2020-01-01 00:25:10,8,3,1538,18,1520,2.35%,1.17%
2020-01-01 00:25:10,8,4,2749,61,2688,4.19%,2.22%
2020-01-01 00:25:10,8,5,8146,484,7662,12.43%,5.94%
2020-01-01 00:25:10,8,6,16092,1860,14232,24.55%,11.56%
2020-01-01 00:25:10,8,7,5137,235,4902,7.84%,4.57%
2020-01-01 00:25:10,8,8,1951,42,1909,2.98%,2.15%
2020-01-01 00:25:10,8,9,6348,288,6060,9.69%,4.54%
2020-01-01 00:25:10,8,10,1782,25,1757,2.72%,1.40%
2020-01-01 00:25:10,8,11,189,0,189,0.29%,0.00%
2020-01-01 00:25:10,8,12,4557,149,4408,6.95%,3.27%
2020-01-01 00:25:10,9,1,2118,12,2106,3.23%,0.57%
2020-01-01 00:25:10,9,2,4042,107,3935,6.17%,2.65%
2020-01-01 00:25:10,9,3,1589,25,1564,2.42%,1.57%
2020-01-01 00:25:10,9,4,3959,133,3826,6.04%,3.36%
2020-01-01 00:25:10,9,5,182,1,181,0.28%,0.55%
2020-01-01 00:25:10,9,6,4839,182,4657,7.38%,3.76%
2020-01-01 00:25:10,9,7,29007,5579,23428,44.26%,19.23%
2020-01-01 00:25:10,9,8,12022,998,11024,18.34%,8.30%
2020-01-01 00:25:10,9,9,148,1,147,0.23%,0.68%
2020-01-01 00:25:10,9,10,4059,104,3955,6.19%,2.56%
2020-01-01 00:25:10,9,11,10301,736,9565,15.72%,7.14%
2020-01-01 00:25:10,9,12,5982,255,5727,9.13%,4.26%
2020-01-01 00:25:10,10,1,1101,181,920,1.68%,16.44%
2020-01-01 00:25:10,10,2,3143,268,2875,4.80%,8.53%
2020-01-01 00:25:10,10,3,1834,34,1800,2.80%,1.85%
2020-01-01 00:25:10,10,4,4274,870,3404,6.52%,20.36%
2020-01-01 00:25:10,10,5,666,1,665,1.02%,0.15%
2020-01-01 00:25:10,10,6,6067,976,5091,9.26%,16.09%
2020-01-01 00:25:10,10,7,11287,1729,9558,17.22%,15.32%
2020-01-01 00:25:10,10,8,30595,7677,22918,46.68%,25.09%
2020-01-01 00:25:10,10,9,550,6,544,0.84%,1.09%
2020-01-01 00:25:10,10,10,2965,54,2911,4.52%,1.82%
2020-01-01 00:25:10,10,11,15217,2136,13081,23.22%,14.04%
2020-01-01 00:25:10,10,12,11645,1539,10106,17.77%,13.22%
2020-01-01 00:25:10,11,1,2253,26,2227,3.44%,1.15%
2020-01-01 00:25:10,11,2,3521,89,3432,5.37%,2.53%
2020-01-01 00:25:10,11,3,1095,16,1079,1.67%,1.46%
2020-01-01 00:25:10,11,4,3439,150,3289,5.25%,4.36%
2020-01-01 00:25:10,11,5,245,0,245,0.37%,0.00%
2020-01-01 00:25:10,11,6,4195,187,4008,6.40%,4.46%
2020-01-01 00:25:10,11,7,9709,691,9018,14.81%,7.12%
2020-01-01 00:25:10,11,8,24020,3942,20078,36.65%,16.41%
2020-01-01 00:25:10,11,9,260,1,259,0.40%,0.38%
2020-01-01 00:25:10,11,10,3192,70,3122,4.87%,2.19%
2020-01-01 00:25:10,11,11,9951,710,9241,15.18%,7.13%
2020-01-01 00:25:10,11,12,6337,307,6030,9.67%,4.84%
2020-01-01 00:25:10,12,1,97,0,97,0.15%,0.00%
2020-01-01 00:25:10,12,2,545,231,314,0.83%,42.39%
2020-01-01 00:25:10,12,3,2494,278,2216,3.81%,11.15%
2020-01-01 00:25:10,12,4,3278,63,3215,5.00%,1.92%
2020-01-01 00:25:10,12,5,9791,899,8892,14.94%,9.18%
2020-01-01 00:25:10,12,6,6406,281,6125,9.77%,4.39%
2020-01-01 00:25:10,12,7,2884,73,2811,4.40%,2.53%
2020-01-01 00:25:10,12,8,1594,300,1294,2.43%,18.82%
2020-01-01 00:25:10,12,9,23010,4768,18242,35.11%,20.72%
2020-01-01 00:25:10,12,10,4500,402,4098,6.87%,8.93%
2020-01-01 00:25:10,12,11,1754,304,1450,2.68%,17.33%
2020-01-01 00:25:10,12,12,8179,1349,6830,12.48%,16.49%
2020-01-01 00:25:10,13,1,2702,49,2653,4.12%,1.81%
2020-01-01 00:25:10,13,2,3003,68,2935,4.58%,2.26%
2020-01-01 00:25:10,13,3,775,7,768,1.18%,0.90%
2020-01-01 00:25:10,13,4,5393,402,4991,8.23%,7.45%
2020-01-01 00:25:10,13,5,7645,731,6914,11.67%,9.56%
2020-01-01 00:25:10,13,6,6058,457,5601,9.24%,7.54%
2020-01-01 00:25:10,13,7,5525,220,5305,8.43%,3.98%
2020-01-01 00:25:10,13,8,7980,450,7530,12.18%,5.64%
2020-01-01 00:25:10,13,9,8050,775,7275,12.28%,9.63%
2020-01-01 00:25:10,13,10,29503,6250,23253,45.02%,21.18%
2020-01-01 00:25:10,13,11,18441,2608,15833,28.14%,14.14%
2020-01-01 00:25:10,13,12,9964,1049,8915,15.20%,10.53%
2020-01-01 00:25:10,14,1,257,3,254,0.39%,1.17%
2020-01-01 00:25:10,14,2,1628,18,1610,2.48%,1.11%
2020-01-01 00:25:10,14,3,983,4,979,1.50%,0.41%
2020-01-01 00:25:10,14,4,4774,186,4588,7.28%,3.90%
2020-01-01 00:25:10,14,5,1321,14,1307,2.02%,1.06%
2020-01-01 00:25:10,14,6,4992,204,4788,7.62%,4.09%
2020-01-01 00:25:10,14,7,12441,1086,11355,18.98%,8.73%
2020-01-01 00:25:10,14,8,14350,1442,12908,21.90%,10.05%
2020-01-01 00:25:10,14,9,1557,22,1535,2.38%,1.41%
2020-01-01 00:25:10,14,10,5343,216,5127,8.15%,4.04%
2020-01-01 00:25:10,14,11,27915,5184,22731,42.59%,18.57%
2020-01-01 00:25:10,14,12,8051,471,7580,12.28%,5.85%
2020-01-01 00:25:10,15,1,624,2,622,0.95%,0.32%
2020-01-01 00:25:10,15,2,235,1,234,0.36%,0.43%
2020-01-01 00:25:10,15,3,4701,160,4541,7.17%,3.40%
2020-01-01 00:25:10,15,4,5732,280,5452,8.75%,4.88%
2020-01-01 00:25:10,15,5,12093,1049,11044,18.45%,8.67%
2020-01-01 00:25:10,15,6,5989,296,5693,9.14%,4.94%
2020-01-01 00:25:10,15,7,4767,216,4551,7.27%,4.53%
2020-01-01 00:25:10,15,8,6377,333,6044,9.73%,5.22%
2020-01-01 00:25:10,15,9,12293,1079,11214,18.76%,8.78%
2020-01-01 00:25:10,15,10,4401,178,4223,6.72%,4.04%
2020-01-01 00:25:10,15,11,10863,913,9950,16.58%,8.40%
2020-01-01 00:25:10,15,12,29629,6039,23590,45.21%,20.38%
2020-01-01 00:25:10,16,1,412,1,411,0.63%,0.24%
2020-01-01 00:25:10,16,2,223,2,221,0.34%,0.90%
2020-01-01 00:25:10,16,3,1799,29,1770,2.75%,1.61%
2020-01-01 00:25:10,16,4,5737,253,5484,8.75%,4.41%
2020-01-01 00:25:10,16,5,9557,723,8834,14.58%,7.57%
2020-01-01 00:25:10,16,6,6566,337,6229,10.02%,5.13%
2020-01-01 00:25:10,16,7,3292,94,3198,5.02%,2.86%
2020-01-01 00:25:10,16,8,7866,560,7306,12.00%,7.12%
2020-01-01 00:25:10,16,9,9943,783,9160,15.17%,7.87%
2020-01-01 00:25:10,16,10,2009,31,1978,3.07%,1.54%
2020-01-01 00:25:10,16,11,10063,822,9241,15.35%,8.17%
2020-01-01 00:25:10,16,12,28073,5418,22655,42.84%,19.30%
2020-01-01 00:25:20,1,1,18030,2350,15680,27.51%,13.03%
2020-01-01 00:25:20,1,2,9372,660,8712,14.30%,7.04%
2020-01-01 00:25:20,1,3,2013,25,1988,3.07%,1.24%
2020-01-01 00:25:20,1,4,8038,539,7499,12.27%,6.71%
2020-01-01 00:25:20,1,5,7329,464,6865,11.18%,6.33%
2020-01-01 00:25:20,1,6,7266,463,6803,11.09%,6.37%
2020-01-01 00:25:20,1,7,7356,421,6935,11.22%,5.72%
2020-01-01 00:25:20,1,8,6333,310,6023,9.66%,4.89%
2020-01-01 00:25:20,1,9,7219,457,6762,11.02%,6.33%
2020-01-01 00:25:20,1,10,5661,252,5409,8.64%,4.45%
2020-01-01 00:25:20,1,11,5791,258,5533,8.84%,4.46%
2020-01-01 00:25:20,1,12,7182,455,6727,10.96%,6.34%
2020-01-01 00:25:20,2,1,828,0,828,1.26%,0.00%
2020-01-01 00:25:20,2,2,23808,3856,19952,36.33%,16.20%
2020-01-01 00:25:20,2,3,18884,2486,16398,28.81%,13.16%
2020-01-01 00:25:20,2,4,475,0,475,0.72%,0.00%
2020-01-01 00:25:20,2,5,11764,1024,10740,17.95%,8.70%
2020-01-01 00:25:20,2,6,62,0,62,0.09%,0.00%
2020-01-01 00:25:20,2,7,4072,114,3958,6.21%,2.80%
2020-01-01 00:25:20,2,8,2699,48,2651,4.12%,1.78%
2020-01-01 00:25:20,2,9,11678,1003,10675,17.82%,8.59%
2020-01-01 00:25:20,2,10,1784,21,1763,2.72%,1.18%
2020-01-01 00:25:20,2,11,1797,21,1776,2.74%,1.17%
2020-01-01 00:25:20,2,12,11517,968,10549,17.57%,8.40%
2020-01-01 00:25:20,3,1,1555,16,1539,2.37%,1.03%
2020-01-01 00:25:20,3,2,29298,5739,23559,44.71%,19.59%
2020-01-01 00:25:20,3,3,79150,33266,45884,120.77%,42.03%
2020-01-01 00:25:20,3,4,9532,650,8882,14.54%,6.82%
2020-01-01 00:25:20,3,5,48906,14460,34446,74.62%,29.57%
2020-01-01 00:25:20,3,6,10458,781,9677,15.96%,7.47%
2020-01-01 00:25:20,3,7,26089,4654,21435,39.81%,17.84%
2020-01-01 00:25:20,3,8,21536,3291,18245,32.86%,15.28%
2020-01-01 00:25:20,3,9,38067,9260,28807,58.09%,24.33%
2020-01-01 00:25:20,3,10,4634,158,4476,7.07%,3.41%
2020-01-01 00:25:20,3,11,1820,28,1792,2.78%,1.54%
2020-01-01 00:25:20,3,12,29054,5728,23326,44.33%,19.72%
2020-01-01 00:25:20,4,1,518,1,517,0.79%,0.19%
2020-01-01 00:25:20,4,2,316,0,316,0.48%,0.00%
2020-01-01 00:25:20,4,3,735,3,732,1.12%,0.41%
2020-01-01 00:25:20,4,4,30007,5963,24044,45.79%,19.87%
2020-01-01 00:25:20,4,5,18295,2347,15948,27.92%,12.83%
2020-01-01 00:25:20,4,6,25948,4578,21370,39.59%,17.64%
2020-01-01 00:25:20,4,7,6336,304,6032,9.67%,4.80%
2020-01-01 00:25:20,4,8,3822,114,3708,5.83%,2.98%
2020-01-01 00:25:20,4,9,16412,1905,14507,25.04%,11.61%
2020-01-01 00:25:20,4,10,2080,40,2040,3.17%,1.92%
2020-01-01 00:25:20,4,11,239,1,238,0.36%,0.42%
2020-01-01 00:25:20,4,12,12394,1096,11298,18.91%,8.84%
2020-01-01 00:25:20,5,1,3586,97,3489,5.47%,2.70%
2020-01-01 00:25:20,5,2,842,2,840,1.28%,0.24%
2020-01-01 00:25:20,5,3,2155,39,2116,3.29%,1.81%
2020-01-01 00:25:20,5,4,25386,4372,21014,38.74%,17.22%
2020-01-01 00:25:20,5,5,11534,964,10570,17.60%,8.36%
2020-01-01 00:25:20,5,6,16382,1892,14490,25.00%,11.55%
2020-01-01 00:25:20,5,7,4326,169,4157,6.60%,3.91%
2020-01-01 00:25:20,5,8,3449,113,3336,5.26%,3.28%
2020-01-01 00:25:20,5,9,8575,530,8045,13.08%,6.18%
2020-01-01 00:25:20,5,10,876,10,866,1.34%,1.14%
2020-01-01 00:25:20,5,11,735,10,725,1.12%,1.36%
2020-01-01 00:25:20,5,12,7370,403,6967,11.25%,5.47%
2020-01-01 00:25:20,6,1,975,4,971,1.49%,0.41%
2020-01-01 00:25:20,6,2,1031,6,1025,1.57%,0.58%
2020-01-01 00:25:20,6,3,1520,15,1505,2.32%,0.99%
2020-01-01 00:25:20,6,4,1849,23,1826,2.82%,1.24%
2020-01-01 00:25:20,6,5,12863,1178,11685,19.63%,9.16%
2020-01-01 00:25:20,6,6,5818,262,5556,8.88%,4.50%
2020-01-01 00:25:20,6,7,3295,100,3195,5.03%,3.03%
2020-01-01 00:25:20,6,8,2601,40,2561,3.97%,1.54%
2020-01-01 00:25:20,6,9,5285,188,5097,8.06%,3.56%
2020-01-01 00:25:20,6,10,1830,19,1811,2.79%,1.04%
2020-01-01 00:25:20,6,11,442,2,440,0.67%,0.45%
2020-01-01 00:25:20,6,12,3420,74,3346,5.22%,2.16%
2020-01-01 00:25:20,7,1,574,1,573,0.88%,0.17%
2020-01-01 00:25:20,7,2,141,0,141,0.22%,0.00%
2020-01-01 00:25:20,7,3,527,1,526,0.80%,0.19%
2020-01-01 00:25:20,7,4,2661,53,2608,4.06%,1.99%
2020-01-01 00:25:20,7,5,9732,709,9023,14.85%,7.29%
2020-01-01 00:25:20,7,6,15807,1763,14044,24.12%,11.15%
2020-01-01 00:25:20,7,7,3360,81,3279,5.13%,2.41%
2020-01-01 00:25:20,7,8,1545,19,1526,2.36%,1.23%
2020-01-01 00:25:20,7,9,8864,603,8261,13.53%,6.80%
2020-01-01 00:25:20,7,10,3137,71,3066,4.79%,2.26%
2020-01-01 00:25:20,7,11,97,0,97,0.15%,0.00%
2020-01-01 00:25:20,7,12,5704,288,5416,8.70%,5.05%
2020-01-01 00:25:20,8,1,439,1,438,0.67%,0.23%
2020-01-01 00:25:20,8,2,88,0,88,0.13%,0.00%
2020-01-01 00:25:20,8,3,1637,17,1620,2.50%,1.04%
2020-01-01 00:25:20,8,4,3436,94,3342,5.24%,2.74%
2020-01-01 00:25:20,8,5,8095,491,7604,12.35%,6.07%
2020-01-01 00:25:20,8,6,17619,2221,15398,26.88%,12.61%
2020-01-01 00:25:20,8,7,5960,293,5667,9.09%,4.92%
2020-01-01 00:25:20,8,8,2905,90,2815,4.43%,3.10%
2020-01-01 00:25:20,8,9,5924,273,5651,9.04%,4.61%
2020-01-01 00:25:20,8,10,1590,26,1564,2.43%,1.64%
2020-01-01 00:25:20,8,11,122,0,122,0.19%,0.00%
2020-01-01 00:25:20,8,12,4364,158,4206,6.66%,3.62%
2020-01-01 00:25:20,9,1,522,1,521,0.80%,0.19%
2020-01-01 00:25:20,9,2,2591,58,2533,3.95%,2.24%
2020-01-01 00:25:20,9,3,1679,35,1644,2.56%,2.08%
2020-01-01 00:25:20,9,4,3607,161,3446,5.50%,4.46%
2020-01-01 00:25:20,9,5,358,2,356,0.55%,0.56%
2020-01-01 00:25:20,9,6,4645,224,4421,7.09%,4.82%
2020-01-01 00:25:20,9,7,23939,4034,19905,36.53%,16.85%
2020-01-01 00:25:20,9,8,10208,735,9473,15.58%,7.20%
2020-01-01 00:25:20,9,9,252,2,250,0.38%,0.79%
2020-01-01 00:25:20,9,10,3836,103,3733,5.85%,2.69%
2020-01-01 00:25:20,9,11,9035,571,8464,13.79%,6.32%
2020-01-01 00:25:20,9,12,4970,166,4804,7.58%,3.34%
2020-01-01 00:25:20,10,1,1303,286,1017,1.99%,21.95%
2020-01-01 00:25:20,10,2,2856,337,2519,4.36%,11.80%
2020-01-01 00:25:20,10,3,1425,28,1397,2.17%,1.96%
2020-01-01 00:25:20,10,4,3842,1305,2537,5.86%,33.97%
2020-01-01 00:25:20,10,5,838,60,778,1.28%,7.16%
2020-01-01 00:25:20,10,6,5586,1422,4164,8.52%,25.46%
2020-01-01 00:25:20,10,7,10300,2102,8198,15.72%,20.41%
2020-01-01 00:25:20,10,8,27961,7375,20586,42.67%,26.38%
2020-01-01 00:25:20,10,9,725,6,719,1.11%,0.83%
2020-01-01 00:25:20,10,10,2319,53,2266,3.54%,2.29%
2020-01-01 00:25:20,10,11,13373,1698,11675,20.41%,12.70%
2020-01-01 00:25:20,10,12,10221,1199,9022,15.60%,11.73%
2020-01-01 00:25:20,11,1,2107,36,2071,3.22%,1.71%
2020-01-01 00:25:20,11,2,4606,150,4456,7.03%,3.26%
2020-01-01 00:25:20,11,3,2389,48,2341,3.65%,2.01%
2020-01-01 00:25:20,11,4,3173,84,3089,4.84%,2.65%
2020-01-01 00:25:20,11,5,150,0,150,0.23%,0.00%
2020-01-01 00:25:20,11,6,4144,136,4008,6.32%,3.28%
2020-01-01 00:25:20,11,7,10394,772,9622,15.86%,7.43%
2020-01-01 00:25:20,11,8,24865,4252,20613,37.94%,17.10%
2020-01-01 00:25:20,11,9,247,0,247,0.38%,0.00%
2020-01-01 00:25:20,11,10,3321,84,3237,5.07%,2.53%
2020-01-01 00:25:20,11,11,11132,995,10137,16.99%,8.94%
2020-01-01 00:25:20,11,12,7104,429,6675,10.84%,6.04%
2020-01-01 00:25:20,12,1,61,0,61,0.09%,0.00%
2020-01-01 00:25:20,12,2,525,163,362,0.80%,31.05%
2020-01-01 00:25:20,12,3,2614,199,2415,3.99%,7.61%
2020-01-01 00:25:20,12,4,3031,66,2965,4.62%,2.18%
2020-01-01 00:25:20,12,5,8326,697,7629,12.70%,8.37%
2020-01-01 00:25:20,12,6,4922,200,4722,7.51%,4.06%
2020-01-01 00:25:20,12,7,1706,33,1673,2.60%,1.93%
2020-01-01 00:25:20,12,8,1575,242,1333,2.40%,15.37%
2020-01-01 00:25:20,12,9,23088,4376,18712,35.23%,18.95%
2020-01-01 00:25:20,12,10,4777,393,4384,7.29%,8.23%
2020-01-01 00:25:20,12,11,2101,254,1847,3.21%,12.09%
2020-01-01 00:25:20,12,12,9432,1130,8302,14.39%,11.98%
2020-01-01 00:25:20,13,1,2430,40,2390,3.71%,1.65%
2020-01-01 00:25:20,13,2,2762,58,2704,4.21%,2.10%
2020-01-01 00:25:20,13,3,818,2,816,1.25%,0.24%
2020-01-01 00:25:20,13,4,5345,590,4755,8.16%,11.04%
2020-01-01 00:25:20,13,5,8722,1058,7664,13.31%,12.13%
2020-01-01 00:25:20,13,6,6670,704,5966,10.18%,10.55%
2020-01-01 00:25:20,13,7,4736,164,4572,7.23%,3.46%
2020-01-01 00:25:20,13,8,6871,335,6536,10.48%,4.88%
2020-01-01 00:25:20,13,9,9032,1095,7937,13.78%,12.12%
2020-01-01 00:25:20,13,10,28468,6069,22399,43.44%,21.32%
2020-01-01 00:25:20,13,11,16298,2235,14063,24.87%,13.71%
2020-01-01 00:25:20,13,12,9039,1040,7999,13.79%,11.51%
2020-01-01 00:25:20,14,1,358,1,357,0.55%,0.28%
2020-01-01 00:25:20,14,2,1216,17,1199,1.86%,1.40%
2020-01-01 00:25:20,14,3,667,4,663,1.02%,0.60%
2020-01-01 00:25:20,14,4,5118,184,4934,7.81%,3.60%
2020-01-01 00:25:20,14,5,1786,22,1764,2.73%,1.23%
2020-01-01 00:25:20,14,6,5471,213,5258,8.35%,3.89%
2020-01-01 00:25:20,14,7,13293,1315,11978,20.28%,9.89%
2020-01-01 00:25:20,14,8,14681,1596,13085,22.40%,10.87%
2020-01-01 00:25:20,14,9,1984,25,1959,3.03%,1.26%
2020-01-01 00:25:20,14,10,4506,148,4358,6.88%,3.28%
2020-01-01 00:25:20,14,11,27750,5218,22532,42.34%,18.80%
2020-01-01 00:25:20,14,12,8298,527,7771,12.66%,6.35%
2020-01-01 00:25:20,15,1,506,3,503,0.77%,0.59%
2020-01-01 00:25:20,15,2,71,1,70,0.11%,1.41%
2020-01-01 00:25:20,15,3,3840,130,3710,5.86%,3.39%
2020-01-01 00:25:20,15,4,5049,234,4815,7.70%,4.63%
2020-01-01 00:25:20,15,5,9741,699,9042,14.86%,7.18%
2020-01-01 00:25:20,15,6,5277,256,5021,8.05%,4.85%
2020-01-01 00:25:20,15,7,3641,126,3515,5.56%,3.46%
2020-01-01 00:25:20,15,8,5392,245,5147,8.23%,4.54%
2020-01-01 00:25:20,15,9,9999,734,9265,15.26%,7.34%
2020-01-01 00:25:20,15,10,4781,273,4508,7.30%,5.71%
2020-01-01 00:25:20,15,11,10338,882,9456,15.77%,8.53%
2020-01-01 00:25:20,15,12,25741,4888,20853,39.28%,18.99%
2020-01-01 00:25:20,16,1,459,4,455,0.70%,0.87%
2020-01-01 00:25:20,16,2,376,2,374,0.57%,0.53%
2020-01-01 00:25:20,16,3,1519,19,1500,2.32%,1.25%
2020-01-01 00:25:20,16,4,3567,116,3451,5.44%,3.25%
2020-01-01 00:25:20,16,5,6779,402,6377,10.34%,5.93%
2020-01-01 00:25:20,16,6,4410,163,4247,6.73%,3.70%
2020-01-01 00:25:20,16,7,3197,75,3122,4.88%,2.35%
2020-01-01 00:25:20,16,8,8280,671,7609,12.63%,8.10%
2020-01-01 00:25:20,16,9,7121,442,6679,10.87%,6.21%
2020-01-01 00:25:20,16,10,1477,19,1458,2.25%,1.29%
2020-01-01 00:25:20,16,11,10062,906,9156,15.35%,9.00%
2020-01-01 00:25:20,16,12,25409,4643,20766,38.77%,18.27%
2020-01-01 00:25:30,1,1,18240,2349,15891,27.83%,12.88%
2020-01-01 00:25:30,1,2,6809,364,6445,10.39%,5.35%
2020-01-01 00:25:30,1,3,501,1,500,0.76%,0.20%
2020-01-01 00:25:30,1,4,10869,812,10057,16.58%,7.47%
2020-01-01 00:25:30,1,5,7211,444,6767,11.00%,6.16%
2020-01-01 00:25:30,1,6,7099,426,6673,10.83%,6.00%
2020-01-01 00:25:30,1,7,6287,317,5970,9.59%,5.04%
2020-01-01 00:25:30,1,8,3913,111,3802,5.97%,2.84%
2020-01-01 00:25:30,1,9,7071,426,6645,10.79%,6.02%
2020-01-01 00:25:30,1,10,2953,63,2890,4.51%,2.13%
2020-01-01 00:25:30,1,11,3092,68,3024,4.72%,2.20%
2020-01-01 00:25:30,1,12,7027,424,6603,10.72%,6.03%
2020-01-01 00:25:30,2,1,685,1,684,1.05%,0.15%
2020-01-01 00:25:30,2,2,24739,4191,20548,37.75%,16.94%
2020-01-01 00:25:30,2,3,20534,2951,17583,31.33%,14.37%
2020-01-01 00:25:30,2,4,590,1,589,0.90%,0.17%
2020-01-01 00:25:30,2,5,11085,892,10193,16.91%,8.05%
2020-01-01 00:25:30,2,6,68,0,68,0.10%,0.00%
2020-01-01 00:25:30,2,7,3503,91,3412,5.35%,2.60%
2020-01-01 00:25:30,2,8,2693,43,2650,4.11%,1.60%
2020-01-01 00:25:30,2,9,11039,881,10158,16.84%,7.98%
2020-01-01 00:25:30,2,10,1816,22,1794,2.77%,1.21%
2020-01-01 00:25:30,2,11,1855,22,1833,2.83%,1.19%
2020-01-01 00:25:30,2,12,10868,851,10017,16.58%,7.83%
2020-01-01 00:25:30,3,1,2173,34,2139,3.32%,1.56%
2020-01-01 00:25:30,3,2,27629,5004,22625,42.16%,18.11%
2020-01-01 00:25:30,3,3,84820,37300,47520,129.43%,43.98%
2020-01-01 00:25:30,3,4,12559,1147,11412,19.16%,9.13%
2020-01-01 00:25:30,3,5,56275,18468,37807,85.87%,32.82%
2020-01-01 00:25:30,3,6,14361,1468,12893,21.91%,10.22%
2020-01-01 00:25:30,3,7,23572,3730,19842,35.97%,15.82%
2020-01-01 00:25:30,3,8,19322,2560,16762,29.48%,13.25%
2020-01-01 00:25:30,3,9,41633,10707,30926,63.53%,25.72%
2020-01-01 00:25:30,3,10,5462,218,5244,8.33%,3.99%
2020-01-01 00:25:30,3,11,2286,48,2238,3.49%,2.10%
2020-01-01 00:25:30,3,12,33370,7166,26204,50.92%,21.47%
2020-01-01 00:25:30,4,1,600,3,597,0.92%,0.50%
2020-01-01 00:25:30,4,2,376,2,374,0.57%,0.53%
2020-01-01 00:25:30,4,3,766,9,757,1.17%,1.17%
2020-01-01 00:25:30,4,4,27326,4990,22336,41.70%,18.26%
2020-01-01 00:25:30,4,5,16909,2024,14885,25.80%,11.97%
2020-01-01 00:25:30,4,6,23406,3715,19691,35.71%,15.87%
2020-01-01 00:25:30,4,7,5223,199,5024,7.97%,3.81%
2020-01-01 00:25:30,4,8,3416,81,3335,5.21%,2.37%
2020-01-01 00:25:30,4,9,14875,1590,13285,22.70%,10.69%
2020-01-01 00:25:30,4,10,1908,44,1864,2.91%,2.31%
2020-01-01 00:25:30,4,11,250,2,248,0.38%,0.80%
2020-01-01 00:25:30,4,12,11918,1007,10911,18.19%,8.45%
2020-01-01 00:25:30,5,1,2711,52,2659,4.14%,1.92%
2020-01-01 00:25:30,5,2,701,4,697,1.07%,0.57%
2020-01-01 00:25:30,5,3,510,2,508,0.78%,0.39%
2020-01-01 00:25:30,5,4,21971,3242,18729,33.53%,14.76%
2020-01-01 00:25:30,5,5,9813,689,9124,14.97%,7.02%
2020-01-01 00:25:30,5,6,13979,1370,12609,21.33%,9.80%
2020-01-01 00:25:30,5,7,3807,126,3681,5.81%,3.31%
2020-01-01 00:25:30,5,8,2951,79,2872,4.50%,2.68%
2020-01-01 00:25:30,5,9,9125,594,8531,13.92%,6.51%
2020-01-01 00:25:30,5,10,1609,29,1580,2.46%,1.80%
2020-01-01 00:25:30,5,11,432,1,431,0.66%,0.23%
2020-01-01 00:25:30,5,12,7265,398,6867,11.09%,5.48%
2020-01-01 00:25:30,6,1,1032,10,1022,1.57%,0.97%
2020-01-01 00:25:30,6,2,1112,15,1097,1.70%,1.35%
2020-01-01 00:25:30,6,3,1891,34,1857,2.89%,1.80%
2020-01-01 00:25:30,6,4,1948,16,1932,2.97%,0.82%
2020-01-01 00:25:30,6,5,14338,1440,12898,21.88%,10.04%
2020-01-01 00:25:30,6,6,6650,297,6353,10.15%,4.47%
2020-01-01 00:25:30,6,7,4323,140,4183,6.60%,3.24%
2020-01-01 00:25:30,6,8,3358,85,3273,5.12%,2.53%
2020-01-01 00:25:30,6,9,5600,226,5374,8.54%,4.04%
2020-01-01 00:25:30,6,10,2283,40,2243,3.48%,1.75%
2020-01-01 00:25:30,6,11,450,2,448,0.69%,0.44%
2020-01-01 00:25:30,6,12,3286,76,3210,5.01%,2.31%
2020-01-01 00:25:30,7,1,664,6,658,1.01%,0.90%
2020-01-01 00:25:30,7,2,198,1,197,0.30%,0.51%
2020-01-01 00:25:30,7,3,587,2,585,0.90%,0.34%
2020-01-01 00:25:30,7,4,2618,60,2558,3.99%,2.29%
2020-01-01 00:25:30,7,5,7949,411,7538,12.13%,5.17%
2020-01-01 00:25:30,7,6,14997,1559,13438,22.88%,10.40%
2020-01-01 00:25:30,7,7,4395,121,4274,6.71%,2.75%
2020-01-01 00:25:30,7,8,2465,37,2428,3.76%,1.50%
2020-01-01 00:25:30,7,9,6929,309,6620,10.57%,4.46%
2020-01-01 00:25:30,7,10,1284,10,1274,1.96%,0.78%
2020-01-01 00:25:30,7,11,82,0,82,0.13%,0.00%
2020-01-01 00:25:30,7,12,5661,200,5461,8.64%,3.53%
2020-01-01 00:25:30,8,1,516,3,513,0.79%,0.58%
2020-01-01 00:25:30,8,2,118,0,118,0.18%,0.00%
2020-01-01 00:25:30,8,3,2800,85,2715,4.27%,3.04%
2020-01-01 00:25:30,8,4,2916,61,2855,4.45%,2.09%
2020-01-01 00:25:30,8,5,10793,851,9942,16.47%,7.88%
2020-01-01 00:25:30,8,6,18842,2469,16373,28.75%,13.10%
2020-01-01 00:25:30,8,7,5066,204,4862,7.73%,4.03%
2020-01-01 00:25:30,8,8,2265,45,2220,3.46%,1.99%
2020-01-01 00:25:30,8,9,7800,430,7370,11.90%,5.51%
2020-01-01 00:25:30,8,10,3618,77,3541,5.52%,2.13%
2020-01-01 00:25:30,8,11,181,0,181,0.28%,0.00%
2020-01-01 00:25:30,8,12,4177,122,4055,6.37%,2.92%
2020-01-01 00:25:30,9,1,469,2,467,0.72%,0.43%
2020-01-01 00:25:30,9,2,2047,24,2023,3.12%,1.17%
2020-01-01 00:25:30,9,3,1241,10,1231,1.89%,0.81%
2020-01-01 00:25:30,9,4,2721,58,2663,4.15%,2.13%
2020-01-01 00:25:30,9,5,328,2,326,0.50%,0.61%
2020-01-01 00:25:30,9,6,3868,106,3762,5.90%,2.74%
2020-01-01 00:25:30,9,7,25656,4294,21362,39.15%,16.74%
2020-01-01 00:25:30,9,8,13564,1298,12266,20.70%,9.57%
2020-01-01 00:25:30,9,9,201,1,200,0.31%,0.50%
2020-01-01 00:25:30,9,10,5192,226,4966,7.92%,4.35%
2020-01-01 00:25:30,9,11,12440,1103,11337,18.98%,8.87%
2020-01-01 00:25:30,9,12,6902,350,6552,10.53%,5.07%
2020-01-01 00:25:30,10,1,1630,280,1350,2.49%,17.18%
2020-01-01 00:25:30,10,2,3394,345,3049,5.18%,10.16%
2020-01-01 00:25:30,10,3,1591,27,1564,2.43%,1.70%
2020-01-01 00:25:30,10,4,3507,967,2540,5.35%,27.57%
2020-01-01 00:25:30,10,5,839,110,729,1.28%,13.11%
2020-01-01 00:25:30,10,6,5708,1210,4498,8.71%,21.20%
2020-01-01 00:25:30,10,7,10494,1940,8554,16.01%,18.49%
2020-01-01 00:25:30,10,8,30098,7773,22325,45.93%,25.83%
2020-01-01 00:25:30,10,9,518,2,516,0.79%,0.39%
2020-01-01 00:25:30,10,10,2166,42,2124,3.31%,1.94%
2020-01-01 00:25:30,10,11,14715,2020,12695,22.45%,13.73%
2020-01-01 00:25:30,10,12,11645,1508,10137,17.77%,12.95%
2020-01-01 00:25:30,11,1,2448,55,2393,3.74%,2.25%
2020-01-01 00:25:30,11,2,3391,99,3292,5.17%,2.92%
2020-01-01 00:25:30,11,3,731,5,726,1.12%,0.68%
2020-01-01 00:25:30,11,4,3618,112,3506,5.52%,3.10%
2020-01-01 00:25:30,11,5,226,1,225,0.34%,0.44%
2020-01-01 00:25:30,11,6,4459,157,4302,6.80%,3.52%
2020-01-01 00:25:30,11,7,9543,695,8848,14.56%,7.28%
2020-01-01 00:25:30,11,8,23900,3871,20029,36.47%,16.20%
2020-01-01 00:25:30,11,9,196,1,195,0.30%,0.51%
2020-01-01 00:25:30,11,10,2777,57,2720,4.24%,2.05%
2020-01-01 00:25:30,11,11,10600,795,9805,16.17%,7.50%
2020-01-01 00:25:30,11,12,7317,377,6940,11.16%,5.15%
2020-01-01 00:25:30,12,1,31,0,31,0.05%,0.00%
2020-01-01 00:25:30,12,2,672,163,509,1.03%,24.26%
2020-01-01 00:25:30,12,3,2121,194,1927,3.24%,9.15%
2020-01-01 00:25:30,12,4,2763,108,2655,4.22%,3.91%
2020-01-01 00:25:30,12,5,7257,642,6615,11.07%,8.85%
2020-01-01 00:25:30,12,6,4388,189,4199,6.70%,4.31%
2020-01-01 00:25:30,12,7,1470,22,1448,2.24%,1.50%
2020-01-01 00:25:30,12,8,1684,339,1345,2.57%,20.13%
2020-01-01 00:25:30,12,9,20298,3929,16369,30.97%,19.36%
2020-01-01 00:25:30,12,10,4949,498,4451,7.55%,10.06%
2020-01-01 00:25:30,12,11,1869,345,1524,2.85%,18.46%
2020-01-01 00:25:30,12,12,7655,1157,6498,11.68%,15.11%
2020-01-01 00:25:30,13,1,1816,26,1790,2.77%,1.43%
2020-01-01 00:25:30,13,2,2121,30,2091,3.24%,1.41%
2020-01-01 00:25:30,13,3,930,9,921,1.42%,0.97%
2020-01-01 00:25:30,13,4,4618,510,4108,7.05%,11.04%
2020-01-01 00:25:30,13,5,7022,809,6213,10.71%,11.52%
2020-01-01 00:25:30,13,6,5252,554,4698,8.01%,10.55%
2020-01-01 00:25:30,13,7,4335,138,4197,6.61%,3.18%
2020-01-01 00:25:30,13,8,7877,433,7444,12.02%,5.50%
2020-01-01 00:25:30,13,9,7296,840,6456,11.13%,11.51%
2020-01-01 00:25:30,13,10,27101,5512,21589,41.35%,20.34%
2020-01-01 00:25:30,13,11,16841,2332,14509,25.70%,13.85%
2020-01-01 00:25:30,13,12,8630,908,7722,13.17%,10.52%
2020-01-01 00:25:30,14,1,171,1,170,0.26%,0.58%
2020-01-01 00:25:30,14,2,1286,14,1272,1.96%,1.09%
2020-01-01 00:25:30,14,3,966,7,959,1.47%,0.72%
2020-01-01 00:25:30,14,4,3346,74,3272,5.11%,2.21%
2020-01-01 00:25:30,14,5,1152,9,1143,1.76%,0.78%
2020-01-01 00:25:30,14,6,3698,94,3604,5.64%,2.54%
2020-01-01 00:25:30,14,7,11128,830,10298,16.98%,7.46%
2020-01-01 00:25:30,14,8,12432,1055,11377,18.97%,8.49%
2020-01-01 00:25:30,14,9,1333,11,1322,2.03%,0.83%
2020-01-01 00:25:30,14,10,4207,124,4083,6.42%,2.95%
2020-01-01 00:25:30,14,11,26457,4616,21841,40.37%,17.45%
2020-01-01 00:25:30,14,12,9463,658,8805,14.44%,6.95%
2020-01-01 00:25:30,15,1,598,3,595,0.91%,0.50%
2020-01-01 00:25:30,15,2,158,1,157,0.24%,0.63%
2020-01-01 00:25:30,15,3,3129,79,3050,4.77%,2.52%
2020-01-01 00:25:30,15,4,4703,182,4521,7.18%,3.87%
2020-01-01 00:25:30,15,5,8830,603,8227,13.47%,6.83%
2020-01-01 00:25:30,15,6,4992,203,4789,7.62%,4.07%
2020-01-01 00:25:30,15,7,3448,113,3335,5.26%,3.28%
2020-01-01 00:25:30,15,8,5542,278,5264,8.46%,5.02%
2020-01-01 00:25:30,15,9,9033,630,8403,13.78%,6.97%
2020-01-01 00:25:30,15,10,5467,418,5049,8.34%,7.65%
2020-01-01 00:25:30,15,11,11148,1152,9996,17.01%,10.33%
2020-01-01 00:25:30,15,12,26055,5094,20961,39.76%,19.55%
2020-01-01 00:25:30,16,1,430,0,430,0.66%,0.00%
2020-01-01 00:25:30,16,2,340,0,340,0.52%,0.00%
2020-01-01 00:25:30,16,3,1449,14,1435,2.21%,0.97%
2020-01-01 00:25:30,16,4,4666,165,4501,7.12%,3.54%
2020-01-01 00:25:30,16,5,7827,475,7352,11.94%,6.07%
2020-01-01 00:25:30,16,6,5497,220,5277,8.39%,4.00%
2020-01-01 00:25:30,16,7,3849,120,3729,5.87%,3.12%
2020-01-01 00:25:30,16,8,7515,539,6976,11.47%,7.17%
2020-01-01 00:25:30,16,9,8373,537,7836,12.78%,6.41%
2020-01-01 00:25:30,16,10,1579,21,1558,2.41%,1.33%
2020-01-01 00:25:30,16,11,9286,711,8575,14.17%,7.66%
2020-01-01 00:25:30,16,12,25056,4264,20792,38.23%,17.02%
2020-01-01 00:25:40,1,1,16946,2105,14841,25.86%,12.42%
2020-01-01 00:25:40,1,2,4140,149,3991,6.32%,3.60%
2020-01-01 00:25:40,1,3,408,1,407,0.62%,0.25%
2020-01-01 00:25:40,1,4,12215,1123,11092,18.64%,9.19%
2020-01-01 00:25:40,1,5,11400,981,10419,17.40%,8.61%
2020-01-01 00:25:40,1,6,11325,968,10357,17.28%,8.55%
2020-01-01 00:25:40,1,7,3723,122,3601,5.68%,3.28%
2020-01-01 00:25:40,1,8,2885,66,2819,4.40%,2.29%
2020-01-01 00:25:40,1,9,11262,957,10305,17.18%,8.50%
2020-01-01 00:25:40,1,10,2056,30,2026,3.14%,1.46%
2020-01-01 00:25:40,1,11,2103,31,2072,3.21%,1.47%
2020-01-01 00:25:40,1,12,11239,956,10283,17.15%,8.51%
2020-01-01 00:25:40,2,1,3205,80,3125,4.89%,2.50%
2020-01-01 00:25:40,2,2,30123,5983,24140,45.96%,19.86%
2020-01-01 00:25:40,2,3,19955,2762,17193,30.45%,13.84%
2020-01-01 00:25:40,2,4,3150,79,3071,4.81%,2.51%
2020-01-01 00:25:40,2,5,12072,1059,11013,18.42%,8.77%
2020-01-01 00:25:40,2,6,50,0,50,0.08%,0.00%
2020-01-01 00:25:40,2,7,6947,367,6580,10.60%,5.28%
2020-01-01 00:25:40,2,8,5382,227,5155,8.21%,4.22%
2020-01-01 00:25:40,2,9,11947,1033,10914,18.23%,8.65%
2020-01-01 00:25:40,2,10,4481,158,4323,6.84%,3.53%
2020-01-01 00:25:40,2,11,4489,158,4331,6.85%,3.52%
2020-01-01 00:25:40,2,12,11807,1006,10801,18.02%,8.52%
2020-01-01 00:25:40,3,1,1357,21,1336,2.07%,1.55%
2020-01-01 00:25:40,3,2,27739,5055,22684,42.33%,18.22%
2020-01-01 00:25:40,3,3,73730,29376,44354,112.50%,39.84%
2020-01-01 00:25:40,3,4,9529,631,8898,14.54%,6.62%
2020-01-01 00:25:40,3,5,44847,12420,32427,68.43%,27.69%
2020-01-01 00:25:40,3,6,10247,726,9521,15.64%,7.09%
2020-01-01 00:25:40,3,7,24768,4087,20681,37.79%,16.50%
2020-01-01 00:25:40,3,8,17887,2175,15712,27.29%,12.16%
2020-01-01 00:25:40,3,9,34213,7665,26548,52.20%,22.40%
2020-01-01 00:25:40,3,10,6009,272,5737,9.17%,4.53%
2020-01-01 00:25:40,3,11,1714,21,1693,2.62%,1.23%
2020-01-01 00:25:40,3,12,25127,4338,20789,38.34%,17.26%
2020-01-01 00:25:40,4,1,574,5,569,0.88%,0.87%
2020-01-01 00:25:40,4,2,366,1,365,0.56%,0.27%
2020-01-01 00:25:40,4,3,694,3,691,1.06%,0.43%
2020-01-01 00:25:40,4,4,27594,5108,22486,42.11%,18.51%
2020-01-01 00:25:40,4,5,17048,2041,15007,26.01%,11.97%
2020-01-01 00:25:40,4,6,23679,3786,19893,36.13%,15.99%
2020-01-01 00:25:40,4,7,5536,226,5310,8.45%,4.08%
2020-01-01 00:25:40,4,8,3146,90,3056,4.80%,2.86%
2020-01-01 00:25:40,4,9,15271,1677,13594,23.30%,10.98%
2020-01-01 00:25:40,4,10,1819,20,1799,2.78%,1.10%
2020-01-01 00:25:40,4,11,168,0,168,0.26%,0.00%
2020-01-01 00:25:40,4,12,12087,1054,11033,18.44%,8.72%
2020-01-01 00:25:40,5,1,3022,76,2946,4.61%,2.51%
2020-01-01 00:25:40,5,2,842,5,837,1.28%,0.59%
2020-01-01 00:25:40,5,3,464,3,461,0.71%,0.65%
2020-01-01 00:25:40,5,4,21591,3210,18381,32.95%,14.87%
2020-01-01 00:25:40,5,5,10087,788,9299,15.39%,7.81%
2020-01-01 00:25:40,5,6,14451,1525,12926,22.05%,10.55%
2020-01-01 00:25:40,5,7,3901,117,3784,5.95%,3.00%
2020-01-01 00:25:40,5,8,3220,75,3145,4.91%,2.33%
2020-01-01 00:25:40,5,9,9516,706,8810,14.52%,7.42%
2020-01-01 00:25:40,5,10,1311,17,1294,2.00%,1.30%
2020-01-01 00:25:40,5,11,503,0,503,0.77%,0.00%
2020-01-01 00:25:40,5,12,7965,498,7467,12.15%,6.25%
2020-01-01 00:25:40,6,1,1203,11,1192,1.84%,0.91%
2020-01-01 00:25:40,6,2,1256,11,1245,1.92%,0.88%
2020-01-01 00:25:40,6,3,1730,14,1716,2.64%,0.81%
2020-01-01 00:25:40,6,4,1041,10,1031,1.59%,0.96%
2020-01-01 00:25:40,6,5,14679,1473,13206,22.40%,10.03%
2020-01-01 00:25:40,6,6,7038,400,6638,10.74%,5.68%
2020-01-01 00:25:40,6,7,5322,237,5085,8.12%,4.45%
2020-01-01 00:25:40,6,8,4583,194,4389,6.99%,4.23%
2020-01-01 00:25:40,6,9,5686,248,5438,8.68%,4.36%
2020-01-01 00:25:40,6,10,1750,29,1721,2.67%,1.66%
2020-01-01 00:25:40,6,11,302,1,301,0.46%,0.33%
2020-01-01 00:25:40,6,12,3838,105,3733,5.86%,2.74%
2020-01-01 00:25:40,7,1,425,5,420,0.65%,1.18%
2020-01-01 00:25:40,7,2,164,1,163,0.25%,0.61%
2020-01-01 00:25:40,7,3,1265,12,1253,1.93%,0.95%
2020-01-01 00:25:40,7,4,1362,28,1334,2.08%,2.06%
2020-01-01 00:25:40,7,5,8476,497,7979,12.93%,5.86%
2020-01-01 00:25:40,7,6,13438,1328,12110,20.50%,9.88%
2020-01-01 00:25:40,7,7,3543,110,3433,5.41%,3.10%
2020-01-01 00:25:40,7,8,1453,15,1438,2.22%,1.03%
2020-01-01 00:25:40,7,9,7118,354,6764,10.86%,4.97%
2020-01-01 00:25:40,7,10,2401,32,2369,3.66%,1.33%
2020-01-01 00:25:40,7,11,145,0,145,0.22%,0.00%
2020-01-01 00:25:40,7,12,4670,161,4509,7.13%,3.45%
2020-01-01 00:25:40,8,1,539,0,539,0.82%,0.00%
2020-01-01 00:25:40,8,2,46,0,46,0.07%,0.00%
2020-01-01 00:25:40,8,3,1602,30,1572,2.44%,1.87%
2020-01-01 00:25:40,8,4,2763,53,2710,4.22%,1.92%
2020-01-01 00:25:40,8,5,8344,478,7866,12.73%,5.73%
2020-01-01 00:25:40,8,6,15898,1769,14129,24.26%,11.13%
2020-01-01 00:25:40,8,7,4715,193,4522,7.19%,4.09%
2020-01-01 00:25:40,8,8,1953,41,1912,2.98%,2.10%
2020-01-01 00:25:40,8,9,6440,295,6145,9.83%,4.58%
2020-01-01 00:25:40,8,10,1717,27,1690,2.62%,1.57%
2020-01-01 00:25:40,8,11,246,0,246,0.38%,0.00%
2020-01-01 00:25:40,8,12,4700,146,4554,7.17%,3.11%
2020-01-01 00:25:40,9,1,413,4,409,0.63%,0.97%
2020-01-01 00:25:40,9,2,5088,181,4907,7.76%,3.56%
2020-01-01 00:25:40,9,3,4237,117,4120,6.47%,2.76%
2020-01-01 00:25:40,9,4,5986,278,5708,9.13%,4.64%
2020-01-01 00:25:40,9,5,225,0,225,0.34%,0.00%
2020-01-01 00:25:40,9,6,6651,340,6311,10.15%,5.11%
2020-01-01 00:25:40,9,7,30692,6199,24493,46.83%,20.20%
2020-01-01 00:25:40,9,8,12234,1056,11178,18.67%,8.63%
2020-01-01 00:25:40,9,9,151,0,151,0.23%,0.00%
2020-01-01 00:25:40,9,10,3410,89,3321,5.20%,2.61%
2020-01-01 00:25:40,9,11,11118,868,10250,16.96%,7.81%
2020-01-01 00:25:40,9,12,7476,424,7052,11.41%,5.67%
2020-01-01 00:25:40,10,1,1265,179,1086,1.93%,14.15%
2020-01-01 00:25:40,10,2,3267,238,3029,4.99%,7.28%
2020-01-01 00:25:40,10,3,1829,27,1802,2.79%,1.48%
2020-01-01 00:25:40,10,4,4042,871,3171,6.17%,21.55%
2020-01-01 00:25:40,10,5,768,59,709,1.17%,7.68%
2020-01-01 00:25:40,10,6,5595,1012,4583,8.54%,18.09%
2020-01-01 00:25:40,10,7,10260,1608,8652,15.66%,15.67%
2020-01-01 00:25:40,10,8,27766,6599,21167,42.37%,23.77%
2020-01-01 00:25:40,10,9,891,4,887,1.36%,0.45%
2020-01-01 00:25:40,10,10,2296,48,2248,3.50%,2.09%
2020-01-01 00:25:40,10,11,13340,1662,11678,20.36%,12.46%
2020-01-01 00:25:40,10,12,10440,1176,9264,15.93%,11.26%
2020-01-01 00:25:40,11,1,2729,63,2666,4.16%,2.31%
2020-01-01 00:25:40,11,2,4861,187,4674,7.42%,3.85%
2020-01-01 00:25:40,11,3,1965,32,1933,3.00%,1.63%
2020-01-01 00:25:40,11,4,5363,192,5171,8.18%,3.58%
2020-01-01 00:25:40,11,5,1489,13,1476,2.27%,0.87%
2020-01-01 00:25:40,11,6,7601,432,7169,11.60%,5.68%
2020-01-01 00:25:40,11,7,14282,1415,12867,21.79%,9.91%
2020-01-01 00:25:40,11,8,28171,5179,22992,42.99%,18.38%
2020-01-01 00:25:40,11,9,199,0,199,0.30%,0.00%
2020-01-01 00:25:40,11,10,3186,93,3093,4.86%,2.92%
2020-01-01 00:25:40,11,11,10457,830,9627,15.96%,7.94%
2020-01-01 00:25:40,11,12,6971,390,6581,10.64%,5.59%
2020-01-01 00:25:40,12,1,25,0,25,0.04%,0.00%
2020-01-01 00:25:40,12,2,595,163,432,0.91%,27.39%
2020-01-01 00:25:40,12,3,2511,228,2283,3.83%,9.08%
2020-01-01 00:25:40,12,4,2872,46,2826,4.38%,1.60%
2020-01-01 00:25:40,12,5,9068,744,8324,13.84%,8.20%
2020-01-01 00:25:40,12,6,5724,250,5474,8.73%,4.37%
2020-01-01 00:25:40,12,7,2649,70,2579,4.04%,2.64%
2020-01-01 00:25:40,12,8,1680,317,1363,2.56%,18.87%
2020-01-01 00:25:40,12,9,26173,5384,20789,39.94%,20.57%
2020-01-01 00:25:40,12,10,4326,417,3909,6.60%,9.64%
2020-01-01 00:25:40,12,11,1772,320,1452,2.70%,18.06%
2020-01-01 00:25:40,12,12,12353,1645,10708,18.85%,13.32%
2020-01-01 00:25:40,13,1,2240,30,2210,3.42%,1.34%
2020-01-01 00:25:40,13,2,2603,89,2514,3.97%,3.42%
2020-01-01 00:25:40,13,3,763,7,756,1.16%,0.92%
2020-01-01 00:25:40,13,4,5687,590,5097,8.68%,10.37%
2020-01-01 00:25:40,13,5,7874,901,6973,12.01%,11.44%
2020-01-01 00:25:40,13,6,6467,669,5798,9.87%,10.34%
2020-01-01 00:25:40,13,7,4687,215,4472,7.15%,4.59%
2020-01-01 00:25:40,13,8,7052,426,6626,10.76%,6.04%
2020-01-01 00:25:40,13,9,8153,932,7221,12.44%,11.43%
2020-01-01 00:25:40,13,10,27965,5792,22173,42.67%,20.71%
2020-01-01 00:25:40,13,11,16811,2330,14481,25.65%,13.86%
2020-01-01 00:25:40,13,12,9252,962,8290,14.12%,10.40%
2020-01-01 00:25:40,14,1,254,0,254,0.39%,0.00%
2020-01-01 00:25:40,14,2,953,4,949,1.45%,0.42%
2020-01-01 00:25:40,14,3,554,2,552,0.85%,0.36%
2020-01-01 00:25:40,14,4,3439,88,3351,5.25%,2.56%
2020-01-01 00:25:40,14,5,1596,20,1576,2.44%,1.25%
2020-01-01 00:25:40,14,6,3692,101,3591,5.63%,2.74%
2020-01-01 00:25:40,14,7,11374,925,10449,17.36%,8.13%
2020-01-01 00:25:40,14,8,12423,1115,11308,18.96%,8.98%
2020-01-01 00:25:40,14,9,1814,26,1788,2.77%,1.43%
2020-01-01 00:25:40,14,10,4099,140,3959,6.25%,3.42%
2020-01-01 00:25:40,14,11,23928,3947,19981,36.51%,16.50%
2020-01-01 00:25:40,14,12,7265,371,6894,11.09%,5.11%
2020-01-01 00:25:40,15,1,1477,12,1465,2.25%,0.81%
2020-01-01 00:25:40,15,2,199,0,199,0.30%,0.00%
2020-01-01 00:25:40,15,3,3720,109,3611,5.68%,2.93%
2020-01-01 00:25:40,15,4,5868,255,5613,8.95%,4.35%
2020-01-01 00:25:40,15,5,10345,812,9533,15.79%,7.85%
2020-01-01 00:25:40,15,6,6141,284,5857,9.37%,4.62%
2020-01-01 00:25:40,15,7,3237,121,3116,4.94%,3.74%
2020-01-01 00:25:40,15,8,5409,272,5137,8.25%,5.03%
2020-01-01 00:25:40,15,9,10525,837,9688,16.06%,7.95%
2020-01-01 00:25:40,15,10,3886,120,3766,5.93%,3.09%
2020-01-01 00:25:40,15,11,9387,684,8703,14.32%,7.29%
2020-01-01 00:25:40,15,12,25805,4996,20809,39.38%,19.36%
2020-01-01 00:25:40,16,1,554,4,550,0.85%,0.72%
2020-01-01 00:25:40,16,2,291,0,291,0.44%,0.00%
2020-01-01 00:25:40,16,3,1173,7,1166,1.79%,0.60%
2020-01-01 00:25:40,16,4,4187,150,4037,6.39%,3.58%
2020-01-01 00:25:40,16,5,7363,521,6842,11.24%,7.08%
2020-01-01 00:25:40,16,6,4981,210,4771,7.60%,4.22%
2020-01-01 00:25:40,16,7,5241,195,5046,8.00%,3.72%
2020-01-01 00:25:40,16,8,8568,592,7976,13.07%,6.91%
2020-01-01 00:25:40,16,9,7799,553,7246,11.90%,7.09%
2020-01-01 00:25:40,16,10,1431,17,1414,2.18%,1.19%
2020-01-01 00:25:40,16,11,10283,805,9478,15.69%,7.83%
2020-01-01 00:25:40,16,12,25458,4501,20957,38.85%,17.68%
2020-01-01 00:25:50,1,1,16550,2014,14536,25.25%,12.17%
2020-01-01 00:25:50,1,2,6709,353,6356,10.24%,5.26%
2020-01-01 00:25:50,1,3,1273,12,1261,1.94%,0.94%
2020-01-01 00:25:50,1,4,9267,725,8542,14.14%,7.82%
2020-01-01 00:25:50,1,5,8849,664,8185,13.50%,7.50%
2020-01-01 00:25:50,1,6,8814,661,8153,13.45%,7.50%
2020-01-01 00:25:50,1,7,5427,220,5207,8.28%,4.05%
2020-01-01 00:25:50,1,8,4621,146,4475,7.05%,3.16%
2020-01-01 00:25:50,1,9,8763,655,8108,13.37%,7.47%
2020-01-01 00:25:50,1,10,4088,115,3973,6.24%,2.81%
2020-01-01 00:25:50,1,11,4180,118,4062,6.38%,2.82%
2020-01-01 00:25:50,1,12,8720,648,8072,13.31%,7.43%
2020-01-01 00:25:50,2,1,868,10,858,1.32%,1.15%
2020-01-01 00:25:50,2,2,28979,5636,23343,44.22%,19.45%
2020-01-01 00:25:50,2,3,23994,3972,20022,36.61%,16.55%
2020-01-01 00:25:50,2,4,800,9,791,1.22%,1.12%
2020-01-01 00:25:50,2,5,13562,1381,12181,20.69%,10.18%
2020-01-01 00:25:50,2,6,49,0,49,0.07%,0.00%
2020-01-01 00:25:50,2,7,4104,125,3979,6.26%,3.05%
2020-01-01 00:25:50,2,8,2524,56,2468,3.85%,2.22%
2020-01-01 00:25:50,2,9,13525,1371,12154,20.64%,10.14%
2020-01-01 00:25:50,2,10,1672,25,1647,2.55%,1.50%
2020-01-01 00:25:50,2,11,1692,25,1667,2.58%,1.48%
2020-01-01 00:25:50,2,12,13343,1340,12003,20.36%,10.04%
2020-01-01 00:25:50,3,1,1087,12,1075,1.66%,1.10%
2020-01-01 00:25:50,3,2,27334,5067,22267,41.71%,18.54%
2020-01-01 00:25:50,3,3,73383,29305,44078,111.97%,39.93%
2020-01-01 00:25:50,3,4,9837,652,9185,15.01%,6.63%
2020-01-01 00:25:50,3,5,45072,12526,32546,68.77%,27.79%
2020-01-01 00:25:50,3,6,10952,812,10140,16.71%,7.41%
2020-01-01 00:25:50,3,7,24239,4056,20183,36.99%,16.73%
2020-01-01 00:25:50,3,8,19841,2799,17042,30.27%,14.11%
2020-01-01 00:25:50,3,9,33625,7411,26214,51.31%,22.04%
2020-01-01 00:25:50,3,10,4810,196,4614,7.34%,4.07%
2020-01-01 00:25:50,3,11,2590,51,2539,3.95%,1.97%
2020-01-01 00:25:50,3,12,25485,4418,21067,38.89%,17.34%
2020-01-01 00:25:50,4,1,580,6,574,0.89%,1.03%
2020-01-01 00:25:50,4,2,404,1,403,0.62%,0.25%
2020-01-01 00:25:50,4,3,948,8,940,1.45%,0.84%
2020-01-01 00:25:50,4,4,29154,5657,23497,44.49%,19.40%
2020-01-01 00:25:50,4,5,17363,2142,15221,26.49%,12.34%
2020-01-01 00:25:50,4,6,24960,4229,20731,38.09%,16.94%
2020-01-01 00:25:50,4,7,6177,247,5930,9.43%,4.00%
2020-01-01 00:25:50,4,8,3683,90,3593,5.62%,2.44%
2020-01-01 00:25:50,4,9,15352,1692,13660,23.43%,11.02%
2020-01-01 00:25:50,4,10,1979,36,1943,3.02%,1.82%
2020-01-01 00:25:50,4,11,227,0,227,0.35%,0.00%
2020-01-01 00:25:50,4,12,12672,1184,11488,19.34%,9.34%
2020-01-01 00:25:50,5,1,2898,65,2833,4.42%,2.24%
2020-01-01 00:25:50,5,2,797,4,793,1.22%,0.50%
2020-01-01 00:25:50,5,3,500,2,498,0.76%,0.40%
2020-01-01 00:25:50,5,4,21205,3074,18131,32.36%,14.50%
2020-01-01 00:25:50,5,5,8726,557,8169,13.31%,6.38%
2020-01-01 00:25:50,5,6,14078,1405,12673,21.48%,9.98%
2020-01-01 00:25:50,5,7,4904,167,4737,7.48%,3.41%
2020-01-01 00:25:50,5,8,3097,77,3020,4.73%,2.49%
2020-01-01 00:25:50,5,9,8046,470,7576,12.28%,5.84%
2020-01-01 00:25:50,5,10,1077,5,1072,1.64%,0.46%
2020-01-01 00:25:50,5,11,511,7,504,0.78%,1.37%
2020-01-01 00:25:50,5,12,6720,348,6372,10.25%,5.18%
2020-01-01 00:25:50,6,1,1208,13,1195,1.84%,1.08%
2020-01-01 00:25:50,6,2,1242,13,1229,1.90%,1.05%
2020-01-01 00:25:50,6,3,2073,28,2045,3.16%,1.35%
2020-01-01 00:25:50,6,4,1301,15,1286,1.99%,1.15%
2020-01-01 00:25:50,6,5,12548,1161,11387,19.15%,9.25%
2020-01-01 00:25:50,6,6,3760,112,3648,5.74%,2.98%
2020-01-01 00:25:50,6,7,1957,29,1928,2.99%,1.48%
2020-01-01 00:25:50,6,8,1479,15,1464,2.26%,1.01%
2020-01-01 00:25:50,6,9,6485,308,6177,9.90%,4.75%
2020-01-01 00:25:50,6,10,2558,42,2516,3.90%,1.64%
2020-01-01 00:25:50,6,11,468,3,465,0.71%,0.64%
2020-01-01 00:25:50,6,12,3879,106,3773,5.92%,2.73%
2020-01-01 00:25:50,7,1,413,2,411,0.63%,0.48%
2020-01-01 00:25:50,7,2,128,0,128,0.20%,0.00%
2020-01-01 00:25:50,7,3,530,2,528,0.81%,0.38%
2020-01-01 00:25:50,7,4,2259,42,2217,3.45%,1.86%
2020-01-01 00:25:50,7,5,7547,430,7117,11.52%,5.70%
2020-01-01 00:25:50,7,6,14147,1388,12759,21.59%,9.81%
2020-01-01 00:25:50,7,7,4281,109,4172,6.53%,2.55%
2020-01-01 00:25:50,7,8,1660,30,1630,2.53%,1.81%
2020-01-01 00:25:50,7,9,6672,340,6332,10.18%,5.10%
2020-01-01 00:25:50,7,10,1483,16,1467,2.26%,1.08%
2020-01-01 00:25:50,7,11,88,0,88,0.13%,0.00%
2020-01-01 00:25:50,7,12,5189,202,4987,7.92%,3.89%
2020-01-01 00:25:50,8,1,589,1,588,0.90%,0.17%
2020-01-01 00:25:50,8,2,112,0,112,0.17%,0.00%
2020-01-01 00:25:50,8,3,1672,28,1644,2.55%,1.67%
2020-01-01 00:25:50,8,4,3190,73,3117,4.87%,2.29%
2020-01-01 00:25:50,8,5,8067,477,7590,12.31%,5.91%
2020-01-01 00:25:50,8,6,16360,1803,14557,24.96%,11.02%
2020-01-01 00:25:50,8,7,4958,157,4801,7.57%,3.17%
2020-01-01 00:25:50,8,8,2283,28,2255,3.48%,1.23%
2020-01-01 00:25:50,8,9,6205,267,5938,9.47%,4.30%
2020-01-01 00:25:50,8,10,1566,28,1538,2.39%,1.79%
2020-01-01 00:25:50,8,11,170,1,169,0.26%,0.59%
2020-01-01 00:25:50,8,12,4642,149,4493,7.08%,3.21%
2020-01-01 00:25:50,9,1,459,1,458,0.70%,0.22%
2020-01-01 00:25:50,9,2,2668,55,2613,4.07%,2.06%
2020-01-01 00:25:50,9,3,1954,31,1923,2.98%,1.59%
2020-01-01 00:25:50,9,4,4683,152,4531,7.15%,3.25%
2020-01-01 00:25:50,9,5,365,0,365,0.56%,0.00%
2020-01-01 00:25:50,9,6,6179,276,5903,9.43%,4.47%
2020-01-01 00:25:50,9,7,27231,4954,22277,41.55%,18.19%
2020-01-01 00:25:50,9,8,10380,795,9585,15.84%,7.66%
2020-01-01 00:25:50,9,9,153,0,153,0.23%,0.00%
2020-01-01 00:25:50,9,10,3110,56,3054,4.75%,1.80%
2020-01-01 00:25:50,9,11,8939,619,8320,13.64%,6.92%
2020-01-01 00:25:50,9,12,5531,263,5268,8.44%,4.76%
2020-01-01 00:25:50,10,1,1442,270,1172,2.20%,18.72%
2020-01-01 00:25:50,10,2,3455,347,3108,5.27%,10.04%
2020-01-01 00:25:50,10,3,1830,31,1799,2.79%,1.69%
2020-01-01 00:25:50,10,4,3559,859,2700,5.43%,24.14%
2020-01-01 00:25:50,10,5,919,106,813,1.40%,11.53%
2020-01-01 00:25:50,10,6,5199,1046,4153,7.93%,20.12%
2020-01-01 00:25:50,10,7,10320,1838,8482,15.75%,17.81%
2020-01-01 00:25:50,10,8,27888,6878,21010,42.55%,24.66%
2020-01-01 00:25:50,10,9,545,1,544,0.83%,0.18%
2020-01-01 00:25:50,10,10,2057,30,2027,3.14%,1.46%
2020-01-01 00:25:50,10,11,13235,1513,11722,20.20%,11.43%
2020-01-01 00:25:50,10,12,10456,1057,9399,15.95%,10.11%
2020-01-01 00:25:50,11,1,2193,32,2161,3.35%,1.46%
2020-01-01 00:25:50,11,2,3253,87,3166,4.96%,2.67%
2020-01-01 00:25:50,11,3,890,8,882,1.36%,0.90%
2020-01-01 00:25:50,11,4,4641,149,4492,7.08%,3.21%
2020-01-01 00:25:50,11,5,353,1,352,0.54%,0.28%
2020-01-01 00:25:50,11,6,5959,251,5708,9.09%,4.21%
2020-01-01 00:25:50,11,7,10972,851,10121,16.74%,7.76%
2020-01-01 00:25:50,11,8,24709,4201,20508,37.70%,17.00%
2020-01-01 00:25:50,11,9,210,0,210,0.32%,0.00%
2020-01-01 00:25:50,11,10,2763,53,2710,4.22%,1.92%
2020-01-01 00:25:50,11,11,9925,754,9171,15.14%,7.60%
2020-01-01 00:25:50,11,12,6762,361,6401,10.32%,5.34%
2020-01-01 00:25:50,12,1,274,1,273,0.42%,0.36%
2020-01-01 00:25:50,12,2,639,116,523,0.98%,18.15%
2020-01-01 00:25:50,12,3,2764,169,2595,4.22%,6.11%
2020-01-01 00:25:50,12,4,2664,53,2611,4.06%,1.99%
2020-01-01 00:25:50,12,5,8264,621,7643,12.61%,7.51%
2020-01-01 00:25:50,12,6,4829,211,4618,7.37%,4.37%
2020-01-01 00:25:50,12,7,2034,43,1991,3.10%,2.11%
2020-01-01 00:25:50,12,8,1388,282,1106,2.12%,20.32%
2020-01-01 00:25:50,12,9,24058,4823,19235,36.71%,20.05%
2020-01-01 00:25:50,12,10,4803,418,4385,7.33%,8.70%
2020-01-01 00:25:50,12,11,1718,287,1431,2.62%,16.71%
2020-01-01 00:25:50,12,12,10561,1616,8945,16.11%,15.30%
2020-01-01 00:25:50,13,1,1902,35,1867,2.90%,1.84%
2020-01-01 00:25:50,13,2,2300,54,2246,3.51%,2.35%
2020-01-01 00:25:50,13,3,960,12,948,1.46%,1.25%
2020-01-01 00:25:50,13,4,6259,752,5507,9.55%,12.01%
2020-01-01 00:25:50,13,5,8969,1193,7776,13.69%,13.30%
2020-01-01 00:25:50,13,6,7090,827,6263,10.82%,11.66%
2020-01-01 00:25:50,13,7,4076,162,3914,6.22%,3.97%
2020-01-01 00:25:50,13,8,6839,356,6483,10.44%,5.21%
2020-01-01 00:25:50,13,9,9553,1261,8292,14.58%,13.20%
2020-01-01 00:25:50,13,10,30981,7023,23958,47.27%,22.67%
2020-01-01 00:25:50,13,11,18005,2581,15424,27.47%,14.33%
2020-01-01 00:25:50,13,12,10834,1174,9660,16.53%,10.84%
2020-01-01 00:25:50,14,1,181,0,181,0.28%,0.00%
2020-01-01 00:25:50,14,2,1672,8,1664,2.55%,0.48%
2020-01-01 00:25:50,14,3,1308,4,1304,2.00%,0.31%
2020-01-01 00:25:50,14,4,3295,86,3209,5.03%,2.61%
2020-01-01 00:25:50,14,5,1682,25,1657,2.57%,1.49%
2020-01-01 00:25:50,14,6,3643,108,3535,5.56%,2.96%
2020-01-01 00:25:50,14,7,11435,906,10529,17.45%,7.92%
2020-01-01 00:25:50,14,8,13201,1207,11994,20.14%,9.14%
2020-01-01 00:25:50,14,9,2000,39,1961,3.05%,1.95%
2020-01-01 00:25:50,14,10,4729,163,4566,7.22%,3.45%
2020-01-01 00:25:50,14,11,27443,4999,22444,41.87%,18.22%
2020-01-01 00:25:50,14,12,9155,611,8544,13.97%,6.67%
2020-01-01 00:25:50,15,1,595,2,593,0.91%,0.34%
2020-01-01 00:25:50,15,2,136,0,136,0.21%,0.00%
2020-01-01 00:25:50,15,3,3829,136,3693,5.84%,3.55%
2020-01-01 00:25:50,15,4,5029,236,4793,7.67%,4.69%
2020-01-01 00:25:50,15,5,9902,826,9076,15.11%,8.34%
2020-01-01 00:25:50,15,6,5367,300,5067,8.19%,5.59%
2020-01-01 00:25:50,15,7,3774,118,3656,5.76%,3.13%
2020-01-01 00:25:50,15,8,6720,351,6369,10.25%,5.22%
2020-01-01 00:25:50,15,9,10112,844,9268,15.43%,8.35%
2020-01-01 00:25:50,15,10,6010,461,5549,9.17%,7.67%
2020-01-01 00:25:50,15,11,12904,1389,11515,19.69%,10.76%
2020-01-01 00:25:50,15,12,29218,6149,23069,44.58%,21.05%
2020-01-01 00:25:50,16,1,344,0,344,0.52%,0.00%
2020-01-01 00:25:50,16,2,281,1,280,0.43%,0.36%
2020-01-01 00:25:50,16,3,1368,16,1352,2.09%,1.17%
2020-01-01 00:25:50,16,4,4312,136,4176,6.58%,3.15%
2020-01-01 00:25:50,16,5,8172,484,7688,12.47%,5.92%
2020-01-01 00:25:50,16,6,5148,204,4944,7.86%,3.96%
2020-01-01 00:25:50,16,7,3765,113,3652,5.74%,3.00%
2020-01-01 00:25:50,16,8,7705,553,7152,11.76%,7.18%
2020-01-01 00:25:50,16,9,8708,556,8152,13.29%,6.38%
2020-01-01 00:25:50,16,10,1587,21,1566,2.42%,1.32%
2020-01-01 00:25:50,16,11,9555,784,8771,14.58%,8.21%
2020-01-01 00:25:50,16,12,26069,4704,21365,39.78%,18.04%
2020-01-01 00:26:00,1,1,20299,2908,17391,30.97%,14.33%
2020-01-01 00:26:00,1,2,8926,555,8371,13.62%,6.22%
2020-01-01 00:26:00,1,3,432,2,430,0.66%,0.46%
2020-01-01 00:26:00,1,4,10795,861,9934,16.47%,7.98%
2020-01-01 00:26:00,1,5,10451,823,9628,15.95%,7.87%
2020-01-01 00:26:00,1,6,10392,810,9582,15.86%,7.79%
2020-01-01 00:26:00,1,7,8486,505,7981,12.95%,5.95%
2020-01-01 00:26:00,1,8,6621,301,6320,10.10%,4.55%
2020-01-01 00:26:00,1,9,10347,803,9544,15.79%,7.76%
2020-01-01 00:26:00,1,10,5398,208,5190,8.24%,3.85%
2020-01-01 00:26:00,1,11,5518,216,5302,8.42%,3.91%
2020-01-01 00:26:00,1,12,10317,801,9516,15.74%,7.76%
2020-01-01 00:26:00,2,1,730,6,724,1.11%,0.82%
2020-01-01 00:26:00,2,2,25130,4192,20938,38.35%,16.68%
2020-01-01 00:26:00,2,3,20670,2948,17722,31.54%,14.26%
2020-01-01 00:26:00,2,4,608,4,604,0.93%,0.66%
2020-01-01 00:26:00,2,5,12789,1173,11616,19.51%,9.17%
2020-01-01 00:26:00,2,6,29,0,29,0.04%,0.00%
2020-01-01 00:26:00,2,7,3708,105,3603,5.66%,2.83%
2020-01-01 00:26:00,2,8,2520,57,2463,3.85%,2.26%
2020-01-01 00:26:00,2,9,12724,1159,11565,19.42%,9.11%
2020-01-01 00:26:00,2,10,1683,26,1657,2.57%,1.54%
2020-01-01 00:26:00,2,11,1710,28,1682,2.61%,1.64%
2020-01-01 00:26:00,2,12,12547,1131,11416,19.15%,9.01%
2020-01-01 00:26:00,3,1,1547,11,1536,2.36%,0.71%
2020-01-01 00:26:00,3,2,22100,3323,18777,33.72%,15.04%
2020-01-01 00:26:00,3,3,77139,31657,45482,117.70%,41.04%
2020-01-01 00:26:00,3,4,13109,1230,11879,20.00%,9.38%
2020-01-01 00:26:00,3,5,52973,16567,36406,80.83%,31.27%
2020-01-01 00:26:00,3,6,14563,1498,13065,22.22%,10.29%
2020-01-01 00:26:00,3,7,18740,2431,16309,28.59%,12.97%
2020-01-01 00:26:00,3,8,16195,1842,14353,24.71%,11.37%
2020-01-01 00:26:00,3,9,37902,9073,28829,57.83%,23.94%
2020-01-01 00:26:00,3,10,6905,389,6516,10.54%,5.63%
2020-01-01 00:26:00,3,11,2016,42,1974,3.08%,2.08%
2020-01-01 00:26:00,3,12,28065,5194,22871,42.82%,18.51%
2020-01-01 00:26:00,4,1,625,4,621,0.95%,0.64%
2020-01-01 00:26:00,4,2,415,2,413,0.63%,0.48%
2020-01-01 00:26:00,4,3,1074,4,1070,1.64%,0.37%
2020-01-01 00:26:00,4,4,27696,5117,22579,42.26%,18.48%
2020-01-01 00:26:00,4,5,17169,2097,15072,26.20%,12.21%
2020-01-01 00:26:00,4,6,24081,3911,20170,36.74%,16.24%
2020-01-01 00:26:00,4,7,5568,196,5372,8.50%,3.52%
2020-01-01 00:26:00,4,8,3274,66,3208,5.00%,2.02%
2020-01-01 00:26:00,4,9,15044,1630,13414,22.96%,10.83%
2020-01-01 00:26:00,4,10,2217,38,2179,3.38%,1.71%
2020-01-01 00:26:00,4,11,206,1,205,0.31%,0.49%
2020-01-01 00:26:00,4,12,12023,1065,10958,18.35%,8.86%
2020-01-01 00:26:00,5,1,3025,74,2951,4.62%,2.45%
2020-01-01 00:26:00,5,2,912,11,901,1.39%,1.21%
2020-01-01 00:26:00,5,3,2083,29,2054,3.18%,1.39%
2020-01-01 00:26:00,5,4,26616,4781,21835,40.61%,17.96%
2020-01-01 00:26:00,5,5,10183,760,9423,15.54%,7.46%
2020-01-01 00:26:00,5,6,19572,2762,16810,29.86%,14.11%
2020-01-01 00:26:00,5,7,8893,631,8262,13.57%,7.10%
2020-01-01 00:26:00,5,8,3183,83,3100,4.86%,2.61%
2020-01-01 00:26:00,5,9,7915,482,7433,12.08%,6.09%
2020-01-01 00:26:00,5,10,1168,10,1158,1.78%,0.86%
2020-01-01 00:26:00,5,11,402,0,402,0.61%,0.00%
2020-01-01 00:26:00,5,12,6497,325,6172,9.91%,5.00%
2020-01-01 00:26:00,6,1,1268,13,1255,1.93%,1.03%
2020-01-01 00:26:00,6,2,1357,16,1341,2.07%,1.18%
2020-01-01 00:26:00,6,3,1881,42,1839,2.87%,2.23%
2020-01-01 00:26:00,6,4,1343,14,1329,2.05%,1.04%
2020-01-01 00:26:00,6,5,13252,1278,11974,20.22%,9.64%
2020-01-01 00:26:00,6,6,4601,181,4420,7.02%,3.93%
2020-01-01 00:26:00,6,7,2741,57,2684,4.18%,2.08%
2020-01-01 00:26:00,6,8,1744,21,1723,2.66%,1.20%
2020-01-01 00:26:00,6,9,6506,303,6203,9.93%,4.66%
2020-01-01 00:26:00,6,10,2271,29,2242,3.47%,1.28%
2020-01-01 00:26:00,6,11,505,0,505,0.77%,0.00%
2020-01-01 00:26:00,6,12,4187,138,4049,6.39%,3.30%
2020-01-01 00:26:00,7,1,535,2,533,0.82%,0.37%
2020-01-01 00:26:00,7,2,175,0,175,0.27%,0.00%
2020-01-01 00:26:00,7,3,629,3,626,0.96%,0.48%
2020-01-01 00:26:00,7,4,2717,51,2666,4.15%,1.88%
2020-01-01 00:26:00,7,5,7143,396,6747,10.90%,5.54%
2020-01-01 00:26:00,7,6,13611,1330,12281,20.77%,9.77%
2020-01-01 00:26:00,7,7,3704,102,3602,5.65%,2.75%
2020-01-01 00:26:00,7,8,1653,18,1635,2.52%,1.09%
2020-01-01 00:26:00,7,9,6131,277,5854,9.36%,4.52%
2020-01-01 00:26:00,7,10,828,5,823,1.26%,0.60%
2020-01-01 00:26:00,7,11,88,0,88,0.13%,0.00%
2020-01-01 00:26:00,7,12,5327,215,5112,8.13%,4.04%
2020-01-01 00:26:00,8,1,582,3,579,0.89%,0.52%
2020-01-01 00:26:00,8,2,109,0,109,0.17%,0.00%
2020-01-01 00:26:00,8,3,2509,51,2458,3.83%,2.03%
2020-01-01 00:26:00,8,4,2863,61,2802,4.37%,2.13%
2020-01-01 00:26:00,8,5,8859,554,8305,13.52%,6.25%
2020-01-01 00:26:00,8,6,16941,2024,14917,25.85%,11.95%
2020-01-01 00:26:00,8,7,5145,233,4912,7.85%,4.53%
2020-01-01 00:26:00,8,8,2440,55,2385,3.72%,2.25%
2020-01-01 00:26:00,8,9,6149,265,5884,9.38%,4.31%
2020-01-01 00:26:00,8,10,1699,21,1678,2.59%,1.24%
2020-01-01 00:26:00,8,11,135,0,135,0.21%,0.00%
2020-01-01 00:26:00,8,12,4427,153,4274,6.76%,3.46%
2020-01-01 00:26:00,9,1,459,3,456,0.70%,0.65%
2020-01-01 00:26:00,9,2,2145,32,2113,3.27%,1.49%
2020-01-01 00:26:00,9,3,1354,16,1338,2.07%,1.18%
2020-01-01 00:26:00,9,4,4288,142,4146,6.54%,3.31%
2020-01-01 00:26:00,9,5,191,1,190,0.29%,0.52%
2020-01-01 00:26:00,9,6,5305,204,5101,8.09%,3.85%
2020-01-01 00:26:00,9,7,26230,4661,21569,40.02%,17.77%
2020-01-01 00:26:00,9,8,11311,900,10411,17.26%,7.96%
2020-01-01 00:26:00,9,9,129,0,129,0.20%,0.00%
2020-01-01 00:26:00,9,10,4597,153,4444,7.01%,3.33%
2020-01-01 00:26:00,9,11,10074,725,9349,15.37%,7.20%
2020-01-01 00:26:00,9,12,5134,194,4940,7.83%,3.78%
2020-01-01 00:26:00,10,1,1403,281,1122,2.14%,20.03%
2020-01-01 00:26:00,10,2,3164,332,2832,4.83%,10.49%
2020-01-01 00:26:00,10,3,1629,23,1606,2.49%,1.41%
2020-01-01 00:26:00,10,4,4006,1029,2977,6.11%,25.69%
2020-01-01 00:26:00,10,5,866,117,749,1.32%,13.51%
2020-01-01 00:26:00,10,6,5969,1246,4723,9.11%,20.87%
2020-01-01 00:26:00,10,7,10807,1988,8819,16.49%,18.40%
2020-01-01 00:26:00,10,8,29478,7640,21838,44.98%,25.92%
2020-01-01 00:26:00,10,9,459,2,457,0.70%,0.44%
2020-01-01 00:26:00,10,10,2374,37,2337,3.62%,1.56%
2020-01-01 00:26:00,10,11,14012,1845,12167,21.38%,13.17%
2020-01-01 00:26:00,10,12,10905,1324,9581,16.64%,12.14%
2020-01-01 00:26:00,11,1,2719,65,2654,4.15%,2.39%
2020-01-01 00:26:00,11,2,3585,103,3482,5.47%,2.87%
2020-01-01 00:26:00,11,3,702,4,698,1.07%,0.57%
2020-01-01 00:26:00,11,4,5204,211,4993,7.94%,4.05%
2020-01-01 00:26:00,11,5,153,0,153,0.23%,0.00%
2020-01-01 00:26:00,11,6,6050,293,5757,9.23%,4.84%
2020-01-01 00:26:00,11,7,11252,924,10328,17.17%,8.21%
2020-01-01 00:26:00,11,8,24595,4181,20414,37.53%,17.00%
2020-01-01 00:26:00,11,9,169,0,169,0.26%,0.00%
2020-01-01 00:26:00,11,10,2846,57,2789,4.34%,2.00%
2020-01-01 00:26:00,11,11,9621,683,8938,14.68%,7.10%
2020-01-01 00:26:00,11,12,6377,316,6061,9.73%,4.96%
2020-01-01 00:26:00,12,1,64,0,64,0.10%,0.00%
2020-01-01 00:26:00,12,2,581,156,425,0.89%,26.85%
2020-01-01 00:26:00,12,3,2647,192,2455,4.04%,7.25%
2020-01-01 00:26:00,12,4,2997,101,2896,4.57%,3.37%
2020-01-01 00:26:00,12,5,8164,632,7532,12.46%,7.74%
2020-01-01 00:26:00,12,6,4847,197,4650,7.40%,4.06%
2020-01-01 00:26:00,12,7,1733,16,1717,2.64%,0.92%
2020-01-01 00:26:00,12,8,1651,326,1325,2.52%,19.75%
2020-01-01 00:26:00,12,9,21378,4270,17108,32.62%,19.97%
2020-01-01 00:26:00,12,10,4526,465,4061,6.91%,10.27%
2020-01-01 00:26:00,12,11,1873,333,1540,2.86%,17.78%
2020-01-01 00:26:00,12,12,8222,1382,6840,12.55%,16.81%
2020-01-01 00:26:00,13,1,2173,42,2131,3.32%,1.93%
2020-01-01 00:26:00,13,2,2553,52,2501,3.90%,2.04%
2020-01-01 00:26:00,13,3,921,5,916,1.41%,0.54%
2020-01-01 00:26:00,13,4,5193,625,4568,7.92%,12.04%
2020-01-01 00:26:00,13,5,7841,954,6887,11.96%,12.17%
2020-01-01 00:26:00,13,6,6113,682,5431,9.33%,11.16%
2020-01-01 00:26:00,13,7,4403,115,4288,6.72%,2.61%
2020-01-01 00:26:00,13,8,7709,412,7297,11.76%,5.34%
2020-01-01 00:26:00,13,9,8165,997,7168,12.46%,12.21%
2020-01-01 00:26:00,13,10,27878,5813,22065,42.54%,20.85%
2020-01-01 00:26:00,13,11,16636,2215,14421,25.38%,13.31%
2020-01-01 00:26:00,13,12,8652,855,7797,13.20%,9.88%
2020-01-01 00:26:00,14,1,223,0,223,0.34%,0.00%
2020-01-01 00:26:00,14,2,1503,14,1489,2.29%,0.93%
2020-01-01 00:26:00,14,3,1136,9,1127,1.73%,0.79%
2020-01-01 00:26:00,14,4,3363,89,3274,5.13%,2.65%
2020-01-01 00:26:00,14,5,1461,13,1448,2.23%,0.89%
2020-01-01 00:26:00,14,6,3798,109,3689,5.80%,2.87%
2020-01-01 00:26:00,14,7,11507,872,10635,17.56%,7.58%
2020-01-01 00:26:00,14,8,13318,1172,12146,20.32%,8.80%
2020-01-01 00:26:00,14,9,1723,18,1705,2.63%,1.04%
2020-01-01 00:26:00,14,10,4052,119,3933,6.18%,2.94%
2020-01-01 00:26:00,14,11,26003,4440,21563,39.68%,17.07%
2020-01-01 00:26:00,14,12,8223,496,7727,12.55%,6.03%
2020-01-01 00:26:00,15,1,578,3,575,0.88%,0.52%
2020-01-01 00:26:00,15,2,169,0,169,0.26%,0.00%
2020-01-01 00:26:00,15,3,3523,95,3428,5.38%,2.70%
2020-01-01 00:26:00,15,4,4543,227,4316,6.93%,5.00%
2020-01-01 00:26:00,15,5,9026,684,8342,13.77%,7.58%
2020-01-01 00:26:00,15,6,4846,257,4589,7.39%,5.30%
2020-01-01 00:26:00,15,7,3392,104,3288,5.18%,3.07%
2020-01-01 00:26:00,15,8,6063,294,5769,9.25%,4.85%
2020-01-01 00:26:00,15,9,9215,711,8504,14.06%,7.72%
2020-01-01 00:26:00,15,10,7273,602,6671,11.10%,8.28%
2020-01-01 00:26:00,15,11,13431,1464,11967,20.49%,10.90%
2020-01-01 00:26:00,15,12,27966,5826,22140,42.67%,20.83%
2020-01-01 00:26:00,16,1,435,2,433,0.66%,0.46%
2020-01-01 00:26:00,16,2,251,0,251,0.38%,0.00%
2020-01-01 00:26:00,16,3,1416,14,1402,2.16%,0.99%
2020-01-01 00:26:00,16,4,4079,119,3960,6.22%,2.92%
2020-01-01 00:26:00,16,5,7502,423,7079,11.45%,5.64%
2020-01-01 00:26:00,16,6,4958,172,4786,7.57%,3.47%
2020-01-01 00:26:00,16,7,3112,74,3038,4.75%,2.38%
2020-01-01 00:26:00,16,8,7427,492,6935,11.33%,6.62%
2020-01-01 00:26:00,16,9,8074,485,7589,12.32%,6.01%
2020-01-01 00:26:00,16,10,2366,43,2323,3.61%,1.82%
2020-01-01 00:26:00,16,11,10015,812,9203,15.28%,8.11%
2020-01-01 00:26:00,16,12,25682,4561,21121,39.19%,17.76%
2020-01-01 00:26:10,1,1,18349,2414,15935,28.00%,13.16%
2020-01-01 00:26:10,1,2,6716,345,6371,10.25%,5.14%
2020-01-01 00:26:10,1,3,605,2,603,0.92%,0.33%
2020-01-01 00:26:10,1,4,11127,965,10162,16.98%,8.67%
2020-01-01 00:26:10,1,5,10690,896,9794,16.31%,8.38%
2020-01-01 00:26:10,1,6,10679,896,9783,16.29%,8.39%
2020-01-01 00:26:10,1,7,6097,290,5807,9.30%,4.76%
2020-01-01 00:26:10,1,8,4944,184,4760,7.54%,3.72%
2020-01-01 00:26:10,1,9,10616,884,9732,16.20%,8.33%
2020-01-01 00:26:10,1,10,4009,121,3888,6.12%,3.02%
2020-01-01 00:26:10,1,11,4082,126,3956,6.23%,3.09%
2020-01-01 00:26:10,1,12,10588,881,9707,16.16%,8.32%
2020-01-01 00:26:10,2,1,730,3,727,1.11%,0.41%
2020-01-01 00:26:10,2,2,27097,4959,22138,41.35%,18.30%
2020-01-01 00:26:10,2,3,20596,2968,17628,31.43%,14.41%
2020-01-01 00:26:10,2,4,704,3,701,1.07%,0.43%
2020-01-01 00:26:10,2,5,11394,950,10444,17.39%,8.34%
2020-01-01 00:26:10,2,6,36,0,36,0.05%,0.00%
2020-01-01 00:26:10,2,7,5759,237,5522,8.79%,4.12%
2020-01-01 00:26:10,2,8,4757,162,4595,7.26%,3.41%
2020-01-01 00:26:10,2,9,11325,937,10388,17.28%,8.27%
2020-01-01 00:26:10,2,10,3688,100,3588,5.63%,2.71%
2020-01-01 00:26:10,2,11,3700,102,3598,5.65%,2.76%
2020-01-01 00:26:10,2,12,11176,913,10263,17.05%,8.17%
2020-01-01 00:26:10,3,1,1517,16,1501,2.31%,1.05%
2020-01-01 00:26:10,3,2,24404,3987,20417,37.24%,16.34%
2020-01-01 00:26:10,3,3,74141,29741,44400,113.13%,40.11%
2020-01-01 00:26:10,3,4,8211,466,7745,12.53%,5.68%
2020-01-01 00:26:10,3,5,47766,13857,33909,72.89%,29.01%
2020-01-01 00:26:10,3,6,9330,602,8728,14.24%,6.45%
2020-01-01 00:26:10,3,7,21141,3005,18136,32.26%,14.21%
2020-01-01 00:26:10,3,8,16196,1793,14403,24.71%,11.07%
2020-01-01 00:26:10,3,9,38054,9301,28753,58.07%,24.44%
2020-01-01 00:26:10,3,10,5713,263,5450,8.72%,4.60%
2020-01-01 00:26:10,3,11,1708,25,1683,2.61%,1.46%
2020-01-01 00:26:10,3,12,27483,5082,22401,41.94%,18.49%
2020-01-01 00:26:10,4,1,540,2,538,0.82%,0.37%
2020-01-01 00:26:10,4,2,345,0,345,0.53%,0.00%
2020-01-01 00:26:10,4,3,1128,5,1123,1.72%,0.44%
2020-01-01 00:26:10,4,4,28419,5222,23197,43.36%,18.38%
2020-01-01 00:26:10,4,5,18145,2238,15907,27.69%,12.33%
2020-01-01 00:26:10,4,6,24760,4025,20735,37.78%,16.26%
2020-01-01 00:26:10,4,7,5304,213,5091,8.09%,4.02%
2020-01-01 00:26:10,4,8,3122,75,3047,4.76%,2.40%
2020-01-01 00:26:10,4,9,15758,1743,14015,24.04%,11.06%
2020-01-01 00:26:10,4,10,1894,34,1860,2.89%,1.80%
2020-01-01 00:26:10,4,11,163,0,163,0.25%,0.00%
2020-01-01 00:26:10,4,12,12252,1070,11182,18.70%,8.73%
2020-01-01 00:26:10,5,1,3186,70,3116,4.86%,2.20%
2020-01-01 00:26:10,5,2,715,4,711,1.09%,0.56%
2020-01-01 00:26:10,5,3,593,7,586,0.90%,1.18%
2020-01-01 00:26:10,5,4,22837,3564,19273,34.85%,15.61%
2020-01-01 00:26:10,5,5,10457,786,9671,15.96%,7.52%
2020-01-01 00:26:10,5,6,15560,1735,13825,23.74%,11.15%
2020-01-01 00:26:10,5,7,4559,154,4405,6.96%,3.38%
2020-01-01 00:26:10,5,8,3289,70,3219,5.02%,2.13%
2020-01-01 00:26:10,5,9,9708,674,9034,14.81%,6.94%
2020-01-01 00:26:10,5,10,1707,28,1679,2.60%,1.64%
2020-01-01 00:26:10,5,11,562,7,555,0.86%,1.25%
2020-01-01 00:26:10,5,12,7637,430,7207,11.65%,5.63%
2020-01-01 00:26:10,6,1,1147,12,1135,1.75%,1.05%
2020-01-01 00:26:10,6,2,1212,13,1199,1.85%,1.07%
2020-01-01 00:26:10,6,3,1790,34,1756,2.73%,1.90%
2020-01-01 00:26:10,6,4,1368,14,1354,2.09%,1.02%
2020-01-01 00:26:10,6,5,12792,1185,11607,19.52%,9.26%
2020-01-01 00:26:10,6,6,4281,137,4144,6.53%,3.20%
2020-01-01 00:26:10,6,7,2444,57,2387,3.73%,2.33%
2020-01-01 00:26:10,6,8,1714,34,1680,2.62%,1.98%
2020-01-01 00:26:10,6,9,6353,299,6054,9.69%,4.71%
2020-01-01 00:26:10,6,10,2399,40,2359,3.66%,1.67%
2020-01-01 00:26:10,6,11,385,2,383,0.59%,0.52%
2020-01-01 00:26:10,6,12,3832,87,3745,5.85%,2.27%
2020-01-01 00:26:10,7,1,405,4,401,0.62%,0.99%
2020-01-01 00:26:10,7,2,219,0,219,0.33%,0.00%
2020-01-01 00:26:10,7,3,676,2,674,1.03%,0.30%
2020-01-01 00:26:10,7,4,1805,20,1785,2.75%,1.11%
2020-01-01 00:26:10,7,5,8189,490,7699,12.50%,5.98%
2020-01-01 00:26:10,7,6,13510,1343,12167,20.61%,9.94%
2020-01-01 00:26:10,7,7,3444,105,3339,5.26%,3.05%
2020-01-01 00:26:10,7,8,1469,24,1445,2.24%,1.63%
2020-01-01 00:26:10,7,9,7401,409,6992,11.29%,5.53%
2020-01-01 00:26:10,7,10,1895,25,1870,2.89%,1.32%
2020-01-01 00:26:10,7,11,98,0,98,0.15%,0.00%
2020-01-01 00:26:10,7,12,5454,208,5246,8.32%,3.81%
2020-01-01 00:26:10,8,1,510,3,507,0.78%,0.59%
2020-01-01 00:26:10,8,2,58,0,58,0.09%,0.00%
2020-01-01 00:26:10,8,3,2055,31,2024,3.14%,1.51%
2020-01-01 00:26:10,8,4,2958,72,2886,4.51%,2.43%
2020-01-01 00:26:10,8,5,8174,486,7688,12.47%,5.95%
2020-01-01 00:26:10,8,6,15813,1780,14033,24.13%,11.26%
2020-01-01 00:26:10,8,7,4524,164,4360,6.90%,3.63%
2020-01-01 00:26:10,8,8,1770,23,1747,2.70%,1.30%
2020-01-01 00:26:10,8,9,5882,262,5620,8.98%,4.45%
2020-01-01 00:26:10,8,10,1648,18,1630,2.51%,1.09%
2020-01-01 00:26:10,8,11,188,1,187,0.29%,0.53%
2020-01-01 00:26:10,8,12,4223,137,4086,6.44%,3.24%
2020-01-01 00:26:10,9,1,498,0,498,0.76%,0.00%
2020-01-01 00:26:10,9,2,3187,79,3108,4.86%,2.48%
2020-01-01 00:26:10,9,3,2251,48,2203,3.43%,2.13%
2020-01-01 00:26:10,9,4,4028,115,3913,6.15%,2.86%
2020-01-01 00:26:10,9,5,225,0,225,0.34%,0.00%
2020-01-01 00:26:10,9,6,4776,167,4609,7.29%,3.50%
2020-01-01 00:26:10,9,7,26704,4775,21929,40.75%,17.88%
2020-01-01 00:26:10,9,8,12988,1197,11791,19.82%,9.22%
2020-01-01 00:26:10,9,9,208,0,208,0.32%,0.00%
2020-01-01 00:26:10,9,10,5962,302,5660,9.10%,5.07%
2020-01-01 00:26:10,9,11,11547,977,10570,17.62%,8.46%
2020-01-01 00:26:10,9,12,5323,179,5144,8.12%,3.36%
2020-01-01 00:26:10,10,1,1241,199,1042,1.89%,16.04%
2020-01-01 00:26:10,10,2,2929,232,2697,4.47%,7.92%
2020-01-01 00:26:10,10,3,1550,9,1541,2.37%,0.58%
2020-01-01 00:26:10,10,4,4052,883,3169,6.18%,21.79%
2020-01-01 00:26:10,10,5,826,70,756,1.26%,8.47%
2020-01-01 00:26:10,10,6,6068,1095,4973,9.26%,18.05%
2020-01-01 00:26:10,10,7,11107,1744,9363,16.95%,15.70%
2020-01-01 00:26:10,10,8,29616,7382,22234,45.19%,24.93%
2020-01-01 00:26:10,10,9,984,6,978,1.50%,0.61%
2020-01-01 00:26:10,10,10,2662,51,2611,4.06%,1.92%
2020-01-01 00:26:10,10,11,13682,1843,11839,20.88%,13.47%
2020-01-01 00:26:10,10,12,10364,1290,9074,15.81%,12.45%
2020-01-01 00:26:10,11,1,2647,65,2582,4.04%,2.46%
2020-01-01 00:26:10,11,2,3720,126,3594,5.68%,3.39%
2020-01-01 00:26:10,11,3,930,11,919,1.42%,1.18%
2020-01-01 00:26:10,11,4,4848,173,4675,7.40%,3.57%
2020-01-01 00:26:10,11,5,154,0,154,0.23%,0.00%
2020-01-01 00:26:10,11,6,5743,238,5505,8.76%,4.14%
2020-01-01 00:26:10,11,7,11326,924,10402,17.28%,8.16%
2020-01-01 00:26:10,11,8,25219,4400,20819,38.48%,17.45%
2020-01-01 00:26:10,11,9,171,0,171,0.26%,0.00%
2020-01-01 00:26:10,11,10,2788,62,2726,4.25%,2.22%
2020-01-01 00:26:10,11,11,10218,808,9410,15.59%,7.91%
2020-01-01 00:26:10,11,12,7039,398,6641,10.74%,5.65%
2020-01-01 00:26:10,12,1,48,0,48,0.07%,0.00%
2020-01-01 00:26:10,12,2,702,167,535,1.07%,23.79%
2020-01-01 00:26:10,12,3,3397,240,3157,5.18%,7.07%
2020-01-01 00:26:10,12,4,2788,76,2712,4.25%,2.73%
2020-01-01 00:26:10,12,5,9769,836,8933,14.91%,8.56%
2020-01-01 00:26:10,12,6,5480,250,5230,8.36%,4.56%
2020-01-01 00:26:10,12,7,2497,40,2457,3.81%,1.60%
2020-01-01 00:26:10,12,8,1775,351,1424,2.71%,19.77%
2020-01-01 00:26:10,12,9,24989,5006,19983,38.13%,20.03%
2020-01-01 00:26:10,12,10,4559,458,4101,6.96%,10.05%
2020-01-01 00:26:10,12,11,2004,358,1646,3.06%,17.86%
2020-01-01 00:26:10,12,12,10131,1377,8754,15.46%,13.59%
2020-01-01 00:26:10,13,1,2300,35,2265,3.51%,1.52%
2020-01-01 00:26:10,13,2,2675,61,2614,4.08%,2.28%
2020-01-01 00:26:10,13,3,838,3,835,1.28%,0.36%
2020-01-01 00:26:10,13,4,5589,834,4755,8.53%,14.92%
2020-01-01 00:26:10,13,5,8322,1111,7211,12.70%,13.35%
2020-01-01 00:26:10,13,6,6279,882,5397,9.58%,14.05%
2020-01-01 00:26:10,13,7,4999,205,4794,7.63%,4.10%
2020-01-01 00:26:10,13,8,7387,427,6960,11.27%,5.78%
2020-01-01 00:26:10,13,9,8564,1134,7430,13.07%,13.24%
2020-01-01 00:26:10,13,10,29093,6342,22751,44.39%,21.80%
2020-01-01 00:26:10,13,11,17738,2591,15147,27.07%,14.61%
2020-01-01 00:26:10,13,12,9840,1131,8709,15.01%,11.49%
2020-01-01 00:26:10,14,1,231,0,231,0.35%,0.00%
2020-01-01 00:26:10,14,2,1460,14,1446,2.23%,0.96%
2020-01-01 00:26:10,14,3,1047,8,1039,1.60%,0.76%
2020-01-01 00:26:10,14,4,3650,118,3532,5.57%,3.23%
2020-01-01 00:26:10,14,5,1327,14,1313,2.02%,1.06%
2020-01-01 00:26:10,14,6,3945,135,3810,6.02%,3.42%
2020-01-01 00:26:10,14,7,12314,1097,11217,18.79%,8.91%
2020-01-01 00:26:10,14,8,13810,1372,12438,21.07%,9.93%
2020-01-01 00:26:10,14,9,1489,14,1475,2.27%,0.94%
2020-01-01 00:26:10,14,10,3868,123,3745,5.90%,3.18%
2020-01-01 00:26:10,14,11,25938,4555,21383,39.58%,17.56%
2020-01-01 00:26:10,14,12,7945,447,7498,12.12%,5.63%
2020-01-01 00:26:10,15,1,480,1,479,0.73%,0.21%
2020-01-01 00:26:10,15,2,149,0,149,0.23%,0.00%
2020-01-01 00:26:10,15,3,4177,140,4037,6.37%,3.35%
2020-01-01 00:26:10,15,4,5360,213,5147,8.18%,3.97%
2020-01-01 00:26:10,15,5,10502,812,9690,16.02%,7.73%
2020-01-01 00:26:10,15,6,5574,236,5338,8.51%,4.23%
2020-01-01 00:26:10,15,7,3827,118,3709,5.84%,3.08%
2020-01-01 00:26:10,15,8,5978,278,5700,9.12%,4.65%
2020-01-01 00:26:10,15,9,10711,847,9864,16.34%,7.91%
2020-01-01 00:26:10,15,10,5490,242,5248,8.38%,4.41%
2020-01-01 00:26:10,15,11,11597,986,10611,17.70%,8.50%
2020-01-01 00:26:10,15,12,28434,5794,22640,43.39%,20.38%
2020-01-01 00:26:10,16,1,642,2,640,0.98%,0.31%
2020-01-01 00:26:10,16,2,205,2,203,0.31%,0.98%
2020-01-01 00:26:10,16,3,1473,8,1465,2.25%,0.54%
2020-01-01 00:26:10,16,4,4538,137,4401,6.92%,3.02%
2020-01-01 00:26:10,16,5,8102,516,7586,12.36%,6.37%
2020-01-01 00:26:10,16,6,5434,204,5230,8.29%,3.75%
2020-01-01 00:26:10,16,7,4094,125,3969,6.25%,3.05%
2020-01-01 00:26:10,16,8,7592,508,7084,11.58%,6.69%
2020-01-01 00:26:10,16,9,8582,574,8008,13.10%,6.69%
2020-01-01 00:26:10,16,10,2648,49,2599,4.04%,1.85%
2020-01-01 00:26:10,16,11,10467,868,9599,15.97%,8.29%
2020-01-01 00:26:10,16,12,26968,4988,21980,41.15%,18.50%
2020-01-01 00:26:20,1,1,20444,2961,17483,31.20%,14.48%
2020-01-01 00:26:20,1,2,8683,566,8117,13.25%,6.52%
2020-01-01 00:26:20,1,3,504,4,500,0.77%,0.79%
2020-01-01 00:26:20,1,4,11189,950,10239,17.07%,8.49%
2020-01-01 00:26:20,1,5,10638,851,9787,16.23%,8.00%
2020-01-01 00:26:20,1,6,10626,856,9770,16.21%,8.06%
2020-01-01 00:26:20,1,7,8164,505,7659,12.46%,6.19%
2020-01-01 00:26:20,1,8,5542,204,5338,8.46%,3.68%
2020-01-01 00:26:20,1,9,10542,844,9698,16.09%,8.01%
2020-01-01 00:26:20,1,10,4713,151,4562,7.19%,3.20%
2020-01-01 00:26:20,1,11,4778,156,4622,7.29%,3.26%
2020-01-01 00:26:20,1,12,10512,839,9673,16.04%,7.98%
2020-01-01 00:26:20,2,1,1482,14,1468,2.26%,0.94%
2020-01-01 00:26:20,2,2,30354,6106,24248,46.32%,20.12%
2020-01-01 00:26:20,2,3,23729,3921,19808,36.21%,16.52%
2020-01-01 00:26:20,2,4,1376,11,1365,2.10%,0.80%
2020-01-01 00:26:20,2,5,13223,1278,11945,20.18%,9.66%
2020-01-01 00:26:20,2,6,34,0,34,0.05%,0.00%
2020-01-01 00:26:20,2,7,5126,190,4936,7.82%,3.71%
2020-01-01 00:26:20,2,8,3738,97,3641,5.70%,2.59%
2020-01-01 00:26:20,2,9,13133,1265,11868,20.04%,9.63%
2020-01-01 00:26:20,2,10,2746,61,2685,4.19%,2.22%
2020-01-01 00:26:20,2,11,2767,61,2706,4.22%,2.20%
2020-01-01 00:26:20,2,12,12937,1227,11710,19.74%,9.48%
2020-01-01 00:26:20,3,1,1625,19,1606,2.48%,1.17%
2020-01-01 00:26:20,3,2,21997,3305,18692,33.56%,15.02%
2020-01-01 00:26:20,3,3,73337,29189,44148,111.90%,39.80%
2020-01-01 00:26:20,3,4,11880,991,10889,18.13%,8.34%
2020-01-01 00:26:20,3,5,50452,15262,35190,76.98%,30.25%
2020-01-01 00:26:20,3,6,13220,1234,11986,20.17%,9.33%
2020-01-01 00:26:20,3,7,18743,2420,16323,28.60%,12.91%
2020-01-01 00:26:20,3,8,15262,1635,13627,23.29%,10.71%
2020-01-01 00:26:20,3,9,36896,8619,28277,56.30%,23.36%
2020-01-01 00:26:20,3,10,6674,309,6365,10.18%,4.63%
2020-01-01 00:26:20,3,11,2045,31,2014,3.12%,1.52%
2020-01-01 00:26:20,3,12,25797,4525,21272,39.36%,17.54%
2020-01-01 00:26:20,4,1,546,1,545,0.83%,0.18%
2020-01-01 00:26:20,4,2,349,1,348,0.53%,0.29%
2020-01-01 00:26:20,4,3,865,11,854,1.32%,1.27%
2020-01-01 00:26:20,4,4,28542,5453,23089,43.55%,19.11%
2020-01-01 00:26:20,4,5,17672,2167,15505,26.97%,12.26%
2020-01-01 00:26:20,4,6,24562,4114,20448,37.48%,16.75%
2020-01-01 00:26:20,4,7,5577,268,5309,8.51%,4.81%
2020-01-01 00:26:20,4,8,3340,99,3241,5.10%,2.96%
2020-01-01 00:26:20,4,9,15564,1733,13831,23.75%,11.13%
2020-01-01 00:26:20,4,10,2199,41,2158,3.36%,1.86%
2020-01-01 00:26:20,4,11,193,0,193,0.29%,0.00%
2020-01-01 00:26:20,4,12,12404,1100,11304,18.93%,8.87%
2020-01-01 00:26:20,5,1,2812,62,2750,4.29%,2.20%
2020-01-01 00:26:20,5,2,660,5,655,1.01%,0.76%
2020-01-01 00:26:20,5,3,820,8,812,1.25%,0.98%
2020-01-01 00:26:20,5,4,24608,4112,20496,37.55%,16.71%
2020-01-01 00:26:20,5,5,9571,629,8942,14.60%,6.57%
2020-01-01 00:26:20,5,6,14159,1433,12726,21.60%,10.12%
2020-01-01 00:26:20,5,7,4145,165,3980,6.32%,3.98%
2020-01-01 00:26:20,5,8,3155,101,3054,4.81%,3.20%
2020-01-01 00:26:20,5,9,8668,509,8159,13.23%,5.87%
2020-01-01 00:26:20,5,10,1111,8,1103,1.70%,0.72%
2020-01-01 00:26:20,5,11,525,3,522,0.80%,0.57%
2020-01-01 00:26:20,5,12,7104,344,6760,10.84%,4.84%
2020-01-01 00:26:20,6,1,1141,10,1131,1.74%,0.88%
2020-01-01 00:26:20,6,2,1191,11,1180,1.82%,0.92%
2020-01-01 00:26:20,6,3,1811,21,1790,2.76%,1.16%
2020-01-01 00:26:20,6,4,1410,13,1397,2.15%,0.92%
2020-01-01 00:26:20,6,5,13812,1304,12508,21.08%,9.44%
2020-01-01 00:26:20,6,6,4329,129,4200,6.61%,2.98%
2020-01-01 00:26:20,6,7,2584,43,2541,3.94%,1.66%
2020-01-01 00:26:20,6,8,1792,24,1768,2.73%,1.34%
2020-01-01 00:26:20,6,9,7390,386,7004,11.28%,5.22%
2020-01-01 00:26:20,6,10,2046,32,2014,3.12%,1.56%
2020-01-01 00:26:20,6,11,516,1,515,0.79%,0.19%
2020-01-01 00:26:20,6,12,5276,196,5080,8.05%,3.71%
2020-01-01 00:26:20,7,1,521,1,520,0.79%,0.19%
2020-01-01 00:26:20,7,2,131,0,131,0.20%,0.00%
2020-01-01 00:26:20,7,3,644,1,643,0.98%,0.16%
2020-01-01 00:26:20,7,4,2225,25,2200,3.40%,1.12%
2020-01-01 00:26:20,7,5,7513,433,7080,11.46%,5.76%
2020-01-01 00:26:20,7,6,12978,1188,11790,19.80%,9.15%
2020-01-01 00:26:20,7,7,3161,68,3093,4.82%,2.15%
2020-01-01 00:26:20,7,8,1384,15,1369,2.11%,1.08%
2020-01-01 00:26:20,7,9,6612,336,6276,10.09%,5.08%
2020-01-01 00:26:20,7,10,1461,9,1452,2.23%,0.62%
2020-01-01 00:26:20,7,11,95,0,95,0.14%,0.00%
2020-01-01 00:26:20,7,12,5159,211,4948,7.87%,4.09%
2020-01-01 00:26:20,8,1,632,8,624,0.96%,1.27%
2020-01-01 00:26:20,8,2,88,0,88,0.13%,0.00%
2020-01-01 00:26:20,8,3,2206,33,2173,3.37%,1.50%
2020-01-01 00:26:20,8,4,3157,88,3069,4.82%,2.79%
2020-01-01 00:26:20,8,5,8355,506,7849,12.75%,6.06%
2020-01-01 00:26:20,8,6,16429,1935,14494,25.07%,11.78%
2020-01-01 00:26:20,8,7,4570,158,4412,6.97%,3.46%
2020-01-01 00:26:20,8,8,1869,34,1835,2.85%,1.82%
2020-01-01 00:26:20,8,9,5876,268,5608,8.97%,4.56%
2020-01-01 00:26:20,8,10,1601,22,1579,2.44%,1.37%
2020-01-01 00:26:20,8,11,90,0,90,0.14%,0.00%
2020-01-01 00:26:20,8,12,4255,150,4105,6.49%,3.53%
2020-01-01 00:26:20,9,1,988,18,970,1.51%,1.82%
2020-01-01 00:26:20,9,2,3950,148,3802,6.03%,3.75%
2020-01-01 00:26:20,9,3,2505,48,2457,3.82%,1.92%
2020-01-01 00:26:20,9,4,2615,48,2567,3.99%,1.84%
2020-01-01 00:26:20,9,5,355,2,353,0.54%,0.56%
2020-01-01 00:26:20,9,6,3679,105,3574,5.61%,2.85%
2020-01-01 00:26:20,9,7,24250,4115,20135,37.00%,16.97%
2020-01-01 00:26:20,9,8,10012,724,9288,15.28%,7.23%
2020-01-01 00:26:20,9,9,263,1,262,0.40%,0.38%
2020-01-01 00:26:20,9,10,2202,36,2166,3.36%,1.63%
2020-01-01 00:26:20,9,11,8598,538,8060,13.12%,6.26%
2020-01-01 00:26:20,9,12,6101,260,5841,9.31%,4.26%
2020-01-01 00:26:20,10,1,1469,282,1187,2.24%,19.20%
2020-01-01 00:26:20,10,2,3480,362,3118,5.31%,10.40%
2020-01-01 00:26:20,10,3,1881,31,1850,2.87%,1.65%
2020-01-01 00:26:20,10,4,4073,984,3089,6.21%,24.16%
2020-01-01 00:26:20,10,5,857,97,760,1.31%,11.32%
2020-01-01 00:26:20,10,6,6073,1180,4893,9.27%,19.43%
2020-01-01 00:26:20,10,7,11139,1983,9156,17.00%,17.80%
2020-01-01 00:26:20,10,8,30135,7747,22388,45.98%,25.71%
2020-01-01 00:26:20,10,9,666,6,660,1.02%,0.90%
2020-01-01 00:26:20,10,10,2274,54,2220,3.47%,2.37%
2020-01-01 00:26:20,10,11,15243,2070,13173,23.26%,13.58%
2020-01-01 00:26:20,10,12,11848,1410,10438,18.08%,11.90%
2020-01-01 00:26:20,11,1,2601,69,2532,3.97%,2.65%
2020-01-01 00:26:20,11,2,4381,167,4214,6.68%,3.81%
2020-01-01 00:26:20,11,3,1577,13,1564,2.41%,0.82%
2020-01-01 00:26:20,11,4,3858,98,3760,5.89%,2.54%
2020-01-01 00:26:20,11,5,193,0,193,0.29%,0.00%
2020-01-01 00:26:20,11,6,4521,149,4372,6.90%,3.30%
2020-01-01 00:26:20,11,7,10509,820,9689,16.04%,7.80%
2020-01-01 00:26:20,11,8,24073,4035,20038,36.73%,16.76%
2020-01-01 00:26:20,11,9,171,1,170,0.26%,0.58%
2020-01-01 00:26:20,11,10,2643,54,2589,4.03%,2.04%
2020-01-01 00:26:20,11,11,10098,732,9366,15.41%,7.25%
2020-01-01 00:26:20,11,12,7059,377,6682,10.77%,5.34%
2020-01-01 00:26:20,12,1,47,0,47,0.07%,0.00%
2020-01-01 00:26:20,12,2,645,127,518,0.98%,19.69%
2020-01-01 00:26:20,12,3,2918,207,2711,4.45%,7.09%
2020-01-01 00:26:20,12,4,3045,121,2924,4.65%,3.97%
2020-01-01 00:26:20,12,5,8901,741,8160,13.58%,8.32%
2020-01-01 00:26:20,12,6,5180,265,4915,7.90%,5.12%
2020-01-01 00:26:20,12,7,2000,47,1953,3.05%,2.35%
2020-01-01 00:26:20,12,8,1829,319,1510,2.79%,17.44%
2020-01-01 00:26:20,12,9,22923,4749,18174,34.98%,20.72%
2020-01-01 00:26:20,12,10,5029,474,4555,7.67%,9.43%
2020-01-01 00:26:20,12,11,2037,325,1712,3.11%,15.95%
2020-01-01 00:26:20,12,12,8183,1292,6891,12.49%,15.79%
2020-01-01 00:26:20,13,1,2201,46,2155,3.36%,2.09%
2020-01-01 00:26:20,13,2,2578,68,2510,3.93%,2.64%
2020-01-01 00:26:20,13,3,981,7,974,1.50%,0.71%
2020-01-01 00:26:20,13,4,5376,551,4825,8.20%,10.25%
2020-01-01 00:26:20,13,5,7835,858,6977,11.96%,10.95%
2020-01-01 00:26:20,13,6,5923,601,5322,9.04%,10.15%
2020-01-01 00:26:20,13,7,4378,158,4220,6.68%,3.61%
2020-01-01 00:26:20,13,8,8070,481,7589,12.31%,5.96%
2020-01-01 00:26:20,13,9,8210,905,7305,12.53%,11.02%
2020-01-01 00:26:20,13,10,28143,5663,22480,42.94%,20.12%
2020-01-01 00:26:20,13,11,17369,2372,14997,26.50%,13.66%
2020-01-01 00:26:20,13,12,8978,915,8063,13.70%,10.19%
2020-01-01 00:26:20,14,1,181,1,180,0.28%,0.55%
2020-01-01 00:26:20,14,2,1523,19,1504,2.32%,1.25%
2020-01-01 00:26:20,14,3,1195,12,1183,1.82%,1.00%
2020-01-01 00:26:20,14,4,3948,135,3813,6.02%,3.42%
2020-01-01 00:26:20,14,5,1158,9,1149,1.77%,0.78%
2020-01-01 00:26:20,14,6,4204,153,4051,6.41%,3.64%
2020-01-01 00:26:20,14,7,12022,1029,10993,18.34%,8.56%
2020-01-01 00:26:20,14,8,13718,1358,12360,20.93%,9.90%
2020-01-01 00:26:20,14,9,1287,11,1276,1.96%,0.85%
2020-01-01 00:26:20,14,10,4035,132,3903,6.16%,3.27%
2020-01-01 00:26:20,14,11,26578,4683,21895,40.55%,17.62%
2020-01-01 00:26:20,14,12,8459,481,7978,12.91%,5.69%
2020-01-01 00:26:20,15,1,569,1,568,0.87%,0.18%
2020-01-01 00:26:20,15,2,111,0,111,0.17%,0.00%
2020-01-01 00:26:20,15,3,4093,130,3963,6.25%,3.18%
2020-01-01 00:26:20,15,4,4586,189,4397,7.00%,4.12%
2020-01-01 00:26:20,15,5,9597,723,8874,14.64%,7.53%
2020-01-01 00:26:20,15,6,4896,211,4685,7.47%,4.31%
2020-01-01 00:26:20,15,7,3513,105,3408,5.36%,2.99%
2020-01-01 00:26:20,15,8,5393,219,5174,8.23%,4.06%
2020-01-01 00:26:20,15,9,9790,746,9044,14.94%,7.62%
2020-01-01 00:26:20,15,10,4224,288,3936,6.45%,6.82%
2020-01-01 00:26:20,15,11,9732,844,8888,14.85%,8.67%
2020-01-01 00:26:20,15,12,26088,5244,20844,39.81%,20.10%
2020-01-01 00:26:20,16,1,628,3,625,0.96%,0.48%
2020-01-01 00:26:20,16,2,242,1,241,0.37%,0.41%
2020-01-01 00:26:20,16,3,1625,18,1607,2.48%,1.11%
2020-01-01 00:26:20,16,4,4631,210,4421,7.07%,4.53%
2020-01-01 00:26:20,16,5,8239,589,7650,12.57%,7.15%
2020-01-01 00:26:20,16,6,5546,283,5263,8.46%,5.10%
2020-01-01 00:26:20,16,7,3882,106,3776,5.92%,2.73%
2020-01-01 00:26:20,16,8,8562,577,7985,13.06%,6.74%
2020-01-01 00:26:20,16,9,8823,658,8165,13.46%,7.46%
2020-01-01 00:26:20,16,10,1880,35,1845,2.87%,1.86%
2020-01-01 00:26:20,16,11,10671,864,9807,16.28%,8.10%
2020-01-01 00:26:20,16,12,27198,5051,22147,41.50%,18.57%
2020-01-01 00:26:30,1,1,19295,2624,16671,29.44%,13.60%
2020-01-01 00:26:30,1,2,11128,876,10252,16.98%,7.87%
2020-01-01 00:26:30,1,3,608,1,607,0.93%,0.16%
2020-01-01 00:26:30,1,4,7767,501,7266,11.85%,6.45%
2020-01-01 00:26:30,1,5,7529,473,7056,11.49%,6.28%
2020-01-01 00:26:30,1,6,7432,458,6974,11.34%,6.16%
2020-01-01 00:26:30,1,7,10497,767,9730,16.02%,7.31%
2020-01-01 00:26:30,1,8,9206,590,8616,14.05%,6.41%
2020-01-01 00:26:30,1,9,7391,453,6938,11.28%,6.13%
2020-01-01 00:26:30,1,10,8481,497,7984,12.94%,5.86%
2020-01-01 00:26:30,1,11,8547,504,8043,13.04%,5.90%
2020-01-01 00:26:30,1,12,7373,450,6923,11.25%,6.10%
2020-01-01 00:26:30,2,1,2337,34,2303,3.57%,1.45%
2020-01-01 00:26:30,2,2,28762,5458,23304,43.89%,18.98%
2020-01-01 00:26:30,2,3,22331,3365,18966,34.07%,15.07%
2020-01-01 00:26:30,2,4,2228,32,2196,3.40%,1.44%
2020-01-01 00:26:30,2,5,14022,1324,12698,21.40%,9.44%
2020-01-01 00:26:30,2,6,74,0,74,0.11%,0.00%
2020-01-01 00:26:30,2,7,4087,131,3956,6.24%,3.21%
2020-01-01 00:26:30,2,8,3098,67,3031,4.73%,2.16%
2020-01-01 00:26:30,2,9,13963,1317,12646,21.31%,9.43%
2020-01-01 00:26:30,2,10,2082,30,2052,3.18%,1.44%
2020-01-01 00:26:30,2,11,2096,30,2066,3.20%,1.43%
2020-01-01 00:26:30,2,12,13764,1280,12484,21.00%,9.30%
2020-01-01 00:26:30,3,1,1403,6,1397,2.14%,0.43%
2020-01-01 00:26:30,3,2,27173,4949,22224,41.46%,18.21%
2020-01-01 00:26:30,3,3,76753,31482,45271,117.12%,41.02%
2020-01-01 00:26:30,3,4,7511,441,7070,11.46%,5.87%
2020-01-01 00:26:30,3,5,46559,13173,33386,71.04%,28.29%
2020-01-01 00:26:30,3,6,9620,694,8926,14.68%,7.21%
2020-01-01 00:26:30,3,7,23865,3922,19943,36.42%,16.43%
2020-01-01 00:26:30,3,8,16994,2119,14875,25.93%,12.47%
2020-01-01 00:26:30,3,9,36586,8433,28153,55.83%,23.05%
2020-01-01 00:26:30,3,10,10737,814,9923,16.38%,7.58%
2020-01-01 00:26:30,3,11,1841,21,1820,2.81%,1.14%
2020-01-01 00:26:30,3,12,22624,3410,19214,34.52%,15.07%
2020-01-01 00:26:30,4,1,504,2,502,0.77%,0.40%
2020-01-01 00:26:30,4,2,278,1,277,0.42%,0.36%
2020-01-01 00:26:30,4,3,727,5,722,1.11%,0.69%
2020-01-01 00:26:30,4,4,28924,5483,23441,44.13%,18.96%
2020-01-01 00:26:30,4,5,17652,2175,15477,26.93%,12.32%
2020-01-01 00:26:30,4,6,24564,4045,20519,37.48%,16.47%
2020-01-01 00:26:30,4,7,5629,231,5398,8.59%,4.10%
2020-01-01 00:26:30,4,8,3237,78,3159,4.94%,2.41%
2020-01-01 00:26:30,4,9,15585,1720,13865,23.78%,11.04%
2020-01-01 00:26:30,4,10,2063,24,2039,3.15%,1.16%
2020-01-01 00:26:30,4,11,117,0,117,0.18%,0.00%
2020-01-01 00:26:30,4,12,12826,1165,11661,19.57%,9.08%
2020-01-01 00:26:30,5,1,2899,69,2830,4.42%,2.38%
2020-01-01 00:26:30,5,2,1209,17,1192,1.84%,1.41%
2020-01-01 00:26:30,5,3,959,8,951,1.46%,0.83%
2020-01-01 00:26:30,5,4,23327,3732,19595,35.59%,16.00%
2020-01-01 00:26:30,5,5,9520,691,8829,14.53%,7.26%
2020-01-01 00:26:30,5,6,13856,1395,12461,21.14%,10.07%
2020-01-01 00:26:30,5,7,3985,129,3856,6.08%,3.24%
2020-01-01 00:26:30,5,8,3247,86,3161,4.95%,2.65%
2020-01-01 00:26:30,5,9,8434,546,7888,12.87%,6.47%
2020-01-01 00:26:30,5,10,1133,11,1122,1.73%,0.97%
2020-01-01 00:26:30,5,11,586,4,582,0.89%,0.68%
2020-01-01 00:26:30,5,12,6919,366,6553,10.56%,5.29%
2020-01-01 00:26:30,6,1,1030,7,1023,1.57%,0.68%
2020-01-01 00:26:30,6,2,1116,8,1108,1.70%,0.72%
2020-01-01 00:26:30,6,3,1522,13,1509,2.32%,0.85%
2020-01-01 00:26:30,6,4,1520,15,1505,2.32%,0.99%
2020-01-01 00:26:30,6,5,14347,1438,12909,21.89%,10.02%
2020-01-01 00:26:30,6,6,4395,123,4272,6.71%,2.80%
2020-01-01 00:26:30,6,7,2173,34,2139,3.32%,1.56%
2020-01-01 00:26:30,6,8,1574,20,1554,2.40%,1.27%
2020-01-01 00:26:30,6,9,8038,466,7572,12.27%,5.80%
2020-01-01 00:26:30,6,10,2257,36,2221,3.44%,1.60%
2020-01-01 00:26:30,6,11,384,1,383,0.59%,0.26%
2020-01-01 00:26:30,6,12,5739,247,5492,8.76%,4.30%
2020-01-01 00:26:30,7,1,372,2,370,0.57%,0.54%
2020-01-01 00:26:30,7,2,92,1,91,0.14%,1.09%
2020-01-01 00:26:30,7,3,938,3,935,1.43%,0.32%
2020-01-01 00:26:30,7,4,1905,25,1880,2.91%,1.31%
2020-01-01 00:26:30,7,5,7702,409,7293,11.75%,5.31%
2020-01-01 00:26:30,7,6,12348,1133,11215,18.84%,9.18%
2020-01-01 00:26:30,7,7,2660,60,2600,4.06%,2.26%
2020-01-01 00:26:30,7,8,1135,11,1124,1.73%,0.97%
2020-01-01 00:26:30,7,9,6533,300,6233,9.97%,4.59%
2020-01-01 00:26:30,7,10,1213,9,1204,1.85%,0.74%
2020-01-01 00:26:30,7,11,99,0,99,0.15%,0.00%
2020-01-01 00:26:30,7,12,5320,201,5119,8.12%,3.78%
2020-01-01 00:26:30,8,1,368,1,367,0.56%,0.27%
2020-01-01 00:26:30,8,2,84,0,84,0.13%,0.00%
2020-01-01 00:26:30,8,3,1788,20,1768,2.73%,1.12%
2020-01-01 00:26:30,8,4,2934,62,2872,4.48%,2.11%
2020-01-01 00:26:30,8,5,7982,476,7506,12.18%,5.96%
2020-01-01 00:26:30,8,6,16061,1847,14214,24.51%,11.50%
2020-01-01 00:26:30,8,7,4971,172,4799,7.59%,3.46%
2020-01-01 00:26:30,8,8,1962,32,1930,2.99%,1.63%
2020-01-01 00:26:30,8,9,5965,272,5693,9.10%,4.56%
2020-01-01 00:26:30,8,10,1677,18,1659,2.56%,1.07%
2020-01-01 00:26:30,8,11,237,0,237,0.36%,0.00%
2020-01-01 00:26:30,8,12,4254,155,4099,6.49%,3.64%
2020-01-01 00:26:30,9,1,806,2,804,1.23%,0.25%
2020-01-01 00:26:30,9,2,2801,75,2726,4.27%,2.68%
2020-01-01 00:26:30,9,3,1648,13,1635,2.51%,0.79%
2020-01-01 00:26:30,9,4,3529,91,3438,5.38%,2.58%
2020-01-01 00:26:30,9,5,201,1,200,0.31%,0.50%
2020-01-01 00:26:30,9,6,4386,128,4258,6.69%,2.92%
2020-01-01 00:26:30,9,7,27119,4919,22200,41.38%,18.14%
2020-01-01 00:26:30,9,8,11572,952,10620,17.66%,8.23%
2020-01-01 00:26:30,9,9,147,1,146,0.22%,0.68%
2020-01-01 00:26:30,9,10,3194,67,3127,4.87%,2.10%
2020-01-01 00:26:30,9,11,10225,759,9466,15.60%,7.42%
2020-01-01 00:26:30,9,12,6654,333,6321,10.15%,5.00%
2020-01-01 00:26:30,10,1,1246,199,1047,1.90%,15.97%
2020-01-01 00:26:30,10,2,2879,255,2624,4.39%,8.86%
2020-01-01 00:26:30,10,3,1408,16,1392,2.15%,1.14%
2020-01-01 00:26:30,10,4,4124,825,3299,6.29%,20.00%
2020-01-01 00:26:30,10,5,754,39,715,1.15%,5.17%
2020-01-01 00:26:30,10,6,5829,968,4861,8.89%,16.61%
2020-01-01 00:26:30,10,7,10358,1618,8740,15.81%,15.62%
2020-01-01 00:26:30,10,8,28764,7162,21602,43.89%,24.90%
2020-01-01 00:26:30,10,9,598,2,596,0.91%,0.33%
2020-01-01 00:26:30,10,10,2669,53,2616,4.07%,1.99%
2020-01-01 00:26:30,10,11,14353,1916,12437,21.90%,13.35%
2020-01-01 00:26:30,10,12,10974,1335,9639,16.74%,12.17%
2020-01-01 00:26:30,11,1,2336,45,2291,3.56%,1.93%
2020-01-01 00:26:30,11,2,3247,89,3158,4.95%,2.74%
2020-01-01 00:26:30,11,3,749,7,742,1.14%,0.93%
2020-01-01 00:26:30,11,4,3154,109,3045,4.81%,3.46%
2020-01-01 00:26:30,11,5,197,0,197,0.30%,0.00%
2020-01-01 00:26:30,11,6,3830,150,3680,5.84%,3.92%
2020-01-01 00:26:30,11,7,9165,628,8537,13.98%,6.85%
2020-01-01 00:26:30,11,8,22463,3527,18936,34.28%,15.70%
2020-01-01 00:26:30,11,9,179,0,179,0.27%,0.00%
2020-01-01 00:26:30,11,10,2533,70,2463,3.87%,2.76%
2020-01-01 00:26:30,11,11,9388,716,8672,14.32%,7.63%
2020-01-01 00:26:30,11,12,6340,329,6011,9.67%,5.19%
2020-01-01 00:26:30,12,1,79,0,79,0.12%,0.00%
2020-01-01 00:26:30,12,2,568,188,380,0.87%,33.10%
2020-01-01 00:26:30,12,3,2903,248,2655,4.43%,8.54%
2020-01-01 00:26:30,12,4,2932,68,2864,4.47%,2.32%
2020-01-01 00:26:30,12,5,9214,786,8428,14.06%,8.53%
2020-01-01 00:26:30,12,6,5449,207,5242,8.31%,3.80%
2020-01-01 00:26:30,12,7,2312,32,2280,3.53%,1.38%
2020-01-01 00:26:30,12,8,1407,305,1102,2.15%,21.68%
2020-01-01 00:26:30,12,9,23272,4760,18512,35.51%,20.45%
2020-01-01 00:26:30,12,10,4041,399,3642,6.17%,9.87%
2020-01-01 00:26:30,12,11,1554,305,1249,2.37%,19.63%
2020-01-01 00:26:30,12,12,9149,1388,7761,13.96%,15.17%
2020-01-01 00:26:30,13,1,2438,44,2394,3.72%,1.80%
2020-01-01 00:26:30,13,2,2695,53,2642,4.11%,1.97%
2020-01-01 00:26:30,13,3,693,17,676,1.06%,2.45%
2020-01-01 00:26:30,13,4,5248,399,4849,8.01%,7.60%
2020-01-01 00:26:30,13,5,7140,650,6490,10.89%,9.10%
2020-01-01 00:26:30,13,6,5848,447,5401,8.92%,7.64%
2020-01-01 00:26:30,13,7,5223,198,5025,7.97%,3.79%
2020-01-01 00:26:30,13,8,7744,413,7331,11.82%,5.33%
2020-01-01 00:26:30,13,9,7542,694,6848,11.51%,9.20%
2020-01-01 00:26:30,13,10,27242,5388,21854,41.57%,19.78%
2020-01-01 00:26:30,13,11,16823,2239,14584,25.67%,13.31%
2020-01-01 00:26:30,13,12,8725,910,7815,13.31%,10.43%
2020-01-01 00:26:30,14,1,290,2,288,0.44%,0.69%
2020-01-01 00:26:30,14,2,1355,24,1331,2.07%,1.77%
2020-01-01 00:26:30,14,3,922,8,914,1.41%,0.87%
2020-01-01 00:26:30,14,4,3691,102,3589,5.63%,2.76%
2020-01-01 00:26:30,14,5,1062,9,1053,1.62%,0.85%
2020-01-01 00:26:30,14,6,3944,116,3828,6.02%,2.94%
2020-01-01 00:26:30,14,7,11461,1053,10408,17.49%,9.19%
2020-01-01 00:26:30,14,8,13082,1330,11752,19.96%,10.17%
2020-01-01 00:26:30,14,9,1343,12,1331,2.05%,0.89%
2020-01-01 00:26:30,14,10,3949,130,3819,6.03%,3.29%
2020-01-01 00:26:30,14,11,25020,4322,20698,38.18%,17.27%
2020-01-01 00:26:30,14,12,7733,432,7301,11.80%,5.59%
2020-01-01 00:26:30,15,1,565,5,560,0.86%,0.88%
2020-01-01 00:26:30,15,2,186,2,184,0.28%,1.08%
2020-01-01 00:26:30,15,3,4068,123,3945,6.21%,3.02%
2020-01-01 00:26:30,15,4,5191,234,4957,7.92%,4.51%
2020-01-01 00:26:30,15,5,10530,831,9699,16.07%,7.89%
2020-01-01 00:26:30,15,6,5446,251,5195,8.31%,4.61%
2020-01-01 00:26:30,15,7,4080,101,3979,6.23%,2.48%
2020-01-01 00:26:30,15,8,6031,245,5786,9.20%,4.06%
2020-01-01 00:26:30,15,9,10712,847,9865,16.35%,7.91%
2020-01-01 00:26:30,15,10,4429,195,4234,6.76%,4.40%
2020-01-01 00:26:30,15,11,10680,809,9871,16.30%,7.57%
2020-01-01 00:26:30,15,12,27919,5471,22448,42.60%,19.60%
2020-01-01 00:26:30,16,1,491,3,488,0.75%,0.61%
2020-01-01 00:26:30,16,2,273,0,273,0.42%,0.00%
2020-01-01 00:26:30,16,3,1229,14,1215,1.88%,1.14%
2020-01-01 00:26:30,16,4,6431,328,6103,9.81%,5.10%
2020-01-01 00:26:30,16,5,9468,699,8769,14.45%,7.38%
2020-01-01 00:26:30,16,6,7127,390,6737,10.87%,5.47%
2020-01-01 00:26:30,16,7,3632,120,3512,5.54%,3.30%
2020-01-01 00:26:30,16,8,7950,619,7331,12.13%,7.79%
2020-01-01 00:26:30,16,9,9949,760,9189,15.18%,7.64%
2020-01-01 00:26:30,16,10,1938,23,1915,2.96%,1.19%
2020-01-01 00:26:30,16,11,10120,898,9222,15.44%,8.87%
2020-01-01 00:26:30,16,12,28316,5534,22782,43.21%,19.54%
2020-01-01 00:26:40,1,1,18272,2440,15832,27.88%,13.35%
2020-01-01 00:26:40,1,2,6051,293,5758,9.23%,4.84%
2020-01-01 00:26:40,1,3,609,1,608,0.93%,0.16%
2020-01-01 00:26:40,1,4,11862,1054,10808,18.10%,8.89%
2020-01-01 00:26:40,1,5,11519,999,10520,17.58%,8.67%
2020-01-01 00:26:40,1,6,11468,984,10484,17.50%,8.58%
2020-01-01 00:26:40,1,7,5414,237,5177,8.26%,4.38%
2020-01-01 00:26:40,1,8,4588,167,4421,7.00%,3.64%
2020-01-01 00:26:40,1,9,11424,980,10444,17.43%,8.58%
2020-01-01 00:26:40,1,10,3960,121,3839,6.04%,3.06%
2020-01-01 00:26:40,1,11,4075,128,3947,6.22%,3.14%
2020-01-01 00:26:40,1,12,10993,921,10072,16.77%,8.38%
2020-01-01 00:26:40,2,1,594,5,589,0.91%,0.84%
2020-01-01 00:26:40,2,2,26810,4775,22035,40.91%,17.81%
2020-01-01 00:26:40,2,3,22007,3282,18725,33.58%,14.91%
2020-01-01 00:26:40,2,4,470,4,466,0.72%,0.85%
2020-01-01 00:26:40,2,5,12896,1125,11771,19.68%,8.72%
2020-01-01 00:26:40,2,6,56,0,56,0.09%,0.00%
2020-01-01 00:26:40,2,7,4188,128,4060,6.39%,3.06%
2020-01-01 00:26:40,2,8,3074,69,3005,4.69%,2.24%
2020-01-01 00:26:40,2,9,12779,1110,11669,19.50%,8.69%
2020-01-01 00:26:40,2,10,2291,39,2252,3.50%,1.70%
2020-01-01 00:26:40,2,11,2295,39,2256,3.50%,1.70%
2020-01-01 00:26:40,2,12,12620,1082,11538,19.26%,8.57%
2020-01-01 00:26:40,3,1,1658,12,1646,2.53%,0.72%
2020-01-01 00:26:40,3,2,24084,3900,20184,36.75%,16.19%
2020-01-01 00:26:40,3,3,65894,24380,41514,100.55%,37.00%
2020-01-01 00:26:40,3,4,9301,608,8693,14.19%,6.54%
2020-01-01 00:26:40,3,5,40444,10258,30186,61.71%,25.36%
2020-01-01 00:26:40,3,6,10819,836,9983,16.51%,7.73%
2020-01-01 00:26:40,3,7,20614,2913,17701,31.45%,14.13%
2020-01-01 00:26:40,3,8,17455,2118,15337,26.63%,12.13%
2020-01-01 00:26:40,3,9,29247,5676,23571,44.63%,19.41%
2020-01-01 00:26:40,3,10,4125,137,3988,6.29%,3.32%
2020-01-01 00:26:40,3,11,2147,36,2111,3.28%,1.68%
2020-01-01 00:26:40,3,12,22434,3474,18960,34.23%,15.49%
2020-01-01 00:26:40,4,1,439,1,438,0.67%,0.23%
2020-01-01 00:26:40,4,2,239,0,239,0.36%,0.00%
2020-01-01 00:26:40,4,3,1048,14,1034,1.60%,1.34%
2020-01-01 00:26:40,4,4,28304,5415,22889,43.19%,19.13%
2020-01-01 00:26:40,4,5,17812,2234,15578,27.18%,12.54%
2020-01-01 00:26:40,4,6,24408,4064,20344,37.24%,16.65%
2020-01-01 00:26:40,4,7,5188,200,4988,7.92%,3.86%
2020-01-01 00:26:40,4,8,3286,77,3209,5.01%,2.34%
2020-01-01 00:26:40,4,9,15707,1785,13922,23.97%,11.36%
2020-01-01 00:26:40,4,10,1985,36,1949,3.03%,1.81%
2020-01-01 00:26:40,4,11,143,0,143,0.22%,0.00%
2020-01-01 00:26:40,4,12,13004,1246,11758,19.84%,9.58%
2020-01-01 00:26:40,5,1,2524,66,2458,3.85%,2.61%
2020-01-01 00:26:40,5,2,876,9,867,1.34%,1.03%
2020-01-01 00:26:40,5,3,820,1,819,1.25%,0.12%
2020-01-01 00:26:40,5,4,24048,3917,20131,36.69%,16.29%
2020-01-01 00:26:40,5,5,10440,780,9660,15.93%,7.47%
2020-01-01 00:26:40,5,6,17554,2124,15430,26.79%,12.10%
2020-01-01 00:26:40,5,7,6523,329,6194,9.95%,5.04%
2020-01-01 00:26:40,5,8,4847,195,4652,7.40%,4.02%
2020-01-01 00:26:40,5,9,9493,665,8828,14.49%,7.01%
2020-01-01 00:26:40,5,10,889,8,881,1.36%,0.90%
2020-01-01 00:26:40,5,11,857,8,849,1.31%,0.93%
2020-01-01 00:26:40,5,12,8010,494,7516,12.22%,6.17%
2020-01-01 00:26:40,6,1,939,5,934,1.43%,0.53%
2020-01-01 00:26:40,6,2,1055,8,1047,1.61%,0.76%
2020-01-01 00:26:40,6,3,1949,32,1917,2.97%,1.64%
2020-01-01 00:26:40,6,4,1400,10,1390,2.14%,0.71%
2020-01-01 00:26:40,6,5,16451,1903,14548,25.10%,11.57%
2020-01-01 00:26:40,6,6,4392,130,4262,6.70%,2.96%
2020-01-01 00:26:40,6,7,2445,46,2399,3.73%,1.88%
2020-01-01 00:26:40,6,8,1829,28,1801,2.79%,1.53%
2020-01-01 00:26:40,6,9,9790,712,9078,14.94%,7.27%
2020-01-01 00:26:40,6,10,2362,46,2316,3.60%,1.95%
2020-01-01 00:26:40,6,11,388,3,385,0.59%,0.77%
2020-01-01 00:26:40,6,12,7379,402,6977,11.26%,5.45%
2020-01-01 00:26:40,7,1,505,1,504,0.77%,0.20%
2020-01-01 00:26:40,7,2,136,0,136,0.21%,0.00%
2020-01-01 00:26:40,7,3,1335,14,1321,2.04%,1.05%
2020-01-01 00:26:40,7,4,1533,27,1506,2.34%,1.76%
2020-01-01 00:26:40,7,5,8018,462,7556,12.23%,5.76%
2020-01-01 00:26:40,7,6,12649,1102,11547,19.30%,8.71%
2020-01-01 00:26:40,7,7,3057,89,2968,4.66%,2.91%
2020-01-01 00:26:40,7,8,1112,12,1100,1.70%,1.08%
2020-01-01 00:26:40,7,9,6596,307,6289,10.06%,4.65%
2020-01-01 00:26:40,7,10,1191,11,1180,1.82%,0.92%
2020-01-01 00:26:40,7,11,73,0,73,0.11%,0.00%
2020-01-01 00:26:40,7,12,5395,206,5189,8.23%,3.82%
2020-01-01 00:26:40,8,1,405,1,404,0.62%,0.25%
2020-01-01 00:26:40,8,2,66,0,66,0.10%,0.00%
2020-01-01 00:26:40,8,3,1381,18,1363,2.11%,1.30%
2020-01-01 00:26:40,8,4,3185,78,3107,4.86%,2.45%
2020-01-01 00:26:40,8,5,8685,574,8111,13.25%,6.61%
2020-01-01 00:26:40,8,6,16935,2013,14922,25.84%,11.89%
2020-01-01 00:26:40,8,7,5003,172,4831,7.63%,3.44%
2020-01-01 00:26:40,8,8,1967,29,1938,3.00%,1.47%
2020-01-01 00:26:40,8,9,7086,391,6695,10.81%,5.52%
2020-01-01 00:26:40,8,10,1955,31,1924,2.98%,1.59%
2020-01-01 00:26:40,8,11,320,1,319,0.49%,0.31%
2020-01-01 00:26:40,8,12,4876,193,4683,7.44%,3.96%
2020-01-01 00:26:40,9,1,2055,6,2049,3.14%,0.29%
2020-01-01 00:26:40,9,2,3752,72,3680,5.73%,1.92%
2020-01-01 00:26:40,9,3,1214,10,1204,1.85%,0.82%
2020-01-01 00:26:40,9,4,7606,397,7209,11.61%,5.22%
2020-01-01 00:26:40,9,5,194,0,194,0.30%,0.00%
2020-01-01 00:26:40,9,6,8179,455,7724,12.48%,5.56%
2020-01-01 00:26:40,9,7,32475,6721,25754,49.55%,20.70%
2020-01-01 00:26:40,9,8,12032,1020,11012,18.36%,8.48%
2020-01-01 00:26:40,9,9,167,0,167,0.25%,0.00%
2020-01-01 00:26:40,9,10,3999,98,3901,6.10%,2.45%
2020-01-01 00:26:40,9,11,10520,813,9707,16.05%,7.73%
2020-01-01 00:26:40,9,12,6254,278,5976,9.54%,4.45%
2020-01-01 00:26:40,10,1,1099,249,850,1.68%,22.66%
2020-01-01 00:26:40,10,2,3616,346,3270,5.52%,9.57%
2020-01-01 00:26:40,10,3,2199,40,2159,3.36%,1.82%
2020-01-01 00:26:40,10,4,4495,979,3516,6.86%,21.78%
2020-01-01 00:26:40,10,5,591,4,587,0.90%,0.68%
2020-01-01 00:26:40,10,6,6372,1106,5266,9.72%,17.36%
2020-01-01 00:26:40,10,7,11719,1910,9809,17.88%,16.30%
2020-01-01 00:26:40,10,8,29463,7591,21872,44.96%,25.76%
2020-01-01 00:26:40,10,9,511,4,507,0.78%,0.78%
2020-01-01 00:26:40,10,10,2665,48,2617,4.07%,1.80%
2020-01-01 00:26:40,10,11,13495,1693,11802,20.59%,12.55%
2020-01-01 00:26:40,10,12,10224,1173,9051,15.60%,11.47%
2020-01-01 00:26:40,11,1,2303,32,2271,3.51%,1.39%
2020-01-01 00:26:40,11,2,3492,89,3403,5.33%,2.55%
2020-01-01 00:26:40,11,3,1077,10,1067,1.64%,0.93%
2020-01-01 00:26:40,11,4,5312,220,5092,8.11%,4.14%
2020-01-01 00:26:40,11,5,588,2,586,0.90%,0.34%
2020-01-01 00:26:40,11,6,6417,320,6097,9.79%,4.99%
2020-01-01 00:26:40,11,7,11759,1072,10687,17.94%,9.12%
2020-01-01 00:26:40,11,8,30550,6213,24337,46.62%,20.34%
2020-01-01 00:26:40,11,9,286,0,286,0.44%,0.00%
2020-01-01 00:26:40,11,10,3026,95,2931,4.62%,3.14%
2020-01-01 00:26:40,11,11,15105,1631,13474,23.05%,10.80%
2020-01-01 00:26:40,11,12,11734,960,10774,17.90%,8.18%
2020-01-01 00:26:40,12,1,96,0,96,0.15%,0.00%
2020-01-01 00:26:40,12,2,600,262,338,0.92%,43.67%
2020-01-01 00:26:40,12,3,2489,277,2212,3.80%,11.13%
2020-01-01 00:26:40,12,4,2563,61,2502,3.91%,2.38%
2020-01-01 00:26:40,12,5,8596,742,7854,13.12%,8.63%
2020-01-01 00:26:40,12,6,5233,214,5019,7.98%,4.09%
2020-01-01 00:26:40,12,7,2495,47,2448,3.81%,1.88%
2020-01-01 00:26:40,12,8,974,255,719,1.49%,26.18%
2020-01-01 00:26:40,12,9,21677,4345,17332,33.08%,20.04%
2020-01-01 00:26:40,12,10,3996,357,3639,6.10%,8.93%
2020-01-01 00:26:40,12,11,1215,259,956,1.85%,21.32%
2020-01-01 00:26:40,12,12,8364,1220,7144,12.76%,14.59%
2020-01-01 00:26:40,13,1,2806,64,2742,4.28%,2.28%
2020-01-01 00:26:40,13,2,3163,79,3084,4.83%,2.50%
2020-01-01 00:26:40,13,3,994,9,985,1.52%,0.91%
2020-01-01 00:26:40,13,4,5288,561,4727,8.07%,10.61%
2020-01-01 00:26:40,13,5,7832,878,6954,11.95%,11.21%
2020-01-01 00:26:40,13,6,6138,625,5513,9.37%,10.18%
2020-01-01 00:26:40,13,7,5846,268,5578,8.92%,4.58%
2020-01-01 00:26:40,13,8,7647,430,7217,11.67%,5.62%
2020-01-01 00:26:40,13,9,8119,903,7216,12.39%,11.12%
2020-01-01 00:26:40,13,10,28115,5836,22279,42.90%,20.76%
2020-01-01 00:26:40,13,11,17331,2397,14934,26.45%,13.83%
2020-01-01 00:26:40,13,12,9148,927,8221,13.96%,10.13%
2020-01-01 00:26:40,14,1,373,2,371,0.57%,0.54%
2020-01-01 00:26:40,14,2,1635,21,1614,2.49%,1.28%
2020-01-01 00:26:40,14,3,990,8,982,1.51%,0.81%
2020-01-01 00:26:40,14,4,4290,147,4143,6.55%,3.43%
2020-01-01 00:26:40,14,5,1423,17,1406,2.17%,1.19%
2020-01-01 00:26:40,14,6,4676,168,4508,7.14%,3.59%
2020-01-01 00:26:40,14,7,11750,953,10797,17.93%,8.11%
2020-01-01 00:26:40,14,8,13507,1248,12259,20.61%,9.24%
2020-01-01 00:26:40,14,9,1683,26,1657,2.57%,1.54%
2020-01-01 00:26:40,14,10,4544,158,4386,6.93%,3.48%
2020-01-01 00:26:40,14,11,25735,4478,21257,39.27%,17.40%
2020-01-01 00:26:40,14,12,7508,456,7052,11.46%,6.07%
2020-01-01 00:26:40,15,1,570,3,567,0.87%,0.53%
2020-01-01 00:26:40,15,2,139,0,139,0.21%,0.00%
2020-01-01 00:26:40,15,3,3662,108,3554,5.59%,2.95%
2020-01-01 00:26:40,15,4,5181,198,4983,7.91%,3.82%
2020-01-01 00:26:40,15,5,10705,839,9866,16.33%,7.84%
2020-01-01 00:26:40,15,6,5381,216,5165,8.21%,4.01%
2020-01-01 00:26:40,15,7,3713,95,3618,5.67%,2.56%
2020-01-01 00:26:40,15,8,6139,281,5858,9.37%,4.58%
2020-01-01 00:26:40,15,9,10873,867,10006,16.59%,7.97%
2020-01-01 00:26:40,15,10,4098,133,3965,6.25%,3.25%
2020-01-01 00:26:40,15,11,10370,792,9578,15.82%,7.64%
2020-01-01 00:26:40,15,12,27327,5187,22140,41.70%,18.98%
2020-01-01 00:26:40,16,1,499,0,499,0.76%,0.00%
2020-01-01 00:26:40,16,2,266,1,265,0.41%,0.38%
2020-01-01 00:26:40,16,3,1082,9,1073,1.65%,0.83%
2020-01-01 00:26:40,16,4,4010,110,3900,6.12%,2.74%
2020-01-01 00:26:40,16,5,7221,446,6775,11.02%,6.18%
2020-01-01 00:26:40,16,6,4943,186,4757,7.54%,3.76%
2020-01-01 00:26:40,16,7,3367,99,3268,5.14%,2.94%
2020-01-01 00:26:40,16,8,7071,402,6669,10.79%,5.69%
2020-01-01 00:26:40,16,9,7620,494,7126,11.63%,6.48%
2020-01-01 00:26:40,16,10,1521,20,1501,2.32%,1.31%
2020-01-01 00:26:40,16,11,8777,616,8161,13.39%,7.02%
2020-01-01 00:26:40,16,12,25239,4310,20929,38.51%,17.08%
2020-01-01 00:26:50,1,1,14721,1531,13190,22.46%,10.40%
2020-01-01 00:26:50,1,2,6762,353,6409,10.32%,5.22%
2020-01-01 00:26:50,1,3,814,3,811,1.24%,0.37%
2020-01-01 00:26:50,1,4,7145,396,6749,10.90%,5.54%
2020-01-01 00:26:50,1,5,6788,357,6431,10.36%,5.26%
2020-01-01 00:26:50,1,6,6716,355,6361,10.25%,5.29%
2020-01-01 00:26:50,1,7,5937,277,5660,9.06%,4.67%
2020-01-01 00:26:50,1,8,3313,77,3236,5.06%,2.32%
2020-01-01 00:26:50,1,9,6671,349,6322,10.18%,5.23%
2020-01-01 00:26:50,1,10,2596,50,2546,3.96%,1.93%
2020-01-01 00:26:50,1,11,2746,54,2692,4.19%,1.97%
2020-01-01 00:26:50,1,12,6632,346,6286,10.12%,5.22%
2020-01-01 00:26:50,2,1,1350,13,1337,2.06%,0.96%
2020-01-01 00:26:50,2,2,24632,4093,20539,37.59%,16.62%
2020-01-01 00:26:50,2,3,19426,2617,16809,29.64%,13.47%
2020-01-01 00:26:50,2,4,1312,12,1300,2.00%,0.91%
2020-01-01 00:26:50,2,5,10556,814,9742,16.11%,7.71%
2020-01-01 00:26:50,2,6,43,0,43,0.07%,0.00%
2020-01-01 00:26:50,2,7,3848,116,3732,5.87%,3.01%
2020-01-01 00:26:50,2,8,2692,66,2626,4.11%,2.45%
2020-01-01 00:26:50,2,9,10468,802,9666,15.97%,7.66%
2020-01-01 00:26:50,2,10,1854,29,1825,2.83%,1.56%
2020-01-01 00:26:50,2,11,1895,31,1864,2.89%,1.64%
2020-01-01 00:26:50,2,12,10330,784,9546,15.76%,7.59%
2020-01-01 00:26:50,3,1,1711,26,1685,2.61%,1.52%
2020-01-01 00:26:50,3,2,25745,4438,21307,39.28%,17.24%
2020-01-01 00:26:50,3,3,76111,31170,44941,116.14%,40.95%
2020-01-01 00:26:50,3,4,8661,543,8118,13.22%,6.27%
2020-01-01 00:26:50,3,5,48831,14458,34373,74.51%,29.61%
2020-01-01 00:26:50,3,6,10531,807,9724,16.07%,7.66%
2020-01-01 00:26:50,3,7,22120,3378,18742,33.75%,15.27%
2020-01-01 00:26:50,3,8,17214,2082,15132,26.27%,12.09%
2020-01-01 00:26:50,3,9,37840,9102,28738,57.74%,24.05%
2020-01-01 00:26:50,3,10,8797,586,8211,13.42%,6.66%
2020-01-01 00:26:50,3,11,2597,51,2546,3.96%,1.96%
2020-01-01 00:26:50,3,12,26180,4516,21664,39.95%,17.25%
2020-01-01 00:26:50,4,1,548,3,545,0.84%,0.55%
2020-01-01 00:26:50,4,2,363,2,361,0.55%,0.55%
2020-01-01 00:26:50,4,3,829,2,827,1.26%,0.24%
2020-01-01 00:26:50,4,4,27677,5083,22594,42.23%,18.37%
2020-01-01 00:26:50,4,5,17345,2177,15168,26.47%,12.55%
2020-01-01 00:26:50,4,6,23738,3841,19897,36.22%,16.18%
2020-01-01 00:26:50,4,7,5000,184,4816,7.63%,3.68%
2020-01-01 00:26:50,4,8,3230,83,3147,4.93%,2.57%
2020-01-01 00:26:50,4,9,15449,1751,13698,23.57%,11.33%
2020-01-01 00:26:50,4,10,2044,52,1992,3.12%,2.54%
2020-01-01 00:26:50,4,11,203,0,203,0.31%,0.00%
2020-01-01 00:26:50,4,12,12507,1184,11323,19.08%,9.47%
2020-01-01 00:26:50,5,1,2522,53,2469,3.85%,2.10%
2020-01-01 00:26:50,5,2,655,2,653,1.00%,0.31%
2020-01-01 00:26:50,5,3,873,7,866,1.33%,0.80%
2020-01-01 00:26:50,5,4,22548,3480,19068,34.41%,15.43%
2020-01-01 00:26:50,5,5,9403,640,8763,14.35%,6.81%
2020-01-01 00:26:50,5,6,15830,1738,14092,24.15%,10.98%
2020-01-01 00:26:50,5,7,5721,250,5471,8.73%,4.37%
2020-01-01 00:26:50,5,8,3754,120,3634,5.73%,3.20%
2020-01-01 00:26:50,5,9,8401,519,7882,12.82%,6.18%
2020-01-01 00:26:50,5,10,1073,12,1061,1.64%,1.12%
2020-01-01 00:26:50,5,11,578,2,576,0.88%,0.35%
2020-01-01 00:26:50,5,12,6986,367,6619,10.66%,5.25%
2020-01-01 00:26:50,6,1,1030,15,1015,1.57%,1.46%
2020-01-01 00:26:50,6,2,1109,17,1092,1.69%,1.53%
2020-01-01 00:26:50,6,3,2000,34,1966,3.05%,1.70%
2020-01-01 00:26:50,6,4,1180,8,1172,1.80%,0.68%
2020-01-01 00:26:50,6,5,14325,1465,12860,21.86%,10.23%
2020-01-01 00:26:50,6,6,5090,191,4899,7.77%,3.75%
2020-01-01 00:26:50,6,7,3424,93,3331,5.22%,2.72%
2020-01-01 00:26:50,6,8,2710,61,2649,4.14%,2.25%
2020-01-01 00:26:50,6,9,6948,370,6578,10.60%,5.33%
2020-01-01 00:26:50,6,10,2075,28,2047,3.17%,1.35%
2020-01-01 00:26:50,6,11,449,0,449,0.69%,0.00%
2020-01-01 00:26:50,6,12,4813,190,4623,7.34%,3.95%
2020-01-01 00:26:50,7,1,444,3,441,0.68%,0.68%
2020-01-01 00:26:50,7,2,178,0,178,0.27%,0.00%
2020-01-01 00:26:50,7,3,789,6,783,1.20%,0.76%
2020-01-01 00:26:50,7,4,2022,23,1999,3.09%,1.14%
2020-01-01 00:26:50,7,5,7175,358,6817,10.95%,4.99%
2020-01-01 00:26:50,7,6,12900,1186,11714,19.68%,9.19%
2020-01-01 00:26:50,7,7,3649,114,3535,5.57%,3.12%
2020-01-01 00:26:50,7,8,1505,23,1482,2.30%,1.53%
2020-01-01 00:26:50,7,9,6200,273,5927,9.46%,4.40%
2020-01-01 00:26:50,7,10,988,12,976,1.51%,1.21%
2020-01-01 00:26:50,7,11,69,0,69,0.11%,0.00%
2020-01-01 00:26:50,7,12,5230,201,5029,7.98%,3.84%
2020-01-01 00:26:50,8,1,428,4,424,0.65%,0.93%
2020-01-01 00:26:50,8,2,54,0,54,0.08%,0.00%
2020-01-01 00:26:50,8,3,2246,32,2214,3.43%,1.42%
2020-01-01 00:26:50,8,4,3279,94,3185,5.00%,2.87%
2020-01-01 00:26:50,8,5,9469,630,8839,14.45%,6.65%
2020-01-01 00:26:50,8,6,18084,2283,15801,27.59%,12.62%
2020-01-01 00:26:50,8,7,5293,216,5077,8.08%,4.08%
2020-01-01 00:26:50,8,8,2233,43,2190,3.41%,1.93%
2020-01-01 00:26:50,8,9,7055,358,6697,10.77%,5.07%
2020-01-01 00:26:50,8,10,2471,39,2432,3.77%,1.58%
2020-01-01 00:26:50,8,11,143,1,142,0.22%,0.70%
2020-01-01 00:26:50,8,12,4477,157,4320,6.83%,3.51%
2020-01-01 00:26:50,9,1,1017,5,1012,1.55%,0.49%
2020-01-01 00:26:50,9,2,2411,30,2381,3.68%,1.24%
2020-01-01 00:26:50,9,3,950,4,946,1.45%,0.42%
2020-01-01 00:26:50,9,4,4445,152,4293,6.78%,3.42%
2020-01-01 00:26:50,9,5,209,0,209,0.32%,0.00%
2020-01-01 00:26:50,9,6,5225,201,5024,7.97%,3.85%
2020-01-01 00:26:50,9,7,28537,5399,23138,43.54%,18.92%
2020-01-01 00:26:50,9,8,11207,924,10283,17.10%,8.24%
2020-01-01 00:26:50,9,9,130,0,130,0.20%,0.00%
2020-01-01 00:26:50,9,10,3999,104,3895,6.10%,2.60%
2020-01-01 00:26:50,9,11,10065,737,9328,15.36%,7.32%
2020-01-01 00:26:50,9,12,5714,239,5475,8.72%,4.18%
2020-01-01 00:26:50,10,1,1366,286,1080,2.08%,20.94%
2020-01-01 00:26:50,10,2,3946,371,3575,6.02%,9.40%
2020-01-01 00:26:50,10,3,2461,39,2422,3.76%,1.58%
2020-01-01 00:26:50,10,4,3930,989,2941,6.00%,25.17%
2020-01-01 00:26:50,10,5,679,72,607,1.04%,10.60%
2020-01-01 00:26:50,10,6,5697,1169,4528,8.69%,20.52%
2020-01-01 00:26:50,10,7,11180,2000,9180,17.06%,17.89%
2020-01-01 00:26:50,10,8,28864,7481,21383,44.04%,25.92%
2020-01-01 00:26:50,10,9,540,0,540,0.82%,0.00%
2020-01-01 00:26:50,10,10,2151,43,2108,3.28%,2.00%
2020-01-01 00:26:50,10,11,13371,1787,11584,20.40%,13.36%
2020-01-01 00:26:50,10,12,10383,1259,9124,15.84%,12.13%
2020-01-01 00:26:50,11,1,2541,53,2488,3.88%,2.09%
2020-01-01 00:26:50,11,2,3732,117,3615,5.69%,3.14%
2020-01-01 00:26:50,11,3,892,7,885,1.36%,0.78%
2020-01-01 00:26:50,11,4,6363,324,6039,9.71%,5.09%
2020-01-01 00:26:50,11,5,212,1,211,0.32%,0.47%
2020-01-01 00:26:50,11,6,7181,399,6782,10.96%,5.56%
2020-01-01 00:26:50,11,7,12584,1147,11437,19.20%,9.11%
2020-01-01 00:26:50,11,8,29723,5830,23893,45.35%,19.61%
2020-01-01 00:26:50,11,9,221,1,220,0.34%,0.45%
2020-01-01 00:26:50,11,10,2709,53,2656,4.13%,1.96%
2020-01-01 00:26:50,11,11,13527,1294,12233,20.64%,9.57%
2020-01-01 00:26:50,11,12,10524,791,9733,16.06%,7.52%
2020-01-01 00:26:50,12,1,38,0,38,0.06%,0.00%
2020-01-01 00:26:50,12,2,650,200,450,0.99%,30.77%
2020-01-01 00:26:50,12,3,2501,239,2262,3.82%,9.56%
2020-01-01 00:26:50,12,4,2499,74,2425,3.81%,2.96%
2020-01-01 00:26:50,12,5,7656,659,6997,11.68%,8.61%
2020-01-01 00:26:50,12,6,4360,199,4161,6.65%,4.56%
2020-01-01 00:26:50,12,7,1742,38,1704,2.66%,2.18%
2020-01-01 00:26:50,12,8,1393,289,1104,2.13%,20.75%
2020-01-01 00:26:50,12,9,20046,3785,16261,30.59%,18.88%
2020-01-01 00:26:50,12,10,4190,378,3812,6.39%,9.02%
2020-01-01 00:26:50,12,11,1639,295,1344,2.50%,18.00%
2020-01-01 00:26:50,12,12,7303,1048,6255,11.14%,14.35%
2020-01-01 00:26:50,13,1,2102,42,2060,3.21%,2.00%
2020-01-01 00:26:50,13,2,2524,51,2473,3.85%,2.02%
2020-01-01 00:26:50,13,3,895,8,887,1.37%,0.89%
2020-01-01 00:26:50,13,4,5261,615,4646,8.03%,11.69%
2020-01-01 00:26:50,13,5,7902,966,6936,12.06%,12.22%
2020-01-01 00:26:50,13,6,6234,680,5554,9.51%,10.91%
2020-01-01 00:26:50,13,7,5179,195,4984,7.90%,3.77%
2020-01-01 00:26:50,13,8,7993,476,7517,12.20%,5.96%
2020-01-01 00:26:50,13,9,8171,1005,7166,12.47%,12.30%
2020-01-01 00:26:50,13,10,29615,6385,23230,45.19%,21.56%
2020-01-01 00:26:50,13,11,18758,2770,15988,28.62%,14.77%
2020-01-01 00:26:50,13,12,10314,1115,9199,15.74%,10.81%
2020-01-01 00:26:50,14,1,419,2,417,0.64%,0.48%
2020-01-01 00:26:50,14,2,1735,27,1708,2.65%,1.56%
2020-01-01 00:26:50,14,3,1129,6,1123,1.72%,0.53%
2020-01-01 00:26:50,14,4,4117,123,3994,6.28%,2.99%
2020-01-01 00:26:50,14,5,1957,28,1929,2.99%,1.43%
2020-01-01 00:26:50,14,6,4533,141,4392,6.92%,3.11%
2020-01-01 00:26:50,14,7,11989,978,11011,18.29%,8.16%
2020-01-01 00:26:50,14,8,13584,1264,12320,20.73%,9.31%
2020-01-01 00:26:50,14,9,2313,46,2267,3.53%,1.99%
2020-01-01 00:26:50,14,10,4932,213,4719,7.53%,4.32%
2020-01-01 00:26:50,14,11,27591,5027,22564,42.10%,18.22%
2020-01-01 00:26:50,14,12,8788,537,8251,13.41%,6.11%
2020-01-01 00:26:50,15,1,611,4,607,0.93%,0.65%
2020-01-01 00:26:50,15,2,146,0,146,0.22%,0.00%
2020-01-01 00:26:50,15,3,5077,179,4898,7.75%,3.53%
2020-01-01 00:26:50,15,4,5335,205,5130,8.14%,3.84%
2020-01-01 00:26:50,15,5,11541,904,10637,17.61%,7.83%
2020-01-01 00:26:50,15,6,5570,237,5333,8.50%,4.25%
2020-01-01 00:26:50,15,7,3585,103,3482,5.47%,2.87%
2020-01-01 00:26:50,15,8,6078,291,5787,9.27%,4.79%
2020-01-01 00:26:50,15,9,11715,930,10785,17.88%,7.94%
2020-01-01 00:26:50,15,10,5389,362,5027,8.22%,6.72%
2020-01-01 00:26:50,15,11,11572,1076,10496,17.66%,9.30%
2020-01-01 00:26:50,15,12,28269,5774,22495,43.14%,20.43%
2020-01-01 00:26:50,16,1,446,0,446,0.68%,0.00%
2020-01-01 00:26:50,16,2,246,1,245,0.38%,0.41%
2020-01-01 00:26:50,16,3,1322,14,1308,2.02%,1.06%
2020-01-01 00:26:50,16,4,4879,181,4698,7.44%,3.71%
2020-01-01 00:26:50,16,5,8137,557,7580,12.42%,6.85%
2020-01-01 00:26:50,16,6,5749,245,5504,8.77%,4.26%
2020-01-01 00:26:50,16,7,3443,92,3351,5.25%,2.67%
2020-01-01 00:26:50,16,8,7431,479,6952,11.34%,6.45%
2020-01-01 00:26:50,16,9,8641,650,7991,13.19%,7.52%
2020-01-01 00:26:50,16,10,1594,11,1583,2.43%,0.69%
2020-01-01 00:26:50,16,11,9258,690,8568,14.13%,7.45%
2020-01-01 00:26:50,16,12,26268,4712,21556,40.08%,17.94%
2020-01-01 00:27:00,1,1,22199,3436,18763,33.87%,15.48%
2020-01-01 00:27:00,1,2,8589,555,8034,13.11%,6.46%
2020-01-01 00:27:00,1,3,1742,25,1717,2.66%,1.44%
2020-01-01 00:27:00,1,4,13144,1290,11854,20.06%,9.81%
2020-01-01 00:27:00,1,5,12833,1247,11586,19.58%,9.72%
2020-01-01 00:27:00,1,6,12755,1224,11531,19.46%,9.60%
2020-01-01 00:27:00,1,7,6822,341,6481,10.41%,5.00%
2020-01-01 00:27:00,1,8,4681,160,4521,7.14%,3.42%
2020-01-01 00:27:00,1,9,12707,1217,11490,19.39%,9.58%
2020-01-01 00:27:00,1,10,4028,116,3912,6.15%,2.88%
2020-01-01 00:27:00,1,11,4149,125,4024,6.33%,3.01%
2020-01-01 00:27:00,1,12,12676,1213,11463,19.34%,9.57%
2020-01-01 00:27:00,2,1,3615,98,3517,5.52%,2.71%
2020-01-01 00:27:00,2,2,32128,6778,25350,49.02%,21.10%
2020-01-01 00:27:00,2,3,23239,3684,19555,35.46%,15.85%
2020-01-01 00:27:00,2,4,3559,96,3463,5.43%,2.70%
2020-01-01 00:27:00,2,5,13487,1279,12208,20.58%,9.48%
2020-01-01 00:27:00,2,6,65,0,65,0.10%,0.00%
2020-01-01 00:27:00,2,7,5262,197,5065,8.03%,3.74%
2020-01-01 00:27:00,2,8,4262,137,4125,6.50%,3.21%
2020-01-01 00:27:00,2,9,13434,1269,12165,20.50%,9.45%
2020-01-01 00:27:00,2,10,3363,93,3270,5.13%,2.77%
2020-01-01 00:27:00,2,11,3381,94,3287,5.16%,2.78%
2020-01-01 00:27:00,2,12,13232,1221,12011,20.19%,9.23%
2020-01-01 00:27:00,3,1,1510,18,1492,2.30%,1.19%
2020-01-01 00:27:00,3,2,25089,4193,20896,38.28%,16.71%
2020-01-01 00:27:00,3,3,72546,28571,43975,110.70%,39.38%
2020-01-01 00:27:00,3,4,8964,578,8386,13.68%,6.45%
2020-01-01 00:27:00,3,5,45372,12467,32905,69.23%,27.48%
2020-01-01 00:27:00,3,6,10618,794,9824,16.20%,7.48%
2020-01-01 00:27:00,3,7,21771,3237,18534,33.22%,14.87%
2020-01-01 00:27:00,3,8,16578,1921,14657,25.30%,11.59%
2020-01-01 00:27:00,3,9,34476,7524,26952,52.61%,21.82%
2020-01-01 00:27:00,3,10,4993,170,4823,7.62%,3.40%
2020-01-01 00:27:00,3,11,2711,52,2659,4.14%,1.92%
2020-01-01 00:27:00,3,12,26410,4593,21817,40.30%,17.39%
2020-01-01 00:27:00,4,1,521,2,519,0.79%,0.38%
2020-01-01 00:27:00,4,2,324,1,323,0.49%,0.31%
2020-01-01 00:27:00,4,3,1016,4,1012,1.55%,0.39%
2020-01-01 00:27:00,4,4,28964,5534,23430,44.20%,19.11%
2020-01-01 00:27:00,4,5,18103,2260,15843,27.62%,12.48%
2020-01-01 00:27:00,4,6,25439,4333,21106,38.82%,17.03%
2020-01-01 00:27:00,4,7,5837,255,5582,8.91%,4.37%
2020-01-01 00:27:00,4,8,2844,55,2789,4.34%,1.93%
2020-01-01 00:27:00,4,9,15849,1752,14097,24.18%,11.05%
2020-01-01 00:27:00,4,10,1893,25,1868,2.89%,1.32%
2020-01-01 00:27:00,4,11,161,0,161,0.25%,0.00%
2020-01-01 00:27:00,4,12,12695,1150,11545,19.37%,9.06%
2020-01-01 00:27:00,5,1,2678,56,2622,4.09%,2.09%
2020-01-01 00:27:00,5,2,636,10,626,0.97%,1.57%
2020-01-01 00:27:00,5,3,569,2,567,0.87%,0.35%
2020-01-01 00:27:00,5,4,23096,3654,19442,35.24%,15.82%
2020-01-01 00:27:00,5,5,9021,611,8410,13.76%,6.77%
2020-01-01 00:27:00,5,6,14495,1534,12961,22.12%,10.58%
2020-01-01 00:27:00,5,7,4984,212,4772,7.60%,4.25%
2020-01-01 00:27:00,5,8,3376,88,3288,5.15%,2.61%
2020-01-01 00:27:00,5,9,8311,526,7785,12.68%,6.33%
2020-01-01 00:27:00,5,10,1054,8,1046,1.61%,0.76%
2020-01-01 00:27:00,5,11,539,2,537,0.82%,0.37%
2020-01-01 00:27:00,5,12,6756,336,6420,10.31%,4.97%
2020-01-01 00:27:00,6,1,966,2,964,1.47%,0.21%
2020-01-01 00:27:00,6,2,1032,2,1030,1.57%,0.19%
2020-01-01 00:27:00,6,3,1503,4,1499,2.29%,0.27%
2020-01-01 00:27:00,6,4,1622,23,1599,2.47%,1.42%
2020-01-01 00:27:00,6,5,14970,1593,13377,22.84%,10.64%
2020-01-01 00:27:00,6,6,6327,315,6012,9.65%,4.98%
2020-01-01 00:27:00,6,7,4293,145,4148,6.55%,3.38%
2020-01-01 00:27:00,6,8,3587,107,3480,5.47%,2.98%
2020-01-01 00:27:00,6,9,6840,343,6497,10.44%,5.01%
2020-01-01 00:27:00,6,10,2055,32,2023,3.14%,1.56%
2020-01-01 00:27:00,6,11,456,0,456,0.70%,0.00%
2020-01-01 00:27:00,6,12,4734,173,4561,7.22%,3.65%
2020-01-01 00:27:00,7,1,423,0,423,0.65%,0.00%
2020-01-01 00:27:00,7,2,198,0,198,0.30%,0.00%
2020-01-01 00:27:00,7,3,676,2,674,1.03%,0.30%
2020-01-01 00:27:00,7,4,1834,15,1819,2.80%,0.82%
2020-01-01 00:27:00,7,5,7127,362,6765,10.87%,5.08%
2020-01-01 00:27:00,7,6,12315,1102,11213,18.79%,8.95%
2020-01-01 00:27:00,7,7,3305,102,3203,5.04%,3.09%
2020-01-01 00:27:00,7,8,1314,25,1289,2.01%,1.90%
2020-01-01 00:27:00,7,9,6304,281,6023,9.62%,4.46%
2020-01-01 00:27:00,7,10,1104,10,1094,1.68%,0.91%
2020-01-01 00:27:00,7,11,88,0,88,0.13%,0.00%
2020-01-01 00:27:00,7,12,5228,188,5040,7.98%,3.60%
2020-01-01 00:27:00,8,1,558,3,555,0.85%,0.54%
2020-01-01 00:27:00,8,2,96,0,96,0.15%,0.00%
2020-01-01 00:27:00,8,3,1762,9,1753,2.69%,0.51%
2020-01-01 00:27:00,8,4,2920,76,2844,4.46%,2.60%
2020-01-01 00:27:00,8,5,8526,474,8052,13.01%,5.56%
2020-01-01 00:27:00,8,6,16879,1992,14887,25.76%,11.80%
2020-01-01 00:27:00,8,7,5359,227,5132,8.18%,4.24%
2020-01-01 00:27:00,8,8,1915,21,1894,2.92%,1.10%
2020-01-01 00:27:00,8,9,6335,263,6072,9.67%,4.15%
2020-01-01 00:27:00,8,10,2294,37,2257,3.50%,1.61%
2020-01-01 00:27:00,8,11,191,1,190,0.29%,0.52%
2020-01-01 00:27:00,8,12,4043,104,3939,6.17%,2.57%
2020-01-01 00:27:00,9,1,586,4,582,0.89%,0.68%
2020-01-01 00:27:00,9,2,1908,29,1879,2.91%,1.52%
2020-01-01 00:27:00,9,3,992,5,987,1.51%,0.50%
2020-01-01 00:27:00,9,4,4475,141,4334,6.83%,3.15%
2020-01-01 00:27:00,9,5,234,0,234,0.36%,0.00%
2020-01-01 00:27:00,9,6,5281,198,5083,8.06%,3.75%
2020-01-01 00:27:00,9,7,25235,4175,21060,38.51%,16.54%
2020-01-01 00:27:00,9,8,12218,1022,11196,18.64%,8.36%
2020-01-01 00:27:00,9,9,183,0,183,0.28%,0.00%
2020-01-01 00:27:00,9,10,4879,129,4750,7.44%,2.64%
2020-01-01 00:27:00,9,11,10129,693,9436,15.46%,6.84%
2020-01-01 00:27:00,9,12,4846,195,4651,7.39%,4.02%
2020-01-01 00:27:00,10,1,1317,253,1064,2.01%,19.21%
2020-01-01 00:27:00,10,2,3123,322,2801,4.77%,10.31%
2020-01-01 00:27:00,10,3,1621,27,1594,2.47%,1.67%
2020-01-01 00:27:00,10,4,5138,809,4329,7.84%,15.75%
2020-01-01 00:27:00,10,5,655,43,612,1.00%,6.56%
2020-01-01 00:27:00,10,6,6820,963,5857,10.41%,14.12%
2020-01-01 00:27:00,10,7,12297,1847,10450,18.76%,15.02%
2020-01-01 00:27:00,10,8,30248,7579,22669,46.15%,25.06%
2020-01-01 00:27:00,10,9,479,4,475,0.73%,0.84%
2020-01-01 00:27:00,10,10,2159,45,2114,3.29%,2.08%
2020-01-01 00:27:00,10,11,13287,1804,11483,20.27%,13.58%
2020-01-01 00:27:00,10,12,10492,1340,9152,16.01%,12.77%
2020-01-01 00:27:00,11,1,2563,50,2513,3.91%,1.95%
2020-01-01 00:27:00,11,2,3617,105,3512,5.52%,2.90%
2020-01-01 00:27:00,11,3,902,4,898,1.38%,0.44%
2020-01-01 00:27:00,11,4,4690,171,4519,7.16%,3.65%
2020-01-01 00:27:00,11,5,156,1,155,0.24%,0.64%
2020-01-01 00:27:00,11,6,5638,248,5390,8.60%,4.40%
2020-01-01 00:27:00,11,7,10915,841,10074,16.65%,7.70%
2020-01-01 00:27:00,11,8,24805,4214,20591,37.85%,16.99%
2020-01-01 00:27:00,11,9,331,0,331,0.51%,0.00%
2020-01-01 00:27:00,11,10,2892,101,2791,4.41%,3.49%
2020-01-01 00:27:00,11,11,10491,835,9656,16.01%,7.96%
2020-01-01 00:27:00,11,12,7307,373,6934,11.15%,5.10%
2020-01-01 00:27:00,12,1,44,0,44,0.07%,0.00%
2020-01-01 00:27:00,12,2,600,196,404,0.92%,32.67%
2020-01-01 00:27:00,12,3,2722,262,2460,4.15%,9.63%
2020-01-01 00:27:00,12,4,2555,75,2480,3.90%,2.94%
2020-01-01 00:27:00,12,5,7884,725,7159,12.03%,9.20%
2020-01-01 00:27:00,12,6,4402,183,4219,6.72%,4.16%
2020-01-01 00:27:00,12,7,1727,35,1692,2.64%,2.03%
2020-01-01 00:27:00,12,8,1930,379,1551,2.94%,19.64%
2020-01-01 00:27:00,12,9,21319,4405,16914,32.53%,20.66%
2020-01-01 00:27:00,12,10,4887,525,4362,7.46%,10.74%
2020-01-01 00:27:00,12,11,2095,381,1714,3.20%,18.19%
2020-01-01 00:27:00,12,12,7708,1272,6436,11.76%,16.50%
2020-01-01 00:27:00,13,1,2194,42,2152,3.35%,1.91%
2020-01-01 00:27:00,13,2,2560,56,2504,3.91%,2.19%
2020-01-01 00:27:00,13,3,637,1,636,0.97%,0.16%
2020-01-01 00:27:00,13,4,5310,559,4751,8.10%,10.53%
2020-01-01 00:27:00,13,5,7461,817,6644,11.38%,10.95%
2020-01-01 00:27:00,13,6,5910,599,5311,9.02%,10.14%
2020-01-01 00:27:00,13,7,5122,208,4914,7.82%,4.06%
2020-01-01 00:27:00,13,8,7556,414,7142,11.53%,5.48%
2020-01-01 00:27:00,13,9,7733,838,6895,11.80%,10.84%
2020-01-01 00:27:00,13,10,27020,5437,21583,41.23%,20.12%
2020-01-01 00:27:00,13,11,16906,2277,14629,25.80%,13.47%
2020-01-01 00:27:00,13,12,8844,894,7950,13.49%,10.11%
2020-01-01 00:27:00,14,1,396,0,396,0.60%,0.00%
2020-01-01 00:27:00,14,2,1761,25,1736,2.69%,1.42%
2020-01-01 00:27:00,14,3,1027,8,1019,1.57%,0.78%
2020-01-01 00:27:00,14,4,3919,127,3792,5.98%,3.24%
2020-01-01 00:27:00,14,5,1310,13,1297,2.00%,0.99%
2020-01-01 00:27:00,14,6,4219,145,4074,6.44%,3.44%
2020-01-01 00:27:00,14,7,11538,1025,10513,17.61%,8.88%
2020-01-01 00:27:00,14,8,13151,1310,11841,20.07%,9.96%
2020-01-01 00:27:00,14,9,1524,17,1507,2.33%,1.12%
2020-01-01 00:27:00,14,10,4317,136,4181,6.59%,3.15%
2020-01-01 00:27:00,14,11,26231,4588,21643,40.03%,17.49%
2020-01-01 00:27:00,14,12,8429,526,7903,12.86%,6.24%
2020-01-01 00:27:00,15,1,512,2,510,0.78%,0.39%
2020-01-01 00:27:00,15,2,188,1,187,0.29%,0.53%
2020-01-01 00:27:00,15,3,3458,88,3370,5.28%,2.54%
2020-01-01 00:27:00,15,4,5975,295,5680,9.12%,4.94%
2020-01-01 00:27:00,15,5,10181,750,9431,15.53%,7.37%
2020-01-01 00:27:00,15,6,6221,315,5906,9.49%,5.06%
2020-01-01 00:27:00,15,7,3465,92,3373,5.29%,2.66%
2020-01-01 00:27:00,15,8,5537,234,5303,8.45%,4.23%
2020-01-01 00:27:00,15,9,10453,781,9672,15.95%,7.47%
2020-01-01 00:27:00,15,10,4466,284,4182,6.81%,6.36%
2020-01-01 00:27:00,15,11,10105,867,9238,15.42%,8.58%
2020-01-01 00:27:00,15,12,25925,4952,20973,39.56%,19.10%
2020-01-01 00:27:00,16,1,380,3,377,0.58%,0.79%
2020-01-01 00:27:00,16,2,217,0,217,0.33%,0.00%
2020-01-01 00:27:00,16,3,1661,24,1637,2.53%,1.44%
2020-01-01 00:27:00,16,4,4598,172,4426,7.02%,3.74%
2020-01-01 00:27:00,16,5,8137,536,7601,12.42%,6.59%
2020-01-01 00:27:00,16,6,5481,237,5244,8.36%,4.32%
2020-01-01 00:27:00,16,7,3940,133,3807,6.01%,3.38%
2020-01-01 00:27:00,16,8,7961,499,7462,12.15%,6.27%
2020-01-01 00:27:00,16,9,8580,584,7996,13.09%,6.81%
2020-01-01 00:27:00,16,10,1681,16,1665,2.57%,0.95%
2020-01-01 00:27:00,16,11,9822,698,9124,14.99%,7.11%
2020-01-01 00:27:00,16,12,26016,4621,21395,39.70%,17.76%
2020-01-01 00:27:10,1,1,20307,2937,17370,30.99%,14.46%
2020-01-01 00:27:10,1,2,4870,221,4649,7.43%,4.54%
2020-01-01 00:27:10,1,3,428,3,425,0.65%,0.70%
2020-01-01 00:27:10,1,4,14949,1591,13358,22.81%,10.64%
2020-01-01 00:27:10,1,5,14288,1478,12810,21.80%,10.34%
2020-01-01 00:27:10,1,6,14170,1447,12723,21.62%,10.21%
2020-01-01 00:27:10,1,7,4433,175,4258,6.76%,3.95%
2020-01-01 00:27:10,1,8,3396,105,3291,5.18%,3.09%
2020-01-01 00:27:10,1,9,14141,1441,12700,21.58%,10.19%
2020-01-01 00:27:10,1,10,2650,75,2575,4.04%,2.83%
2020-01-01 00:27:10,1,11,2740,77,2663,4.18%,2.81%
2020-01-01 00:27:10,1,12,14109,1435,12674,21.53%,10.17%
2020-01-01 00:27:10,2,1,635,5,630,0.97%,0.79%
2020-01-01 00:27:10,2,2,24889,4196,20693,37.98%,16.86%
2020-01-01 00:27:10,2,3,19203,2541,16662,29.30%,13.23%
2020-01-01 00:27:10,2,4,467,3,464,0.71%,0.64%
2020-01-01 00:27:10,2,5,11241,934,10307,17.15%,8.31%
2020-01-01 00:27:10,2,6,78,0,78,0.12%,0.00%
2020-01-01 00:27:10,2,7,5033,184,4849,7.68%,3.66%
2020-01-01 00:27:10,2,8,4173,134,4039,6.37%,3.21%
2020-01-01 00:27:10,2,9,11176,917,10259,17.05%,8.21%
2020-01-01 00:27:10,2,10,3437,92,3345,5.24%,2.68%
2020-01-01 00:27:10,2,11,3454,93,3361,5.27%,2.69%
2020-01-01 00:27:10,2,12,11008,885,10123,16.80%,8.04%
2020-01-01 00:27:10,3,1,1702,29,1673,2.60%,1.70%
2020-01-01 00:27:10,3,2,22682,3512,19170,34.61%,15.48%
2020-01-01 00:27:10,3,3,72093,28559,43534,110.01%,39.61%
2020-01-01 00:27:10,3,4,9957,723,9234,15.19%,7.26%
2020-01-01 00:27:10,3,5,48369,14238,34131,73.81%,29.44%
2020-01-01 00:27:10,3,6,11008,879,10129,16.80%,7.99%
2020-01-01 00:27:10,3,7,19133,2519,16614,29.19%,13.17%
2020-01-01 00:27:10,3,8,15261,1631,13630,23.29%,10.69%
2020-01-01 00:27:10,3,9,37012,8822,28190,56.48%,23.84%
2020-01-01 00:27:10,3,10,4252,144,4108,6.49%,3.39%
2020-01-01 00:27:10,3,11,2212,36,2176,3.38%,1.63%
2020-01-01 00:27:10,3,12,29865,5954,23911,45.57%,19.94%
2020-01-01 00:27:10,4,1,587,1,586,0.90%,0.17%
2020-01-01 00:27:10,4,2,351,0,351,0.54%,0.00%
2020-01-01 00:27:10,4,3,832,10,822,1.27%,1.20%
2020-01-01 00:27:10,4,4,28556,5513,23043,43.57%,19.31%
2020-01-01 00:27:10,4,5,17496,2185,15311,26.70%,12.49%
2020-01-01 00:27:10,4,6,25092,4325,20767,38.29%,17.24%
2020-01-01 00:27:10,4,7,6044,310,5734,9.22%,5.13%
2020-01-01 00:27:10,4,8,3047,68,2979,4.65%,2.23%
2020-01-01 00:27:10,4,9,15488,1721,13767,23.63%,11.11%
2020-01-01 00:27:10,4,10,1814,26,1788,2.77%,1.43%
2020-01-01 00:27:10,4,11,153,1,152,0.23%,0.65%
2020-01-01 00:27:10,4,12,12583,1164,11419,19.20%,9.25%
2020-01-01 00:27:10,5,1,2506,40,2466,3.82%,1.60%
2020-01-01 00:27:10,5,2,563,2,561,0.86%,0.36%
2020-01-01 00:27:10,5,3,533,2,531,0.81%,0.38%
2020-01-01 00:27:10,5,4,26007,4577,21430,39.68%,17.60%
2020-01-01 00:27:10,5,5,9568,676,8892,14.60%,7.07%
2020-01-01 00:27:10,5,6,14638,1553,13085,22.34%,10.61%
2020-01-01 00:27:10,5,7,4652,158,4494,7.10%,3.40%
2020-01-01 00:27:10,5,8,3307,94,3213,5.05%,2.84%
2020-01-01 00:27:10,5,9,8784,572,8212,13.40%,6.51%
2020-01-01 00:27:10,5,10,963,10,953,1.47%,1.04%
2020-01-01 00:27:10,5,11,555,5,550,0.85%,0.90%
2020-01-01 00:27:10,5,12,7654,459,7195,11.68%,6.00%
2020-01-01 00:27:10,6,1,985,10,975,1.50%,1.02%
2020-01-01 00:27:10,6,2,1060,16,1044,1.62%,1.51%
2020-01-01 00:27:10,6,3,1637,32,1605,2.50%,1.95%
2020-01-01 00:27:10,6,4,1606,29,1577,2.45%,1.81%
2020-01-01 00:27:10,6,5,14818,1576,13242,22.61%,10.64%
2020-01-01 00:27:10,6,6,4819,177,4642,7.35%,3.67%
2020-01-01 00:27:10,6,7,2807,59,2748,4.28%,2.10%
2020-01-01 00:27:10,6,8,2300,32,2268,3.51%,1.39%
2020-01-01 00:27:10,6,9,8005,482,7523,12.21%,6.02%
2020-01-01 00:27:10,6,10,2531,47,2484,3.86%,1.86%
2020-01-01 00:27:10,6,11,463,0,463,0.71%,0.00%
2020-01-01 00:27:10,6,12,5403,226,5177,8.24%,4.18%
2020-01-01 00:27:10,7,1,485,0,485,0.74%,0.00%
2020-01-01 00:27:10,7,2,291,1,290,0.44%,0.34%
2020-01-01 00:27:10,7,3,543,1,542,0.83%,0.18%
2020-01-01 00:27:10,7,4,1875,23,1852,2.86%,1.23%
2020-01-01 00:27:10,7,5,7063,352,6711,10.78%,4.98%
2020-01-01 00:27:10,7,6,12342,1076,11266,18.83%,8.72%
2020-01-01 00:27:10,7,7,3344,89,3255,5.10%,2.66%
2020-01-01 00:27:10,7,8,1073,9,1064,1.64%,0.84%
2020-01-01 00:27:10,7,9,6304,295,6009,9.62%,4.68%
2020-01-01 00:27:10,7,10,1176,5,1171,1.79%,0.43%
2020-01-01 00:27:10,7,11,85,0,85,0.13%,0.00%
2020-01-01 00:27:10,7,12,5140,203,4937,7.84%,3.95%
2020-01-01 00:27:10,8,1,628,1,627,0.96%,0.16%
2020-01-01 00:27:10,8,2,86,0,86,0.13%,0.00%
2020-01-01 00:27:10,8,3,1776,32,1744,2.71%,1.80%
2020-01-01 00:27:10,8,4,2507,37,2470,3.83%,1.48%
2020-01-01 00:27:10,8,5,8662,569,8093,13.22%,6.57%
2020-01-01 00:27:10,8,6,16535,1947,14588,25.23%,11.78%
2020-01-01 00:27:10,8,7,5278,210,5068,8.05%,3.98%
2020-01-01 00:27:10,8,8,2080,40,2040,3.17%,1.92%
2020-01-01 00:27:10,8,9,6300,300,6000,9.61%,4.76%
2020-01-01 00:27:10,8,10,1983,34,1949,3.03%,1.71%
2020-01-01 00:27:10,8,11,204,1,203,0.31%,0.49%
2020-01-01 00:27:10,8,12,4319,148,4171,6.59%,3.43%
2020-01-01 00:27:10,9,1,625,1,624,0.95%,0.16%
2020-01-01 00:27:10,9,2,2167,24,2143,3.31%,1.11%
2020-01-01 00:27:10,9,3,1152,7,1145,1.76%,0.61%
2020-01-01 00:27:10,9,4,6780,324,6456,10.35%,4.78%
2020-01-01 00:27:10,9,5,669,2,667,1.02%,0.30%
2020-01-01 00:27:10,9,6,8161,477,7684,12.45%,5.84%
2020-01-01 00:27:10,9,7,28001,5166,22835,42.73%,18.45%
2020-01-01 00:27:10,9,8,12868,1172,11696,19.64%,9.11%
2020-01-01 00:27:10,9,9,480,0,480,0.73%,0.00%
2020-01-01 00:27:10,9,10,3534,83,3451,5.39%,2.35%
2020-01-01 00:27:10,9,11,10992,852,10140,16.77%,7.75%
2020-01-01 00:27:10,9,12,7078,383,6695,10.80%,5.41%
2020-01-01 00:27:10,10,1,1318,257,1061,2.01%,19.50%
2020-01-01 00:27:10,10,2,4443,368,4075,6.78%,8.28%
2020-01-01 00:27:10,10,3,2899,61,2838,4.42%,2.10%
2020-01-01 00:27:10,10,4,4017,811,3206,6.13%,20.19%
2020-01-01 00:27:10,10,5,920,64,856,1.40%,6.96%
2020-01-01 00:27:10,10,6,6051,1010,5041,9.23%,16.69%
2020-01-01 00:27:10,10,7,12343,1973,10370,18.83%,15.98%
2020-01-01 00:27:10,10,8,31001,8041,22960,47.30%,25.94%
2020-01-01 00:27:10,10,9,803,5,798,1.23%,0.62%
2020-01-01 00:27:10,10,10,3481,88,3393,5.31%,2.53%
2020-01-01 00:27:10,10,11,14656,1929,12727,22.36%,13.16%
2020-01-01 00:27:10,10,12,10523,1219,9304,16.06%,11.58%
2020-01-01 00:27:10,11,1,2405,31,2374,3.67%,1.29%
2020-01-01 00:27:10,11,2,3525,79,3446,5.38%,2.24%
2020-01-01 00:27:10,11,3,970,8,962,1.48%,0.82%
2020-01-01 00:27:10,11,4,3740,109,3631,5.71%,2.91%
2020-01-01 00:27:10,11,5,191,1,190,0.29%,0.52%
2020-01-01 00:27:10,11,6,4727,178,4549,7.21%,3.77%
2020-01-01 00:27:10,11,7,10091,727,9364,15.40%,7.20%
2020-01-01 00:27:10,11,8,24292,4073,20219,37.07%,16.77%
2020-01-01 00:27:10,11,9,310,0,310,0.47%,0.00%
2020-01-01 00:27:10,11,10,3488,92,3396,5.32%,2.64%
2020-01-01 00:27:10,11,11,10617,844,9773,16.20%,7.95%
2020-01-01 00:27:10,11,12,6706,336,6370,10.23%,5.01%
2020-01-01 00:27:10,12,1,33,0,33,0.05%,0.00%
2020-01-01 00:27:10,12,2,582,161,421,0.89%,27.66%
2020-01-01 00:27:10,12,3,2641,205,2436,4.03%,7.76%
2020-01-01 00:27:10,12,4,3104,58,3046,4.74%,1.87%
2020-01-01 00:27:10,12,5,8831,741,8090,13.48%,8.39%
2020-01-01 00:27:10,12,6,5458,246,5212,8.33%,4.51%
2020-01-01 00:27:10,12,7,1704,33,1671,2.60%,1.94%
2020-01-01 00:27:10,12,8,1441,301,1140,2.20%,20.89%
2020-01-01 00:27:10,12,9,22341,4478,17863,34.09%,20.04%
2020-01-01 00:27:10,12,10,4487,438,4049,6.85%,9.76%
2020-01-01 00:27:10,12,11,1748,308,1440,2.67%,17.62%
2020-01-01 00:27:10,12,12,8452,1359,7093,12.90%,16.08%
2020-01-01 00:27:10,13,1,2048,27,2021,3.12%,1.32%
2020-01-01 00:27:10,13,2,2339,34,2305,3.57%,1.45%
2020-01-01 00:27:10,13,3,854,28,826,1.30%,3.28%
2020-01-01 00:27:10,13,4,6153,745,5408,9.39%,12.11%
2020-01-01 00:27:10,13,5,8660,1121,7539,13.21%,12.94%
2020-01-01 00:27:10,13,6,6697,797,5900,10.22%,11.90%
2020-01-01 00:27:10,13,7,4798,159,4639,7.32%,3.31%
2020-01-01 00:27:10,13,8,6887,353,6534,10.51%,5.13%
2020-01-01 00:27:10,13,9,9072,1181,7891,13.84%,13.02%
2020-01-01 00:27:10,13,10,29338,6355,22983,44.77%,21.66%
2020-01-01 00:27:10,13,11,17354,2398,14956,26.48%,13.82%
2020-01-01 00:27:10,13,12,9983,1046,8937,15.23%,10.48%
2020-01-01 00:27:10,14,1,320,1,319,0.49%,0.31%
2020-01-01 00:27:10,14,2,1699,19,1680,2.59%,1.12%
2020-01-01 00:27:10,14,3,1119,9,1110,1.71%,0.80%
2020-01-01 00:27:10,14,4,3737,130,3607,5.70%,3.48%
2020-01-01 00:27:10,14,5,1021,10,1011,1.56%,0.98%
2020-01-01 00:27:10,14,6,3922,138,3784,5.98%,3.52%
2020-01-01 00:27:10,14,7,11388,946,10442,17.38%,8.31%
2020-01-01 00:27:10,14,8,13713,1352,12361,20.92%,9.86%
2020-01-01 00:27:10,14,9,1152,12,1140,1.76%,1.04%
2020-01-01 00:27:10,14,10,4128,133,3995,6.30%,3.22%
2020-01-01 00:27:10,14,11,25345,4387,20958,38.67%,17.31%
2020-01-01 00:27:10,14,12,7165,396,6769,10.93%,5.53%
2020-01-01 00:27:10,15,1,565,2,563,0.86%,0.35%
2020-01-01 00:27:10,15,2,145,0,145,0.22%,0.00%
2020-01-01 00:27:10,15,3,3390,97,3293,5.17%,2.86%
2020-01-01 00:27:10,15,4,5530,243,5287,8.44%,4.39%
2020-01-01 00:27:10,15,5,9658,792,8866,14.74%,8.20%
2020-01-01 00:27:10,15,6,5917,295,5622,9.03%,4.99%
2020-01-01 00:27:10,15,7,3858,94,3764,5.89%,2.44%
2020-01-01 00:27:10,15,8,6010,254,5756,9.17%,4.23%
2020-01-01 00:27:10,15,9,9936,831,9105,15.16%,8.36%
2020-01-01 00:27:10,15,10,4864,320,4544,7.42%,6.58%
2020-01-01 00:27:10,15,11,11040,1059,9981,16.85%,9.59%
2020-01-01 00:27:10,15,12,26930,5468,21462,41.09%,20.30%
2020-01-01 00:27:10,16,1,397,0,397,0.61%,0.00%
2020-01-01 00:27:10,16,2,246,0,246,0.38%,0.00%
2020-01-01 00:27:10,16,3,2031,33,1998,3.10%,1.62%
2020-01-01 00:27:10,16,4,4543,156,4387,6.93%,3.43%
2020-01-01 00:27:10,16,5,8852,648,8204,13.51%,7.32%
2020-01-01 00:27:10,16,6,5381,209,5172,8.21%,3.88%
2020-01-01 00:27:10,16,7,3526,98,3428,5.38%,2.78%
2020-01-01 00:27:10,16,8,7576,588,6988,11.56%,7.76%
2020-01-01 00:27:10,16,9,9304,698,8606,14.20%,7.50%
2020-01-01 00:27:10,16,10,1763,21,1742,2.69%,1.19%
2020-01-01 00:27:10,16,11,9567,847,8720,14.60%,8.85%
2020-01-01 00:27:10,16,12,27132,5085,22047,41.40%,18.74%
2020-01-01 00:27:20,1,1,16885,2003,14882,25.76%,11.86%
2020-01-01 00:27:20,1,2,7954,456,7498,12.14%,5.73%
2020-01-01 00:27:20,1,3,600,4,596,0.92%,0.67%
2020-01-01 00:27:20,1,4,8482,534,7948,12.94%,6.30%
2020-01-01 00:27:20,1,5,8118,500,7618,12.39%,6.16%
2020-01-01 00:27:20,1,6,8013,488,7525,12.23%,6.09%
2020-01-01 00:27:20,1,7,7341,373,6968,11.20%,5.08%
2020-01-01 00:27:20,1,8,3834,101,3733,5.85%,2.63%
2020-01-01 00:27:20,1,9,7974,482,7492,12.17%,6.04%
2020-01-01 00:27:20,1,10,2957,66,2891,4.51%,2.23%
2020-01-01 00:27:20,1,11,3096,68,3028,4.72%,2.20%
2020-01-01 00:27:20,1,12,7956,481,7475,12.14%,6.05%
2020-01-01 00:27:20,2,1,1189,14,1175,1.81%,1.18%
2020-01-01 00:27:20,2,2,25611,4357,21254,39.08%,17.01%
2020-01-01 00:27:20,2,3,19635,2638,16997,29.96%,13.44%
2020-01-01 00:27:20,2,4,1092,13,1079,1.67%,1.19%
2020-01-01 00:27:20,2,5,11377,886,10491,17.36%,7.79%
2020-01-01 00:27:20,2,6,47,0,47,0.07%,0.00%
2020-01-01 00:27:20,2,7,4778,155,4623,7.29%,3.24%
2020-01-01 00:27:20,2,8,3477,74,3403,5.31%,2.13%
2020-01-01 00:27:20,2,9,11274,873,10401,17.20%,7.74%
2020-01-01 00:27:20,2,10,2806,48,2758,4.28%,1.71%
2020-01-01 00:27:20,2,11,2823,49,2774,4.31%,1.74%
2020-01-01 00:27:20,2,12,11103,848,10255,16.94%,7.64%
2020-01-01 00:27:20,3,1,1810,23,1787,2.76%,1.27%
2020-01-01 00:27:20,3,2,23188,3589,19599,35.38%,15.48%
2020-01-01 00:27:20,3,3,71429,27961,43468,108.99%,39.15%
2020-01-01 00:27:20,3,4,14187,1437,12750,21.65%,10.13%
2020-01-01 00:27:20,3,5,46692,13320,33372,71.25%,28.53%
2020-01-01 00:27:20,3,6,15826,1754,14072,24.15%,11.08%
2020-01-01 00:27:20,3,7,18789,2446,16343,28.67%,13.02%
2020-01-01 00:27:20,3,8,16338,1857,14481,24.93%,11.37%
2020-01-01 00:27:20,3,9,30465,6062,24403,46.49%,19.90%
2020-01-01 00:27:20,3,10,4074,115,3959,6.22%,2.82%
2020-01-01 00:27:20,3,11,1951,27,1924,2.98%,1.38%
2020-01-01 00:27:20,3,12,23929,3846,20083,36.51%,16.07%
2020-01-01 00:27:20,4,1,586,2,584,0.89%,0.34%
2020-01-01 00:27:20,4,2,345,2,343,0.53%,0.58%
2020-01-01 00:27:20,4,3,840,10,830,1.28%,1.19%
2020-01-01 00:27:20,4,4,27773,5138,22635,42.38%,18.50%
2020-01-01 00:27:20,4,5,17648,2166,15482,26.93%,12.27%
2020-01-01 00:27:20,4,6,24261,3946,20315,37.02%,16.26%
2020-01-01 00:27:20,4,7,5271,185,5086,8.04%,3.51%
2020-01-01 00:27:20,4,8,3391,76,3315,5.17%,2.24%
2020-01-01 00:27:20,4,9,15510,1674,13836,23.67%,10.79%
2020-01-01 00:27:20,4,10,1780,35,1745,2.72%,1.97%
2020-01-01 00:27:20,4,11,128,0,128,0.20%,0.00%
2020-01-01 00:27:20,4,12,13026,1198,11828,19.88%,9.20%
2020-01-01 00:27:20,5,1,2854,76,2778,4.35%,2.66%
2020-01-01 00:27:20,5,2,721,8,713,1.10%,1.11%
2020-01-01 00:27:20,5,3,707,4,703,1.08%,0.57%
2020-01-01 00:27:20,5,4,23444,3838,19606,35.77%,16.37%
2020-01-01 00:27:20,5,5,10082,772,9310,15.38%,7.66%
2020-01-01 00:27:20,5,6,14745,1592,13153,22.50%,10.80%
2020-01-01 00:27:20,5,7,4246,150,4096,6.48%,3.53%
2020-01-01 00:27:20,5,8,3332,94,3238,5.08%,2.82%
2020-01-01 00:27:20,5,9,9176,639,8537,14.00%,6.96%
2020-01-01 00:27:20,5,10,1296,18,1278,1.98%,1.39%
2020-01-01 00:27:20,5,11,663,7,656,1.01%,1.06%
2020-01-01 00:27:20,5,12,7517,425,7092,11.47%,5.65%
2020-01-01 00:27:20,6,1,1120,9,1111,1.71%,0.80%
2020-01-01 00:27:20,6,2,1216,11,1205,1.86%,0.90%
2020-01-01 00:27:20,6,3,1535,15,1520,2.34%,0.98%
2020-01-01 00:27:20,6,4,1295,7,1288,1.98%,0.54%
2020-01-01 00:27:20,6,5,14986,1567,13419,22.87%,10.46%
2020-01-01 00:27:20,6,6,4196,138,4058,6.40%,3.29%
2020-01-01 00:27:20,6,7,2488,47,2441,3.80%,1.89%
2020-01-01 00:27:20,6,8,2019,31,1988,3.08%,1.54%
2020-01-01 00:27:20,6,9,9012,605,8407,13.75%,6.71%
2020-01-01 00:27:20,6,10,2322,53,2269,3.54%,2.28%
2020-01-01 00:27:20,6,11,437,3,434,0.67%,0.69%
2020-01-01 00:27:20,6,12,6644,326,6318,10.14%,4.91%
2020-01-01 00:27:20,7,1,533,5,528,0.81%,0.94%
2020-01-01 00:27:20,7,2,157,0,157,0.24%,0.00%
2020-01-01 00:27:20,7,3,1229,8,1221,1.88%,0.65%
2020-01-01 00:27:20,7,4,2204,46,2158,3.36%,2.09%
2020-01-01 00:27:20,7,5,7491,370,7121,11.43%,4.94%
2020-01-01 00:27:20,7,6,13643,1254,12389,20.82%,9.19%
2020-01-01 00:27:20,7,7,3902,97,3805,5.95%,2.49%
2020-01-01 00:27:20,7,8,1328,10,1318,2.03%,0.75%
2020-01-01 00:27:20,7,9,6148,255,5893,9.38%,4.15%
2020-01-01 00:27:20,7,10,1221,17,1204,1.86%,1.39%
2020-01-01 00:27:20,7,11,171,0,171,0.26%,0.00%
2020-01-01 00:27:20,7,12,4927,152,4775,7.52%,3.09%
2020-01-01 00:27:20,8,1,574,2,572,0.88%,0.35%
2020-01-01 00:27:20,8,2,77,2,75,0.12%,2.60%
2020-01-01 00:27:20,8,3,1663,18,1645,2.54%,1.08%
2020-01-01 00:27:20,8,4,2882,64,2818,4.40%,2.22%
2020-01-01 00:27:20,8,5,8598,495,8103,13.12%,5.76%
2020-01-01 00:27:20,8,6,16973,2036,14937,25.90%,12.00%
2020-01-01 00:27:20,8,7,5314,218,5096,8.11%,4.10%
2020-01-01 00:27:20,8,8,2006,37,1969,3.06%,1.84%
2020-01-01 00:27:20,8,9,6507,278,6229,9.93%,4.27%
2020-01-01 00:27:20,8,10,2123,31,2092,3.24%,1.46%
2020-01-01 00:27:20,8,11,275,0,275,0.42%,0.00%
2020-01-01 00:27:20,8,12,4347,119,4228,6.63%,2.74%
2020-01-01 00:27:20,9,1,891,3,888,1.36%,0.34%
2020-01-01 00:27:20,9,2,3954,101,3853,6.03%,2.55%
2020-01-01 00:27:20,9,3,2661,50,2611,4.06%,1.88%
2020-01-01 00:27:20,9,4,6227,268,5959,9.50%,4.30%
2020-01-01 00:27:20,9,5,542,2,540,0.83%,0.37%
2020-01-01 00:27:20,9,6,7285,377,6908,11.12%,5.18%
2020-01-01 00:27:20,9,7,28923,5699,23224,44.13%,19.70%
2020-01-01 00:27:20,9,8,9915,762,9153,15.13%,7.69%
2020-01-01 00:27:20,9,9,371,1,370,0.57%,0.27%
2020-01-01 00:27:20,9,10,2573,84,2489,3.93%,3.26%
2020-01-01 00:27:20,9,11,8600,617,7983,13.12%,7.17%
2020-01-01 00:27:20,9,12,5767,293,5474,8.80%,5.08%
2020-01-01 00:27:20,10,1,1406,321,1085,2.15%,22.83%
2020-01-01 00:27:20,10,2,3360,403,2957,5.13%,11.99%
2020-01-01 00:27:20,10,3,1789,37,1752,2.73%,2.07%
2020-01-01 00:27:20,10,4,4342,1033,3309,6.63%,23.79%
2020-01-01 00:27:20,10,5,962,58,904,1.47%,6.03%
2020-01-01 00:27:20,10,6,6393,1220,5173,9.75%,19.08%
2020-01-01 00:27:20,10,7,11687,2161,9526,17.83%,18.49%
2020-01-01 00:27:20,10,8,29218,7437,21781,44.58%,25.45%
2020-01-01 00:27:20,10,9,932,4,928,1.42%,0.43%
2020-01-01 00:27:20,10,10,2939,57,2882,4.48%,1.94%
2020-01-01 00:27:20,10,11,14031,1823,12208,21.41%,12.99%
2020-01-01 00:27:20,10,12,10332,1228,9104,15.77%,11.89%
2020-01-01 00:27:20,11,1,2838,68,2770,4.33%,2.40%
2020-01-01 00:27:20,11,2,3804,141,3663,5.80%,3.71%
2020-01-01 00:27:20,11,3,779,4,775,1.19%,0.51%
2020-01-01 00:27:20,11,4,5183,205,4978,7.91%,3.96%
2020-01-01 00:27:20,11,5,411,2,409,0.63%,0.49%
2020-01-01 00:27:20,11,6,6270,293,5977,9.57%,4.67%
2020-01-01 00:27:20,11,7,11805,1006,10799,18.01%,8.52%
2020-01-01 00:27:20,11,8,26372,4644,21728,40.24%,17.61%
2020-01-01 00:27:20,11,9,250,1,249,0.38%,0.40%
2020-01-01 00:27:20,11,10,3161,82,3079,4.82%,2.59%
2020-01-01 00:27:20,11,11,10171,761,9410,15.52%,7.48%
2020-01-01 00:27:20,11,12,6644,334,6310,10.14%,5.03%
2020-01-01 00:27:20,12,1,66,0,66,0.10%,0.00%
2020-01-01 00:27:20,12,2,693,200,493,1.06%,28.86%
2020-01-01 00:27:20,12,3,3181,265,2916,4.85%,8.33%
2020-01-01 00:27:20,12,4,3618,108,3510,5.52%,2.99%
2020-01-01 00:27:20,12,5,10556,984,9572,16.11%,9.32%
2020-01-01 00:27:20,12,6,6543,302,6241,9.98%,4.62%
2020-01-01 00:27:20,12,7,2388,37,2351,3.64%,1.55%
2020-01-01 00:27:20,12,8,1431,323,1108,2.18%,22.57%
2020-01-01 00:27:20,12,9,23188,4782,18406,35.38%,20.62%
2020-01-01 00:27:20,12,10,4426,465,3961,6.75%,10.51%
2020-01-01 00:27:20,12,11,1677,339,1338,2.56%,20.21%
2020-01-01 00:27:20,12,12,7603,1271,6332,11.60%,16.72%
2020-01-01 00:27:20,13,1,2135,30,2105,3.26%,1.41%
2020-01-01 00:27:20,13,2,2499,41,2458,3.81%,1.64%
2020-01-01 00:27:20,13,3,891,7,884,1.36%,0.79%
2020-01-01 00:27:20,13,4,5284,618,4666,8.06%,11.70%
2020-01-01 00:27:20,13,5,7963,997,6966,12.15%,12.52%
2020-01-01 00:27:20,13,6,6103,677,5426,9.31%,11.09%
2020-01-01 00:27:20,13,7,4670,146,4524,7.13%,3.13%
2020-01-01 00:27:20,13,8,6919,337,6582,10.56%,4.87%
2020-01-01 00:27:20,13,9,8285,1040,7245,12.64%,12.55%
2020-01-01 00:27:20,13,10,28437,5937,22500,43.39%,20.88%
2020-01-01 00:27:20,13,11,17606,2412,15194,26.86%,13.70%
2020-01-01 00:27:20,13,12,10249,1078,9171,15.64%,10.52%
2020-01-01 00:27:20,14,1,396,2,394,0.60%,0.51%
2020-01-01 00:27:20,14,2,2026,29,1997,3.09%,1.43%
2020-01-01 00:27:20,14,3,1399,11,1388,2.13%,0.79%
2020-01-01 00:27:20,14,4,3977,131,3846,6.07%,3.29%
2020-01-01 00:27:20,14,5,1188,4,1184,1.81%,0.34%
2020-01-01 00:27:20,14,6,4511,162,4349,6.88%,3.59%
2020-01-01 00:27:20,14,7,12408,1087,11321,18.93%,8.76%
2020-01-01 00:27:20,14,8,14372,1433,12939,21.93%,9.97%
2020-01-01 00:27:20,14,9,1340,7,1333,2.04%,0.52%
2020-01-01 00:27:20,14,10,3902,97,3805,5.95%,2.49%
2020-01-01 00:27:20,14,11,25527,4316,21211,38.95%,16.91%
2020-01-01 00:27:20,14,12,7015,345,6670,10.70%,4.92%
2020-01-01 00:27:20,15,1,679,4,675,1.04%,0.59%
2020-01-01 00:27:20,15,2,158,0,158,0.24%,0.00%
2020-01-01 00:27:20,15,3,3618,142,3476,5.52%,3.92%
2020-01-01 00:27:20,15,4,7379,423,6956,11.26%,5.73%
2020-01-01 00:27:20,15,5,11866,1088,10778,18.11%,9.17%
2020-01-01 00:27:20,15,6,7661,470,7191,11.69%,6.13%
2020-01-01 00:27:20,15,7,4103,104,3999,6.26%,2.53%
2020-01-01 00:27:20,15,8,7045,354,6691,10.75%,5.02%
2020-01-01 00:27:20,15,9,12039,1118,10921,18.37%,9.29%
2020-01-01 00:27:20,15,10,5548,322,5226,8.47%,5.80%
2020-01-01 00:27:20,15,11,12718,1230,11488,19.41%,9.67%
2020-01-01 00:27:20,15,12,30287,6377,23910,46.21%,21.06%
2020-01-01 00:27:20,16,1,497,2,495,0.76%,0.40%
2020-01-01 00:27:20,16,2,310,2,308,0.47%,0.65%
2020-01-01 00:27:20,16,3,1406,16,1390,2.15%,1.14%
2020-01-01 00:27:20,16,4,4961,182,4779,7.57%,3.67%
2020-01-01 00:27:20,16,5,8925,679,8246,13.62%,7.61%
2020-01-01 00:27:20,16,6,5869,252,5617,8.96%,4.29%
2020-01-01 00:27:20,16,7,3197,81,3116,4.88%,2.53%
2020-01-01 00:27:20,16,8,7154,415,6739,10.92%,5.80%
2020-01-01 00:27:20,16,9,9420,743,8677,14.37%,7.89%
2020-01-01 00:27:20,16,10,1394,9,1385,2.13%,0.65%
2020-01-01 00:27:20,16,11,8779,583,8196,13.40%,6.64%
2020-01-01 00:27:20,16,12,27259,5225,22034,41.59%,19.17%
2020-01-01 00:27:30,1,1,19046,2586,16460,29.06%,13.58%
2020-01-01 00:27:30,1,2,7608,439,7169,11.61%,5.77%
2020-01-01 00:27:30,1,3,533,3,530,0.81%,0.56%
2020-01-01 00:27:30,1,4,11192,914,10278,17.08%,8.17%
2020-01-01 00:27:30,1,5,10878,873,10005,16.60%,8.03%
2020-01-01 00:27:30,1,6,10812,865,9947,16.50%,8.00%
2020-01-01 00:27:30,1,7,7064,392,6672,10.78%,5.55%
2020-01-01 00:27:30,1,8,4888,190,4698,7.46%,3.89%
2020-01-01 00:27:30,1,9,10768,857,9911,16.43%,7.96%
2020-01-01 00:27:30,1,10,4151,138,4013,6.33%,3.32%
2020-01-01 00:27:30,1,11,4236,148,4088,6.46%,3.49%
2020-01-01 00:27:30,1,12,10675,844,9831,16.29%,7.91%
2020-01-01 00:27:30,2,1,872,1,871,1.33%,0.11%
2020-01-01 00:27:30,2,2,31201,6352,24849,47.61%,20.36%
2020-01-01 00:27:30,2,3,26962,4861,22101,41.14%,18.03%
2020-01-01 00:27:30,2,4,808,1,807,1.23%,0.12%
2020-01-01 00:27:30,2,5,16275,1904,14371,24.83%,11.70%
2020-01-01 00:27:30,2,6,20,0,20,0.03%,0.00%
2020-01-01 00:27:30,2,7,3356,92,3264,5.12%,2.74%
2020-01-01 00:27:30,2,8,2413,47,2366,3.68%,1.95%
2020-01-01 00:27:30,2,9,16082,1865,14217,24.54%,11.60%
2020-01-01 00:27:30,2,10,1806,29,1777,2.76%,1.61%
2020-01-01 00:27:30,2,11,1827,29,1798,2.79%,1.59%
2020-01-01 00:27:30,2,12,15969,1839,14130,24.37%,11.52%
2020-01-01 00:27:30,3,1,1635,21,1614,2.49%,1.28%
2020-01-01 00:27:30,3,2,21458,3203,18255,32.74%,14.93%
2020-01-01 00:27:30,3,3,68627,25977,42650,104.72%,37.85%
2020-01-01 00:27:30,3,4,12386,1109,11277,18.90%,8.95%
2020-01-01 00:27:30,3,5,45993,12811,33182,70.18%,27.85%
2020-01-01 00:27:30,3,6,13664,1301,12363,20.85%,9.52%
2020-01-01 00:27:30,3,7,17634,2221,15413,26.91%,12.59%
2020-01-01 00:27:30,3,8,14531,1535,12996,22.17%,10.56%
2020-01-01 00:27:30,3,9,31793,6548,25245,48.51%,20.60%
2020-01-01 00:27:30,3,10,4376,157,4219,6.68%,3.59%
2020-01-01 00:27:30,3,11,1649,20,1629,2.52%,1.21%
2020-01-01 00:27:30,3,12,25177,4224,20953,38.42%,16.78%
2020-01-01 00:27:30,4,1,392,0,392,0.60%,0.00%
2020-01-01 00:27:30,4,2,216,0,216,0.33%,0.00%
2020-01-01 00:27:30,4,3,1095,2,1093,1.67%,0.18%
2020-01-01 00:27:30,4,4,27120,4986,22134,41.38%,18.38%
2020-01-01 00:27:30,4,5,17568,2202,15366,26.81%,12.53%
2020-01-01 00:27:30,4,6,23772,3900,19872,36.27%,16.41%
2020-01-01 00:27:30,4,7,4862,152,4710,7.42%,3.13%
2020-01-01 00:27:30,4,8,3087,64,3023,4.71%,2.07%
2020-01-01 00:27:30,4,9,15428,1699,13729,23.54%,11.01%
2020-01-01 00:27:30,4,10,1862,29,1833,2.84%,1.56%
2020-01-01 00:27:30,4,11,108,0,108,0.16%,0.00%
2020-01-01 00:27:30,4,12,12821,1169,11652,19.56%,9.12%
2020-01-01 00:27:30,5,1,3001,58,2943,4.58%,1.93%
2020-01-01 00:27:30,5,2,713,2,711,1.09%,0.28%
2020-01-01 00:27:30,5,3,1288,16,1272,1.97%,1.24%
2020-01-01 00:27:30,5,4,26800,4853,21947,40.89%,18.11%
2020-01-01 00:27:30,5,5,10712,874,9838,16.35%,8.16%
2020-01-01 00:27:30,5,6,15743,1813,13930,24.02%,11.52%
2020-01-01 00:27:30,5,7,4431,155,4276,6.76%,3.50%
2020-01-01 00:27:30,5,8,3267,90,3177,4.99%,2.75%
2020-01-01 00:27:30,5,9,9281,674,8607,14.16%,7.26%
2020-01-01 00:27:30,5,10,1066,11,1055,1.63%,1.03%
2020-01-01 00:27:30,5,11,778,7,771,1.19%,0.90%
2020-01-01 00:27:30,5,12,7847,510,7337,11.97%,6.50%
2020-01-01 00:27:30,6,1,1191,10,1181,1.82%,0.84%
2020-01-01 00:27:30,6,2,1322,12,1310,2.02%,0.91%
2020-01-01 00:27:30,6,3,1612,18,1594,2.46%,1.12%
2020-01-01 00:27:30,6,4,1135,15,1120,1.73%,1.32%
2020-01-01 00:27:30,6,5,16628,1948,14680,25.37%,11.72%
2020-01-01 00:27:30,6,6,4787,208,4579,7.30%,4.35%
2020-01-01 00:27:30,6,7,3173,86,3087,4.84%,2.71%
2020-01-01 00:27:30,6,8,1915,40,1875,2.92%,2.09%
2020-01-01 00:27:30,6,9,9946,705,9241,15.18%,7.09%
2020-01-01 00:27:30,6,10,2162,32,2130,3.30%,1.48%
2020-01-01 00:27:30,6,11,417,0,417,0.64%,0.00%
2020-01-01 00:27:30,6,12,7719,434,7285,11.78%,5.62%
2020-01-01 00:27:30,7,1,530,2,528,0.81%,0.38%
2020-01-01 00:27:30,7,2,72,0,72,0.11%,0.00%
2020-01-01 00:27:30,7,3,962,8,954,1.47%,0.83%
2020-01-01 00:27:30,7,4,1801,10,1791,2.75%,0.56%
2020-01-01 00:27:30,7,5,6946,312,6634,10.60%,4.49%
2020-01-01 00:27:30,7,6,11941,982,10959,18.22%,8.22%
2020-01-01 00:27:30,7,7,3167,75,3092,4.83%,2.37%
2020-01-01 00:27:30,7,8,1178,10,1168,1.80%,0.85%
2020-01-01 00:27:30,7,9,5888,226,5662,8.98%,3.84%
2020-01-01 00:27:30,7,10,1181,7,1174,1.80%,0.59%
2020-01-01 00:27:30,7,11,153,0,153,0.23%,0.00%
2020-01-01 00:27:30,7,12,4718,149,4569,7.20%,3.16%
2020-01-01 00:27:30,8,1,416,1,415,0.63%,0.24%
2020-01-01 00:27:30,8,2,99,1,98,0.15%,1.01%
2020-01-01 00:27:30,8,3,1369,5,1364,2.09%,0.37%
2020-01-01 00:27:30,8,4,2695,46,2649,4.11%,1.71%
2020-01-01 00:27:30,8,5,7696,383,7313,11.74%,4.98%
2020-01-01 00:27:30,8,6,17253,2067,15186,26.33%,11.98%
2020-01-01 00:27:30,8,7,6791,339,6452,10.36%,4.99%
2020-01-01 00:27:30,8,8,3347,87,3260,5.11%,2.60%
2020-01-01 00:27:30,8,9,6025,250,5775,9.19%,4.15%
2020-01-01 00:27:30,8,10,1812,22,1790,2.76%,1.21%
2020-01-01 00:27:30,8,11,350,0,350,0.53%,0.00%
2020-01-01 00:27:30,8,12,4126,120,4006,6.30%,2.91%
2020-01-01 00:27:30,9,1,772,0,772,1.18%,0.00%
2020-01-01 00:27:30,9,2,2483,41,2442,3.79%,1.65%
2020-01-01 00:27:30,9,3,1310,17,1293,2.00%,1.30%
2020-01-01 00:27:30,9,4,4920,159,4761,7.51%,3.23%
2020-01-01 00:27:30,9,5,295,1,294,0.45%,0.34%
2020-01-01 00:27:30,9,6,5601,220,5381,8.55%,3.93%
2020-01-01 00:27:30,9,7,28393,5336,23057,43.32%,18.79%
2020-01-01 00:27:30,9,8,12583,1096,11487,19.20%,8.71%
2020-01-01 00:27:30,9,9,283,1,282,0.43%,0.35%
2020-01-01 00:27:30,9,10,5270,204,5066,8.04%,3.87%
2020-01-01 00:27:30,9,11,11325,879,10446,17.28%,7.76%
2020-01-01 00:27:30,9,12,5788,234,5554,8.83%,4.04%
2020-01-01 00:27:30,10,1,1184,302,882,1.81%,25.51%
2020-01-01 00:27:30,10,2,2976,363,2613,4.54%,12.20%
2020-01-01 00:27:30,10,3,1577,16,1561,2.41%,1.01%
2020-01-01 00:27:30,10,4,4633,1051,3582,7.07%,22.69%
2020-01-01 00:27:30,10,5,736,11,725,1.12%,1.49%
2020-01-01 00:27:30,10,6,6952,1237,5715,10.61%,17.79%
2020-01-01 00:27:30,10,7,11911,2097,9814,18.17%,17.61%
2020-01-01 00:27:30,10,8,28053,6933,21120,42.81%,24.71%
2020-01-01 00:27:30,10,9,884,2,882,1.35%,0.23%
2020-01-01 00:27:30,10,10,2609,47,2562,3.98%,1.80%
2020-01-01 00:27:30,10,11,12369,1557,10812,18.87%,12.59%
2020-01-01 00:27:30,10,12,9172,1100,8072,14.00%,11.99%
2020-01-01 00:27:30,11,1,3045,60,2985,4.65%,1.97%
2020-01-01 00:27:30,11,2,4101,114,3987,6.26%,2.78%
2020-01-01 00:27:30,11,3,904,5,899,1.38%,0.55%
2020-01-01 00:27:30,11,4,3237,73,3164,4.94%,2.26%
2020-01-01 00:27:30,11,5,360,2,358,0.55%,0.56%
2020-01-01 00:27:30,11,6,4324,135,4189,6.60%,3.12%
2020-01-01 00:27:30,11,7,10198,737,9461,15.56%,7.23%
2020-01-01 00:27:30,11,8,24438,3906,20532,37.29%,15.98%
2020-01-01 00:27:30,11,9,312,0,312,0.48%,0.00%
2020-01-01 00:27:30,11,10,3139,89,3050,4.79%,2.84%
2020-01-01 00:27:30,11,11,9863,676,9187,15.05%,6.85%
2020-01-01 00:27:30,11,12,6408,276,6132,9.78%,4.31%
2020-01-01 00:27:30,12,1,152,0,152,0.23%,0.00%
2020-01-01 00:27:30,12,2,721,248,473,1.10%,34.40%
2020-01-01 00:27:30,12,3,2703,288,2415,4.12%,10.65%
2020-01-01 00:27:30,12,4,3517,102,3415,5.37%,2.90%
2020-01-01 00:27:30,12,5,10314,1013,9301,15.74%,9.82%
2020-01-01 00:27:30,12,6,6715,349,6366,10.25%,5.20%
2020-01-01 00:27:30,12,7,3078,86,2992,4.70%,2.79%
2020-01-01 00:27:30,12,8,1180,224,956,1.80%,18.98%
2020-01-01 00:27:30,12,9,24864,5237,19627,37.94%,21.06%
2020-01-01 00:27:30,12,10,3800,318,3482,5.80%,8.37%
2020-01-01 00:27:30,12,11,1355,225,1130,2.07%,16.61%
2020-01-01 00:27:30,12,12,9522,1377,8145,14.53%,14.46%
2020-01-01 00:27:30,13,1,2274,39,2235,3.47%,1.72%
2020-01-01 00:27:30,13,2,2598,42,2556,3.96%,1.62%
2020-01-01 00:27:30,13,3,724,1,723,1.10%,0.14%
2020-01-01 00:27:30,13,4,5495,492,5003,8.38%,8.95%
2020-01-01 00:27:30,13,5,7938,874,7064,12.11%,11.01%
2020-01-01 00:27:30,13,6,6316,565,5751,9.64%,8.95%
2020-01-01 00:27:30,13,7,5420,201,5219,8.27%,3.71%
2020-01-01 00:27:30,13,8,7354,398,6956,11.22%,5.41%
2020-01-01 00:27:30,13,9,8151,917,7234,12.44%,11.25%
2020-01-01 00:27:30,13,10,27964,5806,22158,42.67%,20.76%
2020-01-01 00:27:30,13,11,17639,2495,15144,26.91%,14.14%
2020-01-01 00:27:30,13,12,9886,1012,8874,15.08%,10.24%
2020-01-01 00:27:30,14,1,557,3,554,0.85%,0.54%
2020-01-01 00:27:30,14,2,2065,33,2032,3.15%,1.60%
2020-01-01 00:27:30,14,3,1244,8,1236,1.90%,0.64%
2020-01-01 00:27:30,14,4,4119,120,3999,6.29%,2.91%
2020-01-01 00:27:30,14,5,1703,19,1684,2.60%,1.12%
2020-01-01 00:27:30,14,6,4567,150,4417,6.97%,3.28%
2020-01-01 00:27:30,14,7,11973,1025,10948,18.27%,8.56%
2020-01-01 00:27:30,14,8,13499,1297,12202,20.60%,9.61%
2020-01-01 00:27:30,14,9,1985,27,1958,3.03%,1.36%
2020-01-01 00:27:30,14,10,4791,175,4616,7.31%,3.65%
2020-01-01 00:27:30,14,11,25551,4327,21224,38.99%,16.93%
2020-01-01 00:27:30,14,12,7050,365,6685,10.76%,5.18%
2020-01-01 00:27:30,15,1,440,6,434,0.67%,1.36%
2020-01-01 00:27:30,15,2,135,1,134,0.21%,0.74%
2020-01-01 00:27:30,15,3,3499,80,3419,5.34%,2.29%
2020-01-01 00:27:30,15,4,6417,386,6031,9.79%,6.02%
2020-01-01 00:27:30,15,5,10659,872,9787,16.26%,8.18%
2020-01-01 00:27:30,15,6,6598,400,6198,10.07%,6.06%
2020-01-01 00:27:30,15,7,4132,156,3976,6.30%,3.78%
2020-01-01 00:27:30,15,8,5777,282,5495,8.82%,4.88%
2020-01-01 00:27:30,15,9,10853,897,9956,16.56%,8.26%
2020-01-01 00:27:30,15,10,4086,110,3976,6.23%,2.69%
2020-01-01 00:27:30,15,11,10016,727,9289,15.28%,7.26%
2020-01-01 00:27:30,15,12,26475,4946,21529,40.40%,18.68%
2020-01-01 00:27:30,16,1,424,2,422,0.65%,0.47%
2020-01-01 00:27:30,16,2,298,4,294,0.45%,1.34%
2020-01-01 00:27:30,16,3,1193,23,1170,1.82%,1.93%
2020-01-01 00:27:30,16,4,4386,149,4237,6.69%,3.40%
2020-01-01 00:27:30,16,5,7691,576,7115,11.74%,7.49%
2020-01-01 00:27:30,16,6,5262,209,5053,8.03%,3.97%
2020-01-01 00:27:30,16,7,3211,69,3142,4.90%,2.15%
2020-01-01 00:27:30,16,8,6757,308,6449,10.31%,4.56%
2020-01-01 00:27:30,16,9,8139,622,7517,12.42%,7.64%
2020-01-01 00:27:30,16,10,1437,16,1421,2.19%,1.11%
2020-01-01 00:27:30,16,11,8394,478,7916,12.81%,5.69%
2020-01-01 00:27:30,16,12,25595,4489,21106,39.05%,17.54%
2020-01-01 00:27:40,1,1,18864,2462,16402,28.78%,13.05%
2020-01-01 00:27:40,1,2,7890,441,7449,12.04%,5.59%
2020-01-01 00:27:40,1,3,1277,12,1265,1.95%,0.94%
2020-01-01 00:27:40,1,4,10706,882,9824,16.34%,8.24%
2020-01-01 00:27:40,1,5,10364,823,9541,15.81%,7.94%
2020-01-01 00:27:40,1,6,10274,814,9460,15.68%,7.92%
2020-01-01 00:27:40,1,7,6602,307,6295,10.07%,4.65%
2020-01-01 00:27:40,1,8,5858,246,5612,8.94%,4.20%
2020-01-01 00:27:40,1,9,10244,809,9435,15.63%,7.90%
2020-01-01 00:27:40,1,10,5293,202,5091,8.08%,3.82%
2020-01-01 00:27:40,1,11,5337,204,5133,8.14%,3.82%
2020-01-01 00:27:40,1,12,9766,734,9032,14.90%,7.52%
2020-01-01 00:27:40,2,1,342,0,342,0.52%,0.00%
2020-01-01 00:27:40,2,2,26129,4487,21642,39.87%,17.17%
2020-01-01 00:27:40,2,3,21606,3141,18465,32.97%,14.54%
2020-01-01 00:27:40,2,4,284,0,284,0.43%,0.00%
2020-01-01 00:27:40,2,5,14600,1448,13152,22.28%,9.92%
2020-01-01 00:27:40,2,6,9,0,9,0.01%,0.00%
2020-01-01 00:27:40,2,7,4164,111,4053,6.35%,2.67%
2020-01-01 00:27:40,2,8,3186,61,3125,4.86%,1.91%
2020-01-01 00:27:40,2,9,14440,1423,13017,22.03%,9.85%
2020-01-01 00:27:40,2,10,2513,40,2473,3.83%,1.59%
2020-01-01 00:27:40,2,11,2518,40,2478,3.84%,1.59%
2020-01-01 00:27:40,2,12,14279,1395,12884,21.79%,9.77%
2020-01-01 00:27:40,3,1,1598,13,1585,2.44%,0.81%
2020-01-01 00:27:40,3,2,22440,3507,18933,34.24%,15.63%
2020-01-01 00:27:40,3,3,79958,33756,46202,122.01%,42.22%
2020-01-01 00:27:40,3,4,11818,1020,10798,18.03%,8.63%
2020-01-01 00:27:40,3,5,56632,18705,37927,86.41%,33.03%
2020-01-01 00:27:40,3,6,13256,1271,11985,20.23%,9.59%
2020-01-01 00:27:40,3,7,18874,2565,16309,28.80%,13.59%
2020-01-01 00:27:40,3,8,15450,1747,13703,23.57%,11.31%
2020-01-01 00:27:40,3,9,42886,11387,31499,65.44%,26.55%
2020-01-01 00:27:40,3,10,8640,537,8103,13.18%,6.22%
2020-01-01 00:27:40,3,11,2125,33,2092,3.24%,1.55%
2020-01-01 00:27:40,3,12,31713,6546,25167,48.39%,20.64%
2020-01-01 00:27:40,4,1,393,0,393,0.60%,0.00%
2020-01-01 00:27:40,4,2,226,0,226,0.34%,0.00%
2020-01-01 00:27:40,4,3,1285,11,1274,1.96%,0.86%
2020-01-01 00:27:40,4,4,27333,5020,22313,41.71%,18.37%
2020-01-01 00:27:40,4,5,17539,2179,15360,26.76%,12.42%
2020-01-01 00:27:40,4,6,23854,3910,19944,36.40%,16.39%
2020-01-01 00:27:40,4,7,4816,177,4639,7.35%,3.68%
2020-01-01 00:27:40,4,8,3025,56,2969,4.62%,1.85%
2020-01-01 00:27:40,4,9,15320,1649,13671,23.38%,10.76%
2020-01-01 00:27:40,4,10,1931,22,1909,2.95%,1.14%
2020-01-01 00:27:40,4,11,107,0,107,0.16%,0.00%
2020-01-01 00:27:40,4,12,12666,1176,11490,19.33%,9.28%
2020-01-01 00:27:40,5,1,2719,58,2661,4.15%,2.13%
2020-01-01 00:27:40,5,2,616,2,614,0.94%,0.32%
2020-01-01 00:27:40,5,3,400,0,400,0.61%,0.00%
2020-01-01 00:27:40,5,4,24227,4019,20208,36.97%,16.59%
2020-01-01 00:27:40,5,5,9668,683,8985,14.75%,7.06%
2020-01-01 00:27:40,5,6,15821,1798,14023,24.14%,11.36%
2020-01-01 00:27:40,5,7,5524,253,5271,8.43%,4.58%
2020-01-01 00:27:40,5,8,4141,139,4002,6.32%,3.36%
2020-01-01 00:27:40,5,9,8675,551,8124,13.24%,6.35%
2020-01-01 00:27:40,5,10,771,8,763,1.18%,1.04%
2020-01-01 00:27:40,5,11,909,8,901,1.39%,0.88%
2020-01-01 00:27:40,5,12,7460,409,7051,11.38%,5.48%
2020-01-01 00:27:40,6,1,1137,8,1129,1.73%,0.70%
2020-01-01 00:27:40,6,2,1272,16,1256,1.94%,1.26%
2020-01-01 00:27:40,6,3,2229,43,2186,3.40%,1.93%
2020-01-01 00:27:40,6,4,1421,9,1412,2.17%,0.63%
2020-01-01 00:27:40,6,5,16982,2125,14857,25.91%,12.51%
2020-01-01 00:27:40,6,6,4567,195,4372,6.97%,4.27%
2020-01-01 00:27:40,6,7,2680,64,2616,4.09%,2.39%
2020-01-01 00:27:40,6,8,2066,42,2024,3.15%,2.03%
2020-01-01 00:27:40,6,9,9946,709,9237,15.18%,7.13%
2020-01-01 00:27:40,6,10,2133,30,2103,3.25%,1.41%
2020-01-01 00:27:40,6,11,357,0,357,0.54%,0.00%
2020-01-01 00:27:40,6,12,7725,429,7296,11.79%,5.55%
2020-01-01 00:27:40,7,1,532,1,531,0.81%,0.19%
2020-01-01 00:27:40,7,2,180,1,179,0.27%,0.56%
2020-01-01 00:27:40,7,3,798,3,795,1.22%,0.38%
2020-01-01 00:27:40,7,4,2096,39,2057,3.20%,1.86%
2020-01-01 00:27:40,7,5,6840,345,6495,10.44%,5.04%
2020-01-01 00:27:40,7,6,11946,1042,10904,18.23%,8.72%
2020-01-01 00:27:40,7,7,2959,79,2880,4.52%,2.67%
2020-01-01 00:27:40,7,8,1021,10,1011,1.56%,0.98%
2020-01-01 00:27:40,7,9,6005,260,5745,9.16%,4.33%
2020-01-01 00:27:40,7,10,1150,7,1143,1.75%,0.61%
2020-01-01 00:27:40,7,11,69,0,69,0.11%,0.00%
2020-01-01 00:27:40,7,12,4877,157,4720,7.44%,3.22%
2020-01-01 00:27:40,8,1,430,1,429,0.66%,0.23%
2020-01-01 00:27:40,8,2,96,0,96,0.15%,0.00%
2020-01-01 00:27:40,8,3,1381,9,1372,2.11%,0.65%
2020-01-01 00:27:40,8,4,2731,55,2676,4.17%,2.01%
2020-01-01 00:27:40,8,5,7392,424,6968,11.28%,5.74%
2020-01-01 00:27:40,8,6,15359,1722,13637,23.44%,11.21%
2020-01-01 00:27:40,8,7,5200,203,4997,7.93%,3.90%
2020-01-01 00:27:40,8,8,2059,36,2023,3.14%,1.75%
2020-01-01 00:27:40,8,9,5730,265,5465,8.74%,4.62%
2020-01-01 00:27:40,8,10,1791,31,1760,2.73%,1.73%
2020-01-01 00:27:40,8,11,248,0,248,0.38%,0.00%
2020-01-01 00:27:40,8,12,3844,124,3720,5.87%,3.23%
2020-01-01 00:27:40,9,1,460,2,458,0.70%,0.43%
2020-01-01 00:27:40,9,2,2080,23,2057,3.17%,1.11%
2020-01-01 00:27:40,9,3,1302,9,1293,1.99%,0.69%
2020-01-01 00:27:40,9,4,8140,475,7665,12.42%,5.84%
2020-01-01 00:27:40,9,5,305,1,304,0.47%,0.33%
2020-01-01 00:27:40,9,6,8933,592,8341,13.63%,6.63%
2020-01-01 00:27:40,9,7,26820,4898,21922,40.92%,18.26%
2020-01-01 00:27:40,9,8,9162,634,8528,13.98%,6.92%
2020-01-01 00:27:40,9,9,236,0,236,0.36%,0.00%
2020-01-01 00:27:40,9,10,2842,85,2757,4.34%,2.99%
2020-01-01 00:27:40,9,11,7986,491,7495,12.19%,6.15%
2020-01-01 00:27:40,9,12,4812,185,4627,7.34%,3.84%
2020-01-01 00:27:40,10,1,1055,275,780,1.61%,26.07%
2020-01-01 00:27:40,10,2,2745,325,2420,4.19%,11.84%
2020-01-01 00:27:40,10,3,1457,24,1433,2.22%,1.65%
2020-01-01 00:27:40,10,4,4948,1109,3839,7.55%,22.41%
2020-01-01 00:27:40,10,5,599,7,592,0.91%,1.17%
2020-01-01 00:27:40,10,6,7259,1277,5982,11.08%,17.59%
2020-01-01 00:27:40,10,7,11728,2022,9706,17.90%,17.24%
2020-01-01 00:27:40,10,8,28148,7044,21104,42.95%,25.02%
2020-01-01 00:27:40,10,9,756,4,752,1.15%,0.53%
2020-01-01 00:27:40,10,10,2495,39,2456,3.81%,1.56%
2020-01-01 00:27:40,10,11,12309,1497,10812,18.78%,12.16%
2020-01-01 00:27:40,10,12,9040,1018,8022,13.79%,11.26%
2020-01-01 00:27:40,11,1,2677,68,2609,4.08%,2.54%
2020-01-01 00:27:40,11,2,3883,117,3766,5.92%,3.01%
2020-01-01 00:27:40,11,3,1065,8,1057,1.63%,0.75%
2020-01-01 00:27:40,11,4,3200,67,3133,4.88%,2.09%
2020-01-01 00:27:40,11,5,175,1,174,0.27%,0.57%
2020-01-01 00:27:40,11,6,4029,118,3911,6.15%,2.93%
2020-01-01 00:27:40,11,7,9595,701,8894,14.64%,7.31%
2020-01-01 00:27:40,11,8,27498,5022,22476,41.96%,18.26%
2020-01-01 00:27:40,11,9,303,1,302,0.46%,0.33%
2020-01-01 00:27:40,11,10,3131,67,3064,4.78%,2.14%
2020-01-01 00:27:40,11,11,13812,1351,12461,21.08%,9.78%
2020-01-01 00:27:40,11,12,10297,773,9524,15.71%,7.51%
2020-01-01 00:27:40,12,1,47,0,47,0.07%,0.00%
2020-01-01 00:27:40,12,2,663,240,423,1.01%,36.20%
2020-01-01 00:27:40,12,3,2529,289,2240,3.86%,11.43%
2020-01-01 00:27:40,12,4,3140,73,3067,4.79%,2.32%
2020-01-01 00:27:40,12,5,8848,762,8086,13.50%,8.61%
2020-01-01 00:27:40,12,6,5513,194,5319,8.41%,3.52%
2020-01-01 00:27:40,12,7,2250,38,2212,3.43%,1.69%
2020-01-01 00:27:40,12,8,1228,211,1017,1.87%,17.18%
2020-01-01 00:27:40,12,9,24609,5114,19495,37.55%,20.78%
2020-01-01 00:27:40,12,10,4152,332,3820,6.34%,8.00%
2020-01-01 00:27:40,12,11,1499,221,1278,2.29%,14.74%
2020-01-01 00:27:40,12,12,10010,1330,8680,15.27%,13.29%
2020-01-01 00:27:40,13,1,2395,49,2346,3.65%,2.05%
2020-01-01 00:27:40,13,2,2705,65,2640,4.13%,2.40%
2020-01-01 00:27:40,13,3,661,4,657,1.01%,0.61%
2020-01-01 00:27:40,13,4,4882,481,4401,7.45%,9.85%
2020-01-01 00:27:40,13,5,6951,753,6198,10.61%,10.83%
2020-01-01 00:27:40,13,6,5631,535,5096,8.59%,9.50%
2020-01-01 00:27:40,13,7,5365,213,5152,8.19%,3.97%
2020-01-01 00:27:40,13,8,7486,441,7045,11.42%,5.89%
2020-01-01 00:27:40,13,9,7304,802,6502,11.15%,10.98%
2020-01-01 00:27:40,13,10,26521,5327,21194,40.47%,20.09%
2020-01-01 00:27:40,13,11,16971,2348,14623,25.90%,13.84%
2020-01-01 00:27:40,13,12,9099,941,8158,13.88%,10.34%
2020-01-01 00:27:40,14,1,444,3,441,0.68%,0.68%
2020-01-01 00:27:40,14,2,1747,28,1719,2.67%,1.60%
2020-01-01 00:27:40,14,3,1002,7,995,1.53%,0.70%
2020-01-01 00:27:40,14,4,3584,99,3485,5.47%,2.76%
2020-01-01 00:27:40,14,5,1795,23,1772,2.74%,1.28%
2020-01-01 00:27:40,14,6,4026,124,3902,6.14%,3.08%
2020-01-01 00:27:40,14,7,11571,947,10624,17.66%,8.18%
2020-01-01 00:27:40,14,8,13177,1237,11940,20.11%,9.39%
2020-01-01 00:27:40,14,9,2212,36,2176,3.38%,1.63%
2020-01-01 00:27:40,14,10,4644,143,4501,7.09%,3.08%
2020-01-01 00:27:40,14,11,25159,4189,20970,38.39%,16.65%
2020-01-01 00:27:40,14,12,7129,361,6768,10.88%,5.06%
2020-01-01 00:27:40,15,1,477,5,472,0.73%,1.05%
2020-01-01 00:27:40,15,2,154,0,154,0.23%,0.00%
2020-01-01 00:27:40,15,3,3486,87,3399,5.32%,2.50%
2020-01-01 00:27:40,15,4,4816,196,4620,7.35%,4.07%
2020-01-01 00:27:40,15,5,9388,671,8717,14.32%,7.15%
2020-01-01 00:27:40,15,6,5034,215,4819,7.68%,4.27%
2020-01-01 00:27:40,15,7,3782,108,3674,5.77%,2.86%
2020-01-01 00:27:40,15,8,5496,227,5269,8.39%,4.13%
2020-01-01 00:27:40,15,9,9590,700,8890,14.63%,7.30%
2020-01-01 00:27:40,15,10,4457,164,4293,6.80%,3.68%
2020-01-01 00:27:40,15,11,10085,771,9314,15.39%,7.65%
2020-01-01 00:27:40,15,12,25340,4731,20609,38.67%,18.67%
2020-01-01 00:27:40,16,1,460,4,456,0.70%,0.87%
2020-01-01 00:27:40,16,2,235,0,235,0.36%,0.00%
2020-01-01 00:27:40,16,3,1248,13,1235,1.90%,1.04%
2020-01-01 00:27:40,16,4,3788,177,3611,5.78%,4.67%
2020-01-01 00:27:40,16,5,7210,502,6708,11.00%,6.96%
2020-01-01 00:27:40,16,6,4714,239,4475,7.19%,5.07%
2020-01-01 00:27:40,16,7,3598,103,3495,5.49%,2.86%
2020-01-01 00:27:40,16,8,6798,364,6434,10.37%,5.35%
2020-01-01 00:27:40,16,9,7603,539,7064,11.60%,7.09%
2020-01-01 00:27:40,16,10,1513,23,1490,2.31%,1.52%
2020-01-01 00:27:40,16,11,8497,559,7938,12.97%,6.58%
2020-01-01 00:27:40,16,12,25032,4325,20707,38.20%,17.28%
2020-01-01 00:27:50,1,1,21647,3280,18367,33.03%,15.15%
2020-01-01 00:27:50,1,2,8108,497,7611,12.37%,6.13%
2020-01-01 00:27:50,1,3,379,1,378,0.58%,0.26%
2020-01-01 00:27:50,1,4,13226,1278,11948,20.18%,9.66%
2020-01-01 00:27:50,1,5,12843,1209,11634,19.60%,9.41%
2020-01-01 00:27:50,1,6,12789,1197,11592,19.51%,9.36%
2020-01-01 00:27:50,1,7,7707,454,7253,11.76%,5.89%
2020-01-01 00:27:50,1,8,7050,379,6671,10.76%,5.38%
2020-01-01 00:27:50,1,9,12742,1187,11555,19.44%,9.32%
2020-01-01 00:27:50,1,10,6333,295,6038,9.66%,4.66%
2020-01-01 00:27:50,1,11,6461,308,6153,9.86%,4.77%
2020-01-01 00:27:50,1,12,12510,1132,11378,19.09%,9.05%
2020-01-01 00:27:50,2,1,420,2,418,0.64%,0.48%
2020-01-01 00:27:50,2,2,29278,5712,23566,44.67%,19.51%
2020-01-01 00:27:50,2,3,24380,4064,20316,37.20%,16.67%
2020-01-01 00:27:50,2,4,338,1,337,0.52%,0.30%
2020-01-01 00:27:50,2,5,15065,1639,13426,22.99%,10.88%
2020-01-01 00:27:50,2,6,40,0,40,0.06%,0.00%
2020-01-01 00:27:50,2,7,4464,131,4333,6.81%,2.93%
2020-01-01 00:27:50,2,8,3316,75,3241,5.06%,2.26%
2020-01-01 00:27:50,2,9,14968,1612,13356,22.84%,10.77%
2020-01-01 00:27:50,2,10,2665,53,2612,4.07%,1.99%
2020-01-01 00:27:50,2,11,2674,54,2620,4.08%,2.02%
2020-01-01 00:27:50,2,12,14762,1571,13191,22.53%,10.64%
2020-01-01 00:27:50,3,1,1148,6,1142,1.75%,0.52%
2020-01-01 00:27:50,3,2,22710,3562,19148,34.65%,15.68%
2020-01-01 00:27:50,3,3,73209,29110,44099,111.71%,39.76%
2020-01-01 00:27:50,3,4,10688,886,9802,16.31%,8.29%
2020-01-01 00:27:50,3,5,49320,14727,34593,75.26%,29.86%
2020-01-01 00:27:50,3,6,12010,1096,10914,18.33%,9.13%
2020-01-01 00:27:50,3,7,19823,2759,17064,30.25%,13.92%
2020-01-01 00:27:50,3,8,17014,2052,14962,25.96%,12.06%
2020-01-01 00:27:50,3,9,37011,8793,28218,56.47%,23.76%
2020-01-01 00:27:50,3,10,4611,124,4487,7.04%,2.69%
2020-01-01 00:27:50,3,11,1814,27,1787,2.77%,1.49%
2020-01-01 00:27:50,3,12,29554,5834,23720,45.10%,19.74%
2020-01-01 00:27:50,4,1,468,1,467,0.71%,0.21%
2020-01-01 00:27:50,4,2,265,1,264,0.40%,0.38%
2020-01-01 00:27:50,4,3,909,26,883,1.39%,2.86%
2020-01-01 00:27:50,4,4,27552,5049,22503,42.04%,18.33%
2020-01-01 00:27:50,4,5,17596,2181,15415,26.85%,12.39%
2020-01-01 00:27:50,4,6,24039,3881,20158,36.68%,16.14%
2020-01-01 00:27:50,4,7,4880,186,4694,7.45%,3.81%
2020-01-01 00:27:50,4,8,3075,85,2990,4.69%,2.76%
2020-01-01 00:27:50,4,9,15451,1701,13750,23.58%,11.01%
2020-01-01 00:27:50,4,10,2008,23,1985,3.06%,1.15%
2020-01-01 00:27:50,4,11,178,0,178,0.27%,0.00%
2020-01-01 00:27:50,4,12,12765,1176,11589,19.48%,9.21%
2020-01-01 00:27:50,5,1,2824,51,2773,4.31%,1.81%
2020-01-01 00:27:50,5,2,894,5,889,1.36%,0.56%
2020-01-01 00:27:50,5,3,711,4,707,1.08%,0.56%
2020-01-01 00:27:50,5,4,21597,3202,18395,32.95%,14.83%
2020-01-01 00:27:50,5,5,9793,686,9107,14.94%,7.01%
2020-01-01 00:27:50,5,6,15127,1650,13477,23.08%,10.91%
2020-01-01 00:27:50,5,7,4750,173,4577,7.25%,3.64%
2020-01-01 00:27:50,5,8,3452,91,3361,5.27%,2.64%
2020-01-01 00:27:50,5,9,8921,588,8333,13.61%,6.59%
2020-01-01 00:27:50,5,10,1120,8,1112,1.71%,0.71%
2020-01-01 00:27:50,5,11,683,4,679,1.04%,0.59%
2020-01-01 00:27:50,5,12,7015,374,6641,10.70%,5.33%
2020-01-01 00:27:50,6,1,1009,7,1002,1.54%,0.69%
2020-01-01 00:27:50,6,2,1122,8,1114,1.71%,0.71%
2020-01-01 00:27:50,6,3,2546,45,2501,3.88%,1.77%
2020-01-01 00:27:50,6,4,1175,23,1152,1.79%,1.96%
2020-01-01 00:27:50,6,5,14990,1598,13392,22.87%,10.66%
2020-01-01 00:27:50,6,6,3812,145,3667,5.82%,3.80%
2020-01-01 00:27:50,6,7,2258,54,2204,3.45%,2.39%
2020-01-01 00:27:50,6,8,1691,35,1656,2.58%,2.07%
2020-01-01 00:27:50,6,9,8375,505,7870,12.78%,6.03%
2020-01-01 00:27:50,6,10,2232,39,2193,3.41%,1.75%
2020-01-01 00:27:50,6,11,417,3,414,0.64%,0.72%
2020-01-01 00:27:50,6,12,6081,275,5806,9.28%,4.52%
2020-01-01 00:27:50,7,1,470,2,468,0.72%,0.43%
2020-01-01 00:27:50,7,2,367,0,367,0.56%,0.00%
2020-01-01 00:27:50,7,3,934,5,929,1.43%,0.54%
2020-01-01 00:27:50,7,4,1935,33,1902,2.95%,1.71%
2020-01-01 00:27:50,7,5,6803,307,6496,10.38%,4.51%
2020-01-01 00:27:50,7,6,12407,1056,11351,18.93%,8.51%
2020-01-01 00:27:50,7,7,3641,102,3539,5.56%,2.80%
2020-01-01 00:27:50,7,8,1442,24,1418,2.20%,1.66%
2020-01-01 00:27:50,7,9,5812,230,5582,8.87%,3.96%
2020-01-01 00:27:50,7,10,1292,11,1281,1.97%,0.85%
2020-01-01 00:27:50,7,11,71,0,71,0.11%,0.00%
2020-01-01 00:27:50,7,12,4537,135,4402,6.92%,2.98%
2020-01-01 00:27:50,8,1,370,1,369,0.56%,0.27%
2020-01-01 00:27:50,8,2,97,2,95,0.15%,2.06%
2020-01-01 00:27:50,8,3,1298,7,1291,1.98%,0.54%
2020-01-01 00:27:50,8,4,2759,62,2697,4.21%,2.25%
2020-01-01 00:27:50,8,5,7347,417,6930,11.21%,5.68%
2020-01-01 00:27:50,8,6,16957,2018,14939,25.87%,11.90%
2020-01-01 00:27:50,8,7,6817,338,6479,10.40%,4.96%
2020-01-01 00:27:50,8,8,3679,93,3586,5.61%,2.53%
2020-01-01 00:27:50,8,9,5811,264,5547,8.87%,4.54%
2020-01-01 00:27:50,8,10,1659,16,1643,2.53%,0.96%
2020-01-01 00:27:50,8,11,197,2,195,0.30%,1.02%
2020-01-01 00:27:50,8,12,4108,144,3964,6.27%,3.51%
2020-01-01 00:27:50,9,1,316,0,316,0.48%,0.00%
2020-01-01 00:27:50,9,2,4040,140,3900,6.16%,3.47%
2020-01-01 00:27:50,9,3,3279,104,3175,5.00%,3.17%
2020-01-01 00:27:50,9,4,9505,671,8834,14.50%,7.06%
2020-01-01 00:27:50,9,5,477,0,477,0.73%,0.00%
2020-01-01 00:27:50,9,6,10606,822,9784,16.18%,7.75%
2020-01-01 00:27:50,9,7,29088,5642,23446,44.38%,19.40%
2020-01-01 00:27:50,9,8,8886,577,8309,13.56%,6.49%
2020-01-01 00:27:50,9,9,244,0,244,0.37%,0.00%
2020-01-01 00:27:50,9,10,2105,35,2070,3.21%,1.66%
2020-01-01 00:27:50,9,11,7612,435,7177,11.61%,5.71%
2020-01-01 00:27:50,9,12,5190,222,4968,7.92%,4.28%
2020-01-01 00:27:50,10,1,1133,258,875,1.73%,22.77%
2020-01-01 00:27:50,10,2,3040,318,2722,4.64%,10.46%
2020-01-01 00:27:50,10,3,1680,31,1649,2.56%,1.85%
2020-01-01 00:27:50,10,4,4154,1016,3138,6.34%,24.46%
2020-01-01 00:27:50,10,5,716,30,686,1.09%,4.19%
2020-01-01 00:27:50,10,6,6005,1162,4843,9.16%,19.35%
2020-01-01 00:27:50,10,7,10765,1874,8891,16.43%,17.41%
2020-01-01 00:27:50,10,8,27476,6814,20662,41.93%,24.80%
2020-01-01 00:27:50,10,9,495,3,492,0.76%,0.61%
2020-01-01 00:27:50,10,10,2593,49,2544,3.96%,1.89%
2020-01-01 00:27:50,10,11,12568,1460,11108,19.18%,11.62%
2020-01-01 00:27:50,10,12,9437,1023,8414,14.40%,10.84%
2020-01-01 00:27:50,11,1,2261,47,2214,3.45%,2.08%
2020-01-01 00:27:50,11,2,3399,100,3299,5.19%,2.94%
2020-01-01 00:27:50,11,3,956,8,948,1.46%,0.84%
2020-01-01 00:27:50,11,4,3571,104,3467,5.45%,2.91%
2020-01-01 00:27:50,11,5,751,5,746,1.15%,0.67%
2020-01-01 00:27:50,11,6,5004,213,4791,7.64%,4.26%
2020-01-01 00:27:50,11,7,10116,749,9367,15.44%,7.40%
2020-01-01 00:27:50,11,8,28605,5456,23149,43.65%,19.07%
2020-01-01 00:27:50,11,9,281,0,281,0.43%,0.00%
2020-01-01 00:27:50,11,10,3344,102,3242,5.10%,3.05%
2020-01-01 00:27:50,11,11,14880,1589,13291,22.71%,10.68%
2020-01-01 00:27:50,11,12,11197,907,10290,17.09%,8.10%
2020-01-01 00:27:50,12,1,50,0,50,0.08%,0.00%
2020-01-01 00:27:50,12,2,503,193,310,0.77%,38.37%
2020-01-01 00:27:50,12,3,2471,236,2235,3.77%,9.55%
2020-01-01 00:27:50,12,4,2948,50,2898,4.50%,1.70%
2020-01-01 00:27:50,12,5,8126,623,7503,12.40%,7.67%
2020-01-01 00:27:50,12,6,5009,152,4857,7.64%,3.03%
2020-01-01 00:27:50,12,7,1918,31,1887,2.93%,1.62%
2020-01-01 00:27:50,12,8,961,190,771,1.47%,19.77%
2020-01-01 00:27:50,12,9,21084,3968,17116,32.17%,18.82%
2020-01-01 00:27:50,12,10,3683,288,3395,5.62%,7.82%
2020-01-01 00:27:50,12,11,1150,192,958,1.75%,16.70%
2020-01-01 00:27:50,12,12,7231,1040,6191,11.03%,14.38%
2020-01-01 00:27:50,13,1,1906,39,1867,2.91%,2.05%
2020-01-01 00:27:50,13,2,2270,46,2224,3.46%,2.03%
2020-01-01 00:27:50,13,3,909,3,906,1.39%,0.33%
2020-01-01 00:27:50,13,4,5251,606,4645,8.01%,11.54%
2020-01-01 00:27:50,13,5,8395,996,7399,12.81%,11.86%
2020-01-01 00:27:50,13,6,5871,653,5218,8.96%,11.12%
2020-01-01 00:27:50,13,7,4398,180,4218,6.71%,4.09%
2020-01-01 00:27:50,13,8,6779,378,6401,10.34%,5.58%
2020-01-01 00:27:50,13,9,8705,1027,7678,13.28%,11.80%
2020-01-01 00:27:50,13,10,27797,5631,22166,42.41%,20.26%
2020-01-01 00:27:50,13,11,16706,2253,14453,25.49%,13.49%
2020-01-01 00:27:50,13,12,9512,903,8609,14.51%,9.49%
2020-01-01 00:27:50,14,1,323,2,321,0.49%,0.62%
2020-01-01 00:27:50,14,2,1601,19,1582,2.44%,1.19%
2020-01-01 00:27:50,14,3,1102,4,1098,1.68%,0.36%
2020-01-01 00:27:50,14,4,4111,131,3980,6.27%,3.19%
2020-01-01 00:27:50,14,5,1915,28,1887,2.92%,1.46%
2020-01-01 00:27:50,14,6,4483,164,4319,6.84%,3.66%
2020-01-01 00:27:50,14,7,11437,947,10490,17.45%,8.28%
2020-01-01 00:27:50,14,8,12928,1215,11713,19.73%,9.40%
2020-01-01 00:27:50,14,9,2165,36,2129,3.30%,1.66%
2020-01-01 00:27:50,14,10,4932,182,4750,7.53%,3.69%
2020-01-01 00:27:50,14,11,25162,4220,20942,38.39%,16.77%
2020-01-01 00:27:50,14,12,7005,369,6636,10.69%,5.27%
2020-01-01 00:27:50,15,1,556,11,545,0.85%,1.98%
2020-01-01 00:27:50,15,2,120,0,120,0.18%,0.00%
2020-01-01 00:27:50,15,3,4654,147,4507,7.10%,3.16%
2020-01-01 00:27:50,15,4,4716,194,4522,7.20%,4.11%
2020-01-01 00:27:50,15,5,10934,877,10057,16.68%,8.02%
2020-01-01 00:27:50,15,6,4980,229,4751,7.60%,4.60%
2020-01-01 00:27:50,15,7,3185,74,3111,4.86%,2.32%
2020-01-01 00:27:50,15,8,5451,200,5251,8.32%,3.67%
2020-01-01 00:27:50,15,9,11089,912,10177,16.92%,8.22%
2020-01-01 00:27:50,15,10,5323,238,5085,8.12%,4.47%
2020-01-01 00:27:50,15,11,10920,839,10081,16.66%,7.68%
2020-01-01 00:27:50,15,12,27435,5285,22150,41.86%,19.26%
2020-01-01 00:27:50,16,1,524,2,522,0.80%,0.38%
2020-01-01 00:27:50,16,2,302,1,301,0.46%,0.33%
2020-01-01 00:27:50,16,3,2294,43,2251,3.50%,1.87%
2020-01-01 00:27:50,16,4,3847,85,3762,5.87%,2.21%
2020-01-01 00:27:50,16,5,8339,545,7794,12.72%,6.54%
2020-01-01 00:27:50,16,6,4756,141,4615,7.26%,2.96%
2020-01-01 00:27:50,16,7,3337,66,3271,5.09%,1.98%
2020-01-01 00:27:50,16,8,6741,334,6407,10.29%,4.95%
2020-01-01 00:27:50,16,9,8751,591,8160,13.35%,6.75%
2020-01-01 00:27:50,16,10,1486,14,1472,2.27%,0.94%
2020-01-01 00:27:50,16,11,8418,490,7928,12.84%,5.82%
2020-01-01 00:27:50,16,12,25652,4499,21153,39.14%,17.54%
2020-01-01 00:28:00,1,1,22581,3500,19081,34.46%,15.50%
2020-01-01 00:28:00,1,2,6410,330,6080,9.78%,5.15%
2020-01-01 00:28:00,1,3,511,1,510,0.78%,0.20%
2020-01-01 00:28:00,1,4,15811,1777,14034,24.13%,11.24%
2020-01-01 00:28:00,1,5,15416,1691,13725,23.52%,10.97%
2020-01-01 00:28:00,1,6,15394,1698,13696,23.49%,11.03%
2020-01-01 00:28:00,1,7,5884,282,5602,8.98%,4.79%
2020-01-01 00:28:00,1,8,5122,219,4903,7.82%,4.28%
2020-01-01 00:28:00,1,9,15362,1683,13679,23.44%,10.96%
2020-01-01 00:28:00,1,10,4621,178,4443,7.05%,3.85%
2020-01-01 00:28:00,1,11,4713,186,4527,7.19%,3.95%
2020-01-01 00:28:00,1,12,15340,1680,13660,23.41%,10.95%
2020-01-01 00:28:00,2,1,351,2,349,0.54%,0.57%
2020-01-01 00:28:00,2,2,22364,3369,18995,34.12%,15.06%
2020-01-01 00:28:00,2,3,17170,2040,15130,26.20%,11.88%
2020-01-01 00:28:00,2,4,304,2,302,0.46%,0.66%
2020-01-01 00:28:00,2,5,9955,708,9247,15.19%,7.11%
2020-01-01 00:28:00,2,6,66,0,66,0.10%,0.00%
2020-01-01 00:28:00,2,7,4820,150,4670,7.35%,3.11%
2020-01-01 00:28:00,2,8,3840,102,3738,5.86%,2.66%
2020-01-01 00:28:00,2,9,9889,699,9190,15.09%,7.07%
2020-01-01 00:28:00,2,10,2869,56,2813,4.38%,1.95%
2020-01-01 00:28:00,2,11,2880,57,2823,4.39%,1.98%
2020-01-01 00:28:00,2,12,9737,672,9065,14.86%,6.90%
2020-01-01 00:28:00,3,1,1655,13,1642,2.53%,0.79%
2020-01-01 00:28:00,3,2,25049,4238,20811,38.22%,16.92%
2020-01-01 00:28:00,3,3,69151,26391,42760,105.52%,38.16%
2020-01-01 00:28:00,3,4,6879,379,6500,10.50%,5.51%
2020-01-01 00:28:00,3,5,43118,11545,31573,65.79%,26.78%
2020-01-01 00:28:00,3,6,8394,546,7848,12.81%,6.50%
2020-01-01 00:28:00,3,7,21537,3216,18321,32.86%,14.93%
2020-01-01 00:28:00,3,8,18099,2276,15823,27.62%,12.58%
2020-01-01 00:28:00,3,9,34409,7608,26801,52.50%,22.11%
2020-01-01 00:28:00,3,10,5405,225,5180,8.25%,4.16%
2020-01-01 00:28:00,3,11,1751,18,1733,2.67%,1.03%
2020-01-01 00:28:00,3,12,26484,4726,21758,40.41%,17.84%
2020-01-01 00:28:00,4,1,548,0,548,0.84%,0.00%
2020-01-01 00:28:00,4,2,297,0,297,0.45%,0.00%
2020-01-01 00:28:00,4,3,843,3,840,1.29%,0.36%
2020-01-01 00:28:00,4,4,28890,5471,23419,44.08%,18.94%
2020-01-01 00:28:00,4,5,17277,2094,15183,26.36%,12.12%
2020-01-01 00:28:00,4,6,24606,4105,20501,37.55%,16.68%
2020-01-01 00:28:00,4,7,5787,255,5532,8.83%,4.41%
2020-01-01 00:28:00,4,8,2983,65,2918,4.55%,2.18%
2020-01-01 00:28:00,4,9,15259,1636,13623,23.28%,10.72%
2020-01-01 00:28:00,4,10,1950,25,1925,2.98%,1.28%
2020-01-01 00:28:00,4,11,198,0,198,0.30%,0.00%
2020-01-01 00:28:00,4,12,12597,1120,11477,19.22%,8.89%
2020-01-01 00:28:00,5,1,3043,58,2985,4.64%,1.91%
2020-01-01 00:28:00,5,2,1059,7,1052,1.62%,0.66%
2020-01-01 00:28:00,5,3,402,0,402,0.61%,0.00%
2020-01-01 00:28:00,5,4,23980,3889,20091,36.59%,16.22%
2020-01-01 00:28:00,5,5,9311,624,8687,14.21%,6.70%
2020-01-01 00:28:00,5,6,15507,1712,13795,23.66%,11.04%
2020-01-01 00:28:00,5,7,5688,262,5426,8.68%,4.61%
2020-01-01 00:28:00,5,8,3680,112,3568,5.62%,3.04%
2020-01-01 00:28:00,5,9,8794,567,8227,13.42%,6.45%
2020-01-01 00:28:00,5,10,999,10,989,1.52%,1.00%
2020-01-01 00:28:00,5,11,691,5,686,1.05%,0.72%
2020-01-01 00:28:00,5,12,6965,350,6615,10.63%,5.03%
2020-01-01 00:28:00,6,1,1042,11,1031,1.59%,1.06%
2020-01-01 00:28:00,6,2,1167,13,1154,1.78%,1.11%
2020-01-01 00:28:00,6,3,1953,57,1896,2.98%,2.92%
2020-01-01 00:28:00,6,4,1619,14,1605,2.47%,0.86%
2020-01-01 00:28:00,6,5,13477,1326,12151,20.56%,9.84%
2020-01-01 00:28:00,6,6,4497,153,4344,6.86%,3.40%
2020-01-01 00:28:00,6,7,2546,57,2489,3.88%,2.24%
2020-01-01 00:28:00,6,8,1584,25,1559,2.42%,1.58%
2020-01-01 00:28:00,6,9,6654,350,6304,10.15%,5.26%
2020-01-01 00:28:00,6,10,2033,44,1989,3.10%,2.16%
2020-01-01 00:28:00,6,11,424,2,422,0.65%,0.47%
2020-01-01 00:28:00,6,12,4562,152,4410,6.96%,3.33%
2020-01-01 00:28:00,7,1,528,0,528,0.81%,0.00%
2020-01-01 00:28:00,7,2,202,1,201,0.31%,0.50%
2020-01-01 00:28:00,7,3,820,2,818,1.25%,0.24%
2020-01-01 00:28:00,7,4,2033,29,2004,3.10%,1.43%
2020-01-01 00:28:00,7,5,7096,352,6744,10.83%,4.96%
2020-01-01 00:28:00,7,6,12930,1163,11767,19.73%,8.99%
2020-01-01 00:28:00,7,7,3753,124,3629,5.73%,3.30%
2020-01-01 00:28:00,7,8,1646,18,1628,2.51%,1.09%
2020-01-01 00:28:00,7,9,6225,281,5944,9.50%,4.51%
2020-01-01 00:28:00,7,10,1263,11,1252,1.93%,0.87%
2020-01-01 00:28:00,7,11,64,0,64,0.10%,0.00%
2020-01-01 00:28:00,7,12,4981,190,4791,7.60%,3.81%
2020-01-01 00:28:00,8,1,496,1,495,0.76%,0.20%
2020-01-01 00:28:00,8,2,102,0,102,0.16%,0.00%
2020-01-01 00:28:00,8,3,1573,21,1552,2.40%,1.34%
2020-01-01 00:28:00,8,4,2941,71,2870,4.49%,2.41%
2020-01-01 00:28:00,8,5,8106,494,7612,12.37%,6.09%
2020-01-01 00:28:00,8,6,16613,1916,14697,25.35%,11.53%
2020-01-01 00:28:00,8,7,5544,215,5329,8.46%,3.88%
2020-01-01 00:28:00,8,8,2492,41,2451,3.80%,1.65%
2020-01-01 00:28:00,8,9,6272,295,5977,9.57%,4.70%
2020-01-01 00:28:00,8,10,1732,14,1718,2.64%,0.81%
2020-01-01 00:28:00,8,11,162,1,161,0.25%,0.62%
2020-01-01 00:28:00,8,12,4485,150,4335,6.84%,3.34%
2020-01-01 00:28:00,9,1,345,0,345,0.53%,0.00%
2020-01-01 00:28:00,9,2,3722,91,3631,5.68%,2.44%
2020-01-01 00:28:00,9,3,3025,52,2973,4.62%,1.72%
2020-01-01 00:28:00,9,4,6296,281,6015,9.61%,4.46%
2020-01-01 00:28:00,9,5,639,1,638,0.98%,0.16%
2020-01-01 00:28:00,9,6,7781,429,7352,11.87%,5.51%
2020-01-01 00:28:00,9,7,27541,4987,22554,42.02%,18.11%
2020-01-01 00:28:00,9,8,10903,855,10048,16.64%,7.84%
2020-01-01 00:28:00,9,9,317,1,316,0.48%,0.32%
2020-01-01 00:28:00,9,10,3257,61,3196,4.97%,1.87%
2020-01-01 00:28:00,9,11,9489,637,8852,14.48%,6.71%
2020-01-01 00:28:00,9,12,5882,265,5617,8.98%,4.51%
2020-01-01 00:28:00,10,1,1092,258,834,1.67%,23.63%
2020-01-01 00:28:00,10,2,2790,312,2478,4.26%,11.18%
2020-01-01 00:28:00,10,3,1540,27,1513,2.35%,1.75%
2020-01-01 00:28:00,10,4,4434,874,3560,6.77%,19.71%
2020-01-01 00:28:00,10,5,832,40,792,1.27%,4.81%
2020-01-01 00:28:00,10,6,6578,1065,5513,10.04%,16.19%
2020-01-01 00:28:00,10,7,11498,1867,9631,17.54%,16.24%
2020-01-01 00:28:00,10,8,29707,7448,22259,45.33%,25.07%
2020-01-01 00:28:00,10,9,714,2,712,1.09%,0.28%
2020-01-01 00:28:00,10,10,2652,53,2599,4.05%,2.00%
2020-01-01 00:28:00,10,11,14078,1813,12265,21.48%,12.88%
2020-01-01 00:28:00,10,12,10831,1261,9570,16.53%,11.64%
2020-01-01 00:28:00,11,1,2094,38,2056,3.20%,1.81%
2020-01-01 00:28:00,11,2,3061,89,2972,4.67%,2.91%
2020-01-01 00:28:00,11,3,758,8,750,1.16%,1.06%
2020-01-01 00:28:00,11,4,4959,230,4729,7.57%,4.64%
2020-01-01 00:28:00,11,5,232,5,227,0.35%,2.16%
2020-01-01 00:28:00,11,6,5777,284,5493,8.82%,4.92%
2020-01-01 00:28:00,11,7,10730,863,9867,16.37%,8.04%
2020-01-01 00:28:00,11,8,24760,4149,20611,37.78%,16.76%
2020-01-01 00:28:00,11,9,263,1,262,0.40%,0.38%
2020-01-01 00:28:00,11,10,3143,71,3072,4.80%,2.26%
2020-01-01 00:28:00,11,11,10292,800,9492,15.70%,7.77%
2020-01-01 00:28:00,11,12,6719,351,6368,10.25%,5.22%
2020-01-01 00:28:00,12,1,22,0,22,0.03%,0.00%
2020-01-01 00:28:00,12,2,467,145,322,0.71%,31.05%
2020-01-01 00:28:00,12,3,2177,175,2002,3.32%,8.04%
2020-01-01 00:28:00,12,4,3711,129,3582,5.66%,3.48%
2020-01-01 00:28:00,12,5,8469,710,7759,12.92%,8.38%
2020-01-01 00:28:00,12,6,5595,249,5346,8.54%,4.45%
2020-01-01 00:28:00,12,7,1704,23,1681,2.60%,1.35%
2020-01-01 00:28:00,12,8,1377,274,1103,2.10%,19.90%
2020-01-01 00:28:00,12,9,23226,4598,18628,35.44%,19.80%
2020-01-01 00:28:00,12,10,4485,413,4072,6.84%,9.21%
2020-01-01 00:28:00,12,11,1655,287,1368,2.53%,17.34%
2020-01-01 00:28:00,12,12,8353,1177,7176,12.75%,14.09%
2020-01-01 00:28:00,13,1,1835,17,1818,2.80%,0.93%
2020-01-01 00:28:00,13,2,2243,29,2214,3.42%,1.29%
2020-01-01 00:28:00,13,3,838,6,832,1.28%,0.72%
2020-01-01 00:28:00,13,4,5221,606,4615,7.97%,11.61%
2020-01-01 00:28:00,13,5,8810,1057,7753,13.44%,12.00%
2020-01-01 00:28:00,13,6,5837,645,5192,8.91%,11.05%
2020-01-01 00:28:00,13,7,4783,199,4584,7.30%,4.16%
2020-01-01 00:28:00,13,8,7085,385,6700,10.81%,5.43%
2020-01-01 00:28:00,13,9,9149,1102,8047,13.96%,12.05%
2020-01-01 00:28:00,13,10,28110,5779,22331,42.89%,20.56%
2020-01-01 00:28:00,13,11,16584,2163,14421,25.31%,13.04%
2020-01-01 00:28:00,13,12,9083,840,8243,13.86%,9.25%
2020-01-01 00:28:00,14,1,321,0,321,0.49%,0.00%
2020-01-01 00:28:00,14,2,1213,14,1199,1.85%,1.15%
2020-01-01 00:28:00,14,3,747,6,741,1.14%,0.80%
2020-01-01 00:28:00,14,4,6523,300,6223,9.95%,4.60%
2020-01-01 00:28:00,14,5,1611,16,1595,2.46%,0.99%
2020-01-01 00:28:00,14,6,7006,338,6668,10.69%,4.82%
2020-01-01 00:28:00,14,7,13726,1294,12432,20.94%,9.43%
2020-01-01 00:28:00,14,8,15613,1656,13957,23.82%,10.61%
2020-01-01 00:28:00,14,9,1920,22,1898,2.93%,1.15%
2020-01-01 00:28:00,14,10,4178,117,4061,6.38%,2.80%
2020-01-01 00:28:00,14,11,30685,6117,24568,46.82%,19.93%
2020-01-01 00:28:00,14,12,10599,795,9804,16.17%,7.50%
2020-01-01 00:28:00,15,1,533,2,531,0.81%,0.38%
2020-01-01 00:28:00,15,2,137,0,137,0.21%,0.00%
2020-01-01 00:28:00,15,3,6483,316,6167,9.89%,4.87%
2020-01-01 00:28:00,15,4,4925,215,4710,7.51%,4.37%
2020-01-01 00:28:00,15,5,12271,1146,11125,18.72%,9.34%
2020-01-01 00:28:00,15,6,5198,269,4929,7.93%,5.18%
2020-01-01 00:28:00,15,7,3515,102,3413,5.36%,2.90%
2020-01-01 00:28:00,15,8,5943,280,5663,9.07%,4.71%
2020-01-01 00:28:00,15,9,12501,1183,11318,19.08%,9.46%
2020-01-01 00:28:00,15,10,4611,223,4388,7.04%,4.84%
2020-01-01 00:28:00,15,11,10797,941,9856,16.47%,8.72%
2020-01-01 00:28:00,15,12,28807,5892,22915,43.96%,20.45%
2020-01-01 00:28:00,16,1,554,2,552,0.85%,0.36%
2020-01-01 00:28:00,16,2,240,0,240,0.37%,0.00%
2020-01-01 00:28:00,16,3,1252,11,1241,1.91%,0.88%
2020-01-01 00:28:00,16,4,4044,126,3918,6.17%,3.12%
2020-01-01 00:28:00,16,5,8083,588,7495,12.33%,7.27%
2020-01-01 00:28:00,16,6,4892,190,4702,7.46%,3.88%
2020-01-01 00:28:00,16,7,3533,93,3440,5.39%,2.63%
2020-01-01 00:28:00,16,8,7366,411,6955,11.24%,5.58%
2020-01-01 00:28:00,16,9,8538,643,7895,13.03%,7.53%
2020-01-01 00:28:00,16,10,1710,21,1689,2.61%,1.23%
2020-01-01 00:28:00,16,11,9245,639,8606,14.11%,6.91%
2020-01-01 00:28:00,16,12,27061,5124,21937,41.29%,18.93%
2020-01-01 00:28:10,1,1,26742,4806,21936,40.81%,17.97%
2020-01-01 00:28:10,1,2,8223,497,7726,12.55%,6.04%
2020-01-01 00:28:10,1,3,418,1,417,0.64%,0.24%
2020-01-01 00:28:10,1,4,18235,2310,15925,27.82%,12.67%
2020-01-01 00:28:10,1,5,17921,2220,15701,27.35%,12.39%
2020-01-01 00:28:10,1,6,17866,2213,15653,27.26%,12.39%
2020-01-01 00:28:10,1,7,7788,455,7333,11.88%,5.84%
2020-01-01 00:28:10,1,8,6831,353,6478,10.42%,5.17%
2020-01-01 00:28:10,1,9,17835,2207,15628,27.21%,12.37%
2020-01-01 00:28:10,1,10,6393,311,6082,9.75%,4.86%
2020-01-01 00:28:10,1,11,6452,319,6133,9.84%,4.94%
2020-01-01 00:28:10,1,12,17808,2200,15608,27.17%,12.35%
2020-01-01 00:28:10,2,1,520,0,520,0.79%,0.00%
2020-01-01 00:28:10,2,2,25767,4522,21245,39.32%,17.55%
2020-01-01 00:28:10,2,3,20359,2868,17491,31.07%,14.09%
2020-01-01 00:28:10,2,4,466,0,466,0.71%,0.00%
2020-01-01 00:28:10,2,5,11593,949,10644,17.69%,8.19%
2020-01-01 00:28:10,2,6,55,0,55,0.08%,0.00%
2020-01-01 00:28:10,2,7,4867,193,4674,7.43%,3.97%
2020-01-01 00:28:10,2,8,3864,109,3755,5.90%,2.82%
2020-01-01 00:28:10,2,9,11484,930,10554,17.52%,8.10%
2020-01-01 00:28:10,2,10,2951,65,2886,4.50%,2.20%
2020-01-01 00:28:10,2,11,2963,65,2898,4.52%,2.19%
2020-01-01 00:28:10,2,12,11325,908,10417,17.28%,8.02%
2020-01-01 00:28:10,3,1,1639,14,1625,2.50%,0.85%
2020-01-01 00:28:10,3,2,25558,4411,21147,39.00%,17.26%
2020-01-01 00:28:10,3,3,69034,26339,42695,105.34%,38.15%
2020-01-01 00:28:10,3,4,5400,225,5175,8.24%,4.17%
2020-01-01 00:28:10,3,5,41578,10780,30798,63.44%,25.93%
2020-01-01 00:28:10,3,6,6432,313,6119,9.81%,4.87%
2020-01-01 00:28:10,3,7,21908,3291,18617,33.43%,15.02%
2020-01-01 00:28:10,3,8,16429,1929,14500,25.07%,11.74%
2020-01-01 00:28:10,3,9,34817,7767,27050,53.13%,22.31%
2020-01-01 00:28:10,3,10,6941,333,6608,10.59%,4.80%
2020-01-01 00:28:10,3,11,1980,26,1954,3.02%,1.31%
2020-01-01 00:28:10,3,12,25430,4350,21080,38.80%,17.11%
2020-01-01 00:28:10,4,1,443,1,442,0.68%,0.23%
2020-01-01 00:28:10,4,2,271,0,271,0.41%,0.00%
2020-01-01 00:28:10,4,3,724,4,720,1.10%,0.55%
2020-01-01 00:28:10,4,4,28121,5303,22818,42.91%,18.86%
2020-01-01 00:28:10,4,5,16611,1983,14628,25.35%,11.94%
2020-01-01 00:28:10,4,6,24058,3942,20116,36.71%,16.39%
2020-01-01 00:28:10,4,7,6062,285,5777,9.25%,4.70%
2020-01-01 00:28:10,4,8,2659,48,2611,4.06%,1.81%
2020-01-01 00:28:10,4,9,14836,1585,13251,22.64%,10.68%
2020-01-01 00:28:10,4,10,1917,35,1882,2.93%,1.83%
2020-01-01 00:28:10,4,11,147,0,147,0.22%,0.00%
2020-01-01 00:28:10,4,12,12224,1104,11120,18.65%,9.03%
2020-01-01 00:28:10,5,1,3115,71,3044,4.75%,2.28%
2020-01-01 00:28:10,5,2,936,5,931,1.43%,0.53%
2020-01-01 00:28:10,5,3,449,0,449,0.69%,0.00%
2020-01-01 00:28:10,5,4,27830,5187,22643,42.47%,18.64%
2020-01-01 00:28:10,5,5,10635,865,9770,16.23%,8.13%
2020-01-01 00:28:10,5,6,16372,1868,14504,24.98%,11.41%
2020-01-01 00:28:10,5,7,5229,165,5064,7.98%,3.16%
2020-01-01 00:28:10,5,8,4044,103,3941,6.17%,2.55%
2020-01-01 00:28:10,5,9,10035,773,9262,15.31%,7.70%
2020-01-01 00:28:10,5,10,1033,15,1018,1.58%,1.45%
2020-01-01 00:28:10,5,11,969,7,962,1.48%,0.72%
2020-01-01 00:28:10,5,12,8749,579,8170,13.35%,6.62%
2020-01-01 00:28:10,6,1,1009,8,1001,1.54%,0.79%
2020-01-01 00:28:10,6,2,1143,9,1134,1.74%,0.79%
2020-01-01 00:28:10,6,3,1745,20,1725,2.66%,1.15%
2020-01-01 00:28:10,6,4,1326,12,1314,2.02%,0.90%
2020-01-01 00:28:10,6,5,14349,1459,12890,21.89%,10.17%
2020-01-01 00:28:10,6,6,4141,125,4016,6.32%,3.02%
2020-01-01 00:28:10,6,7,2360,50,2310,3.60%,2.12%
2020-01-01 00:28:10,6,8,1550,26,1524,2.37%,1.68%
2020-01-01 00:28:10,6,9,8054,511,7543,12.29%,6.34%
2020-01-01 00:28:10,6,10,2729,85,2644,4.16%,3.11%
2020-01-01 00:28:10,6,11,463,1,462,0.71%,0.22%
2020-01-01 00:28:10,6,12,5259,195,5064,8.02%,3.71%
2020-01-01 00:28:10,7,1,378,3,375,0.58%,0.79%
2020-01-01 00:28:10,7,2,170,1,169,0.26%,0.59%
2020-01-01 00:28:10,7,3,645,9,636,0.98%,1.40%
2020-01-01 00:28:10,7,4,1355,17,1338,2.07%,1.25%
2020-01-01 00:28:10,7,5,7581,497,7084,11.57%,6.56%
2020-01-01 00:28:10,7,6,12343,1154,11189,18.83%,9.35%
2020-01-01 00:28:10,7,7,3373,86,3287,5.15%,2.55%
2020-01-01 00:28:10,7,8,1247,16,1231,1.90%,1.28%
2020-01-01 00:28:10,7,9,6906,436,6470,10.54%,6.31%
2020-01-01 00:28:10,7,10,1728,19,1709,2.64%,1.10%
2020-01-01 00:28:10,7,11,112,0,112,0.17%,0.00%
2020-01-01 00:28:10,7,12,5257,242,5015,8.02%,4.60%
2020-01-01 00:28:10,8,1,470,1,469,0.72%,0.21%
2020-01-01 00:28:10,8,2,69,0,69,0.11%,0.00%
2020-01-01 00:28:10,8,3,1198,8,1190,1.83%,0.67%
2020-01-01 00:28:10,8,4,2626,46,2580,4.01%,1.75%
2020-01-01 00:28:10,8,5,7473,412,7061,11.40%,5.51%
2020-01-01 00:28:10,8,6,15491,1723,13768,23.64%,11.12%
2020-01-01 00:28:10,8,7,5248,216,5032,8.01%,4.12%
2020-01-01 00:28:10,8,8,2112,34,2078,3.22%,1.61%
2020-01-01 00:28:10,8,9,5884,259,5625,8.98%,4.40%
2020-01-01 00:28:10,8,10,1783,22,1761,2.72%,1.23%
2020-01-01 00:28:10,8,11,275,1,274,0.42%,0.36%
2020-01-01 00:28:10,8,12,4085,127,3958,6.23%,3.11%
2020-01-01 00:28:10,9,1,332,2,330,0.51%,0.60%
2020-01-01 00:28:10,9,2,1870,21,1849,2.85%,1.12%
2020-01-01 00:28:10,9,3,1207,11,1196,1.84%,0.91%
2020-01-01 00:28:10,9,4,7960,484,7476,12.15%,6.08%
2020-01-01 00:28:10,9,5,239,0,239,0.36%,0.00%
2020-01-01 00:28:10,9,6,8919,589,8330,13.61%,6.60%
2020-01-01 00:28:10,9,7,30176,5996,24180,46.04%,19.87%
2020-01-01 00:28:10,9,8,14543,1479,13064,22.19%,10.17%
2020-01-01 00:28:10,9,9,204,0,204,0.31%,0.00%
2020-01-01 00:28:10,9,10,6831,343,6488,10.42%,5.02%
2020-01-01 00:28:10,9,11,11934,1008,10926,18.21%,8.45%
2020-01-01 00:28:10,9,12,4770,167,4603,7.28%,3.50%
2020-01-01 00:28:10,10,1,1215,215,1000,1.85%,17.70%
2020-01-01 00:28:10,10,2,4388,333,4055,6.70%,7.59%
2020-01-01 00:28:10,10,3,2709,60,2649,4.13%,2.21%
2020-01-01 00:28:10,10,4,3974,693,3281,6.06%,17.44%
2020-01-01 00:28:10,10,5,646,5,641,0.99%,0.77%
2020-01-01 00:28:10,10,6,6066,821,5245,9.26%,13.53%
2020-01-01 00:28:10,10,7,12215,1719,10496,18.64%,14.07%
2020-01-01 00:28:10,10,8,29520,7173,22347,45.04%,24.30%
2020-01-01 00:28:10,10,9,684,3,681,1.04%,0.44%
2020-01-01 00:28:10,10,10,2929,65,2864,4.47%,2.22%
2020-01-01 00:28:10,10,11,13827,1773,12054,21.10%,12.82%
2020-01-01 00:28:10,10,12,10205,1192,9013,15.57%,11.68%
2020-01-01 00:28:10,11,1,2277,45,2232,3.47%,1.98%
2020-01-01 00:28:10,11,2,3218,83,3135,4.91%,2.58%
2020-01-01 00:28:10,11,3,799,4,795,1.22%,0.50%
2020-01-01 00:28:10,11,4,4638,163,4475,7.08%,3.51%
2020-01-01 00:28:10,11,5,151,3,148,0.23%,1.99%
2020-01-01 00:28:10,11,6,5444,212,5232,8.31%,3.89%
2020-01-01 00:28:10,11,7,10793,854,9939,16.47%,7.91%
2020-01-01 00:28:10,11,8,23069,3634,19435,35.20%,15.75%
2020-01-01 00:28:10,11,9,205,2,203,0.31%,0.98%
2020-01-01 00:28:10,11,10,2855,62,2793,4.36%,2.17%
2020-01-01 00:28:10,11,11,9181,636,8545,14.01%,6.93%
2020-01-01 00:28:10,11,12,5991,278,5713,9.14%,4.64%
2020-01-01 00:28:10,12,1,41,0,41,0.06%,0.00%
2020-01-01 00:28:10,12,2,510,213,297,0.78%,41.76%
2020-01-01 00:28:10,12,3,2221,243,1978,3.39%,10.94%
2020-01-01 00:28:10,12,4,2644,33,2611,4.03%,1.25%
2020-01-01 00:28:10,12,5,8006,650,7356,12.22%,8.12%
2020-01-01 00:28:10,12,6,5023,199,4824,7.66%,3.96%
2020-01-01 00:28:10,12,7,2273,45,2228,3.47%,1.98%
2020-01-01 00:28:10,12,8,1420,307,1113,2.17%,21.62%
2020-01-01 00:28:10,12,9,22470,4489,17981,34.29%,19.98%
2020-01-01 00:28:10,12,10,4092,413,3679,6.24%,10.09%
2020-01-01 00:28:10,12,11,1666,312,1354,2.54%,18.73%
2020-01-01 00:28:10,12,12,9798,1355,8443,14.95%,13.83%
2020-01-01 00:28:10,13,1,2080,24,2056,3.17%,1.15%
2020-01-01 00:28:10,13,2,2372,37,2335,3.62%,1.56%
2020-01-01 00:28:10,13,3,730,10,720,1.11%,1.37%
2020-01-01 00:28:10,13,4,5324,390,4934,8.12%,7.33%
2020-01-01 00:28:10,13,5,7836,732,7104,11.96%,9.34%
2020-01-01 00:28:10,13,6,6281,463,5818,9.58%,7.37%
2020-01-01 00:28:10,13,7,4742,155,4587,7.24%,3.27%
2020-01-01 00:28:10,13,8,6693,319,6374,10.21%,4.77%
2020-01-01 00:28:10,13,9,8094,768,7326,12.35%,9.49%
2020-01-01 00:28:10,13,10,26499,5135,21364,40.43%,19.38%
2020-01-01 00:28:10,13,11,15597,1986,13611,23.80%,12.73%
2020-01-01 00:28:10,13,12,8312,825,7487,12.68%,9.93%
2020-01-01 00:28:10,14,1,392,1,391,0.60%,0.26%
2020-01-01 00:28:10,14,2,1421,11,1410,2.17%,0.77%
2020-01-01 00:28:10,14,3,915,2,913,1.40%,0.22%
2020-01-01 00:28:10,14,4,4259,131,4128,6.50%,3.08%
2020-01-01 00:28:10,14,5,1541,11,1530,2.35%,0.71%
2020-01-01 00:28:10,14,6,4620,166,4454,7.05%,3.59%
2020-01-01 00:28:10,14,7,11542,954,10588,17.61%,8.27%
2020-01-01 00:28:10,14,8,12982,1197,11785,19.81%,9.22%
2020-01-01 00:28:10,14,9,1753,22,1731,2.67%,1.25%
2020-01-01 00:28:10,14,10,4390,134,4256,6.70%,3.05%
2020-01-01 00:28:10,14,11,25572,4316,21256,39.02%,16.88%
2020-01-01 00:28:10,14,12,8020,474,7546,12.24%,5.91%
2020-01-01 00:28:10,15,1,438,4,434,0.67%,0.91%
2020-01-01 00:28:10,15,2,192,0,192,0.29%,0.00%
2020-01-01 00:28:10,15,3,3377,90,3287,5.15%,2.67%
2020-01-01 00:28:10,15,4,4807,224,4583,7.33%,4.66%
2020-01-01 00:28:10,15,5,9199,673,8526,14.04%,7.32%
2020-01-01 00:28:10,15,6,5041,242,4799,7.69%,4.80%
2020-01-01 00:28:10,15,7,3101,98,3003,4.73%,3.16%
2020-01-01 00:28:10,15,8,5036,229,4807,7.68%,4.55%
2020-01-01 00:28:10,15,9,9500,706,8794,14.50%,7.43%
2020-01-01 00:28:10,15,10,3732,119,3613,5.69%,3.19%
2020-01-01 00:28:10,15,11,8960,620,8340,13.67%,6.92%
2020-01-01 00:28:10,15,12,23734,4225,19509,36.22%,17.80%
2020-01-01 00:28:10,16,1,524,2,522,0.80%,0.38%
2020-01-01 00:28:10,16,2,229,3,226,0.35%,1.31%
2020-01-01 00:28:10,16,3,1490,18,1472,2.27%,1.21%
2020-01-01 00:28:10,16,4,6761,359,6402,10.32%,5.31%
2020-01-01 00:28:10,16,5,11382,1061,10321,17.37%,9.32%
2020-01-01 00:28:10,16,6,7574,454,7120,11.56%,5.99%
2020-01-01 00:28:10,16,7,3454,104,3350,5.27%,3.01%
2020-01-01 00:28:10,16,8,7980,530,7450,12.18%,6.64%
2020-01-01 00:28:10,16,9,11773,1127,10646,17.96%,9.57%
2020-01-01 00:28:10,16,10,1479,18,1461,2.26%,1.22%
2020-01-01 00:28:10,16,11,9612,736,8876,14.67%,7.66%
2020-01-01 00:28:10,16,12,29167,5856,23311,44.51%,20.08%
2020-01-01 00:28:20,1,1,22254,3509,18745,33.96%,15.77%
2020-01-01 00:28:20,1,2,6583,325,6258,10.04%,4.94%
2020-01-01 00:28:20,1,3,552,4,548,0.84%,0.72%
2020-01-01 00:28:20,1,4,15353,1783,13570,23.43%,11.61%
2020-01-01 00:28:20,1,5,14713,1642,13071,22.45%,11.16%
2020-01-01 00:28:20,1,6,14589,1617,12972,22.26%,11.08%
2020-01-01 00:28:20,1,7,6018,282,5736,9.18%,4.69%
2020-01-01 00:28:20,1,8,5055,206,4849,7.71%,4.08%
2020-01-01 00:28:20,1,9,14557,1614,12943,22.21%,11.09%
2020-01-01 00:28:20,1,10,4350,152,4198,6.64%,3.49%
2020-01-01 00:28:20,1,11,4421,160,4261,6.75%,3.62%
2020-01-01 00:28:20,1,12,14526,1602,12924,22.16%,11.03%
2020-01-01 00:28:20,2,1,703,4,699,1.07%,0.57%
2020-01-01 00:28:20,2,2,25490,4363,21127,38.89%,17.12%
2020-01-01 00:28:20,2,3,19722,2671,17051,30.09%,13.54%
2020-01-01 00:28:20,2,4,659,4,655,1.01%,0.61%
2020-01-01 00:28:20,2,5,12595,1162,11433,19.22%,9.23%
2020-01-01 00:28:20,2,6,36,0,36,0.05%,0.00%
2020-01-01 00:28:20,2,7,5042,185,4857,7.69%,3.67%
2020-01-01 00:28:20,2,8,3802,106,3696,5.80%,2.79%
2020-01-01 00:28:20,2,9,12528,1150,11378,19.12%,9.18%
2020-01-01 00:28:20,2,10,2899,60,2839,4.42%,2.07%
2020-01-01 00:28:20,2,11,2906,60,2846,4.43%,2.06%
2020-01-01 00:28:20,2,12,12361,1124,11237,18.86%,9.09%
2020-01-01 00:28:20,3,1,1170,4,1166,1.79%,0.34%
2020-01-01 00:28:20,3,2,21135,3001,18134,32.25%,14.20%
2020-01-01 00:28:20,3,3,73106,29245,43861,111.55%,40.00%
2020-01-01 00:28:20,3,4,13275,1276,11999,20.26%,9.61%
2020-01-01 00:28:20,3,5,50310,15312,34998,76.77%,30.44%
2020-01-01 00:28:20,3,6,14796,1574,13222,22.58%,10.64%
2020-01-01 00:28:20,3,7,18060,2220,15840,27.56%,12.29%
2020-01-01 00:28:20,3,8,14508,1452,13056,22.14%,10.01%
2020-01-01 00:28:20,3,9,35234,8098,27136,53.76%,22.98%
2020-01-01 00:28:20,3,10,8628,563,8065,13.17%,6.53%
2020-01-01 00:28:20,3,11,1566,18,1548,2.39%,1.15%
2020-01-01 00:28:20,3,12,23589,3869,19720,35.99%,16.40%
2020-01-01 00:28:20,4,1,424,0,424,0.65%,0.00%
2020-01-01 00:28:20,4,2,286,0,286,0.44%,0.00%
2020-01-01 00:28:20,4,3,859,5,854,1.31%,0.58%
2020-01-01 00:28:20,4,4,26644,4835,21809,40.66%,18.15%
2020-01-01 00:28:20,4,5,17011,2084,14927,25.96%,12.25%
2020-01-01 00:28:20,4,6,23123,3769,19354,35.28%,16.30%
2020-01-01 00:28:20,4,7,4850,192,4658,7.40%,3.96%
2020-01-01 00:28:20,4,8,2881,71,2810,4.40%,2.46%
2020-01-01 00:28:20,4,9,14957,1640,13317,22.82%,10.96%
2020-01-01 00:28:20,4,10,1996,39,1957,3.05%,1.95%
2020-01-01 00:28:20,4,11,182,1,181,0.28%,0.55%
2020-01-01 00:28:20,4,12,12246,1135,11111,18.69%,9.27%
2020-01-01 00:28:20,5,1,2603,45,2558,3.97%,1.73%
2020-01-01 00:28:20,5,2,990,4,986,1.51%,0.40%
2020-01-01 00:28:20,5,3,3440,63,3377,5.25%,1.83%
2020-01-01 00:28:20,5,4,26267,4675,21592,40.08%,17.80%
2020-01-01 00:28:20,5,5,13206,1238,11968,20.15%,9.37%
2020-01-01 00:28:20,5,6,18803,2500,16303,28.69%,13.30%
2020-01-01 00:28:20,5,7,5086,202,4884,7.76%,3.97%
2020-01-01 00:28:20,5,8,4023,126,3897,6.14%,3.13%
2020-01-01 00:28:20,5,9,9564,702,8862,14.59%,7.34%
2020-01-01 00:28:20,5,10,985,11,974,1.50%,1.12%
2020-01-01 00:28:20,5,11,910,8,902,1.39%,0.88%
2020-01-01 00:28:20,5,12,8148,484,7664,12.43%,5.94%
2020-01-01 00:28:20,6,1,990,7,983,1.51%,0.71%
2020-01-01 00:28:20,6,2,1060,10,1050,1.62%,0.94%
2020-01-01 00:28:20,6,3,1641,21,1620,2.50%,1.28%
2020-01-01 00:28:20,6,4,1295,32,1263,1.98%,2.47%
2020-01-01 00:28:20,6,5,14947,1575,13372,22.81%,10.54%
2020-01-01 00:28:20,6,6,4147,135,4012,6.33%,3.26%
2020-01-01 00:28:20,6,7,2401,38,2363,3.66%,1.58%
2020-01-01 00:28:20,6,8,1692,22,1670,2.58%,1.30%
2020-01-01 00:28:20,6,9,8703,518,8185,13.28%,5.95%
2020-01-01 00:28:20,6,10,2501,41,2460,3.82%,1.64%
2020-01-01 00:28:20,6,11,428,4,424,0.65%,0.93%
2020-01-01 00:28:20,6,12,6111,244,5867,9.32%,3.99%
2020-01-01 00:28:20,7,1,440,3,437,0.67%,0.68%
2020-01-01 00:28:20,7,2,146,0,146,0.22%,0.00%
2020-01-01 00:28:20,7,3,1773,24,1749,2.71%,1.35%
2020-01-01 00:28:20,7,4,1268,10,1258,1.93%,0.79%
2020-01-01 00:28:20,7,5,8620,554,8066,13.15%,6.43%
2020-01-01 00:28:20,7,6,13324,1228,12096,20.33%,9.22%
2020-01-01 00:28:20,7,7,3416,84,3332,5.21%,2.46%
2020-01-01 00:28:20,7,8,1372,11,1361,2.09%,0.80%
2020-01-01 00:28:20,7,9,6713,354,6359,10.24%,5.27%
2020-01-01 00:28:20,7,10,1197,14,1183,1.83%,1.17%
2020-01-01 00:28:20,7,11,110,0,110,0.17%,0.00%
2020-01-01 00:28:20,7,12,5560,262,5298,8.48%,4.71%
2020-01-01 00:28:20,8,1,382,1,381,0.58%,0.26%
2020-01-01 00:28:20,8,2,194,0,194,0.30%,0.00%
2020-01-01 00:28:20,8,3,1413,14,1399,2.16%,0.99%
2020-01-01 00:28:20,8,4,2682,68,2614,4.09%,2.54%
2020-01-01 00:28:20,8,5,7321,435,6886,11.17%,5.94%
2020-01-01 00:28:20,8,6,15596,1759,13837,23.80%,11.28%
2020-01-01 00:28:20,8,7,5535,250,5285,8.45%,4.52%
2020-01-01 00:28:20,8,8,2131,44,2087,3.25%,2.06%
2020-01-01 00:28:20,8,9,5681,288,5393,8.67%,5.07%
2020-01-01 00:28:20,8,10,1511,16,1495,2.31%,1.06%
2020-01-01 00:28:20,8,11,264,1,263,0.40%,0.38%
2020-01-01 00:28:20,8,12,4117,145,3972,6.28%,3.52%
2020-01-01 00:28:20,9,1,630,3,627,0.96%,0.48%
2020-01-01 00:28:20,9,2,1867,22,1845,2.85%,1.18%
2020-01-01 00:28:20,9,3,947,8,939,1.45%,0.84%
2020-01-01 00:28:20,9,4,10512,771,9741,16.04%,7.33%
2020-01-01 00:28:20,9,5,189,0,189,0.29%,0.00%
2020-01-01 00:28:20,9,6,11395,936,10459,17.39%,8.21%
2020-01-01 00:28:20,9,7,31117,6253,24864,47.48%,20.10%
2020-01-01 00:28:20,9,8,10575,749,9826,16.14%,7.08%
2020-01-01 00:28:20,9,9,152,0,152,0.23%,0.00%
2020-01-01 00:28:20,9,10,3452,61,3391,5.27%,1.77%
2020-01-01 00:28:20,9,11,9227,561,8666,14.08%,6.08%
2020-01-01 00:28:20,9,12,5487,214,5273,8.37%,3.90%
2020-01-01 00:28:20,10,1,1303,191,1112,1.99%,14.66%
2020-01-01 00:28:20,10,2,3042,235,2807,4.64%,7.73%
2020-01-01 00:28:20,10,3,1489,13,1476,2.27%,0.87%
2020-01-01 00:28:20,10,4,3697,813,2884,5.64%,21.99%
2020-01-01 00:28:20,10,5,573,5,568,0.87%,0.87%
2020-01-01 00:28:20,10,6,5211,898,4313,7.95%,17.23%
2020-01-01 00:28:20,10,7,10396,1564,8832,15.86%,15.04%
2020-01-01 00:28:20,10,8,28128,6709,21419,42.92%,23.85%
2020-01-01 00:28:20,10,9,585,1,584,0.89%,0.17%
2020-01-01 00:28:20,10,10,2520,46,2474,3.85%,1.83%
2020-01-01 00:28:20,10,11,13901,1721,12180,21.21%,12.38%
2020-01-01 00:28:20,10,12,10597,1167,9430,16.17%,11.01%
2020-01-01 00:28:20,11,1,2483,51,2432,3.79%,2.05%
2020-01-01 00:28:20,11,2,3479,90,3389,5.31%,2.59%
2020-01-01 00:28:20,11,3,880,5,875,1.34%,0.57%
2020-01-01 00:28:20,11,4,5121,226,4895,7.81%,4.41%
2020-01-01 00:28:20,11,5,192,0,192,0.29%,0.00%
2020-01-01 00:28:20,11,6,5851,279,5572,8.93%,4.77%
2020-01-01 00:28:20,11,7,11398,1044,10354,17.39%,9.16%
2020-01-01 00:28:20,11,8,24924,4321,20603,38.03%,17.34%
2020-01-01 00:28:20,11,9,124,0,124,0.19%,0.00%
2020-01-01 00:28:20,11,10,2858,59,2799,4.36%,2.06%
2020-01-01 00:28:20,11,11,10179,746,9433,15.53%,7.33%
2020-01-01 00:28:20,11,12,7020,371,6649,10.71%,5.28%
2020-01-01 00:28:20,12,1,65,0,65,0.10%,0.00%
2020-01-01 00:28:20,12,2,546,222,324,0.83%,40.66%
2020-01-01 00:28:20,12,3,2683,278,2405,4.09%,10.36%
2020-01-01 00:28:20,12,4,2555,56,2499,3.90%,2.19%
2020-01-01 00:28:20,12,5,8370,745,7625,12.77%,8.90%
2020-01-01 00:28:20,12,6,4909,188,4721,7.49%,3.83%
2020-01-01 00:28:20,12,7,2254,39,2215,3.44%,1.73%
2020-01-01 00:28:20,12,8,1111,225,886,1.70%,20.25%
2020-01-01 00:28:20,12,9,21250,4140,17110,32.42%,19.48%
2020-01-01 00:28:20,12,10,3872,327,3545,5.91%,8.45%
2020-01-01 00:28:20,12,11,1223,227,996,1.87%,18.56%
2020-01-01 00:28:20,12,12,7930,1060,6870,12.10%,13.37%
2020-01-01 00:28:20,13,1,2177,33,2144,3.32%,1.52%
2020-01-01 00:28:20,13,2,2548,50,2498,3.89%,1.96%
2020-01-01 00:28:20,13,3,717,5,712,1.09%,0.70%
2020-01-01 00:28:20,13,4,4704,374,4330,7.18%,7.95%
2020-01-01 00:28:20,13,5,6629,596,6033,10.12%,8.99%
2020-01-01 00:28:20,13,6,5273,419,4854,8.05%,7.95%
2020-01-01 00:28:20,13,7,4925,185,4740,7.51%,3.76%
2020-01-01 00:28:20,13,8,7036,375,6661,10.74%,5.33%
2020-01-01 00:28:20,13,9,6970,623,6347,10.64%,8.94%
2020-01-01 00:28:20,13,10,26146,5058,21088,39.90%,19.35%
2020-01-01 00:28:20,13,11,16565,2292,14273,25.28%,13.84%
2020-01-01 00:28:20,13,12,9081,955,8126,13.86%,10.52%
2020-01-01 00:28:20,14,1,251,0,251,0.38%,0.00%
2020-01-01 00:28:20,14,2,1380,19,1361,2.11%,1.38%
2020-01-01 00:28:20,14,3,965,11,954,1.47%,1.14%
2020-01-01 00:28:20,14,4,4244,155,4089,6.48%,3.65%
2020-01-01 00:28:20,14,5,1367,16,1351,2.09%,1.17%
2020-01-01 00:28:20,14,6,4556,174,4382,6.95%,3.82%
2020-01-01 00:28:20,14,7,11734,989,10745,17.90%,8.43%
2020-01-01 00:28:20,14,8,13222,1248,11974,20.18%,9.44%
2020-01-01 00:28:20,14,9,1531,21,1510,2.34%,1.37%
2020-01-01 00:28:20,14,10,4314,149,4165,6.58%,3.45%
2020-01-01 00:28:20,14,11,27733,5186,22547,42.32%,18.70%
2020-01-01 00:28:20,14,12,10018,726,9292,15.29%,7.25%
2020-01-01 00:28:20,15,1,453,1,452,0.69%,0.22%
2020-01-01 00:28:20,15,2,172,0,172,0.26%,0.00%
2020-01-01 00:28:20,15,3,3794,116,3678,5.79%,3.06%
2020-01-01 00:28:20,15,4,5845,266,5579,8.92%,4.55%
2020-01-01 00:28:20,15,5,11297,971,10326,17.24%,8.60%
2020-01-01 00:28:20,15,6,6066,282,5784,9.26%,4.65%
2020-01-01 00:28:20,15,7,3706,102,3604,5.65%,2.75%
2020-01-01 00:28:20,15,8,5637,229,5408,8.60%,4.06%
2020-01-01 00:28:20,15,9,11487,998,10489,17.53%,8.69%
2020-01-01 00:28:20,15,10,5514,239,5275,8.41%,4.33%
2020-01-01 00:28:20,15,11,11237,918,10319,17.15%,8.17%
2020-01-01 00:28:20,15,12,28008,5572,22436,42.74%,19.89%
2020-01-01 00:28:20,16,1,491,2,489,0.75%,0.41%
2020-01-01 00:28:20,16,2,232,2,230,0.35%,0.86%
2020-01-01 00:28:20,16,3,1260,15,1245,1.92%,1.19%
2020-01-01 00:28:20,16,4,4410,126,4284,6.73%,2.86%
2020-01-01 00:28:20,16,5,7853,465,7388,11.98%,5.92%
2020-01-01 00:28:20,16,6,5355,186,5169,8.17%,3.47%
2020-01-01 00:28:20,16,7,3114,88,3026,4.75%,2.83%
2020-01-01 00:28:20,16,8,7176,402,6774,10.95%,5.60%
2020-01-01 00:28:20,16,9,8236,512,7724,12.57%,6.22%
2020-01-01 00:28:20,16,10,1584,21,1563,2.42%,1.33%
2020-01-01 00:28:20,16,11,8915,594,8321,13.60%,6.66%
2020-01-01 00:28:20,16,12,24969,4214,20755,38.10%,16.88%
2020-01-01 00:28:30,1,1,18639,2453,16186,28.44%,13.16%
2020-01-01 00:28:30,1,2,8323,507,7816,12.70%,6.09%
2020-01-01 00:28:30,1,3,898,5,893,1.37%,0.56%
2020-01-01 00:28:30,1,4,9962,788,9174,15.20%,7.91%
2020-01-01 00:28:30,1,5,9543,735,8808,14.56%,7.70%
2020-01-01 00:28:30,1,6,9518,731,8787,14.52%,7.68%
2020-01-01 00:28:30,1,7,7407,409,6998,11.30%,5.52%
2020-01-01 00:28:30,1,8,6488,298,6190,9.90%,4.59%
2020-01-01 00:28:30,1,9,9455,724,8731,14.43%,7.66%
2020-01-01 00:28:30,1,10,5676,232,5444,8.66%,4.09%
2020-01-01 00:28:30,1,11,5768,236,5532,8.80%,4.09%
2020-01-01 00:28:30,1,12,9428,719,8709,14.39%,7.63%
2020-01-01 00:28:30,2,1,1643,23,1620,2.51%,1.40%
2020-01-01 00:28:30,2,2,30379,5928,24451,46.35%,19.51%
2020-01-01 00:28:30,2,3,23787,3745,20042,36.30%,15.74%
2020-01-01 00:28:30,2,4,1543,20,1523,2.35%,1.30%
2020-01-01 00:28:30,2,5,17407,2084,15323,26.56%,11.97%
2020-01-01 00:28:30,2,6,28,0,28,0.04%,0.00%
2020-01-01 00:28:30,2,7,4927,169,4758,7.52%,3.43%
2020-01-01 00:28:30,2,8,3846,105,3741,5.87%,2.73%
2020-01-01 00:28:30,2,9,17290,2064,15226,26.38%,11.94%
2020-01-01 00:28:30,2,10,3071,60,3011,4.69%,1.95%
2020-01-01 00:28:30,2,11,3098,60,3038,4.73%,1.94%
2020-01-01 00:28:30,2,12,17131,2024,15107,26.14%,11.81%
2020-01-01 00:28:30,3,1,1477,14,1463,2.25%,0.95%
2020-01-01 00:28:30,3,2,26726,4844,21882,40.78%,18.12%
2020-01-01 00:28:30,3,3,78543,32783,45760,119.85%,41.74%
2020-01-01 00:28:30,3,4,17528,2110,15418,26.75%,12.04%
2020-01-01 00:28:30,3,5,50797,15369,35428,77.51%,30.26%
2020-01-01 00:28:30,3,6,18559,2342,16217,28.32%,12.62%
2020-01-01 00:28:30,3,7,22995,3640,19355,35.09%,15.83%
2020-01-01 00:28:30,3,8,19954,2780,17174,30.45%,13.93%
2020-01-01 00:28:30,3,9,31847,6621,25226,48.59%,20.79%
2020-01-01 00:28:30,3,10,4423,151,4272,6.75%,3.41%
2020-01-01 00:28:30,3,11,1929,32,1897,2.94%,1.66%
2020-01-01 00:28:30,3,12,24828,4170,20658,37.88%,16.80%
2020-01-01 00:28:30,4,1,491,2,489,0.75%,0.41%
2020-01-01 00:28:30,4,2,332,0,332,0.51%,0.00%
2020-01-01 00:28:30,4,3,1354,11,1343,2.07%,0.81%
2020-01-01 00:28:30,4,4,28156,5279,22877,42.96%,18.75%
2020-01-01 00:28:30,4,5,18258,2358,15900,27.86%,12.91%
2020-01-01 00:28:30,4,6,24553,4076,20477,37.46%,16.60%
2020-01-01 00:28:30,4,7,4880,180,4700,7.45%,3.69%
2020-01-01 00:28:30,4,8,2942,73,2869,4.49%,2.48%
2020-01-01 00:28:30,4,9,15754,1774,13980,24.04%,11.26%
2020-01-01 00:28:30,4,10,1886,26,1860,2.88%,1.38%
2020-01-01 00:28:30,4,11,193,0,193,0.29%,0.00%
2020-01-01 00:28:30,4,12,12894,1216,11678,19.67%,9.43%
2020-01-01 00:28:30,5,1,2470,44,2426,3.77%,1.78%
2020-01-01 00:28:30,5,2,709,6,703,1.08%,0.85%
2020-01-01 00:28:30,5,3,529,4,525,0.81%,0.76%
2020-01-01 00:28:30,5,4,22593,3547,19046,34.47%,15.70%
2020-01-01 00:28:30,5,5,10514,814,9700,16.04%,7.74%
2020-01-01 00:28:30,5,6,15451,1716,13735,23.58%,11.11%
2020-01-01 00:28:30,5,7,4323,160,4163,6.60%,3.70%
2020-01-01 00:28:30,5,8,3505,105,3400,5.35%,3.00%
2020-01-01 00:28:30,5,9,9883,714,9169,15.08%,7.22%
2020-01-01 00:28:30,5,10,1158,12,1146,1.77%,1.04%
2020-01-01 00:28:30,5,11,743,5,738,1.13%,0.67%
2020-01-01 00:28:30,5,12,8441,502,7939,12.88%,5.95%
2020-01-01 00:28:30,6,1,1057,9,1048,1.61%,0.85%
2020-01-01 00:28:30,6,2,1185,10,1175,1.81%,0.84%
2020-01-01 00:28:30,6,3,1645,18,1627,2.51%,1.09%
2020-01-01 00:28:30,6,4,1159,4,1155,1.77%,0.35%
2020-01-01 00:28:30,6,5,14095,1412,12683,21.51%,10.02%
2020-01-01 00:28:30,6,6,3757,93,3664,5.73%,2.48%
2020-01-01 00:28:30,6,7,2136,38,2098,3.26%,1.78%
2020-01-01 00:28:30,6,8,1597,15,1582,2.44%,0.94%
2020-01-01 00:28:30,6,9,8422,524,7898,12.85%,6.22%
2020-01-01 00:28:30,6,10,2001,38,1963,3.05%,1.90%
2020-01-01 00:28:30,6,11,457,3,454,0.70%,0.66%
2020-01-01 00:28:30,6,12,6332,303,6029,9.66%,4.79%
2020-01-01 00:28:30,7,1,354,2,352,0.54%,0.56%
2020-01-01 00:28:30,7,2,193,0,193,0.29%,0.00%
2020-01-01 00:28:30,7,3,1550,14,1536,2.37%,0.90%
2020-01-01 00:28:30,7,4,1837,28,1809,2.80%,1.52%
2020-01-01 00:28:30,7,5,7164,346,6818,10.93%,4.83%
2020-01-01 00:28:30,7,6,12827,1155,11672,19.57%,9.00%
2020-01-01 00:28:30,7,7,3796,111,3685,5.79%,2.92%
2020-01-01 00:28:30,7,8,1613,30,1583,2.46%,1.86%
2020-01-01 00:28:30,7,9,5549,204,5345,8.47%,3.68%
2020-01-01 00:28:30,7,10,946,12,934,1.44%,1.27%
2020-01-01 00:28:30,7,11,63,0,63,0.10%,0.00%
2020-01-01 00:28:30,7,12,4584,149,4435,6.99%,3.25%
2020-01-01 00:28:30,8,1,460,3,457,0.70%,0.65%
2020-01-01 00:28:30,8,2,162,0,162,0.25%,0.00%
2020-01-01 00:28:30,8,3,1453,15,1438,2.22%,1.03%
2020-01-01 00:28:30,8,4,2615,63,2552,3.99%,2.41%
2020-01-01 00:28:30,8,5,7667,404,7263,11.70%,5.27%
2020-01-01 00:28:30,8,6,15920,1739,14181,24.29%,10.92%
2020-01-01 00:28:30,8,7,5569,232,5337,8.50%,4.17%
2020-01-01 00:28:30,8,8,2509,52,2457,3.83%,2.07%
2020-01-01 00:28:30,8,9,6050,251,5799,9.23%,4.15%
2020-01-01 00:28:30,8,10,1718,21,1697,2.62%,1.22%
2020-01-01 00:28:30,8,11,425,0,425,0.65%,0.00%
2020-01-01 00:28:30,8,12,4220,126,4094,6.44%,2.99%
2020-01-01 00:28:30,9,1,454,0,454,0.69%,0.00%
2020-01-01 00:28:30,9,2,2148,28,2120,3.28%,1.30%
2020-01-01 00:28:30,9,3,1189,8,1181,1.81%,0.67%
2020-01-01 00:28:30,9,4,8909,581,8328,13.59%,6.52%
2020-01-01 00:28:30,9,5,171,1,170,0.26%,0.58%
2020-01-01 00:28:30,9,6,9810,699,9111,14.97%,7.13%
2020-01-01 00:28:30,9,7,27567,5100,22467,42.06%,18.50%
2020-01-01 00:28:30,9,8,8484,516,7968,12.95%,6.08%
2020-01-01 00:28:30,9,9,152,1,151,0.23%,0.66%
2020-01-01 00:28:30,9,10,2358,40,2318,3.60%,1.70%
2020-01-01 00:28:30,9,11,7289,396,6893,11.12%,5.43%
2020-01-01 00:28:30,9,12,4667,152,4515,7.12%,3.26%
2020-01-01 00:28:30,10,1,1121,251,870,1.71%,22.39%
2020-01-01 00:28:30,10,2,2800,296,2504,4.27%,10.57%
2020-01-01 00:28:30,10,3,1491,21,1470,2.28%,1.41%
2020-01-01 00:28:30,10,4,3915,988,2927,5.97%,25.24%
2020-01-01 00:28:30,10,5,658,16,642,1.00%,2.43%
2020-01-01 00:28:30,10,6,5794,1140,4654,8.84%,19.68%
2020-01-01 00:28:30,10,7,10574,1872,8702,16.13%,17.70%
2020-01-01 00:28:30,10,8,27783,6826,20957,42.39%,24.57%
2020-01-01 00:28:30,10,9,659,1,658,1.01%,0.15%
2020-01-01 00:28:30,10,10,2216,30,2186,3.38%,1.35%
2020-01-01 00:28:30,10,11,12881,1513,11368,19.65%,11.75%
2020-01-01 00:28:30,10,12,10148,1103,9045,15.48%,10.87%
2020-01-01 00:28:30,11,1,2244,48,2196,3.42%,2.14%
2020-01-01 00:28:30,11,2,3373,106,3267,5.15%,3.14%
2020-01-01 00:28:30,11,3,1011,3,1008,1.54%,0.30%
2020-01-01 00:28:30,11,4,4905,173,4732,7.48%,3.53%
2020-01-01 00:28:30,11,5,267,0,267,0.41%,0.00%
2020-01-01 00:28:30,11,6,5725,240,5485,8.74%,4.19%
2020-01-01 00:28:30,11,7,10835,863,9972,16.53%,7.96%
2020-01-01 00:28:30,11,8,28175,5318,22857,42.99%,18.87%
2020-01-01 00:28:30,11,9,171,0,171,0.26%,0.00%
2020-01-01 00:28:30,11,10,3024,54,2970,4.61%,1.79%
2020-01-01 00:28:30,11,11,13578,1344,12234,20.72%,9.90%
2020-01-01 00:28:30,11,12,10268,789,9479,15.67%,7.68%
2020-01-01 00:28:30,12,1,122,0,122,0.19%,0.00%
2020-01-01 00:28:30,12,2,747,238,509,1.14%,31.86%
2020-01-01 00:28:30,12,3,3085,301,2784,4.71%,9.76%
2020-01-01 00:28:30,12,4,3012,46,2966,4.60%,1.53%
2020-01-01 00:28:30,12,5,9685,831,8854,14.78%,8.58%
2020-01-01 00:28:30,12,6,5360,174,5186,8.18%,3.25%
2020-01-01 00:28:30,12,7,2229,33,2196,3.40%,1.48%
2020-01-01 00:28:30,12,8,1066,217,849,1.63%,20.36%
2020-01-01 00:28:30,12,9,21738,4173,17565,33.17%,19.20%
2020-01-01 00:28:30,12,10,3675,326,3349,5.61%,8.87%
2020-01-01 00:28:30,12,11,1258,225,1033,1.92%,17.89%
2020-01-01 00:28:30,12,12,6783,925,5858,10.35%,13.64%
2020-01-01 00:28:30,13,1,2318,46,2272,3.54%,1.98%
2020-01-01 00:28:30,13,2,2813,61,2752,4.29%,2.17%
2020-01-01 00:28:30,13,3,852,7,845,1.30%,0.82%
2020-01-01 00:28:30,13,4,4587,447,4140,7.00%,9.74%
2020-01-01 00:28:30,13,5,6870,718,6152,10.48%,10.45%
2020-01-01 00:28:30,13,6,5477,513,4964,8.36%,9.37%
2020-01-01 00:28:30,13,7,5660,224,5436,8.64%,3.96%
2020-01-01 00:28:30,13,8,7755,451,7304,11.83%,5.82%
2020-01-01 00:28:30,13,9,7204,745,6459,10.99%,10.34%
2020-01-01 00:28:30,13,10,27327,5522,21805,41.70%,20.21%
2020-01-01 00:28:30,13,11,17542,2516,15026,26.77%,14.34%
2020-01-01 00:28:30,13,12,9295,976,8319,14.18%,10.50%
2020-01-01 00:28:30,14,1,537,3,534,0.82%,0.56%
2020-01-01 00:28:30,14,2,1624,20,1604,2.48%,1.23%
2020-01-01 00:28:30,14,3,866,6,860,1.32%,0.69%
2020-01-01 00:28:30,14,4,5014,183,4831,7.65%,3.65%
2020-01-01 00:28:30,14,5,1250,13,1237,1.91%,1.04%
2020-01-01 00:28:30,14,6,5517,221,5296,8.42%,4.01%
2020-01-01 00:28:30,14,7,12428,1077,11351,18.96%,8.67%
2020-01-01 00:28:30,14,8,13898,1360,12538,21.21%,9.79%
2020-01-01 00:28:30,14,9,1489,17,1472,2.27%,1.14%
2020-01-01 00:28:30,14,10,4628,172,4456,7.06%,3.72%
2020-01-01 00:28:30,14,11,25563,4362,21201,39.01%,17.06%
2020-01-01 00:28:30,14,12,6790,352,6438,10.36%,5.18%
2020-01-01 00:28:30,15,1,458,5,453,0.70%,1.09%
2020-01-01 00:28:30,15,2,175,2,173,0.27%,1.14%
2020-01-01 00:28:30,15,3,3715,110,3605,5.67%,2.96%
2020-01-01 00:28:30,15,4,4508,154,4354,6.88%,3.42%
2020-01-01 00:28:30,15,5,9931,745,9186,15.15%,7.50%
2020-01-01 00:28:30,15,6,4767,174,4593,7.27%,3.65%
2020-01-01 00:28:30,15,7,3636,141,3495,5.55%,3.88%
2020-01-01 00:28:30,15,8,5987,306,5681,9.14%,5.11%
2020-01-01 00:28:30,15,9,10107,769,9338,15.42%,7.61%
2020-01-01 00:28:30,15,10,4130,150,3980,6.30%,3.63%
2020-01-01 00:28:30,15,11,10273,801,9472,15.68%,7.80%
2020-01-01 00:28:30,15,12,26042,4970,21072,39.74%,19.08%
2020-01-01 00:28:30,16,1,422,3,419,0.64%,0.71%
2020-01-01 00:28:30,16,2,268,0,268,0.41%,0.00%
2020-01-01 00:28:30,16,3,1082,18,1064,1.65%,1.66%
2020-01-01 00:28:30,16,4,3563,98,3465,5.44%,2.75%
2020-01-01 00:28:30,16,5,6688,377,6311,10.21%,5.64%
2020-01-01 00:28:30,16,6,4417,141,4276,6.74%,3.19%
2020-01-01 00:28:30,16,7,3418,107,3311,5.22%,3.13%
2020-01-01 00:28:30,16,8,7065,396,6669,10.78%,5.61%
2020-01-01 00:28:30,16,9,7120,414,6706,10.86%,5.81%
2020-01-01 00:28:30,16,10,2037,36,2001,3.11%,1.77%
2020-01-01 00:28:30,16,11,9298,651,8647,14.19%,7.00%
2020-01-01 00:28:30,16,12,24602,4246,20356,37.54%,17.26%
2020-01-01 00:28:40,1,1,19792,2753,17039,30.20%,13.91%
2020-01-01 00:28:40,1,2,7280,414,6866,11.11%,5.69%
2020-01-01 00:28:40,1,3,679,1,678,1.04%,0.15%
2020-01-01 00:28:40,1,4,11963,1132,10831,18.25%,9.46%
2020-01-01 00:28:40,1,5,11670,1072,10598,17.81%,9.19%
2020-01-01 00:28:40,1,6,11604,1066,10538,17.71%,9.19%
2020-01-01 00:28:40,1,7,6583,351,6232,10.04%,5.33%
2020-01-01 00:28:40,1,8,4547,148,4399,6.94%,3.25%
2020-01-01 00:28:40,1,9,11550,1055,10495,17.62%,9.13%
2020-01-01 00:28:40,1,10,3988,116,3872,6.09%,2.91%
2020-01-01 00:28:40,1,11,4061,120,3941,6.20%,2.95%
2020-01-01 00:28:40,1,12,11522,1049,10473,17.58%,9.10%
2020-01-01 00:28:40,2,1,357,0,357,0.54%,0.00%
2020-01-01 00:28:40,2,2,29766,5849,23917,45.42%,19.65%
2020-01-01 00:28:40,2,3,23282,3703,19579,35.53%,15.90%
2020-01-01 00:28:40,2,4,314,0,314,0.48%,0.00%
2020-01-01 00:28:40,2,5,15487,1696,13791,23.63%,10.95%
2020-01-01 00:28:40,2,6,76,0,76,0.12%,0.00%
2020-01-01 00:28:40,2,7,6117,271,5846,9.33%,4.43%
2020-01-01 00:28:40,2,8,3339,81,3258,5.09%,2.43%
2020-01-01 00:28:40,2,9,15423,1682,13741,23.53%,10.91%
2020-01-01 00:28:40,2,10,2564,52,2512,3.91%,2.03%
2020-01-01 00:28:40,2,11,2582,53,2529,3.94%,2.05%
2020-01-01 00:28:40,2,12,15250,1652,13598,23.27%,10.83%
2020-01-01 00:28:40,3,1,1499,15,1484,2.29%,1.00%
2020-01-01 00:28:40,3,2,23962,3969,19993,36.56%,16.56%
2020-01-01 00:28:40,3,3,73122,29206,43916,111.58%,39.94%
2020-01-01 00:28:40,3,4,10206,771,9435,15.57%,7.55%
2020-01-01 00:28:40,3,5,47254,13682,33572,72.10%,28.95%
2020-01-01 00:28:40,3,6,11212,934,10278,17.11%,8.33%
2020-01-01 00:28:40,3,7,20459,2904,17555,31.22%,14.19%
2020-01-01 00:28:40,3,8,16583,1925,14658,25.30%,11.61%
2020-01-01 00:28:40,3,9,35665,8260,27405,54.42%,23.16%
2020-01-01 00:28:40,3,10,6115,289,5826,9.33%,4.73%
2020-01-01 00:28:40,3,11,2289,33,2256,3.49%,1.44%
2020-01-01 00:28:40,3,12,24152,3970,20182,36.85%,16.44%
2020-01-01 00:28:40,4,1,548,4,544,0.84%,0.73%
2020-01-01 00:28:40,4,2,360,1,359,0.55%,0.28%
2020-01-01 00:28:40,4,3,946,0,946,1.44%,0.00%
2020-01-01 00:28:40,4,4,29247,5604,23643,44.63%,19.16%
2020-01-01 00:28:40,4,5,17959,2250,15709,27.40%,12.53%
2020-01-01 00:28:40,4,6,25019,4201,20818,38.18%,16.79%
2020-01-01 00:28:40,4,7,5620,246,5374,8.58%,4.38%
2020-01-01 00:28:40,4,8,3138,75,3063,4.79%,2.39%
2020-01-01 00:28:40,4,9,15984,1785,14199,24.39%,11.17%
2020-01-01 00:28:40,4,10,2148,50,2098,3.28%,2.33%
2020-01-01 00:28:40,4,11,151,0,151,0.23%,0.00%
2020-01-01 00:28:40,4,12,12708,1113,11595,19.39%,8.76%
2020-01-01 00:28:40,5,1,2822,75,2747,4.31%,2.66%
2020-01-01 00:28:40,5,2,695,5,690,1.06%,0.72%
2020-01-01 00:28:40,5,3,1179,14,1165,1.80%,1.19%
2020-01-01 00:28:40,5,4,23619,3884,19735,36.04%,16.44%
2020-01-01 00:28:40,5,5,9347,651,8696,14.26%,6.96%
2020-01-01 00:28:40,5,6,14795,1578,13217,22.58%,10.67%
2020-01-01 00:28:40,5,7,4870,176,4694,7.43%,3.61%
2020-01-01 00:28:40,5,8,4128,130,3998,6.30%,3.15%
2020-01-01 00:28:40,5,9,8042,489,7553,12.27%,6.08%
2020-01-01 00:28:40,5,10,911,7,904,1.39%,0.77%
2020-01-01 00:28:40,5,11,578,7,571,0.88%,1.21%
2020-01-01 00:28:40,5,12,6937,381,6556,10.59%,5.49%
2020-01-01 00:28:40,6,1,1100,10,1090,1.68%,0.91%
2020-01-01 00:28:40,6,2,1172,10,1162,1.79%,0.85%
2020-01-01 00:28:40,6,3,1660,20,1640,2.53%,1.20%
2020-01-01 00:28:40,6,4,1220,12,1208,1.86%,0.98%
2020-01-01 00:28:40,6,5,12766,1150,11616,19.48%,9.01%
2020-01-01 00:28:40,6,6,5203,219,4984,7.94%,4.21%
2020-01-01 00:28:40,6,7,3203,95,3108,4.89%,2.97%
2020-01-01 00:28:40,6,8,2623,64,2559,4.00%,2.44%
2020-01-01 00:28:40,6,9,5713,229,5484,8.72%,4.01%
2020-01-01 00:28:40,6,10,1690,24,1666,2.58%,1.42%
2020-01-01 00:28:40,6,11,405,0,405,0.62%,0.00%
2020-01-01 00:28:40,6,12,3978,97,3881,6.07%,2.44%
2020-01-01 00:28:40,7,1,347,0,347,0.53%,0.00%
2020-01-01 00:28:40,7,2,166,0,166,0.25%,0.00%
2020-01-01 00:28:40,7,3,1697,17,1680,2.59%,1.00%
2020-01-01 00:28:40,7,4,2280,28,2252,3.48%,1.23%
2020-01-01 00:28:40,7,5,8516,552,7964,12.99%,6.48%
2020-01-01 00:28:40,7,6,14613,1485,13128,22.30%,10.16%
2020-01-01 00:28:40,7,7,3747,106,3641,5.72%,2.83%
2020-01-01 00:28:40,7,8,1784,30,1754,2.72%,1.68%
2020-01-01 00:28:40,7,9,6772,397,6375,10.33%,5.86%
2020-01-01 00:28:40,7,10,1623,21,1602,2.48%,1.29%
2020-01-01 00:28:40,7,11,96,0,96,0.15%,0.00%
2020-01-01 00:28:40,7,12,5128,240,4888,7.82%,4.68%
2020-01-01 00:28:40,8,1,508,1,507,0.78%,0.20%
2020-01-01 00:28:40,8,2,95,0,95,0.14%,0.00%
2020-01-01 00:28:40,8,3,1936,26,1910,2.95%,1.34%
2020-01-01 00:28:40,8,4,2881,60,2821,4.40%,2.08%
2020-01-01 00:28:40,8,5,8244,520,7724,12.58%,6.31%
2020-01-01 00:28:40,8,6,16759,2028,14731,25.57%,12.10%
2020-01-01 00:28:40,8,7,5570,231,5339,8.50%,4.15%
2020-01-01 00:28:40,8,8,2277,45,2232,3.47%,1.98%
2020-01-01 00:28:40,8,9,6038,294,5744,9.21%,4.87%
2020-01-01 00:28:40,8,10,1676,21,1655,2.56%,1.25%
2020-01-01 00:28:40,8,11,298,0,298,0.45%,0.00%
2020-01-01 00:28:40,8,12,4380,169,4211,6.68%,3.86%
2020-01-01 00:28:40,9,1,663,1,662,1.01%,0.15%
2020-01-01 00:28:40,9,2,4232,126,4106,6.46%,2.98%
2020-01-01 00:28:40,9,3,2954,68,2886,4.51%,2.30%
2020-01-01 00:28:40,9,4,6193,279,5914,9.45%,4.51%
2020-01-01 00:28:40,9,5,194,0,194,0.30%,0.00%
2020-01-01 00:28:40,9,6,7491,428,7063,11.43%,5.71%
2020-01-01 00:28:40,9,7,30251,6114,24137,46.16%,20.21%
2020-01-01 00:28:40,9,8,10131,784,9347,15.46%,7.74%
2020-01-01 00:28:40,9,9,143,0,143,0.22%,0.00%
2020-01-01 00:28:40,9,10,4272,129,4143,6.52%,3.02%
2020-01-01 00:28:40,9,11,9188,642,8546,14.02%,6.99%
2020-01-01 00:28:40,9,12,4634,163,4471,7.07%,3.52%
2020-01-01 00:28:40,10,1,1152,232,920,1.76%,20.14%
2020-01-01 00:28:40,10,2,2884,275,2609,4.40%,9.54%
2020-01-01 00:28:40,10,3,1609,13,1596,2.46%,0.81%
2020-01-01 00:28:40,10,4,4537,1042,3495,6.92%,22.97%
2020-01-01 00:28:40,10,5,833,65,768,1.27%,7.80%
2020-01-01 00:28:40,10,6,6708,1244,5464,10.24%,18.55%
2020-01-01 00:28:40,10,7,11673,2020,9653,17.81%,17.30%
2020-01-01 00:28:40,10,8,29206,7355,21851,44.56%,25.18%
2020-01-01 00:28:40,10,9,900,3,897,1.37%,0.33%
2020-01-01 00:28:40,10,10,2661,53,2608,4.06%,1.99%
2020-01-01 00:28:40,10,11,13165,1589,11576,20.09%,12.07%
2020-01-01 00:28:40,10,12,9723,1046,8677,14.84%,10.76%
2020-01-01 00:28:40,11,1,2187,36,2151,3.34%,1.65%
2020-01-01 00:28:40,11,2,3047,78,2969,4.65%,2.56%
2020-01-01 00:28:40,11,3,727,10,717,1.11%,1.38%
2020-01-01 00:28:40,11,4,4069,141,3928,6.21%,3.47%
2020-01-01 00:28:40,11,5,275,0,275,0.42%,0.00%
2020-01-01 00:28:40,11,6,5047,204,4843,7.70%,4.04%
2020-01-01 00:28:40,11,7,9600,717,8883,14.65%,7.47%
2020-01-01 00:28:40,11,8,24864,4179,20685,37.94%,16.81%
2020-01-01 00:28:40,11,9,336,2,334,0.51%,0.60%
2020-01-01 00:28:40,11,10,3181,83,3098,4.85%,2.61%
2020-01-01 00:28:40,11,11,11340,943,10397,17.30%,8.32%
2020-01-01 00:28:40,11,12,7499,436,7063,11.44%,5.81%
2020-01-01 00:28:40,12,1,44,0,44,0.07%,0.00%
2020-01-01 00:28:40,12,2,611,152,459,0.93%,24.88%
2020-01-01 00:28:40,12,3,2737,198,2539,4.18%,7.23%
2020-01-01 00:28:40,12,4,2697,42,2655,4.12%,1.56%
2020-01-01 00:28:40,12,5,9559,779,8780,14.59%,8.15%
2020-01-01 00:28:40,12,6,5118,156,4962,7.81%,3.05%
2020-01-01 00:28:40,12,7,2245,31,2214,3.43%,1.38%
2020-01-01 00:28:40,12,8,1335,297,1038,2.04%,22.25%
2020-01-01 00:28:40,12,9,22257,4108,18149,33.96%,18.46%
2020-01-01 00:28:40,12,10,4445,416,4029,6.78%,9.36%
2020-01-01 00:28:40,12,11,1563,299,1264,2.38%,19.13%
2020-01-01 00:28:40,12,12,7665,929,6736,11.70%,12.12%
2020-01-01 00:28:40,13,1,2370,49,2321,3.62%,2.07%
2020-01-01 00:28:40,13,2,2840,62,2778,4.33%,2.18%
2020-01-01 00:28:40,13,3,867,6,861,1.32%,0.69%
2020-01-01 00:28:40,13,4,4995,450,4545,7.62%,9.01%
2020-01-01 00:28:40,13,5,7600,797,6803,11.60%,10.49%
2020-01-01 00:28:40,13,6,5911,528,5383,9.02%,8.93%
2020-01-01 00:28:40,13,7,4993,195,4798,7.62%,3.91%
2020-01-01 00:28:40,13,8,7818,473,7345,11.93%,6.05%
2020-01-01 00:28:40,13,9,7887,827,7060,12.03%,10.49%
2020-01-01 00:28:40,13,10,26986,5517,21469,41.18%,20.44%
2020-01-01 00:28:40,13,11,16413,2342,14071,25.04%,14.27%
2020-01-01 00:28:40,13,12,8232,955,7277,12.56%,11.60%
2020-01-01 00:28:40,14,1,770,7,763,1.17%,0.91%
2020-01-01 00:28:40,14,2,1833,29,1804,2.80%,1.58%
2020-01-01 00:28:40,14,3,820,5,815,1.25%,0.61%
2020-01-01 00:28:40,14,4,3745,111,3634,5.71%,2.96%
2020-01-01 00:28:40,14,5,1198,14,1184,1.83%,1.17%
2020-01-01 00:28:40,14,6,4107,136,3971,6.27%,3.31%
2020-01-01 00:28:40,14,7,11862,1043,10819,18.10%,8.79%
2020-01-01 00:28:40,14,8,13556,1346,12210,20.68%,9.93%
2020-01-01 00:28:40,14,9,1341,21,1320,2.05%,1.57%
2020-01-01 00:28:40,14,10,3802,119,3683,5.80%,3.13%
2020-01-01 00:28:40,14,11,25127,4234,20893,38.34%,16.85%
2020-01-01 00:28:40,14,12,7510,413,7097,11.46%,5.50%
2020-01-01 00:28:40,15,1,566,5,561,0.86%,0.88%
2020-01-01 00:28:40,15,2,106,0,106,0.16%,0.00%
2020-01-01 00:28:40,15,3,3763,101,3662,5.74%,2.68%
2020-01-01 00:28:40,15,4,5323,252,5071,8.12%,4.73%
2020-01-01 00:28:40,15,5,9808,755,9053,14.97%,7.70%
2020-01-01 00:28:40,15,6,5617,275,5342,8.57%,4.90%
2020-01-01 00:28:40,15,7,3528,93,3435,5.38%,2.64%
2020-01-01 00:28:40,15,8,5570,246,5324,8.50%,4.42%
2020-01-01 00:28:40,15,9,9987,776,9211,15.24%,7.77%
2020-01-01 00:28:40,15,10,4439,188,4251,6.77%,4.24%
2020-01-01 00:28:40,15,11,10132,810,9322,15.46%,7.99%
2020-01-01 00:28:40,15,12,26165,5025,21140,39.92%,19.21%
2020-01-01 00:28:40,16,1,490,1,489,0.75%,0.20%
2020-01-01 00:28:40,16,2,357,1,356,0.54%,0.28%
2020-01-01 00:28:40,16,3,1230,9,1221,1.88%,0.73%
2020-01-01 00:28:40,16,4,3727,95,3632,5.69%,2.55%
2020-01-01 00:28:40,16,5,6868,393,6475,10.48%,5.72%
2020-01-01 00:28:40,16,6,4581,155,4426,6.99%,3.38%
2020-01-01 00:28:40,16,7,3287,92,3195,5.02%,2.80%
2020-01-01 00:28:40,16,8,7784,591,7193,11.88%,7.59%
2020-01-01 00:28:40,16,9,7276,434,6842,11.10%,5.96%
2020-01-01 00:28:40,16,10,2282,40,2242,3.48%,1.75%
2020-01-01 00:28:40,16,11,10472,901,9571,15.98%,8.60%
2020-01-01 00:28:40,16,12,25370,4380,20990,38.71%,17.26%
2020-01-01 00:28:50,1,1,20821,3041,17780,31.77%,14.61%
2020-01-01 00:28:50,1,2,8504,539,7965,12.98%,6.34%
2020-01-01 00:28:50,1,3,662,6,656,1.01%,0.91%
2020-01-01 00:28:50,1,4,11787,1050,10737,17.99%,8.91%
2020-01-01 00:28:50,1,5,11558,1025,10533,17.64%,8.87%
2020-01-01 00:28:50,1,6,11455,994,10461,17.48%,8.68%
2020-01-01 00:28:50,1,7,7821,455,7366,11.93%,5.82%
2020-01-01 00:28:50,1,8,5618,251,5367,8.57%,4.47%
2020-01-01 00:28:50,1,9,11398,988,10410,17.39%,8.67%
2020-01-01 00:28:50,1,10,4988,196,4792,7.61%,3.93%
2020-01-01 00:28:50,1,11,5075,199,4876,7.74%,3.92%
2020-01-01 00:28:50,1,12,11372,983,10389,17.35%,8.64%
2020-01-01 00:28:50,2,1,741,5,736,1.13%,0.67%
2020-01-01 00:28:50,2,2,28913,5546,23367,44.12%,19.18%
2020-01-01 00:28:50,2,3,23597,3791,19806,36.01%,16.07%
2020-01-01 00:28:50,2,4,633,4,629,0.97%,0.63%
2020-01-01 00:28:50,2,5,14100,1434,12666,21.51%,10.17%
2020-01-01 00:28:50,2,6,59,0,59,0.09%,0.00%
2020-01-01 00:28:50,2,7,4562,166,4396,6.96%,3.64%
2020-01-01 00:28:50,2,8,2437,48,2389,3.72%,1.97%
2020-01-01 00:28:50,2,9,14023,1417,12606,21.40%,10.10%
2020-01-01 00:28:50,2,10,1625,27,1598,2.48%,1.66%
2020-01-01 00:28:50,2,11,1652,27,1625,2.52%,1.63%
2020-01-01 00:28:50,2,12,13783,1366,12417,21.03%,9.91%
2020-01-01 00:28:50,3,1,1478,13,1465,2.26%,0.88%
2020-01-01 00:28:50,3,2,24878,4163,20715,37.96%,16.73%
2020-01-01 00:28:50,3,3,75234,30573,44661,114.80%,40.64%
2020-01-01 00:28:50,3,4,11971,984,10987,18.27%,8.22%
2020-01-01 00:28:50,3,5,49170,14587,34583,75.03%,29.67%
2020-01-01 00:28:50,3,6,13855,1303,12552,21.14%,9.40%
2020-01-01 00:28:50,3,7,21636,3225,18411,33.01%,14.91%
2020-01-01 00:28:50,3,8,18871,2480,16391,28.79%,13.14%
2020-01-01 00:28:50,3,9,34977,7909,27068,53.37%,22.61%
2020-01-01 00:28:50,3,10,7100,382,6718,10.83%,5.38%
2020-01-01 00:28:50,3,11,2344,41,2303,3.58%,1.75%
2020-01-01 00:28:50,3,12,23676,3815,19861,36.13%,16.11%
2020-01-01 00:28:50,4,1,576,0,576,0.88%,0.00%
2020-01-01 00:28:50,4,2,388,0,388,0.59%,0.00%
2020-01-01 00:28:50,4,3,1107,12,1095,1.69%,1.08%
2020-01-01 00:28:50,4,4,28200,5327,22873,43.03%,18.89%
2020-01-01 00:28:50,4,5,17587,2188,15399,26.84%,12.44%
2020-01-01 00:28:50,4,6,24149,3972,20177,36.85%,16.45%
2020-01-01 00:28:50,4,7,5161,203,4958,7.88%,3.93%
2020-01-01 00:28:50,4,8,2998,69,2929,4.57%,2.30%
2020-01-01 00:28:50,4,9,14978,1630,13348,22.85%,10.88%
2020-01-01 00:28:50,4,10,1914,38,1876,2.92%,1.99%
2020-01-01 00:28:50,4,11,224,0,224,0.34%,0.00%
2020-01-01 00:28:50,4,12,12355,1117,11238,18.85%,9.04%
2020-01-01 00:28:50,5,1,2898,66,2832,4.42%,2.28%
2020-01-01 00:28:50,5,2,634,2,632,0.97%,0.32%
2020-01-01 00:28:50,5,3,495,2,493,0.76%,0.40%
2020-01-01 00:28:50,5,4,21544,3213,18331,32.87%,14.91%
2020-01-01 00:28:50,5,5,8917,611,8306,13.61%,6.85%
2020-01-01 00:28:50,5,6,12859,1217,11642,19.62%,9.46%
2020-01-01 00:28:50,5,7,3545,87,3458,5.41%,2.45%
2020-01-01 00:28:50,5,8,2834,54,2780,4.32%,1.91%
2020-01-01 00:28:50,5,9,8229,533,7696,12.56%,6.48%
2020-01-01 00:28:50,5,10,834,4,830,1.27%,0.48%
2020-01-01 00:28:50,5,11,480,8,472,0.73%,1.67%
2020-01-01 00:28:50,5,12,7143,421,6722,10.90%,5.89%
2020-01-01 00:28:50,6,1,1145,16,1129,1.75%,1.40%
2020-01-01 00:28:50,6,2,1225,17,1208,1.87%,1.39%
2020-01-01 00:28:50,6,3,1736,29,1707,2.65%,1.67%
2020-01-01 00:28:50,6,4,1238,4,1234,1.89%,0.32%
2020-01-01 00:28:50,6,5,13054,1261,11793,19.92%,9.66%
2020-01-01 00:28:50,6,6,4170,135,4035,6.36%,3.24%
2020-01-01 00:28:50,6,7,2382,57,2325,3.63%,2.39%
2020-01-01 00:28:50,6,8,1623,40,1583,2.48%,2.46%
2020-01-01 00:28:50,6,9,6860,374,6486,10.47%,5.45%
2020-01-01 00:28:50,6,10,2025,38,1987,3.09%,1.88%
2020-01-01 00:28:50,6,11,466,2,464,0.71%,0.43%
2020-01-01 00:28:50,6,12,4803,176,4627,7.33%,3.66%
2020-01-01 00:28:50,7,1,443,2,441,0.68%,0.45%
2020-01-01 00:28:50,7,2,260,0,260,0.40%,0.00%
2020-01-01 00:28:50,7,3,789,18,771,1.20%,2.28%
2020-01-01 00:28:50,7,4,2421,46,2375,3.69%,1.90%
2020-01-01 00:28:50,7,5,7836,433,7403,11.96%,5.53%
2020-01-01 00:28:50,7,6,13857,1351,12506,21.14%,9.75%
2020-01-01 00:28:50,7,7,3565,94,3471,5.44%,2.64%
2020-01-01 00:28:50,7,8,1648,16,1632,2.51%,0.97%
2020-01-01 00:28:50,7,9,6974,326,6648,10.64%,4.67%
2020-01-01 00:28:50,7,10,1592,22,1570,2.43%,1.38%
2020-01-01 00:28:50,7,11,102,0,102,0.16%,0.00%
2020-01-01 00:28:50,7,12,5341,169,5172,8.15%,3.16%
2020-01-01 00:28:50,8,1,674,1,673,1.03%,0.15%
2020-01-01 00:28:50,8,2,119,0,119,0.18%,0.00%
2020-01-01 00:28:50,8,3,2325,36,2289,3.55%,1.55%
2020-01-01 00:28:50,8,4,2709,53,2656,4.13%,1.96%
2020-01-01 00:28:50,8,5,8930,613,8317,13.63%,6.86%
2020-01-01 00:28:50,8,6,16441,1993,14448,25.09%,12.12%
2020-01-01 00:28:50,8,7,4706,194,4512,7.18%,4.12%
2020-01-01 00:28:50,8,8,1839,34,1805,2.81%,1.85%
2020-01-01 00:28:50,8,9,6144,279,5865,9.38%,4.54%
2020-01-01 00:28:50,8,10,1570,22,1548,2.40%,1.40%
2020-01-01 00:28:50,8,11,188,0,188,0.29%,0.00%
2020-01-01 00:28:50,8,12,4600,158,4442,7.02%,3.43%
2020-01-01 00:28:50,9,1,1300,7,1293,1.98%,0.54%
2020-01-01 00:28:50,9,2,3998,146,3852,6.10%,3.65%
2020-01-01 00:28:50,9,3,2303,38,2265,3.51%,1.65%
2020-01-01 00:28:50,9,4,3734,100,3634,5.70%,2.68%
2020-01-01 00:28:50,9,5,691,3,688,1.05%,0.43%
2020-01-01 00:28:50,9,6,5240,196,5044,8.00%,3.74%
2020-01-01 00:28:50,9,7,31234,6351,24883,47.66%,20.33%
2020-01-01 00:28:50,9,8,14731,1508,13223,22.48%,10.24%
2020-01-01 00:28:50,9,9,229,0,229,0.35%,0.00%
2020-01-01 00:28:50,9,10,4630,164,4466,7.06%,3.54%
2020-01-01 00:28:50,9,11,13733,1311,12422,20.95%,9.55%
2020-01-01 00:28:50,9,12,8757,538,8219,13.36%,6.14%
2020-01-01 00:28:50,10,1,1479,283,1196,2.26%,19.13%
2020-01-01 00:28:50,10,2,3277,338,2939,5.00%,10.31%
2020-01-01 00:28:50,10,3,1693,18,1675,2.58%,1.06%
2020-01-01 00:28:50,10,4,3684,921,2763,5.62%,25.00%
2020-01-01 00:28:50,10,5,1023,119,904,1.56%,11.63%
2020-01-01 00:28:50,10,6,6054,1160,4894,9.24%,19.16%
2020-01-01 00:28:50,10,7,10651,1926,8725,16.25%,18.08%
2020-01-01 00:28:50,10,8,29808,7771,22037,45.48%,26.07%
2020-01-01 00:28:50,10,9,460,3,457,0.70%,0.65%
2020-01-01 00:28:50,10,10,2842,60,2782,4.34%,2.11%
2020-01-01 00:28:50,10,11,14702,1839,12863,22.43%,12.51%
2020-01-01 00:28:50,10,12,11211,1214,9997,17.11%,10.83%
2020-01-01 00:28:50,11,1,2513,44,2469,3.83%,1.75%
2020-01-01 00:28:50,11,2,3316,84,3232,5.06%,2.53%
2020-01-01 00:28:50,11,3,626,5,621,0.96%,0.80%
2020-01-01 00:28:50,11,4,4877,200,4677,7.44%,4.10%
2020-01-01 00:28:50,11,5,214,0,214,0.33%,0.00%
2020-01-01 00:28:50,11,6,5706,264,5442,8.71%,4.63%
2020-01-01 00:28:50,11,7,10592,800,9792,16.16%,7.55%
2020-01-01 00:28:50,11,8,25736,4464,21272,39.27%,17.35%
2020-01-01 00:28:50,11,9,266,1,265,0.41%,0.38%
2020-01-01 00:28:50,11,10,3005,72,2933,4.59%,2.40%
2020-01-01 00:28:50,11,11,10692,818,9874,16.31%,7.65%
2020-01-01 00:28:50,11,12,7222,400,6822,11.02%,5.54%
2020-01-01 00:28:50,12,1,101,1,100,0.15%,0.99%
2020-01-01 00:28:50,12,2,532,115,417,0.81%,21.62%
2020-01-01 00:28:50,12,3,3191,192,2999,4.87%,6.02%
2020-01-01 00:28:50,12,4,3203,81,3122,4.89%,2.53%
2020-01-01 00:28:50,12,5,10480,857,9623,15.99%,8.18%
2020-01-01 00:28:50,12,6,5434,192,5242,8.29%,3.53%
2020-01-01 00:28:50,12,7,2128,28,2100,3.25%,1.32%
2020-01-01 00:28:50,12,8,1536,327,1209,2.34%,21.29%
2020-01-01 00:28:50,12,9,22438,4330,18108,34.24%,19.30%
2020-01-01 00:28:50,12,10,4461,489,3972,6.81%,10.96%
2020-01-01 00:28:50,12,11,1758,331,1427,2.68%,18.83%
2020-01-01 00:28:50,12,12,7056,1054,6002,10.77%,14.94%
2020-01-01 00:28:50,13,1,2116,41,2075,3.23%,1.94%
2020-01-01 00:28:50,13,2,2394,48,2346,3.65%,2.01%
2020-01-01 00:28:50,13,3,1013,4,1009,1.55%,0.39%
2020-01-01 00:28:50,13,4,5305,671,4634,8.09%,12.65%
2020-01-01 00:28:50,13,5,7725,986,6739,11.79%,12.76%
2020-01-01 00:28:50,13,6,5801,715,5086,8.85%,12.33%
2020-01-01 00:28:50,13,7,4279,146,4133,6.53%,3.41%
2020-01-01 00:28:50,13,8,7562,420,7142,11.54%,5.55%
2020-01-01 00:28:50,13,9,8053,1009,7044,12.29%,12.53%
2020-01-01 00:28:50,13,10,28404,5901,22503,43.34%,20.78%
2020-01-01 00:28:50,13,11,17188,2376,14812,26.23%,13.82%
2020-01-01 00:28:50,13,12,9342,987,8355,14.25%,10.57%
2020-01-01 00:28:50,14,1,201,0,201,0.31%,0.00%
2020-01-01 00:28:50,14,2,1601,26,1575,2.44%,1.62%
2020-01-01 00:28:50,14,3,1123,9,1114,1.71%,0.80%
2020-01-01 00:28:50,14,4,3674,100,3574,5.61%,2.72%
2020-01-01 00:28:50,14,5,1100,13,1087,1.68%,1.18%
2020-01-01 00:28:50,14,6,3919,116,3803,5.98%,2.96%
2020-01-01 00:28:50,14,7,11540,991,10549,17.61%,8.59%
2020-01-01 00:28:50,14,8,13404,1299,12105,20.45%,9.69%
2020-01-01 00:28:50,14,9,1241,16,1225,1.89%,1.29%
2020-01-01 00:28:50,14,10,3932,120,3812,6.00%,3.05%
2020-01-01 00:28:50,14,11,25229,4318,20911,38.50%,17.12%
2020-01-01 00:28:50,14,12,7504,424,7080,11.45%,5.65%
2020-01-01 00:28:50,15,1,531,2,529,0.81%,0.38%
2020-01-01 00:28:50,15,2,115,0,115,0.18%,0.00%
2020-01-01 00:28:50,15,3,4008,135,3873,6.12%,3.37%
2020-01-01 00:28:50,15,4,4613,192,4421,7.04%,4.16%
2020-01-01 00:28:50,15,5,9434,690,8744,14.40%,7.31%
2020-01-01 00:28:50,15,6,4850,216,4634,7.40%,4.45%
2020-01-01 00:28:50,15,7,3885,107,3778,5.93%,2.75%
2020-01-01 00:28:50,15,8,5848,264,5584,8.92%,4.51%
2020-01-01 00:28:50,15,9,9643,716,8927,14.71%,7.43%
2020-01-01 00:28:50,15,10,4324,333,3991,6.60%,7.70%
2020-01-01 00:28:50,15,11,10307,923,9384,15.73%,8.96%
2020-01-01 00:28:50,15,12,25082,4802,20280,38.27%,19.15%
2020-01-01 00:28:50,16,1,449,2,447,0.69%,0.45%
2020-01-01 00:28:50,16,2,352,3,349,0.54%,0.85%
2020-01-01 00:28:50,16,3,1391,19,1372,2.12%,1.37%
2020-01-01 00:28:50,16,4,4030,195,3835,6.15%,4.84%
2020-01-01 00:28:50,16,5,7403,526,6877,11.30%,7.11%
2020-01-01 00:28:50,16,6,4793,256,4537,7.31%,5.34%
2020-01-01 00:28:50,16,7,3054,67,2987,4.66%,2.19%
2020-01-01 00:28:50,16,8,6671,359,6312,10.18%,5.38%
2020-01-01 00:28:50,16,9,8014,600,7414,12.23%,7.49%
2020-01-01 00:28:50,16,10,1480,21,1459,2.26%,1.42%
2020-01-01 00:28:50,16,11,8328,503,7825,12.71%,6.04%
2020-01-01 00:28:50,16,12,23920,4052,19868,36.50%,16.94%
2020-01-01 00:29:00,1,1,22015,3342,18673,33.59%,15.18%
2020-01-01 00:29:00,1,2,11388,909,10479,17.38%,7.98%
2020-01-01 00:29:00,1,3,600,0,600,0.92%,0.00%
2020-01-01 00:29:00,1,4,10170,774,9396,15.52%,7.61%
2020-01-01 00:29:00,1,5,9799,726,9073,14.95%,7.41%
2020-01-01 00:29:00,1,6,9695,712,8983,14.79%,7.34%
2020-01-01 00:29:00,1,7,10776,820,9956,16.44%,7.61%
2020-01-01 00:29:00,1,8,9858,686,9172,15.04%,6.96%
2020-01-01 00:29:00,1,9,9640,705,8935,14.71%,7.31%
2020-01-01 00:29:00,1,10,9150,594,8556,13.96%,6.49%
2020-01-01 00:29:00,1,11,9232,607,8625,14.09%,6.57%
2020-01-01 00:29:00,1,12,9614,699,8915,14.67%,7.27%
2020-01-01 00:29:00,2,1,496,3,493,0.76%,0.60%
2020-01-01 00:29:00,2,2,23973,3896,20077,36.58%,16.25%
2020-01-01 00:29:00,2,3,19133,2524,16609,29.19%,13.19%
2020-01-01 00:29:00,2,4,432,1,431,0.66%,0.23%
2020-01-01 00:29:00,2,5,11509,975,10534,17.56%,8.47%
2020-01-01 00:29:00,2,6,34,0,34,0.05%,0.00%
2020-01-01 00:29:00,2,7,4327,136,4191,6.60%,3.14%
2020-01-01 00:29:00,2,8,2972,73,2899,4.53%,2.46%
2020-01-01 00:29:00,2,9,11421,965,10456,17.43%,8.45%
2020-01-01 00:29:00,2,10,1993,36,1957,3.04%,1.81%
2020-01-01 00:29:00,2,11,2008,36,1972,3.06%,1.79%
2020-01-01 00:29:00,2,12,11223,926,10297,17.12%,8.25%
2020-01-01 00:29:00,3,1,1611,34,1577,2.46%,2.11%
2020-01-01 00:29:00,3,2,27438,5086,22352,41.87%,18.54%
2020-01-01 00:29:00,3,3,73135,29037,44098,111.60%,39.70%
2020-01-01 00:29:00,3,4,8608,539,8069,13.13%,6.26%
2020-01-01 00:29:00,3,5,44829,12276,32553,68.40%,27.38%
2020-01-01 00:29:00,3,6,10166,747,9419,15.51%,7.35%
2020-01-01 00:29:00,3,7,23756,3883,19873,36.25%,16.35%
2020-01-01 00:29:00,3,8,16184,1881,14303,24.69%,11.62%
2020-01-01 00:29:00,3,9,34348,7572,26776,52.41%,22.04%
2020-01-01 00:29:00,3,10,4972,187,4785,7.59%,3.76%
2020-01-01 00:29:00,3,11,1714,26,1688,2.62%,1.52%
2020-01-01 00:29:00,3,12,25824,4423,21401,39.40%,17.13%
2020-01-01 00:29:00,4,1,628,2,626,0.96%,0.32%
2020-01-01 00:29:00,4,2,388,1,387,0.59%,0.26%
2020-01-01 00:29:00,4,3,909,5,904,1.39%,0.55%
2020-01-01 00:29:00,4,4,29291,5640,23651,44.69%,19.26%
2020-01-01 00:29:00,4,5,17284,2085,15199,26.37%,12.06%
2020-01-01 00:29:00,4,6,24680,4120,20560,37.66%,16.69%
2020-01-01 00:29:00,4,7,5975,280,5695,9.12%,4.69%
2020-01-01 00:29:00,4,8,3472,91,3381,5.30%,2.62%
2020-01-01 00:29:00,4,9,15190,1638,13552,23.18%,10.78%
2020-01-01 00:29:00,4,10,1940,41,1899,2.96%,2.11%
2020-01-01 00:29:00,4,11,230,2,228,0.35%,0.87%
2020-01-01 00:29:00,4,12,12613,1118,11495,19.25%,8.86%
2020-01-01 00:29:00,5,1,2416,52,2364,3.69%,2.15%
2020-01-01 00:29:00,5,2,651,4,647,0.99%,0.61%
2020-01-01 00:29:00,5,3,472,2,470,0.72%,0.42%
2020-01-01 00:29:00,5,4,20849,3009,17840,31.81%,14.43%
2020-01-01 00:29:00,5,5,8758,626,8132,13.36%,7.15%
2020-01-01 00:29:00,5,6,13516,1360,12156,20.62%,10.06%
2020-01-01 00:29:00,5,7,4363,157,4206,6.66%,3.60%
2020-01-01 00:29:00,5,8,3401,92,3309,5.19%,2.71%
2020-01-01 00:29:00,5,9,8134,539,7595,12.41%,6.63%
2020-01-01 00:29:00,5,10,1152,31,1121,1.76%,2.69%
2020-01-01 00:29:00,5,11,640,4,636,0.98%,0.62%
2020-01-01 00:29:00,5,12,6687,363,6324,10.20%,5.43%
2020-01-01 00:29:00,6,1,1041,3,1038,1.59%,0.29%
2020-01-01 00:29:00,6,2,1147,3,1144,1.75%,0.26%
2020-01-01 00:29:00,6,3,1691,12,1679,2.58%,0.71%
2020-01-01 00:29:00,6,4,1762,16,1746,2.69%,0.91%
2020-01-01 00:29:00,6,5,13516,1316,12200,20.62%,9.74%
2020-01-01 00:29:00,6,6,5097,200,4897,7.78%,3.92%
2020-01-01 00:29:00,6,7,2977,85,2892,4.54%,2.86%
2020-01-01 00:29:00,6,8,2559,66,2493,3.90%,2.58%
2020-01-01 00:29:00,6,9,6429,288,6141,9.81%,4.48%
2020-01-01 00:29:00,6,10,1651,15,1636,2.52%,0.91%
2020-01-01 00:29:00,6,11,447,1,446,0.68%,0.22%
2020-01-01 00:29:00,6,12,4737,155,4582,7.23%,3.27%
2020-01-01 00:29:00,7,1,416,2,414,0.63%,0.48%
2020-01-01 00:29:00,7,2,351,1,350,0.54%,0.28%
2020-01-01 00:29:00,7,3,683,6,677,1.04%,0.88%
2020-01-01 00:29:00,7,4,2561,60,2501,3.91%,2.34%
2020-01-01 00:29:00,7,5,6884,354,6530,10.50%,5.14%
2020-01-01 00:29:00,7,6,13259,1227,12032,20.23%,9.25%
2020-01-01 00:29:00,7,7,3767,124,3643,5.75%,3.29%
2020-01-01 00:29:00,7,8,1753,35,1718,2.67%,2.00%
2020-01-01 00:29:00,7,9,6036,266,5770,9.21%,4.41%
2020-01-01 00:29:00,7,10,925,7,918,1.41%,0.76%
2020-01-01 00:29:00,7,11,89,0,89,0.14%,0.00%
2020-01-01 00:29:00,7,12,5100,181,4919,7.78%,3.55%
2020-01-01 00:29:00,8,1,770,4,766,1.17%,0.52%
2020-01-01 00:29:00,8,2,74,0,74,0.11%,0.00%
2020-01-01 00:29:00,8,3,1948,35,1913,2.97%,1.80%
2020-01-01 00:29:00,8,4,2960,60,2900,4.52%,2.03%
2020-01-01 00:29:00,8,5,8953,613,8340,13.66%,6.85%
2020-01-01 00:29:00,8,6,20109,2777,17332,30.68%,13.81%
2020-01-01 00:29:00,8,7,8096,462,7634,12.35%,5.71%
2020-01-01 00:29:00,8,8,2403,35,2368,3.67%,1.46%
2020-01-01 00:29:00,8,9,6772,340,6432,10.33%,5.02%
2020-01-01 00:29:00,8,10,1954,31,1923,2.98%,1.59%
2020-01-01 00:29:00,8,11,133,0,133,0.20%,0.00%
2020-01-01 00:29:00,8,12,4863,170,4693,7.42%,3.50%
2020-01-01 00:29:00,9,1,527,1,526,0.80%,0.19%
2020-01-01 00:29:00,9,2,2161,48,2113,3.30%,2.22%
2020-01-01 00:29:00,9,3,1254,20,1234,1.91%,1.59%
2020-01-01 00:29:00,9,4,6720,317,6403,10.25%,4.72%
2020-01-01 00:29:00,9,5,414,1,413,0.63%,0.24%
2020-01-01 00:29:00,9,6,8154,480,7674,12.44%,5.89%
2020-01-01 00:29:00,9,7,28832,5597,23235,43.99%,19.41%
2020-01-01 00:29:00,9,8,10723,865,9858,16.36%,8.07%
2020-01-01 00:29:00,9,9,232,1,231,0.35%,0.43%
2020-01-01 00:29:00,9,10,2507,54,2453,3.83%,2.15%
2020-01-01 00:29:00,9,11,9567,702,8865,14.60%,7.34%
2020-01-01 00:29:00,9,12,6623,370,6253,10.11%,5.59%
2020-01-01 00:29:00,10,1,1440,282,1158,2.20%,19.58%
2020-01-01 00:29:00,10,2,3253,324,2929,4.96%,9.96%
2020-01-01 00:29:00,10,3,1695,18,1677,2.59%,1.06%
2020-01-01 00:29:00,10,4,3751,951,2800,5.72%,25.35%
2020-01-01 00:29:00,10,5,1015,114,901,1.55%,11.23%
2020-01-01 00:29:00,10,6,5796,1180,4616,8.84%,20.36%
2020-01-01 00:29:00,10,7,10865,1932,8933,16.58%,17.78%
2020-01-01 00:29:00,10,8,29795,7563,22232,45.46%,25.38%
2020-01-01 00:29:00,10,9,369,3,366,0.56%,0.81%
2020-01-01 00:29:00,10,10,2081,26,2055,3.18%,1.25%
2020-01-01 00:29:00,10,11,13976,1695,12281,21.33%,12.13%
2020-01-01 00:29:00,10,12,11180,1242,9938,17.06%,11.11%
2020-01-01 00:29:00,11,1,2279,45,2234,3.48%,1.97%
2020-01-01 00:29:00,11,2,3466,97,3369,5.29%,2.80%
2020-01-01 00:29:00,11,3,1036,6,1030,1.58%,0.58%
2020-01-01 00:29:00,11,4,4521,164,4357,6.90%,3.63%
2020-01-01 00:29:00,11,5,150,0,150,0.23%,0.00%
2020-01-01 00:29:00,11,6,5476,233,5243,8.36%,4.25%
2020-01-01 00:29:00,11,7,10944,856,10088,16.70%,7.82%
2020-01-01 00:29:00,11,8,24835,4145,20690,37.90%,16.69%
2020-01-01 00:29:00,11,9,239,0,239,0.36%,0.00%
2020-01-01 00:29:00,11,10,2972,60,2912,4.53%,2.02%
2020-01-01 00:29:00,11,11,10121,748,9373,15.44%,7.39%
2020-01-01 00:29:00,11,12,6732,362,6370,10.27%,5.38%
2020-01-01 00:29:00,12,1,96,0,96,0.15%,0.00%
2020-01-01 00:29:00,12,2,542,121,421,0.83%,22.32%
2020-01-01 00:29:00,12,3,3146,186,2960,4.80%,5.91%
2020-01-01 00:29:00,12,4,3354,58,3296,5.12%,1.73%
2020-01-01 00:29:00,12,5,8923,629,8294,13.62%,7.05%
2020-01-01 00:29:00,12,6,5059,151,4908,7.72%,2.98%
2020-01-01 00:29:00,12,7,1553,15,1538,2.37%,0.97%
2020-01-01 00:29:00,12,8,1779,280,1499,2.71%,15.74%
2020-01-01 00:29:00,12,9,21521,4216,17305,32.84%,19.59%
2020-01-01 00:29:00,12,10,4637,400,4237,7.08%,8.63%
2020-01-01 00:29:00,12,11,2061,290,1771,3.14%,14.07%
2020-01-01 00:29:00,12,12,7465,1468,5997,11.39%,19.67%
2020-01-01 00:29:00,13,1,1934,27,1907,2.95%,1.40%
2020-01-01 00:29:00,13,2,2270,42,2228,3.46%,1.85%
2020-01-01 00:29:00,13,3,753,4,749,1.15%,0.53%
2020-01-01 00:29:00,13,4,5045,826,4219,7.70%,16.37%
2020-01-01 00:29:00,13,5,7421,1173,6248,11.32%,15.81%
2020-01-01 00:29:00,13,6,5604,860,4744,8.55%,15.35%
2020-01-01 00:29:00,13,7,5009,192,4817,7.64%,3.83%
2020-01-01 00:29:00,13,8,7546,476,7070,11.51%,6.31%
2020-01-01 00:29:00,13,9,7944,1223,6721,12.12%,15.40%
2020-01-01 00:29:00,13,10,29206,6477,22729,44.56%,22.18%
2020-01-01 00:29:00,13,11,18117,2523,15594,27.64%,13.93%
2020-01-01 00:29:00,13,12,10180,1018,9162,15.53%,10.00%
2020-01-01 00:29:00,14,1,314,1,313,0.48%,0.32%
2020-01-01 00:29:00,14,2,2076,30,2046,3.17%,1.45%
2020-01-01 00:29:00,14,3,1533,12,1521,2.34%,0.78%
2020-01-01 00:29:00,14,4,3332,77,3255,5.08%,2.31%
2020-01-01 00:29:00,14,5,1452,15,1437,2.22%,1.03%
2020-01-01 00:29:00,14,6,3646,104,3542,5.56%,2.85%
2020-01-01 00:29:00,14,7,11446,903,10543,17.47%,7.89%
2020-01-01 00:29:00,14,8,13261,1198,12063,20.23%,9.03%
2020-01-01 00:29:00,14,9,1662,17,1645,2.54%,1.02%
2020-01-01 00:29:00,14,10,4220,123,4097,6.44%,2.91%
2020-01-01 00:29:00,14,11,26806,4708,22098,40.90%,17.56%
2020-01-01 00:29:00,14,12,8948,611,8337,13.65%,6.83%
2020-01-01 00:29:00,15,1,468,4,464,0.71%,0.85%
2020-01-01 00:29:00,15,2,141,0,141,0.22%,0.00%
2020-01-01 00:29:00,15,3,3908,116,3792,5.96%,2.97%
2020-01-01 00:29:00,15,4,4828,202,4626,7.37%,4.18%
2020-01-01 00:29:00,15,5,9415,715,8700,14.37%,7.59%
2020-01-01 00:29:00,15,6,5089,254,4835,7.77%,4.99%
2020-01-01 00:29:00,15,7,3936,147,3789,6.01%,3.73%
2020-01-01 00:29:00,15,8,5743,283,5460,8.76%,4.93%
2020-01-01 00:29:00,15,9,9610,743,8867,14.66%,7.73%
2020-01-01 00:29:00,15,10,5398,302,5096,8.24%,5.59%
2020-01-01 00:29:00,15,11,11350,1068,10282,17.32%,9.41%
2020-01-01 00:29:00,15,12,26583,5197,21386,40.56%,19.55%
2020-01-01 00:29:00,16,1,413,0,413,0.63%,0.00%
2020-01-01 00:29:00,16,2,345,0,345,0.53%,0.00%
2020-01-01 00:29:00,16,3,1551,27,1524,2.37%,1.74%
2020-01-01 00:29:00,16,4,4601,232,4369,7.02%,5.04%
2020-01-01 00:29:00,16,5,8525,662,7863,13.01%,7.77%
2020-01-01 00:29:00,16,6,5504,305,5199,8.40%,5.54%
2020-01-01 00:29:00,16,7,3560,91,3469,5.43%,2.56%
2020-01-01 00:29:00,16,8,7390,435,6955,11.28%,5.89%
2020-01-01 00:29:00,16,9,9102,740,8362,13.89%,8.13%
2020-01-01 00:29:00,16,10,1586,21,1565,2.42%,1.32%
2020-01-01 00:29:00,16,11,9223,637,8586,14.07%,6.91%
2020-01-01 00:29:00,16,12,26144,4709,21435,39.89%,18.01%
2020-01-01 00:29:10,1,1,16688,1982,14706,25.46%,11.88%
2020-01-01 00:29:10,1,2,5424,267,5157,8.28%,4.92%
2020-01-01 00:29:10,1,3,529,1,528,0.81%,0.19%
2020-01-01 00:29:10,1,4,10670,836,9834,16.28%,7.84%
2020-01-01 00:29:10,1,5,10252,774,9478,15.64%,7.55%
2020-01-01 00:29:10,1,6,10161,756,9405,15.50%,7.44%
2020-01-01 00:29:10,1,7,4871,224,4647,7.43%,4.60%
2020-01-01 00:29:10,1,8,3741,115,3626,5.71%,3.07%
2020-01-01 00:29:10,1,9,10123,752,9371,15.45%,7.43%
2020-01-01 00:29:10,1,10,3264,88,3176,4.98%,2.70%
2020-01-01 00:29:10,1,11,3349,92,3257,5.11%,2.75%
2020-01-01 00:29:10,1,12,10104,752,9352,15.42%,7.44%
2020-01-01 00:29:10,2,1,454,6,448,0.69%,1.32%
2020-01-01 00:29:10,2,2,27147,4923,22224,41.42%,18.13%
2020-01-01 00:29:10,2,3,18970,2516,16454,28.95%,13.26%
2020-01-01 00:29:10,2,4,394,0,394,0.60%,0.00%
2020-01-01 00:29:10,2,5,11242,929,10313,17.15%,8.26%
2020-01-01 00:29:10,2,6,43,0,43,0.07%,0.00%
2020-01-01 00:29:10,2,7,7708,419,7289,11.76%,5.44%
2020-01-01 00:29:10,2,8,6646,297,6349,10.14%,4.47%
2020-01-01 00:29:10,2,9,11160,912,10248,17.03%,8.17%
2020-01-01 00:29:10,2,10,5717,223,5494,8.72%,3.90%
2020-01-01 00:29:10,2,11,5742,224,5518,8.76%,3.90%
2020-01-01 00:29:10,2,12,10988,889,10099,16.77%,8.09%
2020-01-01 00:29:10,3,1,1337,19,1318,2.04%,1.42%
2020-01-01 00:29:10,3,2,23545,3694,19851,35.93%,15.69%
2020-01-01 00:29:10,3,3,69384,26524,42860,105.87%,38.23%
2020-01-01 00:29:10,3,4,7660,405,7255,11.69%,5.29%
2020-01-01 00:29:10,3,5,44226,12028,32198,67.48%,27.20%
2020-01-01 00:29:10,3,6,9221,584,8637,14.07%,6.33%
2020-01-01 00:29:10,3,7,20230,2775,17455,30.87%,13.72%
2020-01-01 00:29:10,3,8,15627,1733,13894,23.84%,11.09%
2020-01-01 00:29:10,3,9,34595,7680,26915,52.79%,22.20%
2020-01-01 00:29:10,3,10,6238,303,5935,9.52%,4.86%
2020-01-01 00:29:10,3,11,2044,24,2020,3.12%,1.17%
2020-01-01 00:29:10,3,12,24418,4058,20360,37.26%,16.62%
2020-01-01 00:29:10,4,1,599,1,598,0.91%,0.17%
2020-01-01 00:29:10,4,2,408,0,408,0.62%,0.00%
2020-01-01 00:29:10,4,3,956,5,951,1.46%,0.52%
2020-01-01 00:29:10,4,4,29627,5798,23829,45.21%,19.57%
2020-01-01 00:29:10,4,5,17783,2272,15511,27.13%,12.78%
2020-01-01 00:29:10,4,6,25137,4262,20875,38.36%,16.96%
2020-01-01 00:29:10,4,7,5794,234,5560,8.84%,4.04%
2020-01-01 00:29:10,4,8,3511,97,3414,5.36%,2.76%
2020-01-01 00:29:10,4,9,15618,1786,13832,23.83%,11.44%
2020-01-01 00:29:10,4,10,2116,40,2076,3.23%,1.89%
2020-01-01 00:29:10,4,11,271,1,270,0.41%,0.37%
2020-01-01 00:29:10,4,12,12384,1126,11258,18.90%,9.09%
2020-01-01 00:29:10,5,1,3067,65,3002,4.68%,2.12%
2020-01-01 00:29:10,5,2,860,9,851,1.31%,1.05%
2020-01-01 00:29:10,5,3,415,3,412,0.63%,0.72%
2020-01-01 00:29:10,5,4,28823,5501,23322,43.98%,19.09%
2020-01-01 00:29:10,5,5,9866,736,9130,15.05%,7.46%
2020-01-01 00:29:10,5,6,14835,1547,13288,22.64%,10.43%
2020-01-01 00:29:10,5,7,4390,149,4241,6.70%,3.39%
2020-01-01 00:29:10,5,8,3299,82,3217,5.03%,2.49%
2020-01-01 00:29:10,5,9,8567,570,7997,13.07%,6.65%
2020-01-01 00:29:10,5,10,1210,10,1200,1.85%,0.83%
2020-01-01 00:29:10,5,11,629,7,622,0.96%,1.11%
2020-01-01 00:29:10,5,12,7066,409,6657,10.78%,5.79%
2020-01-01 00:29:10,6,1,904,5,899,1.38%,0.55%
2020-01-01 00:29:10,6,2,983,6,977,1.50%,0.61%
2020-01-01 00:29:10,6,3,1569,16,1553,2.39%,1.02%
2020-01-01 00:29:10,6,4,977,7,970,1.49%,0.72%
2020-01-01 00:29:10,6,5,12082,1050,11032,18.44%,8.69%
2020-01-01 00:29:10,6,6,3329,81,3248,5.08%,2.43%
2020-01-01 00:29:10,6,7,1775,22,1753,2.71%,1.24%
2020-01-01 00:29:10,6,8,1305,12,1293,1.99%,0.92%
2020-01-01 00:29:10,6,9,6906,350,6556,10.54%,5.07%
2020-01-01 00:29:10,6,10,1936,29,1907,2.95%,1.50%
2020-01-01 00:29:10,6,11,369,3,366,0.56%,0.81%
2020-01-01 00:29:10,6,12,4888,171,4717,7.46%,3.50%
2020-01-01 00:29:10,7,1,465,5,460,0.71%,1.08%
2020-01-01 00:29:10,7,2,139,0,139,0.21%,0.00%
2020-01-01 00:29:10,7,3,993,5,988,1.52%,0.50%
2020-01-01 00:29:10,7,4,2622,71,2551,4.00%,2.71%
2020-01-01 00:29:10,7,5,8316,499,7817,12.69%,6.00%
2020-01-01 00:29:10,7,6,14901,1616,13285,22.74%,10.84%
2020-01-01 00:29:10,7,7,3901,141,3760,5.95%,3.61%
2020-01-01 00:29:10,7,8,1719,27,1692,2.62%,1.57%
2020-01-01 00:29:10,7,9,7108,379,6729,10.85%,5.33%
2020-01-01 00:29:10,7,10,1392,13,1379,2.12%,0.93%
2020-01-01 00:29:10,7,11,86,1,85,0.13%,1.16%
2020-01-01 00:29:10,7,12,5692,251,5441,8.69%,4.41%
2020-01-01 00:29:10,8,1,505,6,499,0.77%,1.19%
2020-01-01 00:29:10,8,2,109,0,109,0.17%,0.00%
2020-01-01 00:29:10,8,3,2055,22,2033,3.14%,1.07%
2020-01-01 00:29:10,8,4,2877,80,2797,4.39%,2.78%
2020-01-01 00:29:10,8,5,8700,577,8123,13.28%,6.63%
2020-01-01 00:29:10,8,6,16769,1975,14794,25.59%,11.78%
2020-01-01 00:29:10,8,7,5013,194,4819,7.65%,3.87%
2020-01-01 00:29:10,8,8,1951,32,1919,2.98%,1.64%
2020-01-01 00:29:10,8,9,6421,316,6105,9.80%,4.92%
2020-01-01 00:29:10,8,10,1677,12,1665,2.56%,0.72%
2020-01-01 00:29:10,8,11,99,0,99,0.15%,0.00%
2020-01-01 00:29:10,8,12,4727,163,4564,7.21%,3.45%
2020-01-01 00:29:10,9,1,400,1,399,0.61%,0.25%
2020-01-01 00:29:10,9,2,3354,89,3265,5.12%,2.65%
2020-01-01 00:29:10,9,3,2500,53,2447,3.81%,2.12%
2020-01-01 00:29:10,9,4,4822,165,4657,7.36%,3.42%
2020-01-01 00:29:10,9,5,311,0,311,0.47%,0.00%
2020-01-01 00:29:10,9,6,5851,236,5615,8.93%,4.03%
2020-01-01 00:29:10,9,7,25434,4415,21019,38.81%,17.36%
2020-01-01 00:29:10,9,8,10212,806,9406,15.58%,7.89%
2020-01-01 00:29:10,9,9,120,0,120,0.18%,0.00%
2020-01-01 00:29:10,9,10,3170,68,3102,4.84%,2.15%
2020-01-01 00:29:10,9,11,9078,654,8424,13.85%,7.20%
2020-01-01 00:29:10,9,12,5516,260,5256,8.42%,4.71%
2020-01-01 00:29:10,10,1,1354,225,1129,2.07%,16.62%
2020-01-01 00:29:10,10,2,2899,268,2631,4.42%,9.24%
2020-01-01 00:29:10,10,3,1397,19,1378,2.13%,1.36%
2020-01-01 00:29:10,10,4,4431,1521,2910,6.76%,34.33%
2020-01-01 00:29:10,10,5,650,53,597,0.99%,8.15%
2020-01-01 00:29:10,10,6,6541,1697,4844,9.98%,25.94%
2020-01-01 00:29:10,10,7,11656,2425,9231,17.79%,20.80%
2020-01-01 00:29:10,10,8,29859,7811,22048,45.56%,26.16%
2020-01-01 00:29:10,10,9,601,4,597,0.92%,0.67%
2020-01-01 00:29:10,10,10,2445,48,2397,3.73%,1.96%
2020-01-01 00:29:10,10,11,14132,1931,12201,21.56%,13.66%
2020-01-01 00:29:10,10,12,11051,1414,9637,16.86%,12.80%
2020-01-01 00:29:10,11,1,2429,63,2366,3.71%,2.59%
2020-01-01 00:29:10,11,2,4876,204,4672,7.44%,4.18%
2020-01-01 00:29:10,11,3,2205,34,2171,3.36%,1.54%
2020-01-01 00:29:10,11,4,3827,125,3702,5.84%,3.27%
2020-01-01 00:29:10,11,5,181,3,178,0.28%,1.66%
2020-01-01 00:29:10,11,6,4736,194,4542,7.23%,4.10%
2020-01-01 00:29:10,11,7,12006,1092,10914,18.32%,9.10%
2020-01-01 00:29:10,11,8,25744,4548,21196,39.28%,17.67%
2020-01-01 00:29:10,11,9,248,1,247,0.38%,0.40%
2020-01-01 00:29:10,11,10,3091,79,3012,4.72%,2.56%
2020-01-01 00:29:10,11,11,10236,800,9436,15.62%,7.82%
2020-01-01 00:29:10,11,12,6611,331,6280,10.09%,5.01%
2020-01-01 00:29:10,12,1,67,0,67,0.10%,0.00%
2020-01-01 00:29:10,12,2,600,172,428,0.92%,28.67%
2020-01-01 00:29:10,12,3,3037,237,2800,4.63%,7.80%
2020-01-01 00:29:10,12,4,3023,69,2954,4.61%,2.28%
2020-01-01 00:29:10,12,5,8769,751,8018,13.38%,8.56%
2020-01-01 00:29:10,12,6,4894,166,4728,7.47%,3.39%
2020-01-01 00:29:10,12,7,1712,20,1692,2.61%,1.17%
2020-01-01 00:29:10,12,8,1859,415,1444,2.84%,22.32%
2020-01-01 00:29:10,12,9,23570,4992,18578,35.96%,21.18%
2020-01-01 00:29:10,12,10,4927,550,4377,7.52%,11.16%
2020-01-01 00:29:10,12,11,1983,421,1562,3.03%,21.23%
2020-01-01 00:29:10,12,12,8845,1412,7433,13.50%,15.96%
2020-01-01 00:29:10,13,1,2397,52,2345,3.66%,2.17%
2020-01-01 00:29:10,13,2,2706,64,2642,4.13%,2.37%
2020-01-01 00:29:10,13,3,1145,10,1135,1.75%,0.87%
2020-01-01 00:29:10,13,4,4309,363,3946,6.58%,8.42%
2020-01-01 00:29:10,13,5,7202,785,6417,10.99%,10.90%
2020-01-01 00:29:10,13,6,5183,415,4768,7.91%,8.01%
2020-01-01 00:29:10,13,7,4872,229,4643,7.43%,4.70%
2020-01-01 00:29:10,13,8,6993,426,6567,10.67%,6.09%
2020-01-01 00:29:10,13,9,7479,813,6666,11.41%,10.87%
2020-01-01 00:29:10,13,10,26827,5497,21330,40.93%,20.49%
2020-01-01 00:29:10,13,11,16909,2404,14505,25.80%,14.22%
2020-01-01 00:29:10,13,12,9632,1045,8587,14.70%,10.85%
2020-01-01 00:29:10,14,1,272,0,272,0.42%,0.00%
2020-01-01 00:29:10,14,2,1258,9,1249,1.92%,0.72%
2020-01-01 00:29:10,14,3,736,4,732,1.12%,0.54%
2020-01-01 00:29:10,14,4,4499,142,4357,6.86%,3.16%
2020-01-01 00:29:10,14,5,1368,11,1357,2.09%,0.80%
2020-01-01 00:29:10,14,6,4908,169,4739,7.49%,3.44%
2020-01-01 00:29:10,14,7,12572,1068,11504,19.18%,8.50%
2020-01-01 00:29:10,14,8,14132,1371,12761,21.56%,9.70%
2020-01-01 00:29:10,14,9,1513,14,1499,2.31%,0.93%
2020-01-01 00:29:10,14,10,4324,134,4190,6.60%,3.10%
2020-01-01 00:29:10,14,11,30074,5954,24120,45.89%,19.80%
2020-01-01 00:29:10,14,12,11272,985,10287,17.20%,8.74%
2020-01-01 00:29:10,15,1,582,2,580,0.89%,0.34%
2020-01-01 00:29:10,15,2,132,0,132,0.20%,0.00%
2020-01-01 00:29:10,15,3,4134,124,4010,6.31%,3.00%
2020-01-01 00:29:10,15,4,5807,334,5473,8.86%,5.75%
2020-01-01 00:29:10,15,5,10968,954,10014,16.74%,8.70%
2020-01-01 00:29:10,15,6,6074,354,5720,9.27%,5.83%
2020-01-01 00:29:10,15,7,3724,102,3622,5.68%,2.74%
2020-01-01 00:29:10,15,8,5870,280,5590,8.96%,4.77%
2020-01-01 00:29:10,15,9,11224,992,10232,17.13%,8.84%
2020-01-01 00:29:10,15,10,4705,257,4448,7.18%,5.46%
2020-01-01 00:29:10,15,11,10791,933,9858,16.47%,8.65%
2020-01-01 00:29:10,15,12,27881,5606,22275,42.54%,20.11%
2020-01-01 00:29:10,16,1,422,0,422,0.64%,0.00%
2020-01-01 00:29:10,16,2,245,1,244,0.37%,0.41%
2020-01-01 00:29:10,16,3,1648,29,1619,2.51%,1.76%
2020-01-01 00:29:10,16,4,4569,155,4414,6.97%,3.39%
2020-01-01 00:29:10,16,5,7942,501,7441,12.12%,6.31%
2020-01-01 00:29:10,16,6,5295,212,5083,8.08%,4.00%
2020-01-01 00:29:10,16,7,3295,79,3216,5.03%,2.40%
2020-01-01 00:29:10,16,8,7608,552,7056,11.61%,7.26%
2020-01-01 00:29:10,16,9,8427,561,7866,12.86%,6.66%
2020-01-01 00:29:10,16,10,1310,8,1302,2.00%,0.61%
2020-01-01 00:29:10,16,11,9115,723,8392,13.91%,7.93%
2020-01-01 00:29:10,16,12,25128,4517,20611,38.34%,17.98%
