2020-01-01 00:00:10,1,1,17936,2188,15748,27.37%,3.34%
2020-01-01 00:00:10,1,2,8870,540,8330,13.53%,0.82%
2020-01-01 00:00:10,1,3,539,1,538,0.82%,0.00%
2020-01-01 00:00:10,1,4,8778,582,8196,13.39%,0.89%
2020-01-01 00:00:10,1,5,8544,550,7994,13.04%,0.84%
2020-01-01 00:00:10,1,6,8561,550,8011,13.06%,0.84%
2020-01-01 00:00:10,1,7,8323,483,7840,12.70%,0.74%
2020-01-01 00:00:10,1,8,6535,262,6273,9.97%,0.40%
2020-01-01 00:00:10,1,9,8452,539,7913,12.90%,0.82%
2020-01-01 00:00:10,1,10,5999,220,5779,9.15%,0.34%
2020-01-01 00:00:10,1,11,6035,224,5811,9.21%,0.34%
2020-01-01 00:00:10,1,12,8430,532,7898,12.86%,0.81%
2020-01-01 00:00:10,2,1,1740,30,1710,2.66%,0.05%
2020-01-01 00:00:10,2,2,25237,4318,20919,38.51%,6.59%
2020-01-01 00:00:10,2,3,20121,2847,17274,30.70%,4.34%
2020-01-01 00:00:10,2,4,1666,26,1640,2.54%,0.04%
2020-01-01 00:00:10,2,5,14023,1445,12578,21.40%,2.20%
2020-01-01 00:00:10,2,6,85,0,85,0.13%,0.00%
2020-01-01 00:00:10,2,7,3345,75,3270,5.10%,0.11%
2020-01-01 00:00:10,2,8,2165,35,2130,3.30%,0.05%
2020-01-01 00:00:10,2,9,13851,1416,12435,21.13%,2.16%
2020-01-01 00:00:10,2,10,1493,12,1481,2.28%,0.02%
2020-01-01 00:00:10,2,11,1502,13,1489,2.29%,0.02%
2020-01-01 00:00:10,2,12,13684,1381,12303,20.88%,2.11%
2020-01-01 00:00:10,3,1,1258,17,1241,1.92%,0.03%
2020-01-01 00:00:10,3,2,21868,3154,18714,33.37%,4.81%
2020-01-01 00:00:10,3,3,71981,28264,43717,109.83%,43.13%
2020-01-01 00:00:10,3,4,9312,637,8675,14.21%,0.97%
2020-01-01 00:00:10,3,5,48171,14123,34048,73.50%,21.55%
2020-01-01 00:00:10,3,6,10490,809,9681,16.01%,1.23%
2020-01-01 00:00:10,3,7,18957,2412,16545,28.93%,3.68%
2020-01-01 00:00:10,3,8,16018,1760,14258,24.44%,2.69%
2020-01-01 00:00:10,3,9,37222,8840,28382,56.80%,13.49%
2020-01-01 00:00:10,3,10,6482,307,6175,9.89%,0.47%
2020-01-01 00:00:10,3,11,2259,29,2230,3.45%,0.04%
2020-01-01 00:00:10,3,12,29430,5720,23710,44.91%,8.73%
2020-01-01 00:00:10,4,1,489,1,488,0.75%,0.00%
2020-01-01 00:00:10,4,2,294,0,294,0.45%,0.00%
2020-01-01 00:00:10,4,3,948,11,937,1.45%,0.02%
2020-01-01 00:00:10,4,4,26825,4802,22023,40.93%,7.33%
2020-01-01 00:00:10,4,5,17855,2258,15597,27.24%,3.45%
2020-01-01 00:00:10,4,6,23053,3626,19427,35.18%,5.53%
2020-01-01 00:00:10,4,7,4120,127,3993,6.29%,0.19%
2020-01-01 00:00:10,4,8,2738,62,2676,4.18%,0.09%
2020-01-01 00:00:10,4,9,15813,1798,14015,24.13%,2.74%
2020-01-01 00:00:10,4,10,2116,35,2081,3.23%,0.05%
2020-01-01 00:00:10,4,11,120,0,120,0.18%,0.00%
2020-01-01 00:00:10,4,12,12763,1141,11622,19.47%,1.74%
2020-01-01 00:00:10,5,1,2729,58,2671,4.16%,0.09%
2020-01-01 00:00:10,5,2,731,5,726,1.12%,0.01%
2020-01-01 00:00:10,5,3,1898,33,1865,2.90%,0.05%
2020-01-01 00:00:10,5,4,25428,4278,21150,38.80%,6.53%
2020-01-01 00:00:10,5,5,11028,896,10132,16.83%,1.37%
2020-01-01 00:00:10,5,6,17730,2186,15544,27.05%,3.34%
2020-01-01 00:00:10,5,7,6198,286,5912,9.46%,0.44%
2020-01-01 00:00:10,5,8,4699,167,4532,7.17%,0.25%
2020-01-01 00:00:10,5,9,9024,608,8416,13.77%,0.93%
2020-01-01 00:00:10,5,10,964,9,955,1.47%,0.01%
2020-01-01 00:00:10,5,11,1247,19,1228,1.90%,0.03%
2020-01-01 00:00:10,5,12,7462,424,7038,11.39%,0.65%
2020-01-01 00:00:10,6,1,1130,12,1118,1.72%,0.02%
2020-01-01 00:00:10,6,2,1272,16,1256,1.94%,0.02%
2020-01-01 00:00:10,6,3,1591,19,1572,2.43%,0.03%
2020-01-01 00:00:10,6,4,1621,18,1603,2.47%,0.03%
2020-01-01 00:00:10,6,5,13348,1300,12048,20.37%,1.98%
2020-01-01 00:00:10,6,6,4697,147,4550,7.17%,0.22%
2020-01-01 00:00:10,6,7,2643,49,2594,4.03%,0.07%
2020-01-01 00:00:10,6,8,2072,37,2035,3.16%,0.06%
2020-01-01 00:00:10,6,9,6857,381,6476,10.46%,0.58%
2020-01-01 00:00:10,6,10,1997,30,1967,3.05%,0.05%
2020-01-01 00:00:10,6,11,371,3,368,0.57%,0.00%
2020-01-01 00:00:10,6,12,4801,175,4626,7.33%,0.27%
2020-01-01 00:00:10,7,1,355,1,354,0.54%,0.00%
2020-01-01 00:00:10,7,2,128,0,128,0.20%,0.00%
2020-01-01 00:00:10,7,3,750,5,745,1.14%,0.01%
2020-01-01 00:00:10,7,4,1399,12,1387,2.13%,0.02%
2020-01-01 00:00:10,7,5,7092,336,6756,10.82%,0.51%
2020-01-01 00:00:10,7,6,12299,1055,11244,18.77%,1.61%
2020-01-01 00:00:10,7,7,3775,88,3687,5.76%,0.13%
2020-01-01 00:00:10,7,8,1579,13,1566,2.41%,0.02%
2020-01-01 00:00:10,7,9,6213,258,5955,9.48%,0.39%
2020-01-01 00:00:10,7,10,2020,30,1990,3.08%,0.05%
2020-01-01 00:00:10,7,11,181,0,181,0.28%,0.00%
2020-01-01 00:00:10,7,12,4154,111,4043,6.34%,0.17%
2020-01-01 00:00:10,8,1,389,1,388,0.59%,0.00%
2020-01-01 00:00:10,8,2,48,0,48,0.07%,0.00%
2020-01-01 00:00:10,8,3,1325,3,1322,2.02%,0.00%
2020-01-01 00:00:10,8,4,2141,49,2092,3.27%,0.07%
2020-01-01 00:00:10,8,5,7605,430,7175,11.60%,0.66%
2020-01-01 00:00:10,8,6,15241,1623,13618,23.26%,2.48%
2020-01-01 00:00:10,8,7,5386,212,5174,8.22%,0.32%
2020-01-01 00:00:10,8,8,2265,43,2222,3.46%,0.07%
2020-01-01 00:00:10,8,9,6196,286,5910,9.45%,0.44%
2020-01-01 00:00:10,8,10,1921,25,1896,2.93%,0.04%
2020-01-01 00:00:10,8,11,260,0,260,0.40%,0.00%
2020-01-01 00:00:10,8,12,4111,142,3969,6.27%,0.22%
2020-01-01 00:00:10,9,1,1305,3,1302,1.99%,0.00%
2020-01-01 00:00:10,9,2,11368,939,10429,17.35%,1.43%
2020-01-01 00:00:10,9,3,9562,672,8890,14.59%,1.03%
2020-01-01 00:00:10,9,4,11165,872,10293,17.04%,1.33%
2020-01-01 00:00:10,9,5,1743,34,1709,2.66%,0.05%
2020-01-01 00:00:10,9,6,13276,1257,12019,20.26%,1.92%
2020-01-01 00:00:10,9,7,40590,10332,30258,61.94%,15.77%
2020-01-01 00:00:10,9,8,10990,967,10023,16.77%,1.48%
2020-01-01 00:00:10,9,9,144,0,144,0.22%,0.00%
2020-01-01 00:00:10,9,10,3093,131,2962,4.72%,0.20%
2020-01-01 00:00:10,9,11,9746,777,8969,14.87%,1.19%
2020-01-01 00:00:10,9,12,6355,310,6045,9.70%,0.47%
2020-01-01 00:00:10,10,1,1163,329,834,1.77%,0.50%
2020-01-01 00:00:10,10,2,3721,412,3309,5.68%,0.63%
2020-01-01 00:00:10,10,3,2375,41,2334,3.62%,0.06%
2020-01-01 00:00:10,10,4,3234,652,2582,4.93%,0.99%
2020-01-01 00:00:10,10,5,581,2,579,0.89%,0.00%
2020-01-01 00:00:10,10,6,4787,719,4068,7.30%,1.10%
2020-01-01 00:00:10,10,7,10106,1549,8557,15.42%,2.36%
2020-01-01 00:00:10,10,8,26131,5791,20340,39.87%,8.84%
2020-01-01 00:00:10,10,9,824,6,818,1.26%,0.01%
2020-01-01 00:00:10,10,10,3431,105,3326,5.24%,0.16%
2020-01-01 00:00:10,10,11,12579,1446,11133,19.19%,2.21%
2020-01-01 00:00:10,10,12,8664,884,7780,13.22%,1.35%
2020-01-01 00:00:10,11,1,1995,36,1959,3.04%,0.05%
2020-01-01 00:00:10,11,2,3375,85,3290,5.15%,0.13%
2020-01-01 00:00:10,11,3,1259,14,1245,1.92%,0.02%
2020-01-01 00:00:10,11,4,5396,211,5185,8.23%,0.32%
2020-01-01 00:00:10,11,5,317,1,316,0.48%,0.00%
2020-01-01 00:00:10,11,6,6418,301,6117,9.79%,0.46%
2020-01-01 00:00:10,11,7,12045,1079,10966,18.38%,1.65%
2020-01-01 00:00:10,11,8,25863,4534,21329,39.46%,6.92%
2020-01-01 00:00:10,11,9,231,1,230,0.35%,0.00%
2020-01-01 00:00:10,11,10,3426,102,3324,5.23%,0.16%
2020-01-01 00:00:10,11,11,9637,700,8937,14.70%,1.07%
2020-01-01 00:00:10,11,12,6062,278,5784,9.25%,0.42%
2020-01-01 00:00:10,12,1,26,0,26,0.04%,0.00%
2020-01-01 00:00:10,12,2,700,270,430,1.07%,0.41%
2020-01-01 00:00:10,12,3,3599,340,3259,5.49%,0.52%
2020-01-01 00:00:10,12,4,3338,92,3246,5.09%,0.14%
2020-01-01 00:00:10,12,5,10546,995,9551,16.09%,1.52%
2020-01-01 00:00:10,12,6,6046,270,5776,9.23%,0.41%
2020-01-01 00:00:10,12,7,2244,29,2215,3.42%,0.04%
2020-01-01 00:00:10,12,8,1386,266,1120,2.11%,0.41%
2020-01-01 00:00:10,12,9,24397,5098,19299,37.23%,7.78%
2020-01-01 00:00:10,12,10,4215,393,3822,6.43%,0.60%
2020-01-01 00:00:10,12,11,1549,268,1281,2.36%,0.41%
2020-01-01 00:00:10,12,12,7674,1203,6471,11.71%,1.84%
2020-01-01 00:00:10,13,1,2155,32,2123,3.29%,0.05%
2020-01-01 00:00:10,13,2,2560,49,2511,3.91%,0.07%
2020-01-01 00:00:10,13,3,883,2,881,1.35%,0.00%
2020-01-01 00:00:10,13,4,4465,485,3980,6.81%,0.74%
2020-01-01 00:00:10,13,5,7798,940,6858,11.90%,1.43%
2020-01-01 00:00:10,13,6,6068,604,5464,9.26%,0.92%
2020-01-01 00:00:10,13,7,4481,163,4318,6.84%,0.25%
2020-01-01 00:00:10,13,8,6136,290,5846,9.36%,0.44%
2020-01-01 00:00:10,13,9,8042,958,7084,12.27%,1.46%
2020-01-01 00:00:10,13,10,27323,5768,21555,41.69%,8.80%
2020-01-01 00:00:10,13,11,15786,2125,13661,24.09%,3.24%
2020-01-01 00:00:10,13,12,9181,993,8188,14.01%,1.52%
2020-01-01 00:00:10,14,1,312,0,312,0.48%,0.00%
2020-01-01 00:00:10,14,2,2486,59,2427,3.79%,0.09%
2020-01-01 00:00:10,14,3,1806,36,1770,2.76%,0.05%
2020-01-01 00:00:10,14,4,4403,125,4278,6.72%,0.19%
2020-01-01 00:00:10,14,5,1515,18,1497,2.31%,0.03%
2020-01-01 00:00:10,14,6,4691,142,4549,7.16%,0.22%
2020-01-01 00:00:10,14,7,12243,1118,11125,18.68%,1.71%
2020-01-01 00:00:10,14,8,13691,1389,12302,20.89%,2.12%
2020-01-01 00:00:10,14,9,1746,24,1722,2.66%,0.04%
2020-01-01 00:00:10,14,10,4147,115,4032,6.33%,0.18%
2020-01-01 00:00:10,14,11,24576,4198,20378,37.50%,6.41%
2020-01-01 00:00:10,14,12,6504,332,6172,9.92%,0.51%
2020-01-01 00:00:10,15,1,501,1,500,0.76%,0.00%
2020-01-01 00:00:10,15,2,76,0,76,0.12%,0.00%
2020-01-01 00:00:10,15,3,3826,154,3672,5.84%,0.23%
2020-01-01 00:00:10,15,4,5233,302,4931,7.98%,0.46%
2020-01-01 00:00:10,15,5,9706,857,8849,14.81%,1.31%
2020-01-01 00:00:10,15,6,5450,314,5136,8.32%,0.48%
2020-01-01 00:00:10,15,7,3476,115,3361,5.30%,0.18%
2020-01-01 00:00:10,15,8,5423,233,5190,8.27%,0.36%
2020-01-01 00:00:10,15,9,9865,880,8985,15.05%,1.34%
2020-01-01 00:00:10,15,10,4222,142,4080,6.44%,0.22%
2020-01-01 00:00:10,15,11,9765,690,9075,14.90%,1.05%
2020-01-01 00:00:10,15,12,24362,4281,20081,37.17%,6.53%
2020-01-01 00:00:10,16,1,428,3,425,0.65%,0.00%
2020-01-01 00:00:10,16,2,257,0,257,0.39%,0.00%
2020-01-01 00:00:10,16,3,2815,64,2751,4.30%,0.10%
2020-01-01 00:00:10,16,4,5013,214,4799,7.65%,0.33%
2020-01-01 00:00:10,16,5,10075,857,9218,15.37%,1.31%
2020-01-01 00:00:10,16,6,6004,304,5700,9.16%,0.46%
2020-01-01 00:00:10,16,7,3363,80,3283,5.13%,0.12%
2020-01-01 00:00:10,16,8,7199,405,6794,10.98%,0.62%
2020-01-01 00:00:10,16,9,10536,917,9619,16.08%,1.40%
2020-01-01 00:00:10,16,10,1540,40,1500,2.35%,0.06%
2020-01-01 00:00:10,16,11,9017,630,8387,13.76%,0.96%
2020-01-01 00:00:10,16,12,28435,5467,22968,43.39%,8.34%
2020-01-01 00:00:20,1,1,15583,1771,13812,23.78%,2.70%
2020-01-01 00:00:20,1,2,5197,231,4966,7.93%,0.35%
2020-01-01 00:00:20,1,3,561,4,557,0.86%,0.01%
2020-01-01 00:00:20,1,4,10158,791,9367,15.50%,1.21%
2020-01-01 00:00:20,1,5,9931,753,9178,15.15%,1.15%
2020-01-01 00:00:20,1,6,9962,757,9205,15.20%,1.16%
2020-01-01 00:00:20,1,7,4626,193,4433,7.06%,0.29%
2020-01-01 00:00:20,1,8,3679,102,3577,5.61%,0.16%
2020-01-01 00:00:20,1,9,9846,739,9107,15.02%,1.13%
2020-01-01 00:00:20,1,10,3093,69,3024,4.72%,0.11%
2020-01-01 00:00:20,1,11,3135,70,3065,4.78%,0.11%
2020-01-01 00:00:20,1,12,9760,727,9033,14.89%,1.11%
2020-01-01 00:00:20,2,1,1964,9,1955,3.00%,0.01%
2020-01-01 00:00:20,2,2,33396,7300,26096,50.96%,11.14%
2020-01-01 00:00:20,2,3,28622,5501,23121,43.67%,8.39%
2020-01-01 00:00:20,2,4,1904,9,1895,2.91%,0.01%
2020-01-01 00:00:20,2,5,20099,2785,17314,30.67%,4.25%
2020-01-01 00:00:20,2,6,64,0,64,0.10%,0.00%
2020-01-01 00:00:20,2,7,2779,57,2722,4.24%,0.09%
2020-01-01 00:00:20,2,8,1747,21,1726,2.67%,0.03%
2020-01-01 00:00:20,2,9,19949,2750,17199,30.44%,4.20%
2020-01-01 00:00:20,2,10,1131,6,1125,1.73%,0.01%
2020-01-01 00:00:20,2,11,1140,6,1134,1.74%,0.01%
2020-01-01 00:00:20,2,12,19788,2702,17086,30.19%,4.12%
2020-01-01 00:00:20,3,1,1581,6,1575,2.41%,0.01%
2020-01-01 00:00:20,3,2,21783,3198,18585,33.24%,4.88%
2020-01-01 00:00:20,3,3,62630,22244,40386,95.57%,33.94%
2020-01-01 00:00:20,3,4,5543,212,5331,8.46%,0.32%
2020-01-01 00:00:20,3,5,37830,9053,28777,57.72%,13.81%
2020-01-01 00:00:20,3,6,7142,368,6774,10.90%,0.56%
2020-01-01 00:00:20,3,7,18501,2377,16124,28.23%,3.63%
2020-01-01 00:00:20,3,8,15610,1734,13876,23.82%,2.65%
2020-01-01 00:00:20,3,9,30350,6005,24345,46.31%,9.16%
2020-01-01 00:00:20,3,10,6916,350,6566,10.55%,0.53%
2020-01-01 00:00:20,3,11,2139,34,2105,3.26%,0.05%
2020-01-01 00:00:20,3,12,22175,3336,18839,33.84%,5.09%
2020-01-01 00:00:20,4,1,483,0,483,0.74%,0.00%
2020-01-01 00:00:20,4,2,282,0,282,0.43%,0.00%
2020-01-01 00:00:20,4,3,906,8,898,1.38%,0.01%
2020-01-01 00:00:20,4,4,27925,5230,22695,42.61%,7.98%
2020-01-01 00:00:20,4,5,18263,2381,15882,27.87%,3.63%
2020-01-01 00:00:20,4,6,23939,3955,19984,36.53%,6.03%
2020-01-01 00:00:20,4,7,4568,160,4408,6.97%,0.24%
2020-01-01 00:00:20,4,8,3113,81,3032,4.75%,0.12%
2020-01-01 00:00:20,4,9,16268,1930,14338,24.82%,2.94%
2020-01-01 00:00:20,4,10,2154,38,2116,3.29%,0.06%
2020-01-01 00:00:20,4,11,168,0,168,0.26%,0.00%
2020-01-01 00:00:20,4,12,13150,1259,11891,20.07%,1.92%
2020-01-01 00:00:20,5,1,2664,49,2615,4.06%,0.07%
2020-01-01 00:00:20,5,2,947,4,943,1.45%,0.01%
2020-01-01 00:00:20,5,3,770,4,766,1.17%,0.01%
2020-01-01 00:00:20,5,4,22858,3683,19175,34.88%,5.62%
2020-01-01 00:00:20,5,5,10023,792,9231,15.29%,1.21%
2020-01-01 00:00:20,5,6,16478,1976,14502,25.14%,3.02%
2020-01-01 00:00:20,5,7,5794,266,5528,8.84%,0.41%
2020-01-01 00:00:20,5,8,4513,166,4347,6.89%,0.25%
2020-01-01 00:00:20,5,9,8799,619,8180,13.43%,0.94%
2020-01-01 00:00:20,5,10,985,7,978,1.50%,0.01%
2020-01-01 00:00:20,5,11,1178,10,1168,1.80%,0.02%
2020-01-01 00:00:20,5,12,7208,433,6775,11.00%,0.66%
2020-01-01 00:00:20,6,1,1075,8,1067,1.64%,0.01%
2020-01-01 00:00:20,6,2,1205,10,1195,1.84%,0.02%
2020-01-01 00:00:20,6,3,1600,19,1581,2.44%,0.03%
2020-01-01 00:00:20,6,4,1279,10,1269,1.95%,0.02%
2020-01-01 00:00:20,6,5,13294,1260,12034,20.29%,1.92%
2020-01-01 00:00:20,6,6,4828,174,4654,7.37%,0.27%
2020-01-01 00:00:20,6,7,2977,76,2901,4.54%,0.12%
2020-01-01 00:00:20,6,8,2390,57,2333,3.65%,0.09%
2020-01-01 00:00:20,6,9,6653,320,6333,10.15%,0.49%
2020-01-01 00:00:20,6,10,1982,30,1952,3.02%,0.05%
2020-01-01 00:00:20,6,11,451,2,449,0.69%,0.00%
2020-01-01 00:00:20,6,12,4621,145,4476,7.05%,0.22%
2020-01-01 00:00:20,7,1,379,5,374,0.58%,0.01%
2020-01-01 00:00:20,7,2,100,0,100,0.15%,0.00%
2020-01-01 00:00:20,7,3,910,8,902,1.39%,0.01%
2020-01-01 00:00:20,7,4,1415,18,1397,2.16%,0.03%
2020-01-01 00:00:20,7,5,6872,385,6487,10.49%,0.59%
2020-01-01 00:00:20,7,6,12129,1104,11025,18.51%,1.68%
2020-01-01 00:00:20,7,7,3812,136,3676,5.82%,0.21%
2020-01-01 00:00:20,7,8,1695,29,1666,2.59%,0.04%
2020-01-01 00:00:20,7,9,5865,287,5578,8.95%,0.44%
2020-01-01 00:00:20,7,10,1671,37,1634,2.55%,0.06%
2020-01-01 00:00:20,7,11,194,1,193,0.30%,0.00%
2020-01-01 00:00:20,7,12,4155,133,4022,6.34%,0.20%
2020-01-01 00:00:20,8,1,384,1,383,0.59%,0.00%
2020-01-01 00:00:20,8,2,28,0,28,0.04%,0.00%
2020-01-01 00:00:20,8,3,2210,40,2170,3.37%,0.06%
2020-01-01 00:00:20,8,4,2091,30,2061,3.19%,0.05%
2020-01-01 00:00:20,8,5,8396,522,7874,12.81%,0.80%
2020-01-01 00:00:20,8,6,15042,1625,13417,22.95%,2.48%
2020-01-01 00:00:20,8,7,4460,155,4305,6.81%,0.24%
2020-01-01 00:00:20,8,8,1471,14,1457,2.24%,0.02%
2020-01-01 00:00:20,8,9,6070,282,5788,9.26%,0.43%
2020-01-01 00:00:20,8,10,1913,25,1888,2.92%,0.04%
2020-01-01 00:00:20,8,11,245,0,245,0.37%,0.00%
2020-01-01 00:00:20,8,12,4103,131,3972,6.26%,0.20%
2020-01-01 00:00:20,9,1,781,6,775,1.19%,0.01%
2020-01-01 00:00:20,9,2,11927,1012,10915,18.20%,1.54%
2020-01-01 00:00:20,9,3,10600,826,9774,16.17%,1.26%
2020-01-01 00:00:20,9,4,6165,261,5904,9.41%,0.40%
2020-01-01 00:00:20,9,5,658,0,658,1.00%,0.00%
2020-01-01 00:00:20,9,6,7098,340,6758,10.83%,0.52%
2020-01-01 00:00:20,9,7,41594,10760,30834,63.47%,16.42%
2020-01-01 00:00:20,9,8,15207,1627,13580,23.20%,2.48%
2020-01-01 00:00:20,9,9,227,0,227,0.35%,0.00%
2020-01-01 00:00:20,9,10,5857,275,5582,8.94%,0.42%
2020-01-01 00:00:20,9,11,13819,1367,12452,21.09%,2.09%
2020-01-01 00:00:20,9,12,7721,444,7277,11.78%,0.68%
2020-01-01 00:00:20,10,1,1302,337,965,1.99%,0.51%
2020-01-01 00:00:20,10,2,3391,409,2982,5.17%,0.62%
2020-01-01 00:00:20,10,3,1855,27,1828,2.83%,0.04%
2020-01-01 00:00:20,10,4,3507,661,2846,5.35%,1.01%
2020-01-01 00:00:20,10,5,589,3,586,0.90%,0.00%
2020-01-01 00:00:20,10,6,5305,770,4535,8.09%,1.17%
2020-01-01 00:00:20,10,7,10456,1608,8848,15.95%,2.45%
2020-01-01 00:00:20,10,8,27507,6337,21170,41.97%,9.67%
2020-01-01 00:00:20,10,9,1028,7,1021,1.57%,0.01%
2020-01-01 00:00:20,10,10,3306,77,3229,5.04%,0.12%
2020-01-01 00:00:20,10,11,13169,1538,11631,20.09%,2.35%
2020-01-01 00:00:20,10,12,9383,985,8398,14.32%,1.50%
2020-01-01 00:00:20,11,1,2156,43,2113,3.29%,0.07%
2020-01-01 00:00:20,11,2,3905,129,3776,5.96%,0.20%
2020-01-01 00:00:20,11,3,1638,24,1614,2.50%,0.04%
2020-01-01 00:00:20,11,4,3581,104,3477,5.46%,0.16%
2020-01-01 00:00:20,11,5,689,3,686,1.05%,0.00%
2020-01-01 00:00:20,11,6,5058,192,4866,7.72%,0.29%
2020-01-01 00:00:20,11,7,11342,969,10373,17.31%,1.48%
2020-01-01 00:00:20,11,8,24862,4264,20598,37.94%,6.51%
2020-01-01 00:00:20,11,9,269,2,267,0.41%,0.00%
2020-01-01 00:00:20,11,10,3750,99,3651,5.72%,0.15%
2020-01-01 00:00:20,11,11,9322,642,8680,14.22%,0.98%
2020-01-01 00:00:20,11,12,5398,222,5176,8.24%,0.34%
2020-01-01 00:00:20,12,1,53,0,53,0.08%,0.00%
2020-01-01 00:00:20,12,2,728,276,452,1.11%,0.42%
2020-01-01 00:00:20,12,3,4101,363,3738,6.26%,0.55%
2020-01-01 00:00:20,12,4,3229,71,3158,4.93%,0.11%
2020-01-01 00:00:20,12,5,10927,1035,9892,16.67%,1.58%
2020-01-01 00:00:20,12,6,5912,262,5650,9.02%,0.40%
2020-01-01 00:00:20,12,7,2270,31,2239,3.46%,0.05%
2020-01-01 00:00:20,12,8,1272,246,1026,1.94%,0.38%
2020-01-01 00:00:20,12,9,25415,5374,20041,38.78%,8.20%
2020-01-01 00:00:20,12,10,5018,446,4572,7.66%,0.68%
2020-01-01 00:00:20,12,11,1508,250,1258,2.30%,0.38%
2020-01-01 00:00:20,12,12,7565,1177,6388,11.54%,1.80%
2020-01-01 00:00:20,13,1,2136,37,2099,3.26%,0.06%
2020-01-01 00:00:20,13,2,2452,49,2403,3.74%,0.07%
2020-01-01 00:00:20,13,3,979,2,977,1.49%,0.00%
2020-01-01 00:00:20,13,4,4342,378,3964,6.63%,0.58%
2020-01-01 00:00:20,13,5,7727,888,6839,11.79%,1.35%
2020-01-01 00:00:20,13,6,5876,496,5380,8.97%,0.76%
2020-01-01 00:00:20,13,7,4373,141,4232,6.67%,0.22%
2020-01-01 00:00:20,13,8,6292,279,6013,9.60%,0.43%
2020-01-01 00:00:20,13,9,7912,905,7007,12.07%,1.38%
2020-01-01 00:00:20,13,10,26381,5359,21022,40.25%,8.18%
2020-01-01 00:00:20,13,11,16050,2182,13868,24.49%,3.33%
2020-01-01 00:00:20,13,12,9081,1030,8051,13.86%,1.57%
2020-01-01 00:00:20,14,1,380,1,379,0.58%,0.00%
2020-01-01 00:00:20,14,2,2071,27,2044,3.16%,0.04%
2020-01-01 00:00:20,14,3,1521,12,1509,2.32%,0.02%
2020-01-01 00:00:20,14,4,4431,140,4291,6.76%,0.21%
2020-01-01 00:00:20,14,5,1561,24,1537,2.38%,0.04%
2020-01-01 00:00:20,14,6,4703,157,4546,7.18%,0.24%
2020-01-01 00:00:20,14,7,11571,926,10645,17.66%,1.41%
2020-01-01 00:00:20,14,8,13033,1183,11850,19.89%,1.81%
2020-01-01 00:00:20,14,9,1693,31,1662,2.58%,0.05%
2020-01-01 00:00:20,14,10,4045,109,3936,6.17%,0.17%
2020-01-01 00:00:20,14,11,24567,4082,20485,37.49%,6.23%
2020-01-01 00:00:20,14,12,7245,380,6865,11.05%,0.58%
2020-01-01 00:00:20,15,1,390,0,390,0.60%,0.00%
2020-01-01 00:00:20,15,2,54,0,54,0.08%,0.00%
2020-01-01 00:00:20,15,3,4285,116,4169,6.54%,0.18%
2020-01-01 00:00:20,15,4,7241,515,6726,11.05%,0.79%
2020-01-01 00:00:20,15,5,12239,1156,11083,18.68%,1.76%
2020-01-01 00:00:20,15,6,7467,534,6933,11.39%,0.81%
2020-01-01 00:00:20,15,7,3883,116,3767,5.92%,0.18%
2020-01-01 00:00:20,15,8,6124,279,5845,9.34%,0.43%
2020-01-01 00:00:20,15,9,12380,1189,11191,18.89%,1.81%
2020-01-01 00:00:20,15,10,4356,140,4216,6.65%,0.21%
2020-01-01 00:00:20,15,11,10629,845,9784,16.22%,1.29%
2020-01-01 00:00:20,15,12,27724,5492,22232,42.30%,8.38%
2020-01-01 00:00:20,16,1,552,2,550,0.84%,0.00%
2020-01-01 00:00:20,16,2,214,1,213,0.33%,0.00%
2020-01-01 00:00:20,16,3,1221,13,1208,1.86%,0.02%
2020-01-01 00:00:20,16,4,3366,95,3271,5.14%,0.14%
2020-01-01 00:00:20,16,5,6857,462,6395,10.46%,0.70%
2020-01-01 00:00:20,16,6,4313,161,4152,6.58%,0.25%
2020-01-01 00:00:20,16,7,3622,138,3484,5.53%,0.21%
2020-01-01 00:00:20,16,8,10975,915,10060,16.75%,1.40%
2020-01-01 00:00:20,16,9,7280,500,6780,11.11%,0.76%
2020-01-01 00:00:20,16,10,1460,92,1368,2.23%,0.14%
2020-01-01 00:00:20,16,11,12626,1246,11380,19.27%,1.90%
2020-01-01 00:00:20,16,12,29043,5755,23288,44.32%,8.78%
2020-01-01 00:00:30,1,1,20913,2988,17925,31.91%,4.56%
2020-01-01 00:00:30,1,2,8406,523,7883,12.83%,0.80%
2020-01-01 00:00:30,1,3,563,2,561,0.86%,0.00%
2020-01-01 00:00:30,1,4,12232,1075,11157,18.66%,1.64%
2020-01-01 00:00:30,1,5,12071,1048,11023,18.42%,1.60%
2020-01-01 00:00:30,1,6,12064,1052,11012,18.41%,1.61%
2020-01-01 00:00:30,1,7,7840,452,7388,11.96%,0.69%
2020-01-01 00:00:30,1,8,4568,145,4423,6.97%,0.22%
2020-01-01 00:00:30,1,9,11989,1040,10949,18.29%,1.59%
2020-01-01 00:00:30,1,10,3882,111,3771,5.92%,0.17%
2020-01-01 00:00:30,1,11,3932,112,3820,6.00%,0.17%
2020-01-01 00:00:30,1,12,11869,1024,10845,18.11%,1.56%
2020-01-01 00:00:30,2,1,1699,4,1695,2.59%,0.01%
2020-01-01 00:00:30,2,2,30740,6168,24572,46.91%,9.41%
2020-01-01 00:00:30,2,3,24987,4168,20819,38.13%,6.36%
2020-01-01 00:00:30,2,4,1615,2,1613,2.46%,0.00%
2020-01-01 00:00:30,2,5,13062,1218,11844,19.93%,1.86%
2020-01-01 00:00:30,2,6,71,0,71,0.11%,0.00%
2020-01-01 00:00:30,2,7,4032,122,3910,6.15%,0.19%
2020-01-01 00:00:30,2,8,3165,76,3089,4.83%,0.12%
2020-01-01 00:00:30,2,9,12885,1185,11700,19.66%,1.81%
2020-01-01 00:00:30,2,10,2740,58,2682,4.18%,0.09%
2020-01-01 00:00:30,2,11,2744,58,2686,4.19%,0.09%
2020-01-01 00:00:30,2,12,12711,1152,11559,19.40%,1.76%
2020-01-01 00:00:30,3,1,1700,23,1677,2.59%,0.04%
2020-01-01 00:00:30,3,2,20812,2962,17850,31.76%,4.52%
2020-01-01 00:00:30,3,3,59746,20566,39180,91.17%,31.38%
2020-01-01 00:00:30,3,4,7845,464,7381,11.97%,0.71%
2020-01-01 00:00:30,3,5,37899,9155,28744,57.83%,13.97%
2020-01-01 00:00:30,3,6,9161,612,8549,13.98%,0.93%
2020-01-01 00:00:30,3,7,17277,2027,15250,26.36%,3.09%
2020-01-01 00:00:30,3,8,14514,1440,13074,22.15%,2.20%
2020-01-01 00:00:30,3,9,28318,5433,22885,43.21%,8.29%
2020-01-01 00:00:30,3,10,8455,574,7881,12.90%,0.88%
2020-01-01 00:00:30,3,11,1985,35,1950,3.03%,0.05%
2020-01-01 00:00:30,3,12,18437,2383,16054,28.13%,3.64%
2020-01-01 00:00:30,4,1,424,2,422,0.65%,0.00%
2020-01-01 00:00:30,4,2,230,0,230,0.35%,0.00%
2020-01-01 00:00:30,4,3,1088,9,1079,1.66%,0.01%
2020-01-01 00:00:30,4,4,28085,5214,22871,42.85%,7.96%
2020-01-01 00:00:30,4,5,18390,2412,15978,28.06%,3.68%
2020-01-01 00:00:30,4,6,24263,4021,20242,37.02%,6.14%
2020-01-01 00:00:30,4,7,4682,135,4547,7.14%,0.21%
2020-01-01 00:00:30,4,8,3137,56,3081,4.79%,0.09%
2020-01-01 00:00:30,4,9,16143,1864,14279,24.63%,2.84%
2020-01-01 00:00:30,4,10,2203,29,2174,3.36%,0.04%
2020-01-01 00:00:30,4,11,183,0,183,0.28%,0.00%
2020-01-01 00:00:30,4,12,12943,1227,11716,19.75%,1.87%
2020-01-01 00:00:30,5,1,2611,47,2564,3.98%,0.07%
2020-01-01 00:00:30,5,2,669,3,666,1.02%,0.00%
2020-01-01 00:00:30,5,3,3683,133,3550,5.62%,0.20%
2020-01-01 00:00:30,5,4,27059,5019,22040,41.29%,7.66%
2020-01-01 00:00:30,5,5,13452,1353,12099,20.53%,2.06%
2020-01-01 00:00:30,5,6,20883,3164,17719,31.86%,4.83%
2020-01-01 00:00:30,5,7,6625,400,6225,10.11%,0.61%
2020-01-01 00:00:30,5,8,5140,206,4934,7.84%,0.31%
2020-01-01 00:00:30,5,9,9286,661,8625,14.17%,1.01%
2020-01-01 00:00:30,5,10,968,5,963,1.48%,0.01%
2020-01-01 00:00:30,5,11,845,9,836,1.29%,0.01%
2020-01-01 00:00:30,5,12,7538,479,7059,11.50%,0.73%
2020-01-01 00:00:30,6,1,1140,10,1130,1.74%,0.02%
2020-01-01 00:00:30,6,2,1289,11,1278,1.97%,0.02%
2020-01-01 00:00:30,6,3,1678,25,1653,2.56%,0.04%
2020-01-01 00:00:30,6,4,1049,5,1044,1.60%,0.01%
2020-01-01 00:00:30,6,5,14438,1439,12999,22.03%,2.20%
2020-01-01 00:00:30,6,6,4499,163,4336,6.86%,0.25%
2020-01-01 00:00:30,6,7,2824,82,2742,4.31%,0.13%
2020-01-01 00:00:30,6,8,2158,58,2100,3.29%,0.09%
2020-01-01 00:00:30,6,9,8011,441,7570,12.22%,0.67%
2020-01-01 00:00:30,6,10,2046,27,2019,3.12%,0.04%
2020-01-01 00:00:30,6,11,423,0,423,0.65%,0.00%
2020-01-01 00:00:30,6,12,5909,245,5664,9.02%,0.37%
2020-01-01 00:00:30,7,1,394,0,394,0.60%,0.00%
2020-01-01 00:00:30,7,2,201,1,200,0.31%,0.00%
2020-01-01 00:00:30,7,3,1118,6,1112,1.71%,0.01%
2020-01-01 00:00:30,7,4,1829,25,1804,2.79%,0.04%
2020-01-01 00:00:30,7,5,7221,362,6859,11.02%,0.55%
2020-01-01 00:00:30,7,6,13349,1214,12135,20.37%,1.85%
2020-01-01 00:00:30,7,7,4254,116,4138,6.49%,0.18%
2020-01-01 00:00:30,7,8,1808,19,1789,2.76%,0.03%
2020-01-01 00:00:30,7,9,6003,260,5743,9.16%,0.40%
2020-01-01 00:00:30,7,10,1770,20,1750,2.70%,0.03%
2020-01-01 00:00:30,7,11,221,1,220,0.34%,0.00%
2020-01-01 00:00:30,7,12,4195,133,4062,6.40%,0.20%
2020-01-01 00:00:30,8,1,261,1,260,0.40%,0.00%
2020-01-01 00:00:30,8,2,66,4,62,0.10%,0.01%
2020-01-01 00:00:30,8,3,1515,24,1491,2.31%,0.04%
2020-01-01 00:00:30,8,4,2041,31,2010,3.11%,0.05%
2020-01-01 00:00:30,8,5,7629,432,7197,11.64%,0.66%
2020-01-01 00:00:30,8,6,15259,1580,13679,23.28%,2.41%
2020-01-01 00:00:30,8,7,5479,200,5279,8.36%,0.31%
2020-01-01 00:00:30,8,8,2324,30,2294,3.55%,0.05%
2020-01-01 00:00:30,8,9,5978,275,5703,9.12%,0.42%
2020-01-01 00:00:30,8,10,1813,24,1789,2.77%,0.04%
2020-01-01 00:00:30,8,11,247,0,247,0.38%,0.00%
2020-01-01 00:00:30,8,12,4083,128,3955,6.23%,0.20%
2020-01-01 00:00:30,9,1,353,0,353,0.54%,0.00%
2020-01-01 00:00:30,9,2,11173,878,10295,17.05%,1.34%
2020-01-01 00:00:30,9,3,10346,753,9593,15.79%,1.15%
2020-01-01 00:00:30,9,4,8206,378,7828,12.52%,0.58%
2020-01-01 00:00:30,9,5,375,2,373,0.57%,0.00%
2020-01-01 00:00:30,9,6,8806,455,8351,13.44%,0.69%
2020-01-01 00:00:30,9,7,36314,8298,28016,55.41%,12.66%
2020-01-01 00:00:30,9,8,10303,769,9534,15.72%,1.17%
2020-01-01 00:00:30,9,9,249,2,247,0.38%,0.00%
2020-01-01 00:00:30,9,10,3165,51,3114,4.83%,0.08%
2020-01-01 00:00:30,9,11,9053,582,8471,13.81%,0.89%
2020-01-01 00:00:30,9,12,5637,240,5397,8.60%,0.37%
2020-01-01 00:00:30,10,1,1304,335,969,1.99%,0.51%
2020-01-01 00:00:30,10,2,3120,401,2719,4.76%,0.61%
2020-01-01 00:00:30,10,3,1596,23,1573,2.44%,0.04%
2020-01-01 00:00:30,10,4,3745,657,3088,5.71%,1.00%
2020-01-01 00:00:30,10,5,628,1,627,0.96%,0.00%
2020-01-01 00:00:30,10,6,5206,726,4480,7.94%,1.11%
2020-01-01 00:00:30,10,7,9972,1542,8430,15.22%,2.35%
2020-01-01 00:00:30,10,8,27001,6115,20886,41.20%,9.33%
2020-01-01 00:00:30,10,9,930,4,926,1.42%,0.01%
2020-01-01 00:00:30,10,10,4276,121,4155,6.52%,0.18%
2020-01-01 00:00:30,10,11,13616,1575,12041,20.78%,2.40%
2020-01-01 00:00:30,10,12,8832,848,7984,13.48%,1.29%
2020-01-01 00:00:30,11,1,2140,34,2106,3.27%,0.05%
2020-01-01 00:00:30,11,2,3700,112,3588,5.65%,0.17%
2020-01-01 00:00:30,11,3,1464,15,1449,2.23%,0.02%
2020-01-01 00:00:30,11,4,5714,256,5458,8.72%,0.39%
2020-01-01 00:00:30,11,5,288,2,286,0.44%,0.00%
2020-01-01 00:00:30,11,6,6748,335,6413,10.30%,0.51%
2020-01-01 00:00:30,11,7,12781,1206,11575,19.50%,1.84%
2020-01-01 00:00:30,11,8,26182,4750,21432,39.95%,7.25%
2020-01-01 00:00:30,11,9,250,1,249,0.38%,0.00%
2020-01-01 00:00:30,11,10,3560,98,3462,5.43%,0.15%
2020-01-01 00:00:30,11,11,8901,605,8296,13.58%,0.92%
2020-01-01 00:00:30,11,12,5134,206,4928,7.83%,0.31%
2020-01-01 00:00:30,12,1,56,0,56,0.09%,0.00%
2020-01-01 00:00:30,12,2,698,273,425,1.07%,0.42%
2020-01-01 00:00:30,12,3,3405,352,3053,5.20%,0.54%
2020-01-01 00:00:30,12,4,3153,94,3059,4.81%,0.14%
2020-01-01 00:00:30,12,5,10250,1044,9206,15.64%,1.59%
2020-01-01 00:00:30,12,6,5953,306,5647,9.08%,0.47%
2020-01-01 00:00:30,12,7,2457,42,2415,3.75%,0.06%
2020-01-01 00:00:30,12,8,1553,254,1299,2.37%,0.39%
2020-01-01 00:00:30,12,9,24012,5131,18881,36.64%,7.83%
2020-01-01 00:00:30,12,10,4608,423,4185,7.03%,0.65%
2020-01-01 00:00:30,12,11,1714,258,1456,2.62%,0.39%
2020-01-01 00:00:30,12,12,8012,1249,6763,12.23%,1.91%
2020-01-01 00:00:30,13,1,2396,47,2349,3.66%,0.07%
2020-01-01 00:00:30,13,2,2665,54,2611,4.07%,0.08%
2020-01-01 00:00:30,13,3,969,6,963,1.48%,0.01%
2020-01-01 00:00:30,13,4,4072,301,3771,6.21%,0.46%
2020-01-01 00:00:30,13,5,6815,669,6146,10.40%,1.02%
2020-01-01 00:00:30,13,6,5101,351,4750,7.78%,0.54%
2020-01-01 00:00:30,13,7,4558,168,4390,6.95%,0.26%
2020-01-01 00:00:30,13,8,6380,318,6062,9.74%,0.49%
2020-01-01 00:00:30,13,9,7009,690,6319,10.69%,1.05%
2020-01-01 00:00:30,13,10,27103,5512,21591,41.36%,8.41%
2020-01-01 00:00:30,13,11,17469,2491,14978,26.66%,3.80%
2020-01-01 00:00:30,13,12,10570,1185,9385,16.13%,1.81%
2020-01-01 00:00:30,14,1,453,1,452,0.69%,0.00%
2020-01-01 00:00:30,14,2,2280,35,2245,3.48%,0.05%
2020-01-01 00:00:30,14,3,1692,20,1672,2.58%,0.03%
2020-01-01 00:00:30,14,4,4627,149,4478,7.06%,0.23%
2020-01-01 00:00:30,14,5,1444,15,1429,2.20%,0.02%
2020-01-01 00:00:30,14,6,4951,174,4777,7.55%,0.27%
2020-01-01 00:00:30,14,7,12169,1045,11124,18.57%,1.59%
2020-01-01 00:00:30,14,8,13894,1329,12565,21.20%,2.03%
2020-01-01 00:00:30,14,9,1573,17,1556,2.40%,0.03%
2020-01-01 00:00:30,14,10,4098,125,3973,6.25%,0.19%
2020-01-01 00:00:30,14,11,25094,4171,20923,38.29%,6.36%
2020-01-01 00:00:30,14,12,6862,342,6520,10.47%,0.52%
2020-01-01 00:00:30,15,1,478,5,473,0.73%,0.01%
2020-01-01 00:00:30,15,2,59,0,59,0.09%,0.00%
2020-01-01 00:00:30,15,3,4076,112,3964,6.22%,0.17%
2020-01-01 00:00:30,15,4,7121,511,6610,10.87%,0.78%
2020-01-01 00:00:30,15,5,12005,1144,10861,18.32%,1.75%
2020-01-01 00:00:30,15,6,7365,539,6826,11.24%,0.82%
2020-01-01 00:00:30,15,7,4093,196,3897,6.25%,0.30%
2020-01-01 00:00:30,15,8,6514,378,6136,9.94%,0.58%
2020-01-01 00:00:30,15,9,12168,1172,10996,18.57%,1.79%
2020-01-01 00:00:30,15,10,4033,151,3882,6.15%,0.23%
2020-01-01 00:00:30,15,11,10690,977,9713,16.31%,1.49%
2020-01-01 00:00:30,15,12,27845,5681,22164,42.49%,8.67%
2020-01-01 00:00:30,16,1,487,4,483,0.74%,0.01%
2020-01-01 00:00:30,16,2,271,0,271,0.41%,0.00%
2020-01-01 00:00:30,16,3,1408,19,1389,2.15%,0.03%
2020-01-01 00:00:30,16,4,3899,130,3769,5.95%,0.20%
2020-01-01 00:00:30,16,5,7424,538,6886,11.33%,0.82%
2020-01-01 00:00:30,16,6,4677,184,4493,7.14%,0.28%
2020-01-01 00:00:30,16,7,4072,143,3929,6.21%,0.22%
2020-01-01 00:00:30,16,8,8165,517,7648,12.46%,0.79%
2020-01-01 00:00:30,16,9,7846,574,7272,11.97%,0.88%
2020-01-01 00:00:30,16,10,1714,101,1613,2.62%,0.15%
2020-01-01 00:00:30,16,11,10093,813,9280,15.40%,1.24%
2020-01-01 00:00:30,16,12,26822,5051,21771,40.93%,7.71%
2020-01-01 00:00:40,1,1,23484,3790,19694,35.83%,5.78%
2020-01-01 00:00:40,1,2,6451,318,6133,9.84%,0.49%
2020-01-01 00:00:40,1,3,544,3,541,0.83%,0.00%
2020-01-01 00:00:40,1,4,16764,2022,14742,25.58%,3.09%
2020-01-01 00:00:40,1,5,16552,1968,14584,25.26%,3.00%
2020-01-01 00:00:40,1,6,16534,1968,14566,25.23%,3.00%
2020-01-01 00:00:40,1,7,5900,267,5633,9.00%,0.41%
2020-01-01 00:00:40,1,8,4604,148,4456,7.03%,0.23%
2020-01-01 00:00:40,1,9,16478,1953,14525,25.14%,2.98%
2020-01-01 00:00:40,1,10,4067,120,3947,6.21%,0.18%
2020-01-01 00:00:40,1,11,4133,123,4010,6.31%,0.19%
2020-01-01 00:00:40,1,12,16338,1930,14408,24.93%,2.94%
2020-01-01 00:00:40,2,1,1648,30,1618,2.51%,0.05%
2020-01-01 00:00:40,2,2,24570,4085,20485,37.49%,6.23%
2020-01-01 00:00:40,2,3,20099,2816,17283,30.67%,4.30%
2020-01-01 00:00:40,2,4,1571,4,1567,2.40%,0.01%
2020-01-01 00:00:40,2,5,12900,1234,11666,19.68%,1.88%
2020-01-01 00:00:40,2,6,95,0,95,0.14%,0.00%
2020-01-01 00:00:40,2,7,2804,70,2734,4.28%,0.11%
2020-01-01 00:00:40,2,8,1677,27,1650,2.56%,0.04%
2020-01-01 00:00:40,2,9,12715,1197,11518,19.40%,1.83%
2020-01-01 00:00:40,2,10,1250,13,1237,1.91%,0.02%
2020-01-01 00:00:40,2,11,1254,13,1241,1.91%,0.02%
2020-01-01 00:00:40,2,12,12512,1174,11338,19.09%,1.79%
2020-01-01 00:00:40,3,1,1272,12,1260,1.94%,0.02%
2020-01-01 00:00:40,3,2,22008,3375,18633,33.58%,5.15%
2020-01-01 00:00:40,3,3,73865,29508,44357,112.71%,45.03%
2020-01-01 00:00:40,3,4,10597,861,9736,16.17%,1.31%
2020-01-01 00:00:40,3,5,50976,15430,35546,77.78%,23.54%
2020-01-01 00:00:40,3,6,12080,1096,10984,18.43%,1.67%
2020-01-01 00:00:40,3,7,19022,2601,16421,29.03%,3.97%
2020-01-01 00:00:40,3,8,15748,1813,13935,24.03%,2.77%
2020-01-01 00:00:40,3,9,38503,9206,29297,58.75%,14.05%
2020-01-01 00:00:40,3,10,11145,882,10263,17.01%,1.35%
2020-01-01 00:00:40,3,11,1788,27,1761,2.73%,0.04%
2020-01-01 00:00:40,3,12,25563,4326,21237,39.01%,6.60%
2020-01-01 00:00:40,4,1,483,4,479,0.74%,0.01%
2020-01-01 00:00:40,4,2,267,1,266,0.41%,0.00%
2020-01-01 00:00:40,4,3,1087,7,1080,1.66%,0.01%
2020-01-01 00:00:40,4,4,27562,5077,22485,42.06%,7.75%
2020-01-01 00:00:40,4,5,18166,2324,15842,27.72%,3.55%
2020-01-01 00:00:40,4,6,23812,3895,19917,36.33%,5.94%
2020-01-01 00:00:40,4,7,4424,153,4271,6.75%,0.23%
2020-01-01 00:00:40,4,8,2908,54,2854,4.44%,0.08%
2020-01-01 00:00:40,4,9,15827,1772,14055,24.15%,2.70%
2020-01-01 00:00:40,4,10,2150,33,2117,3.28%,0.05%
2020-01-01 00:00:40,4,11,158,1,157,0.24%,0.00%
2020-01-01 00:00:40,4,12,12989,1221,11768,19.82%,1.86%
2020-01-01 00:00:40,5,1,2608,43,2565,3.98%,0.07%
2020-01-01 00:00:40,5,2,753,4,749,1.15%,0.01%
2020-01-01 00:00:40,5,3,568,7,561,0.87%,0.01%
2020-01-01 00:00:40,5,4,25036,4190,20846,38.20%,6.39%
2020-01-01 00:00:40,5,5,9633,696,8937,14.70%,1.06%
2020-01-01 00:00:40,5,6,15725,1814,13911,23.99%,2.77%
2020-01-01 00:00:40,5,7,5454,262,5192,8.32%,0.40%
2020-01-01 00:00:40,5,8,4288,157,4131,6.54%,0.24%
2020-01-01 00:00:40,5,9,8933,604,8329,13.63%,0.92%
2020-01-01 00:00:40,5,10,1134,14,1120,1.73%,0.02%
2020-01-01 00:00:40,5,11,858,10,848,1.31%,0.02%
2020-01-01 00:00:40,5,12,7412,421,6991,11.31%,0.64%
2020-01-01 00:00:40,6,1,1076,13,1063,1.64%,0.02%
2020-01-01 00:00:40,6,2,1235,14,1221,1.88%,0.02%
2020-01-01 00:00:40,6,3,1702,24,1678,2.60%,0.04%
2020-01-01 00:00:40,6,4,2041,20,2021,3.11%,0.03%
2020-01-01 00:00:40,6,5,15891,1778,14113,24.25%,2.71%
2020-01-01 00:00:40,6,6,5346,218,5128,8.16%,0.33%
2020-01-01 00:00:40,6,7,2649,50,2599,4.04%,0.08%
2020-01-01 00:00:40,6,8,2054,38,2016,3.13%,0.06%
2020-01-01 00:00:40,6,9,8631,561,8070,13.17%,0.86%
2020-01-01 00:00:40,6,10,2407,39,2368,3.67%,0.06%
2020-01-01 00:00:40,6,11,454,2,452,0.69%,0.00%
2020-01-01 00:00:40,6,12,6166,282,5884,9.41%,0.43%
2020-01-01 00:00:40,7,1,337,1,336,0.51%,0.00%
2020-01-01 00:00:40,7,2,102,0,102,0.16%,0.00%
2020-01-01 00:00:40,7,3,881,4,877,1.34%,0.01%
2020-01-01 00:00:40,7,4,2066,31,2035,3.15%,0.05%
2020-01-01 00:00:40,7,5,7304,383,6921,11.15%,0.58%
2020-01-01 00:00:40,7,6,14080,1444,12636,21.48%,2.20%
2020-01-01 00:00:40,7,7,4673,167,4506,7.13%,0.25%
2020-01-01 00:00:40,7,8,2392,41,2351,3.65%,0.06%
2020-01-01 00:00:40,7,9,6309,282,6027,9.63%,0.43%
2020-01-01 00:00:40,7,10,1848,21,1827,2.82%,0.03%
2020-01-01 00:00:40,7,11,300,0,300,0.46%,0.00%
2020-01-01 00:00:40,7,12,4419,142,4277,6.74%,0.22%
2020-01-01 00:00:40,8,1,479,3,476,0.73%,0.00%
2020-01-01 00:00:40,8,2,84,0,84,0.13%,0.00%
2020-01-01 00:00:40,8,3,1481,16,1465,2.26%,0.02%
2020-01-01 00:00:40,8,4,2375,43,2332,3.62%,0.07%
2020-01-01 00:00:40,8,5,7993,452,7541,12.20%,0.69%
2020-01-01 00:00:40,8,6,15334,1664,13670,23.40%,2.54%
2020-01-01 00:00:40,8,7,4881,221,4660,7.45%,0.34%
2020-01-01 00:00:40,8,8,1817,36,1781,2.77%,0.05%
2020-01-01 00:00:40,8,9,6380,292,6088,9.74%,0.45%
2020-01-01 00:00:40,8,10,2012,24,1988,3.07%,0.04%
2020-01-01 00:00:40,8,11,244,1,243,0.37%,0.00%
2020-01-01 00:00:40,8,12,4287,126,4161,6.54%,0.19%
2020-01-01 00:00:40,9,1,388,0,388,0.59%,0.00%
2020-01-01 00:00:40,9,2,5649,241,5408,8.62%,0.37%
2020-01-01 00:00:40,9,3,4716,171,4545,7.20%,0.26%
2020-01-01 00:00:40,9,4,5968,242,5726,9.11%,0.37%
2020-01-01 00:00:40,9,5,318,2,316,0.49%,0.00%
2020-01-01 00:00:40,9,6,6500,296,6204,9.92%,0.45%
2020-01-01 00:00:40,9,7,27523,5077,22446,42.00%,7.75%
2020-01-01 00:00:40,9,8,9867,721,9146,15.06%,1.10%
2020-01-01 00:00:40,9,9,204,1,203,0.31%,0.00%
2020-01-01 00:00:40,9,10,2482,54,2428,3.79%,0.08%
2020-01-01 00:00:40,9,11,8664,563,8101,13.22%,0.86%
2020-01-01 00:00:40,9,12,5943,272,5671,9.07%,0.42%
2020-01-01 00:00:40,10,1,1388,341,1047,2.12%,0.52%
2020-01-01 00:00:40,10,2,3059,387,2672,4.67%,0.59%
2020-01-01 00:00:40,10,3,1479,10,1469,2.26%,0.02%
2020-01-01 00:00:40,10,4,3824,709,3115,5.83%,1.08%
2020-01-01 00:00:40,10,5,653,21,632,1.00%,0.03%
2020-01-01 00:00:40,10,6,5494,826,4668,8.38%,1.26%
2020-01-01 00:00:40,10,7,10297,1612,8685,15.71%,2.46%
2020-01-01 00:00:40,10,8,26415,5942,20473,40.31%,9.07%
2020-01-01 00:00:40,10,9,937,2,935,1.43%,0.00%
2020-01-01 00:00:40,10,10,4010,108,3902,6.12%,0.16%
2020-01-01 00:00:40,10,11,12812,1552,11260,19.55%,2.37%
2020-01-01 00:00:40,10,12,8314,889,7425,12.69%,1.36%
2020-01-01 00:00:40,11,1,2073,36,2037,3.16%,0.05%
2020-01-01 00:00:40,11,2,3646,102,3544,5.56%,0.16%
2020-01-01 00:00:40,11,3,1332,23,1309,2.03%,0.04%
2020-01-01 00:00:40,11,4,3567,103,3464,5.44%,0.16%
2020-01-01 00:00:40,11,5,600,1,599,0.92%,0.00%
2020-01-01 00:00:40,11,6,4710,168,4542,7.19%,0.26%
2020-01-01 00:00:40,11,7,10772,874,9898,16.44%,1.33%
2020-01-01 00:00:40,11,8,24013,4000,20013,36.64%,6.10%
2020-01-01 00:00:40,11,9,237,0,237,0.36%,0.00%
2020-01-01 00:00:40,11,10,3064,101,2963,4.68%,0.15%
2020-01-01 00:00:40,11,11,9009,626,8383,13.75%,0.96%
2020-01-01 00:00:40,11,12,5751,260,5491,8.78%,0.40%
2020-01-01 00:00:40,12,1,48,0,48,0.07%,0.00%
2020-01-01 00:00:40,12,2,676,274,402,1.03%,0.42%
2020-01-01 00:00:40,12,3,4674,418,4256,7.13%,0.64%
2020-01-01 00:00:40,12,4,3279,85,3194,5.00%,0.13%
2020-01-01 00:00:40,12,5,11603,1204,10399,17.70%,1.84%
2020-01-01 00:00:40,12,6,6029,273,5756,9.20%,0.42%
2020-01-01 00:00:40,12,7,2444,55,2389,3.73%,0.08%
2020-01-01 00:00:40,12,8,1400,220,1180,2.14%,0.34%
2020-01-01 00:00:40,12,9,24073,5050,19023,36.73%,7.71%
2020-01-01 00:00:40,12,10,3922,349,3573,5.98%,0.53%
2020-01-01 00:00:40,12,11,1580,225,1355,2.41%,0.34%
2020-01-01 00:00:40,12,12,7402,1177,6225,11.29%,1.80%
2020-01-01 00:00:40,13,1,1798,22,1776,2.74%,0.03%
2020-01-01 00:00:40,13,2,2083,35,2048,3.18%,0.05%
2020-01-01 00:00:40,13,3,1115,8,1107,1.70%,0.01%
2020-01-01 00:00:40,13,4,4500,369,4131,6.87%,0.56%
2020-01-01 00:00:40,13,5,7609,825,6784,11.61%,1.26%
2020-01-01 00:00:40,13,6,5689,453,5236,8.68%,0.69%
2020-01-01 00:00:40,13,7,3949,116,3833,6.03%,0.18%
2020-01-01 00:00:40,13,8,6056,251,5805,9.24%,0.38%
2020-01-01 00:00:40,13,9,7827,849,6978,11.94%,1.30%
2020-01-01 00:00:40,13,10,27680,5661,22019,42.24%,8.64%
2020-01-01 00:00:40,13,11,17001,2318,14683,25.94%,3.54%
2020-01-01 00:00:40,13,12,10468,1124,9344,15.97%,1.72%
2020-01-01 00:00:40,14,1,391,1,390,0.60%,0.00%
2020-01-01 00:00:40,14,2,2358,35,2323,3.60%,0.05%
2020-01-01 00:00:40,14,3,1688,16,1672,2.58%,0.02%
2020-01-01 00:00:40,14,4,7913,429,7484,12.07%,0.65%
2020-01-01 00:00:40,14,5,1361,10,1351,2.08%,0.02%
2020-01-01 00:00:40,14,6,8208,463,7745,12.52%,0.71%
2020-01-01 00:00:40,14,7,15560,1690,13870,23.74%,2.58%
2020-01-01 00:00:40,14,8,17077,2004,15073,26.06%,3.06%
2020-01-01 00:00:40,14,9,1492,14,1478,2.28%,0.02%
2020-01-01 00:00:40,14,10,3834,97,3737,5.85%,0.15%
2020-01-01 00:00:40,14,11,28102,5170,22932,42.88%,7.89%
2020-01-01 00:00:40,14,12,6892,336,6556,10.52%,0.51%
2020-01-01 00:00:40,15,1,395,17,378,0.60%,0.03%
2020-01-01 00:00:40,15,2,84,0,84,0.13%,0.00%
2020-01-01 00:00:40,15,3,3661,95,3566,5.59%,0.14%
2020-01-01 00:00:40,15,4,6077,466,5611,9.27%,0.71%
2020-01-01 00:00:40,15,5,10605,998,9607,16.18%,1.52%
2020-01-01 00:00:40,15,6,6292,487,5805,9.60%,0.74%
2020-01-01 00:00:40,15,7,3563,157,3406,5.44%,0.24%
2020-01-01 00:00:40,15,8,5977,316,5661,9.12%,0.48%
2020-01-01 00:00:40,15,9,10748,1015,9733,16.40%,1.55%
2020-01-01 00:00:40,15,10,4072,143,3929,6.21%,0.22%
2020-01-01 00:00:40,15,11,10216,816,9400,15.59%,1.25%
2020-01-01 00:00:40,15,12,26218,4973,21245,40.01%,7.59%
2020-01-01 00:00:40,16,1,625,2,623,0.95%,0.00%
2020-01-01 00:00:40,16,2,252,0,252,0.38%,0.00%
2020-01-01 00:00:40,16,3,1426,15,1411,2.18%,0.02%
2020-01-01 00:00:40,16,4,3906,120,3786,5.96%,0.18%
2020-01-01 00:00:40,16,5,7117,426,6691,10.86%,0.65%
2020-01-01 00:00:40,16,6,4616,158,4458,7.04%,0.24%
2020-01-01 00:00:40,16,7,3626,113,3513,5.53%,0.17%
2020-01-01 00:00:40,16,8,7519,468,7051,11.47%,0.71%
2020-01-01 00:00:40,16,9,7552,479,7073,11.52%,0.73%
2020-01-01 00:00:40,16,10,1718,89,1629,2.62%,0.14%
2020-01-01 00:00:40,16,11,9441,740,8701,14.41%,1.13%
2020-01-01 00:00:40,16,12,26115,4635,21480,39.85%,7.07%
2020-01-01 00:00:50,1,1,22063,3342,18721,33.67%,5.10%
2020-01-01 00:00:50,1,2,8706,548,8158,13.28%,0.84%
2020-01-01 00:00:50,1,3,1013,9,1004,1.55%,0.01%
2020-01-01 00:00:50,1,4,13111,1296,11815,20.01%,1.98%
2020-01-01 00:00:50,1,5,12011,1103,10908,18.33%,1.68%
2020-01-01 00:00:50,1,6,11994,1097,10897,18.30%,1.67%
2020-01-01 00:00:50,1,7,7681,423,7258,11.72%,0.65%
2020-01-01 00:00:50,1,8,6167,270,5897,9.41%,0.41%
2020-01-01 00:00:50,1,9,11920,1086,10834,18.19%,1.66%
2020-01-01 00:00:50,1,10,5630,225,5405,8.59%,0.34%
2020-01-01 00:00:50,1,11,5668,232,5436,8.65%,0.35%
2020-01-01 00:00:50,1,12,11874,1076,10798,18.12%,1.64%
2020-01-01 00:00:50,2,1,3067,43,3024,4.68%,0.07%
2020-01-01 00:00:50,2,2,24774,4088,20686,37.80%,6.24%
2020-01-01 00:00:50,2,3,17878,2182,15696,27.28%,3.33%
2020-01-01 00:00:50,2,4,2324,34,2290,3.55%,0.05%
2020-01-01 00:00:50,2,5,11690,940,10750,17.84%,1.43%
2020-01-01 00:00:50,2,6,67,0,67,0.10%,0.00%
2020-01-01 00:00:50,2,7,3794,101,3693,5.79%,0.15%
2020-01-01 00:00:50,2,8,2468,46,2422,3.77%,0.07%
2020-01-01 00:00:50,2,9,11567,915,10652,17.65%,1.40%
2020-01-01 00:00:50,2,10,1936,30,1906,2.95%,0.05%
2020-01-01 00:00:50,2,11,1937,30,1907,2.96%,0.05%
2020-01-01 00:00:50,2,12,11352,872,10480,17.32%,1.33%
2020-01-01 00:00:50,3,1,6390,280,6110,9.75%,0.43%
2020-01-01 00:00:50,3,2,28278,5297,22981,43.15%,8.08%
2020-01-01 00:00:50,3,3,78807,32895,45912,120.25%,50.19%
2020-01-01 00:00:50,3,4,5077,218,4859,7.75%,0.33%
2020-01-01 00:00:50,3,5,49119,14602,34517,74.95%,22.28%
2020-01-01 00:00:50,3,6,6424,347,6077,9.80%,0.53%
2020-01-01 00:00:50,3,7,19930,2748,17182,30.41%,4.19%
2020-01-01 00:00:50,3,8,16796,1941,14855,25.63%,2.96%
2020-01-01 00:00:50,3,9,42214,11131,31083,64.41%,16.98%
2020-01-01 00:00:50,3,10,12337,1089,11248,18.82%,1.66%
2020-01-01 00:00:50,3,11,1729,28,1701,2.64%,0.04%
2020-01-01 00:00:50,3,12,27890,5158,22732,42.56%,7.87%
2020-01-01 00:00:50,4,1,510,0,510,0.78%,0.00%
2020-01-01 00:00:50,4,2,284,0,284,0.43%,0.00%
2020-01-01 00:00:50,4,3,1403,16,1387,2.14%,0.02%
2020-01-01 00:00:50,4,4,28167,5341,22826,42.98%,8.15%
2020-01-01 00:00:50,4,5,18809,2473,16336,28.70%,3.77%
2020-01-01 00:00:50,4,6,24526,4133,20393,37.42%,6.31%
2020-01-01 00:00:50,4,7,4488,182,4306,6.85%,0.28%
2020-01-01 00:00:50,4,8,2916,77,2839,4.45%,0.12%
2020-01-01 00:00:50,4,9,16256,1867,14389,24.80%,2.85%
2020-01-01 00:00:50,4,10,2340,32,2308,3.57%,0.05%
2020-01-01 00:00:50,4,11,213,1,212,0.33%,0.00%
2020-01-01 00:00:50,4,12,13168,1275,11893,20.09%,1.95%
2020-01-01 00:00:50,5,1,2632,51,2581,4.02%,0.08%
2020-01-01 00:00:50,5,2,761,2,759,1.16%,0.00%
2020-01-01 00:00:50,5,3,649,1,648,0.99%,0.00%
2020-01-01 00:00:50,5,4,24548,4135,20413,37.46%,6.31%
2020-01-01 00:00:50,5,5,10483,822,9661,16.00%,1.25%
2020-01-01 00:00:50,5,6,16806,2043,14763,25.64%,3.12%
2020-01-01 00:00:50,5,7,5763,296,5467,8.79%,0.45%
2020-01-01 00:00:50,5,8,4144,158,3986,6.32%,0.24%
2020-01-01 00:00:50,5,9,9640,711,8929,14.71%,1.08%
2020-01-01 00:00:50,5,10,1027,13,1014,1.57%,0.02%
2020-01-01 00:00:50,5,11,883,10,873,1.35%,0.02%
2020-01-01 00:00:50,5,12,8071,506,7565,12.32%,0.77%
2020-01-01 00:00:50,6,1,1297,12,1285,1.98%,0.02%
2020-01-01 00:00:50,6,2,1457,15,1442,2.22%,0.02%
2020-01-01 00:00:50,6,3,1865,26,1839,2.85%,0.04%
2020-01-01 00:00:50,6,4,1919,13,1906,2.93%,0.02%
2020-01-01 00:00:50,6,5,14080,1378,12702,21.48%,2.10%
2020-01-01 00:00:50,6,6,5301,205,5096,8.09%,0.31%
2020-01-01 00:00:50,6,7,2750,63,2687,4.20%,0.10%
2020-01-01 00:00:50,6,8,2193,43,2150,3.35%,0.07%
2020-01-01 00:00:50,6,9,6680,343,6337,10.19%,0.52%
2020-01-01 00:00:50,6,10,2038,37,2001,3.11%,0.06%
2020-01-01 00:00:50,6,11,379,1,378,0.58%,0.00%
2020-01-01 00:00:50,6,12,4580,177,4403,6.99%,0.27%
2020-01-01 00:00:50,7,1,399,1,398,0.61%,0.00%
2020-01-01 00:00:50,7,2,244,1,243,0.37%,0.00%
2020-01-01 00:00:50,7,3,532,1,531,0.81%,0.00%
2020-01-01 00:00:50,7,4,1516,18,1498,2.31%,0.03%
2020-01-01 00:00:50,7,5,6764,345,6419,10.32%,0.53%
2020-01-01 00:00:50,7,6,12469,1147,11322,19.03%,1.75%
2020-01-01 00:00:50,7,7,4159,137,4022,6.35%,0.21%
2020-01-01 00:00:50,7,8,1796,17,1779,2.74%,0.03%
2020-01-01 00:00:50,7,9,6104,294,5810,9.31%,0.45%
2020-01-01 00:00:50,7,10,2150,38,2112,3.28%,0.06%
2020-01-01 00:00:50,7,11,239,0,239,0.36%,0.00%
2020-01-01 00:00:50,7,12,3915,126,3789,5.97%,0.19%
2020-01-01 00:00:50,8,1,282,2,280,0.43%,0.00%
2020-01-01 00:00:50,8,2,59,0,59,0.09%,0.00%
2020-01-01 00:00:50,8,3,1485,24,1461,2.27%,0.04%
2020-01-01 00:00:50,8,4,2317,46,2271,3.54%,0.07%
2020-01-01 00:00:50,8,5,7896,442,7454,12.05%,0.67%
2020-01-01 00:00:50,8,6,15698,1815,13883,23.95%,2.77%
2020-01-01 00:00:50,8,7,5406,256,5150,8.25%,0.39%
2020-01-01 00:00:50,8,8,2273,54,2219,3.47%,0.08%
2020-01-01 00:00:50,8,9,6315,275,6040,9.64%,0.42%
2020-01-01 00:00:50,8,10,1972,33,1939,3.01%,0.05%
2020-01-01 00:00:50,8,11,251,0,251,0.38%,0.00%
2020-01-01 00:00:50,8,12,4159,110,4049,6.35%,0.17%
2020-01-01 00:00:50,9,1,275,0,275,0.42%,0.00%
2020-01-01 00:00:50,9,2,3270,83,3187,4.99%,0.13%
2020-01-01 00:00:50,9,3,2469,45,2424,3.77%,0.07%
2020-01-01 00:00:50,9,4,7829,464,7365,11.95%,0.71%
2020-01-01 00:00:50,9,5,365,3,362,0.56%,0.00%
2020-01-01 00:00:50,9,6,8499,542,7957,12.97%,0.83%
2020-01-01 00:00:50,9,7,29625,5741,23884,45.20%,8.76%
2020-01-01 00:00:50,9,8,12453,1135,11318,19.00%,1.73%
2020-01-01 00:00:50,9,9,243,1,242,0.37%,0.00%
2020-01-01 00:00:50,9,10,5457,210,5247,8.33%,0.32%
2020-01-01 00:00:50,9,11,11472,973,10499,17.50%,1.48%
2020-01-01 00:00:50,9,12,5717,260,5457,8.72%,0.40%
2020-01-01 00:00:50,10,1,1311,338,973,2.00%,0.52%
2020-01-01 00:00:50,10,2,3331,393,2938,5.08%,0.60%
2020-01-01 00:00:50,10,3,1807,21,1786,2.76%,0.03%
2020-01-01 00:00:50,10,4,3627,805,2822,5.53%,1.23%
2020-01-01 00:00:50,10,5,654,0,654,1.00%,0.00%
2020-01-01 00:00:50,10,6,5081,877,4204,7.75%,1.34%
2020-01-01 00:00:50,10,7,10425,1704,8721,15.91%,2.60%
2020-01-01 00:00:50,10,8,25783,5866,19917,39.34%,8.95%
2020-01-01 00:00:50,10,9,972,13,959,1.48%,0.02%
2020-01-01 00:00:50,10,10,3324,92,3232,5.07%,0.14%
2020-01-01 00:00:50,10,11,12372,1391,10981,18.88%,2.12%
2020-01-01 00:00:50,10,12,8467,825,7642,12.92%,1.26%
2020-01-01 00:00:50,11,1,2016,33,1983,3.08%,0.05%
2020-01-01 00:00:50,11,2,3456,82,3374,5.27%,0.13%
2020-01-01 00:00:50,11,3,1309,4,1305,2.00%,0.01%
2020-01-01 00:00:50,11,4,4018,118,3900,6.13%,0.18%
2020-01-01 00:00:50,11,5,278,1,277,0.42%,0.00%
2020-01-01 00:00:50,11,6,5040,186,4854,7.69%,0.28%
2020-01-01 00:00:50,11,7,10846,876,9970,16.55%,1.34%
2020-01-01 00:00:50,11,8,24659,4291,20368,37.63%,6.55%
2020-01-01 00:00:50,11,9,301,0,301,0.46%,0.00%
2020-01-01 00:00:50,11,10,3523,88,3435,5.38%,0.13%
2020-01-01 00:00:50,11,11,9838,732,9106,15.01%,1.12%
2020-01-01 00:00:50,11,12,6054,308,5746,9.24%,0.47%
2020-01-01 00:00:50,12,1,64,0,64,0.10%,0.00%
2020-01-01 00:00:50,12,2,681,276,405,1.04%,0.42%
2020-01-01 00:00:50,12,3,3522,352,3170,5.37%,0.54%
2020-01-01 00:00:50,12,4,3947,74,3873,6.02%,0.11%
2020-01-01 00:00:50,12,5,11310,1122,10188,17.26%,1.71%
2020-01-01 00:00:50,12,6,6821,329,6492,10.41%,0.50%
2020-01-01 00:00:50,12,7,2632,56,2576,4.02%,0.09%
2020-01-01 00:00:50,12,8,1267,264,1003,1.93%,0.40%
2020-01-01 00:00:50,12,9,23942,4991,18951,36.53%,7.62%
2020-01-01 00:00:50,12,10,3712,399,3313,5.66%,0.61%
2020-01-01 00:00:50,12,11,1426,267,1159,2.18%,0.41%
2020-01-01 00:00:50,12,12,7567,1141,6426,11.55%,1.74%
2020-01-01 00:00:50,13,1,1951,27,1924,2.98%,0.04%
2020-01-01 00:00:50,13,2,2286,39,2247,3.49%,0.06%
2020-01-01 00:00:50,13,3,1088,2,1086,1.66%,0.00%
2020-01-01 00:00:50,13,4,4945,444,4501,7.55%,0.68%
2020-01-01 00:00:50,13,5,8077,911,7166,12.32%,1.39%
2020-01-01 00:00:50,13,6,6151,529,5622,9.39%,0.81%
2020-01-01 00:00:50,13,7,4455,145,4310,6.80%,0.22%
2020-01-01 00:00:50,13,8,6612,298,6314,10.09%,0.45%
2020-01-01 00:00:50,13,9,8336,934,7402,12.72%,1.43%
2020-01-01 00:00:50,13,10,28337,5947,22390,43.24%,9.07%
2020-01-01 00:00:50,13,11,16969,2299,14670,25.89%,3.51%
2020-01-01 00:00:50,13,12,9625,1027,8598,14.69%,1.57%
2020-01-01 00:00:50,14,1,312,1,311,0.48%,0.00%
2020-01-01 00:00:50,14,2,2401,30,2371,3.66%,0.05%
2020-01-01 00:00:50,14,3,1858,15,1843,2.84%,0.02%
2020-01-01 00:00:50,14,4,4379,139,4240,6.68%,0.21%
2020-01-01 00:00:50,14,5,1159,14,1145,1.77%,0.02%
2020-01-01 00:00:50,14,6,4790,171,4619,7.31%,0.26%
2020-01-01 00:00:50,14,7,12262,1091,11171,18.71%,1.66%
2020-01-01 00:00:50,14,8,13772,1348,12424,21.01%,2.06%
2020-01-01 00:00:50,14,9,1292,15,1277,1.97%,0.02%
2020-01-01 00:00:50,14,10,3991,116,3875,6.09%,0.18%
2020-01-01 00:00:50,14,11,24605,4083,20522,37.54%,6.23%
2020-01-01 00:00:50,14,12,6603,306,6297,10.08%,0.47%
2020-01-01 00:00:50,15,1,491,2,489,0.75%,0.00%
2020-01-01 00:00:50,15,2,142,0,142,0.22%,0.00%
2020-01-01 00:00:50,15,3,3729,107,3622,5.69%,0.16%
2020-01-01 00:00:50,15,4,6229,436,5793,9.50%,0.67%
2020-01-01 00:00:50,15,5,10780,990,9790,16.45%,1.51%
2020-01-01 00:00:50,15,6,6455,456,5999,9.85%,0.70%
2020-01-01 00:00:50,15,7,3547,140,3407,5.41%,0.21%
2020-01-01 00:00:50,15,8,5724,286,5438,8.73%,0.44%
2020-01-01 00:00:50,15,9,10920,1011,9909,16.66%,1.54%
2020-01-01 00:00:50,15,10,4049,135,3914,6.18%,0.21%
2020-01-01 00:00:50,15,11,9930,775,9155,15.15%,1.18%
2020-01-01 00:00:50,15,12,25577,4827,20750,39.03%,7.37%
2020-01-01 00:00:50,16,1,392,1,391,0.60%,0.00%
2020-01-01 00:00:50,16,2,300,1,299,0.46%,0.00%
2020-01-01 00:00:50,16,3,1381,17,1364,2.11%,0.03%
2020-01-01 00:00:50,16,4,3847,98,3749,5.87%,0.15%
2020-01-01 00:00:50,16,5,7085,427,6658,10.81%,0.65%
2020-01-01 00:00:50,16,6,4593,150,4443,7.01%,0.23%
2020-01-01 00:00:50,16,7,4076,117,3959,6.22%,0.18%
2020-01-01 00:00:50,16,8,8252,500,7752,12.59%,0.76%
2020-01-01 00:00:50,16,9,7467,465,7002,11.39%,0.71%
2020-01-01 00:00:50,16,10,1514,62,1452,2.31%,0.09%
2020-01-01 00:00:50,16,11,9975,768,9207,15.22%,1.17%
2020-01-01 00:00:50,16,12,26813,4999,21814,40.91%,7.63%
2020-01-01 00:01:00,1,1,20387,2901,17486,31.11%,4.43%
2020-01-01 00:01:00,1,2,8664,604,8060,13.22%,0.92%
2020-01-01 00:01:00,1,3,521,3,518,0.79%,0.00%
2020-01-01 00:01:00,1,4,11488,1001,10487,17.53%,1.53%
2020-01-01 00:01:00,1,5,10492,839,9653,16.01%,1.28%
2020-01-01 00:01:00,1,6,10449,836,9613,15.94%,1.28%
2020-01-01 00:01:00,1,7,8139,538,7601,12.42%,0.82%
2020-01-01 00:01:00,1,8,5336,216,5120,8.14%,0.33%
2020-01-01 00:01:00,1,9,10389,825,9564,15.85%,1.26%
2020-01-01 00:01:00,1,10,4660,169,4491,7.11%,0.26%
2020-01-01 00:01:00,1,11,4745,173,4572,7.24%,0.26%
2020-01-01 00:01:00,1,12,10361,820,9541,15.81%,1.25%
2020-01-01 00:01:00,2,1,1625,15,1610,2.48%,0.02%
2020-01-01 00:01:00,2,2,28248,5234,23014,43.10%,7.99%
2020-01-01 00:01:00,2,3,20701,2925,17776,31.59%,4.46%
2020-01-01 00:01:00,2,4,1417,11,1406,2.16%,0.02%
2020-01-01 00:01:00,2,5,15040,1557,13483,22.95%,2.38%
2020-01-01 00:01:00,2,6,85,0,85,0.13%,0.00%
2020-01-01 00:01:00,2,7,5907,235,5672,9.01%,0.36%
2020-01-01 00:01:00,2,8,4566,147,4419,6.97%,0.22%
2020-01-01 00:01:00,2,9,14897,1511,13386,22.73%,2.31%
2020-01-01 00:01:00,2,10,3732,98,3634,5.69%,0.15%
2020-01-01 00:01:00,2,11,3732,98,3634,5.69%,0.15%
2020-01-01 00:01:00,2,12,14719,1483,13236,22.46%,2.26%
2020-01-01 00:01:00,3,1,1834,31,1803,2.80%,0.05%
2020-01-01 00:01:00,3,2,21560,3172,18388,32.90%,4.84%
2020-01-01 00:01:00,3,3,74177,29894,44283,113.19%,45.61%
2020-01-01 00:01:00,3,4,7768,430,7338,11.85%,0.66%
2020-01-01 00:01:00,3,5,50741,15510,35231,77.42%,23.67%
2020-01-01 00:01:00,3,6,8995,573,8422,13.73%,0.87%
2020-01-01 00:01:00,3,7,17825,2202,15623,27.20%,3.36%
2020-01-01 00:01:00,3,8,15143,1621,13522,23.11%,2.47%
2020-01-01 00:01:00,3,9,41280,10727,30553,62.99%,16.37%
2020-01-01 00:01:00,3,10,13971,1423,12548,21.32%,2.17%
2020-01-01 00:01:00,3,11,2177,36,2141,3.32%,0.05%
2020-01-01 00:01:00,3,12,25644,4450,21194,39.13%,6.79%
2020-01-01 00:01:00,4,1,489,0,489,0.75%,0.00%
2020-01-01 00:01:00,4,2,291,0,291,0.44%,0.00%
2020-01-01 00:01:00,4,3,978,9,969,1.49%,0.01%
2020-01-01 00:01:00,4,4,27387,5017,22370,41.79%,7.66%
2020-01-01 00:01:00,4,5,18131,2335,15796,27.67%,3.56%
2020-01-01 00:01:00,4,6,23979,3914,20065,36.59%,5.97%
2020-01-01 00:01:00,4,7,4621,140,4481,7.05%,0.21%
2020-01-01 00:01:00,4,8,2980,67,2913,4.55%,0.10%
2020-01-01 00:01:00,4,9,16205,1890,14315,24.73%,2.88%
2020-01-01 00:01:00,4,10,2227,34,2193,3.40%,0.05%
2020-01-01 00:01:00,4,11,191,0,191,0.29%,0.00%
2020-01-01 00:01:00,4,12,13083,1222,11861,19.96%,1.86%
2020-01-01 00:01:00,5,1,2615,65,2550,3.99%,0.10%
2020-01-01 00:01:00,5,2,934,7,927,1.43%,0.01%
2020-01-01 00:01:00,5,3,2857,74,2783,4.36%,0.11%
2020-01-01 00:01:00,5,4,26452,4777,21675,40.36%,7.29%
2020-01-01 00:01:00,5,5,12564,1199,11365,19.17%,1.83%
2020-01-01 00:01:00,5,6,18412,2431,15981,28.09%,3.71%
2020-01-01 00:01:00,5,7,5252,215,5037,8.01%,0.33%
2020-01-01 00:01:00,5,8,3665,111,3554,5.59%,0.17%
2020-01-01 00:01:00,5,9,9566,712,8854,14.60%,1.09%
2020-01-01 00:01:00,5,10,1770,27,1743,2.70%,0.04%
2020-01-01 00:01:00,5,11,868,10,858,1.32%,0.02%
2020-01-01 00:01:00,5,12,7241,418,6823,11.05%,0.64%
2020-01-01 00:01:00,6,1,1257,4,1253,1.92%,0.01%
2020-01-01 00:01:00,6,2,1372,5,1367,2.09%,0.01%
2020-01-01 00:01:00,6,3,1791,16,1775,2.73%,0.02%
2020-01-01 00:01:00,6,4,2391,54,2337,3.65%,0.08%
2020-01-01 00:01:00,6,5,13487,1280,12207,20.58%,1.95%
2020-01-01 00:01:00,6,6,5830,237,5593,8.90%,0.36%
2020-01-01 00:01:00,6,7,2835,64,2771,4.33%,0.10%
2020-01-01 00:01:00,6,8,2025,35,1990,3.09%,0.05%
2020-01-01 00:01:00,6,9,5711,267,5444,8.71%,0.41%
2020-01-01 00:01:00,6,10,1810,22,1788,2.76%,0.03%
2020-01-01 00:01:00,6,11,450,2,448,0.69%,0.00%
2020-01-01 00:01:00,6,12,3822,121,3701,5.83%,0.18%
2020-01-01 00:01:00,7,1,361,1,360,0.55%,0.00%
2020-01-01 00:01:00,7,2,248,2,246,0.38%,0.00%
2020-01-01 00:01:00,7,3,1133,4,1129,1.73%,0.01%
2020-01-01 00:01:00,7,4,1438,14,1424,2.19%,0.02%
2020-01-01 00:01:00,7,5,6722,339,6383,10.26%,0.52%
2020-01-01 00:01:00,7,6,12038,1099,10939,18.37%,1.68%
2020-01-01 00:01:00,7,7,3838,97,3741,5.86%,0.15%
2020-01-01 00:01:00,7,8,1479,17,1462,2.26%,0.03%
2020-01-01 00:01:00,7,9,5486,221,5265,8.37%,0.34%
2020-01-01 00:01:00,7,10,1261,11,1250,1.92%,0.02%
2020-01-01 00:01:00,7,11,90,0,90,0.14%,0.00%
2020-01-01 00:01:00,7,12,4164,121,4043,6.35%,0.18%
2020-01-01 00:01:00,8,1,407,4,403,0.62%,0.01%
2020-01-01 00:01:00,8,2,89,0,89,0.14%,0.00%
2020-01-01 00:01:00,8,3,1414,10,1404,2.16%,0.02%
2020-01-01 00:01:00,8,4,2380,39,2341,3.63%,0.06%
2020-01-01 00:01:00,8,5,7606,436,7170,11.61%,0.67%
2020-01-01 00:01:00,8,6,14731,1567,13164,22.48%,2.39%
2020-01-01 00:01:00,8,7,4615,159,4456,7.04%,0.24%
2020-01-01 00:01:00,8,8,1786,30,1756,2.73%,0.05%
2020-01-01 00:01:00,8,9,6090,275,5815,9.29%,0.42%
2020-01-01 00:01:00,8,10,1779,23,1756,2.71%,0.04%
2020-01-01 00:01:00,8,11,241,1,240,0.37%,0.00%
2020-01-01 00:01:00,8,12,4141,146,3995,6.32%,0.22%
2020-01-01 00:01:00,9,1,729,12,717,1.11%,0.02%
2020-01-01 00:01:00,9,2,2549,75,2474,3.89%,0.11%
2020-01-01 00:01:00,9,3,1276,12,1264,1.95%,0.02%
2020-01-01 00:01:00,9,4,10324,801,9523,15.75%,1.22%
2020-01-01 00:01:00,9,5,241,3,238,0.37%,0.00%
2020-01-01 00:01:00,9,6,10964,885,10079,16.73%,1.35%
2020-01-01 00:01:00,9,7,28358,5301,23057,43.27%,8.09%
2020-01-01 00:01:00,9,8,9687,661,9026,14.78%,1.01%
2020-01-01 00:01:00,9,9,199,2,197,0.30%,0.00%
2020-01-01 00:01:00,9,10,3416,69,3347,5.21%,0.11%
2020-01-01 00:01:00,9,11,8697,537,8160,13.27%,0.82%
2020-01-01 00:01:00,9,12,4893,195,4698,7.47%,0.30%
2020-01-01 00:01:00,10,1,1289,339,950,1.97%,0.52%
2020-01-01 00:01:00,10,2,3106,396,2710,4.74%,0.60%
2020-01-01 00:01:00,10,3,1584,24,1560,2.42%,0.04%
2020-01-01 00:01:00,10,4,4124,847,3277,6.29%,1.29%
2020-01-01 00:01:00,10,5,712,10,702,1.09%,0.02%
2020-01-01 00:01:00,10,6,5889,984,4905,8.99%,1.50%
2020-01-01 00:01:00,10,7,10753,1803,8950,16.41%,2.75%
2020-01-01 00:01:00,10,8,27764,6481,21283,42.36%,9.89%
2020-01-01 00:01:00,10,9,992,3,989,1.51%,0.00%
2020-01-01 00:01:00,10,10,4058,125,3933,6.19%,0.19%
2020-01-01 00:01:00,10,11,13629,1631,11998,20.80%,2.49%
2020-01-01 00:01:00,10,12,8962,896,8066,13.67%,1.37%
2020-01-01 00:01:00,11,1,1981,20,1961,3.02%,0.03%
2020-01-01 00:01:00,11,2,3485,81,3404,5.32%,0.12%
2020-01-01 00:01:00,11,3,1396,11,1385,2.13%,0.02%
2020-01-01 00:01:00,11,4,3451,92,3359,5.27%,0.14%
2020-01-01 00:01:00,11,5,545,2,543,0.83%,0.00%
2020-01-01 00:01:00,11,6,4566,152,4414,6.97%,0.23%
2020-01-01 00:01:00,11,7,10515,789,9726,16.04%,1.20%
2020-01-01 00:01:00,11,8,25148,4222,20926,38.37%,6.44%
2020-01-01 00:01:00,11,9,258,0,258,0.39%,0.00%
2020-01-01 00:01:00,11,10,3691,110,3581,5.63%,0.17%
2020-01-01 00:01:00,11,11,10601,837,9764,16.18%,1.28%
2020-01-01 00:01:00,11,12,6620,345,6275,10.10%,0.53%
2020-01-01 00:01:00,12,1,53,1,52,0.08%,0.00%
2020-01-01 00:01:00,12,2,688,276,412,1.05%,0.42%
2020-01-01 00:01:00,12,3,3810,360,3450,5.81%,0.55%
2020-01-01 00:01:00,12,4,3422,63,3359,5.22%,0.10%
2020-01-01 00:01:00,12,5,10927,1066,9861,16.67%,1.63%
2020-01-01 00:01:00,12,6,6206,263,5943,9.47%,0.40%
2020-01-01 00:01:00,12,7,2553,71,2482,3.90%,0.11%
2020-01-01 00:01:00,12,8,1415,243,1172,2.16%,0.37%
2020-01-01 00:01:00,12,9,23853,4829,19024,36.40%,7.37%
2020-01-01 00:01:00,12,10,4038,385,3653,6.16%,0.59%
2020-01-01 00:01:00,12,11,1635,247,1388,2.49%,0.38%
2020-01-01 00:01:00,12,12,7306,1154,6152,11.15%,1.76%
2020-01-01 00:01:00,13,1,2197,48,2149,3.35%,0.07%
2020-01-01 00:01:00,13,2,2663,68,2595,4.06%,0.10%
2020-01-01 00:01:00,13,3,1024,3,1021,1.56%,0.00%
2020-01-01 00:01:00,13,4,4053,327,3726,6.18%,0.50%
2020-01-01 00:01:00,13,5,7412,784,6628,11.31%,1.20%
2020-01-01 00:01:00,13,6,5530,420,5110,8.44%,0.64%
2020-01-01 00:01:00,13,7,4673,180,4493,7.13%,0.27%
2020-01-01 00:01:00,13,8,6655,349,6306,10.15%,0.53%
2020-01-01 00:01:00,13,9,7686,818,6868,11.73%,1.25%
2020-01-01 00:01:00,13,10,29035,6183,22852,44.30%,9.43%
2020-01-01 00:01:00,13,11,17531,2516,15015,26.75%,3.84%
2020-01-01 00:01:00,13,12,10186,1217,8969,15.54%,1.86%
2020-01-01 00:01:00,14,1,299,0,299,0.46%,0.00%
2020-01-01 00:01:00,14,2,2426,45,2381,3.70%,0.07%
2020-01-01 00:01:00,14,3,1845,25,1820,2.82%,0.04%
2020-01-01 00:01:00,14,4,4533,141,4392,6.92%,0.22%
2020-01-01 00:01:00,14,5,1437,18,1419,2.19%,0.03%
2020-01-01 00:01:00,14,6,5207,195,5012,7.95%,0.30%
2020-01-01 00:01:00,14,7,12971,1228,11743,19.79%,1.87%
2020-01-01 00:01:00,14,8,14331,1474,12857,21.87%,2.25%
2020-01-01 00:01:00,14,9,1585,18,1567,2.42%,0.03%
2020-01-01 00:01:00,14,10,4247,139,4108,6.48%,0.21%
2020-01-01 00:01:00,14,11,25331,4304,21027,38.65%,6.57%
2020-01-01 00:01:00,14,12,6516,316,6200,9.94%,0.48%
2020-01-01 00:01:00,15,1,497,1,496,0.76%,0.00%
2020-01-01 00:01:00,15,2,181,0,181,0.28%,0.00%
2020-01-01 00:01:00,15,3,3919,126,3793,5.98%,0.19%
2020-01-01 00:01:00,15,4,7348,476,6872,11.21%,0.73%
2020-01-01 00:01:00,15,5,11933,1083,10850,18.21%,1.65%
2020-01-01 00:01:00,15,6,7555,501,7054,11.53%,0.76%
2020-01-01 00:01:00,15,7,3748,161,3587,5.72%,0.25%
2020-01-01 00:01:00,15,8,6075,345,5730,9.27%,0.53%
2020-01-01 00:01:00,15,9,12106,1103,11003,18.47%,1.68%
2020-01-01 00:01:00,15,10,4008,123,3885,6.12%,0.19%
2020-01-01 00:01:00,15,11,10254,854,9400,15.65%,1.30%
2020-01-01 00:01:00,15,12,27478,5351,22127,41.93%,8.16%
2020-01-01 00:01:00,16,1,406,3,403,0.62%,0.00%
2020-01-01 00:01:00,16,2,277,1,276,0.42%,0.00%
2020-01-01 00:01:00,16,3,1267,19,1248,1.93%,0.03%
2020-01-01 00:01:00,16,4,3948,118,3830,6.02%,0.18%
2020-01-01 00:01:00,16,5,7172,476,6696,10.94%,0.73%
2020-01-01 00:01:00,16,6,4704,164,4540,7.18%,0.25%
2020-01-01 00:01:00,16,7,3928,122,3806,5.99%,0.19%
2020-01-01 00:01:00,16,8,7675,456,7219,11.71%,0.70%
2020-01-01 00:01:00,16,9,7564,513,7051,11.54%,0.78%
2020-01-01 00:01:00,16,10,1585,34,1551,2.42%,0.05%
2020-01-01 00:01:00,16,11,9504,705,8799,14.50%,1.08%
2020-01-01 00:01:00,16,12,26093,4683,21410,39.81%,7.15%
2020-01-01 00:01:10,1,1,18739,2470,16269,28.59%,3.77%
2020-01-01 00:01:10,1,2,9251,620,8631,14.12%,0.95%
2020-01-01 00:01:10,1,3,945,2,943,1.44%,0.00%
2020-01-01 00:01:10,1,4,9152,606,8546,13.96%,0.92%
2020-01-01 00:01:10,1,5,8780,571,8209,13.40%,0.87%
2020-01-01 00:01:10,1,6,8722,555,8167,13.31%,0.85%
2020-01-01 00:01:10,1,7,8294,505,7789,12.66%,0.77%
2020-01-01 00:01:10,1,8,6560,319,6241,10.01%,0.49%
2020-01-01 00:01:10,1,9,8661,552,8109,13.22%,0.84%
2020-01-01 00:01:10,1,10,5908,269,5639,9.01%,0.41%
2020-01-01 00:01:10,1,11,5950,272,5678,9.08%,0.42%
2020-01-01 00:01:10,1,12,8640,550,8090,13.18%,0.84%
2020-01-01 00:01:10,2,1,1950,25,1925,2.98%,0.04%
2020-01-01 00:01:10,2,2,29803,5901,23902,45.48%,9.00%
2020-01-01 00:01:10,2,3,24545,4094,20451,37.45%,6.25%
2020-01-01 00:01:10,2,4,1869,24,1845,2.85%,0.04%
2020-01-01 00:01:10,2,5,17018,2042,14976,25.97%,3.12%
2020-01-01 00:01:10,2,6,76,0,76,0.12%,0.00%
2020-01-01 00:01:10,2,7,3289,82,3207,5.02%,0.13%
2020-01-01 00:01:10,2,8,2017,28,1989,3.08%,0.04%
2020-01-01 00:01:10,2,9,16830,2001,14829,25.68%,3.05%
2020-01-01 00:01:10,2,10,1031,4,1027,1.57%,0.01%
2020-01-01 00:01:10,2,11,1038,4,1034,1.58%,0.01%
2020-01-01 00:01:10,2,12,16665,1962,14703,25.43%,2.99%
2020-01-01 00:01:10,3,1,1408,11,1397,2.15%,0.02%
2020-01-01 00:01:10,3,2,25336,4353,20983,38.66%,6.64%
2020-01-01 00:01:10,3,3,74344,29869,44475,113.44%,45.58%
2020-01-01 00:01:10,3,4,8639,519,8120,13.18%,0.79%
2020-01-01 00:01:10,3,5,46543,13214,33329,71.02%,20.16%
2020-01-01 00:01:10,3,6,10127,725,9402,15.45%,1.11%
2020-01-01 00:01:10,3,7,21673,3201,18472,33.07%,4.88%
2020-01-01 00:01:10,3,8,18694,2390,16304,28.52%,3.65%
2020-01-01 00:01:10,3,9,35904,8246,27658,54.79%,12.58%
2020-01-01 00:01:10,3,10,7333,388,6945,11.19%,0.59%
2020-01-01 00:01:10,3,11,2255,39,2216,3.44%,0.06%
2020-01-01 00:01:10,3,12,27115,4968,22147,41.37%,7.58%
2020-01-01 00:01:10,4,1,492,1,491,0.75%,0.00%
2020-01-01 00:01:10,4,2,270,0,270,0.41%,0.00%
2020-01-01 00:01:10,4,3,1036,13,1023,1.58%,0.02%
2020-01-01 00:01:10,4,4,28702,5377,23325,43.80%,8.20%
2020-01-01 00:01:10,4,5,19112,2564,16548,29.16%,3.91%
2020-01-01 00:01:10,4,6,24811,4134,20677,37.86%,6.31%
2020-01-01 00:01:10,4,7,4407,133,4274,6.72%,0.20%
2020-01-01 00:01:10,4,8,2831,59,2772,4.32%,0.09%
2020-01-01 00:01:10,4,9,16787,1983,14804,25.61%,3.03%
2020-01-01 00:01:10,4,10,2370,45,2325,3.62%,0.07%
2020-01-01 00:01:10,4,11,125,0,125,0.19%,0.00%
2020-01-01 00:01:10,4,12,13588,1312,12276,20.73%,2.00%
2020-01-01 00:01:10,5,1,2586,60,2526,3.95%,0.09%
2020-01-01 00:01:10,5,2,740,6,734,1.13%,0.01%
2020-01-01 00:01:10,5,3,1644,14,1630,2.51%,0.02%
2020-01-01 00:01:10,5,4,23949,3840,20109,36.54%,5.86%
2020-01-01 00:01:10,5,5,12017,1015,11002,18.34%,1.55%
2020-01-01 00:01:10,5,6,17584,2175,15409,26.83%,3.32%
2020-01-01 00:01:10,5,7,4892,199,4693,7.46%,0.30%
2020-01-01 00:01:10,5,8,3739,121,3618,5.71%,0.18%
2020-01-01 00:01:10,5,9,10251,769,9482,15.64%,1.17%
2020-01-01 00:01:10,5,10,2235,53,2182,3.41%,0.08%
2020-01-01 00:01:10,5,11,989,18,971,1.51%,0.03%
2020-01-01 00:01:10,5,12,6959,373,6586,10.62%,0.57%
2020-01-01 00:01:10,6,1,1137,16,1121,1.73%,0.02%
2020-01-01 00:01:10,6,2,1238,18,1220,1.89%,0.03%
2020-01-01 00:01:10,6,3,1754,28,1726,2.68%,0.04%
2020-01-01 00:01:10,6,4,1782,26,1756,2.72%,0.04%
2020-01-01 00:01:10,6,5,13165,1277,11888,20.09%,1.95%
2020-01-01 00:01:10,6,6,5082,182,4900,7.75%,0.28%
2020-01-01 00:01:10,6,7,2754,72,2682,4.20%,0.11%
2020-01-01 00:01:10,6,8,2150,47,2103,3.28%,0.07%
2020-01-01 00:01:10,6,9,6110,279,5831,9.32%,0.43%
2020-01-01 00:01:10,6,10,1856,17,1839,2.83%,0.03%
2020-01-01 00:01:10,6,11,447,0,447,0.68%,0.00%
2020-01-01 00:01:10,6,12,4191,146,4045,6.39%,0.22%
2020-01-01 00:01:10,7,1,318,3,315,0.49%,0.00%
2020-01-01 00:01:10,7,2,805,7,798,1.23%,0.01%
2020-01-01 00:01:10,7,3,1366,12,1354,2.08%,0.02%
2020-01-01 00:01:10,7,4,1485,14,1471,2.27%,0.02%
2020-01-01 00:01:10,7,5,6902,379,6523,10.53%,0.58%
2020-01-01 00:01:10,7,6,12663,1109,11554,19.32%,1.69%
2020-01-01 00:01:10,7,7,4252,107,4145,6.49%,0.16%
2020-01-01 00:01:10,7,8,1514,12,1502,2.31%,0.02%
2020-01-01 00:01:10,7,9,5395,226,5169,8.23%,0.34%
2020-01-01 00:01:10,7,10,1338,21,1317,2.04%,0.03%
2020-01-01 00:01:10,7,11,84,0,84,0.13%,0.00%
2020-01-01 00:01:10,7,12,3927,135,3792,5.99%,0.21%
2020-01-01 00:01:10,8,1,518,3,515,0.79%,0.00%
2020-01-01 00:01:10,8,2,69,0,69,0.11%,0.00%
2020-01-01 00:01:10,8,3,1407,10,1397,2.15%,0.02%
2020-01-01 00:01:10,8,4,2602,53,2549,3.97%,0.08%
2020-01-01 00:01:10,8,5,7913,457,7456,12.07%,0.70%
2020-01-01 00:01:10,8,6,15204,1640,13564,23.20%,2.50%
2020-01-01 00:01:10,8,7,4572,151,4421,6.98%,0.23%
2020-01-01 00:01:10,8,8,1615,21,1594,2.46%,0.03%
2020-01-01 00:01:10,8,9,6389,296,6093,9.75%,0.45%
2020-01-01 00:01:10,8,10,2053,29,2024,3.13%,0.04%
2020-01-01 00:01:10,8,11,290,0,290,0.44%,0.00%
2020-01-01 00:01:10,8,12,4262,131,4131,6.50%,0.20%
2020-01-01 00:01:10,9,1,431,1,430,0.66%,0.00%
2020-01-01 00:01:10,9,2,3477,91,3386,5.31%,0.14%
2020-01-01 00:01:10,9,3,2611,55,2556,3.98%,0.08%
2020-01-01 00:01:10,9,4,6446,272,6174,9.84%,0.42%
2020-01-01 00:01:10,9,5,215,0,215,0.33%,0.00%
2020-01-01 00:01:10,9,6,6926,308,6618,10.57%,0.47%
2020-01-01 00:01:10,9,7,25927,4509,21418,39.56%,6.88%
2020-01-01 00:01:10,9,8,10797,801,9996,16.47%,1.22%
2020-01-01 00:01:10,9,9,198,0,198,0.30%,0.00%
2020-01-01 00:01:10,9,10,4791,170,4621,7.31%,0.26%
2020-01-01 00:01:10,9,11,9768,660,9108,14.90%,1.01%
2020-01-01 00:01:10,9,12,4715,160,4555,7.19%,0.24%
2020-01-01 00:01:10,10,1,1453,396,1057,2.22%,0.60%
2020-01-01 00:01:10,10,2,3335,461,2874,5.09%,0.70%
2020-01-01 00:01:10,10,3,1714,31,1683,2.62%,0.05%
2020-01-01 00:01:10,10,4,3996,886,3110,6.10%,1.35%
2020-01-01 00:01:10,10,5,719,1,718,1.10%,0.00%
2020-01-01 00:01:10,10,6,5617,987,4630,8.57%,1.51%
2020-01-01 00:01:10,10,7,10707,1861,8846,16.34%,2.84%
2020-01-01 00:01:10,10,8,26582,6146,20436,40.56%,9.38%
2020-01-01 00:01:10,10,9,1097,9,1088,1.67%,0.01%
2020-01-01 00:01:10,10,10,3775,93,3682,5.76%,0.14%
2020-01-01 00:01:10,10,11,12940,1440,11500,19.74%,2.20%
2020-01-01 00:01:10,10,12,8561,832,7729,13.06%,1.27%
2020-01-01 00:01:10,11,1,2327,49,2278,3.55%,0.07%
2020-01-01 00:01:10,11,2,4011,121,3890,6.12%,0.18%
2020-01-01 00:01:10,11,3,1462,16,1446,2.23%,0.02%
2020-01-01 00:01:10,11,4,5160,193,4967,7.87%,0.29%
2020-01-01 00:01:10,11,5,157,1,156,0.24%,0.00%
2020-01-01 00:01:10,11,6,6010,269,5741,9.17%,0.41%
2020-01-01 00:01:10,11,7,12537,1155,11382,19.13%,1.76%
2020-01-01 00:01:10,11,8,28078,5448,22630,42.84%,8.31%
2020-01-01 00:01:10,11,9,313,1,312,0.48%,0.00%
2020-01-01 00:01:10,11,10,4087,132,3955,6.24%,0.20%
2020-01-01 00:01:10,11,11,11061,942,10119,16.88%,1.44%
2020-01-01 00:01:10,11,12,6682,351,6331,10.20%,0.54%
2020-01-01 00:01:10,12,1,32,0,32,0.05%,0.00%
2020-01-01 00:01:10,12,2,704,283,421,1.07%,0.43%
2020-01-01 00:01:10,12,3,4164,377,3787,6.35%,0.58%
2020-01-01 00:01:10,12,4,3290,63,3227,5.02%,0.10%
2020-01-01 00:01:10,12,5,10942,1042,9900,16.70%,1.59%
2020-01-01 00:01:10,12,6,5890,247,5643,8.99%,0.38%
2020-01-01 00:01:10,12,7,2315,41,2274,3.53%,0.06%
2020-01-01 00:01:10,12,8,1297,293,1004,1.98%,0.45%
2020-01-01 00:01:10,12,9,24212,5041,19171,36.94%,7.69%
2020-01-01 00:01:10,12,10,3913,400,3513,5.97%,0.61%
2020-01-01 00:01:10,12,11,1436,296,1140,2.19%,0.45%
2020-01-01 00:01:10,12,12,7986,1244,6742,12.19%,1.90%
2020-01-01 00:01:10,13,1,1905,32,1873,2.91%,0.05%
2020-01-01 00:01:10,13,2,2279,39,2240,3.48%,0.06%
2020-01-01 00:01:10,13,3,988,4,984,1.51%,0.01%
2020-01-01 00:01:10,13,4,4509,377,4132,6.88%,0.58%
2020-01-01 00:01:10,13,5,7963,889,7074,12.15%,1.36%
2020-01-01 00:01:10,13,6,6084,498,5586,9.28%,0.76%
2020-01-01 00:01:10,13,7,4514,164,4350,6.89%,0.25%
2020-01-01 00:01:10,13,8,6251,289,5962,9.54%,0.44%
2020-01-01 00:01:10,13,9,8232,926,7306,12.56%,1.41%
2020-01-01 00:01:10,13,10,27741,5827,21914,42.33%,8.89%
2020-01-01 00:01:10,13,11,16355,2292,14063,24.96%,3.50%
2020-01-01 00:01:10,13,12,9352,1078,8274,14.27%,1.64%
2020-01-01 00:01:10,14,1,300,0,300,0.46%,0.00%
2020-01-01 00:01:10,14,2,2281,29,2252,3.48%,0.04%
2020-01-01 00:01:10,14,3,1689,19,1670,2.58%,0.03%
2020-01-01 00:01:10,14,4,4418,150,4268,6.74%,0.23%
2020-01-01 00:01:10,14,5,1436,16,1420,2.19%,0.02%
2020-01-01 00:01:10,14,6,4919,181,4738,7.51%,0.28%
2020-01-01 00:01:10,14,7,12628,1131,11497,19.27%,1.73%
2020-01-01 00:01:10,14,8,14369,1448,12921,21.93%,2.21%
2020-01-01 00:01:10,14,9,1550,16,1534,2.37%,0.02%
2020-01-01 00:01:10,14,10,3871,99,3772,5.91%,0.15%
2020-01-01 00:01:10,14,11,25565,4364,21201,39.01%,6.66%
2020-01-01 00:01:10,14,12,7136,407,6729,10.89%,0.62%
2020-01-01 00:01:10,15,1,377,0,377,0.58%,0.00%
2020-01-01 00:01:10,15,2,182,1,181,0.28%,0.00%
2020-01-01 00:01:10,15,3,4637,165,4472,7.08%,0.25%
2020-01-01 00:01:10,15,4,5997,352,5645,9.15%,0.54%
2020-01-01 00:01:10,15,5,11327,961,10366,17.28%,1.47%
2020-01-01 00:01:10,15,6,6201,370,5831,9.46%,0.56%
2020-01-01 00:01:10,15,7,4028,137,3891,6.15%,0.21%
2020-01-01 00:01:10,15,8,5767,264,5503,8.80%,0.40%
2020-01-01 00:01:10,15,9,11467,973,10494,17.50%,1.48%
2020-01-01 00:01:10,15,10,4316,140,4176,6.59%,0.21%
2020-01-01 00:01:10,15,11,10214,730,9484,15.59%,1.11%
2020-01-01 00:01:10,15,12,26754,4958,21796,40.82%,7.57%
2020-01-01 00:01:10,16,1,490,2,488,0.75%,0.00%
2020-01-01 00:01:10,16,2,319,1,318,0.49%,0.00%
2020-01-01 00:01:10,16,3,2494,60,2434,3.81%,0.09%
2020-01-01 00:01:10,16,4,3748,99,3649,5.72%,0.15%
2020-01-01 00:01:10,16,5,8326,583,7743,12.70%,0.89%
2020-01-01 00:01:10,16,6,4605,162,4443,7.03%,0.25%
2020-01-01 00:01:10,16,7,3267,85,3182,4.99%,0.13%
2020-01-01 00:01:10,16,8,9317,545,8772,14.22%,0.83%
2020-01-01 00:01:10,16,9,8740,631,8109,13.34%,0.96%
2020-01-01 00:01:10,16,10,1219,12,1207,1.86%,0.02%
2020-01-01 00:01:10,16,11,10772,764,10008,16.44%,1.17%
2020-01-01 00:01:10,16,12,28514,5353,23161,43.51%,8.17%
2020-01-01 00:01:20,1,1,18075,2268,15807,27.58%,3.46%
2020-01-01 00:01:20,1,2,6693,328,6365,10.21%,0.50%
2020-01-01 00:01:20,1,3,1812,26,1786,2.76%,0.04%
2020-01-01 00:01:20,1,4,11011,922,10089,16.80%,1.41%
2020-01-01 00:01:20,1,5,10780,870,9910,16.45%,1.33%
2020-01-01 00:01:20,1,6,10735,868,9867,16.38%,1.32%
2020-01-01 00:01:20,1,7,4865,180,4685,7.42%,0.27%
2020-01-01 00:01:20,1,8,3296,79,3217,5.03%,0.12%
2020-01-01 00:01:20,1,9,10634,848,9786,16.23%,1.29%
2020-01-01 00:01:20,1,10,2627,48,2579,4.01%,0.07%
2020-01-01 00:01:20,1,11,2682,54,2628,4.09%,0.08%
2020-01-01 00:01:20,1,12,10624,848,9776,16.21%,1.29%
2020-01-01 00:01:20,2,1,1605,13,1592,2.45%,0.02%
2020-01-01 00:01:20,2,2,26064,4625,21439,39.77%,7.06%
2020-01-01 00:01:20,2,3,21126,3131,17995,32.24%,4.78%
2020-01-01 00:01:20,2,4,1489,10,1479,2.27%,0.02%
2020-01-01 00:01:20,2,5,12965,1230,11735,19.78%,1.88%
2020-01-01 00:01:20,2,6,95,0,95,0.14%,0.00%
2020-01-01 00:01:20,2,7,3321,75,3246,5.07%,0.11%
2020-01-01 00:01:20,2,8,1950,24,1926,2.98%,0.04%
2020-01-01 00:01:20,2,9,12795,1200,11595,19.52%,1.83%
2020-01-01 00:01:20,2,10,1288,13,1275,1.97%,0.02%
2020-01-01 00:01:20,2,11,1289,13,1276,1.97%,0.02%
2020-01-01 00:01:20,2,12,12603,1162,11441,19.23%,1.77%
2020-01-01 00:01:20,3,1,1863,23,1840,2.84%,0.04%
2020-01-01 00:01:20,3,2,23304,3698,19606,35.56%,5.64%
2020-01-01 00:01:20,3,3,65994,24356,41638,100.70%,37.16%
2020-01-01 00:01:20,3,4,6491,286,6205,9.90%,0.44%
2020-01-01 00:01:20,3,5,41740,10699,31041,63.69%,16.33%
2020-01-01 00:01:20,3,6,7967,426,7541,12.16%,0.65%
2020-01-01 00:01:20,3,7,19426,2576,16850,29.64%,3.93%
2020-01-01 00:01:20,3,8,15836,1735,14101,24.16%,2.65%
2020-01-01 00:01:20,3,9,33384,7082,26302,50.94%,10.81%
2020-01-01 00:01:20,3,10,5639,230,5409,8.60%,0.35%
2020-01-01 00:01:20,3,11,2274,34,2240,3.47%,0.05%
2020-01-01 00:01:20,3,12,25861,4426,21435,39.46%,6.75%
2020-01-01 00:01:20,4,1,478,1,477,0.73%,0.00%
2020-01-01 00:01:20,4,2,262,1,261,0.40%,0.00%
2020-01-01 00:01:20,4,3,938,7,931,1.43%,0.01%
2020-01-01 00:01:20,4,4,28551,5371,23180,43.57%,8.20%
2020-01-01 00:01:20,4,5,18828,2391,16437,28.73%,3.65%
2020-01-01 00:01:20,4,6,24569,4044,20525,37.49%,6.17%
2020-01-01 00:01:20,4,7,4587,150,4437,7.00%,0.23%
2020-01-01 00:01:20,4,8,2885,62,2823,4.40%,0.09%
2020-01-01 00:01:20,4,9,16730,1959,14771,25.53%,2.99%
2020-01-01 00:01:20,4,10,2398,52,2346,3.66%,0.08%
2020-01-01 00:01:20,4,11,132,0,132,0.20%,0.00%
2020-01-01 00:01:20,4,12,13439,1272,12167,20.51%,1.94%
2020-01-01 00:01:20,5,1,2650,51,2599,4.04%,0.08%
2020-01-01 00:01:20,5,2,813,6,807,1.24%,0.01%
2020-01-01 00:01:20,5,3,1324,9,1315,2.02%,0.01%
2020-01-01 00:01:20,5,4,30543,6111,24432,46.60%,9.32%
2020-01-01 00:01:20,5,5,11743,978,10765,17.92%,1.49%
2020-01-01 00:01:20,5,6,19816,2752,17064,30.24%,4.20%
2020-01-01 00:01:20,5,7,7359,388,6971,11.23%,0.59%
2020-01-01 00:01:20,5,8,4841,161,4680,7.39%,0.25%
2020-01-01 00:01:20,5,9,10305,769,9536,15.72%,1.17%
2020-01-01 00:01:20,5,10,2085,36,2049,3.18%,0.05%
2020-01-01 00:01:20,5,11,1077,10,1067,1.64%,0.02%
2020-01-01 00:01:20,5,12,7780,441,7339,11.87%,0.67%
2020-01-01 00:01:20,6,1,1141,8,1133,1.74%,0.01%
2020-01-01 00:01:20,6,2,1297,12,1285,1.98%,0.02%
2020-01-01 00:01:20,6,3,1681,20,1661,2.57%,0.03%
2020-01-01 00:01:20,6,4,1182,18,1164,1.80%,0.03%
2020-01-01 00:01:20,6,5,13120,1242,11878,20.02%,1.90%
2020-01-01 00:01:20,6,6,4314,158,4156,6.58%,0.24%
2020-01-01 00:01:20,6,7,2581,75,2506,3.94%,0.11%
2020-01-01 00:01:20,6,8,2023,31,1992,3.09%,0.05%
2020-01-01 00:01:20,6,9,6924,327,6597,10.57%,0.50%
2020-01-01 00:01:20,6,10,3045,50,2995,4.65%,0.08%
2020-01-01 00:01:20,6,11,492,1,491,0.75%,0.00%
2020-01-01 00:01:20,6,12,3807,109,3698,5.81%,0.17%
2020-01-01 00:01:20,7,1,378,2,376,0.58%,0.00%
2020-01-01 00:01:20,7,2,595,3,592,0.91%,0.00%
2020-01-01 00:01:20,7,3,556,5,551,0.85%,0.01%
2020-01-01 00:01:20,7,4,1902,29,1873,2.90%,0.04%
2020-01-01 00:01:20,7,5,6538,303,6235,9.98%,0.46%
2020-01-01 00:01:20,7,6,13045,1244,11801,19.91%,1.90%
2020-01-01 00:01:20,7,7,4590,168,4422,7.00%,0.26%
2020-01-01 00:01:20,7,8,1592,10,1582,2.43%,0.02%
2020-01-01 00:01:20,7,9,5858,250,5608,8.94%,0.38%
2020-01-01 00:01:20,7,10,1891,25,1866,2.89%,0.04%
2020-01-01 00:01:20,7,11,135,0,135,0.21%,0.00%
2020-01-01 00:01:20,7,12,3881,129,3752,5.92%,0.20%
2020-01-01 00:01:20,8,1,394,2,392,0.60%,0.00%
2020-01-01 00:01:20,8,2,51,0,51,0.08%,0.00%
2020-01-01 00:01:20,8,3,1591,15,1576,2.43%,0.02%
2020-01-01 00:01:20,8,4,2459,39,2420,3.75%,0.06%
2020-01-01 00:01:20,8,5,8145,484,7661,12.43%,0.74%
2020-01-01 00:01:20,8,6,15372,1649,13723,23.46%,2.52%
2020-01-01 00:01:20,8,7,4636,159,4477,7.07%,0.24%
2020-01-01 00:01:20,8,8,1733,29,1704,2.64%,0.04%
2020-01-01 00:01:20,8,9,6447,305,6142,9.84%,0.47%
2020-01-01 00:01:20,8,10,1806,27,1779,2.76%,0.04%
2020-01-01 00:01:20,8,11,304,2,302,0.46%,0.00%
2020-01-01 00:01:20,8,12,4544,150,4394,6.93%,0.23%
2020-01-01 00:01:20,9,1,291,0,291,0.44%,0.00%
2020-01-01 00:01:20,9,2,2048,33,2015,3.12%,0.05%
2020-01-01 00:01:20,9,3,1320,8,1312,2.01%,0.01%
2020-01-01 00:01:20,9,4,9723,699,9024,14.84%,1.07%
2020-01-01 00:01:20,9,5,196,1,195,0.30%,0.00%
2020-01-01 00:01:20,9,6,10092,752,9340,15.40%,1.15%
2020-01-01 00:01:20,9,7,27660,5237,22423,42.21%,7.99%
2020-01-01 00:01:20,9,8,10912,887,10025,16.65%,1.35%
2020-01-01 00:01:20,9,9,174,1,173,0.27%,0.00%
2020-01-01 00:01:20,9,10,2209,46,2163,3.37%,0.07%
2020-01-01 00:01:20,9,11,10148,763,9385,15.48%,1.16%
2020-01-01 00:01:20,9,12,7659,430,7229,11.69%,0.66%
2020-01-01 00:01:20,10,1,1424,403,1021,2.17%,0.61%
2020-01-01 00:01:20,10,2,3401,470,2931,5.19%,0.72%
2020-01-01 00:01:20,10,3,1821,38,1783,2.78%,0.06%
2020-01-01 00:01:20,10,4,4237,894,3343,6.47%,1.36%
2020-01-01 00:01:20,10,5,736,2,734,1.12%,0.00%
2020-01-01 00:01:20,10,6,5823,989,4834,8.89%,1.51%
2020-01-01 00:01:20,10,7,10883,1879,9004,16.61%,2.87%
2020-01-01 00:01:20,10,8,28202,6657,21545,43.03%,10.16%
2020-01-01 00:01:20,10,9,1068,7,1061,1.63%,0.01%
2020-01-01 00:01:20,10,10,3698,120,3578,5.64%,0.18%
2020-01-01 00:01:20,10,11,13988,1674,12314,21.34%,2.55%
2020-01-01 00:01:20,10,12,9729,987,8742,14.85%,1.51%
2020-01-01 00:01:20,11,1,2145,40,2105,3.27%,0.06%
2020-01-01 00:01:20,11,2,3673,107,3566,5.60%,0.16%
2020-01-01 00:01:20,11,3,1387,11,1376,2.12%,0.02%
2020-01-01 00:01:20,11,4,4190,239,3951,6.39%,0.36%
2020-01-01 00:01:20,11,5,558,4,554,0.85%,0.01%
2020-01-01 00:01:20,11,6,5456,326,5130,8.33%,0.50%
2020-01-01 00:01:20,11,7,11845,1135,10710,18.07%,1.73%
2020-01-01 00:01:20,11,8,27477,5162,22315,41.93%,7.88%
2020-01-01 00:01:20,11,9,242,2,240,0.37%,0.00%
2020-01-01 00:01:20,11,10,3706,107,3599,5.65%,0.16%
2020-01-01 00:01:20,11,11,11237,969,10268,17.15%,1.48%
2020-01-01 00:01:20,11,12,7221,447,6774,11.02%,0.68%
2020-01-01 00:01:20,12,1,35,0,35,0.05%,0.00%
2020-01-01 00:01:20,12,2,739,282,457,1.13%,0.43%
2020-01-01 00:01:20,12,3,3997,365,3632,6.10%,0.56%
2020-01-01 00:01:20,12,4,3521,63,3458,5.37%,0.10%
2020-01-01 00:01:20,12,5,11496,1110,10386,17.54%,1.69%
2020-01-01 00:01:20,12,6,6536,283,6253,9.97%,0.43%
2020-01-01 00:01:20,12,7,2773,61,2712,4.23%,0.09%
2020-01-01 00:01:20,12,8,1772,283,1489,2.70%,0.43%
2020-01-01 00:01:20,12,9,25473,5337,20136,38.87%,8.14%
2020-01-01 00:01:20,12,10,4769,437,4332,7.28%,0.67%
2020-01-01 00:01:20,12,11,2037,289,1748,3.11%,0.44%
2020-01-01 00:01:20,12,12,7957,1271,6686,12.14%,1.94%
2020-01-01 00:01:20,13,1,1940,35,1905,2.96%,0.05%
2020-01-01 00:01:20,13,2,2333,51,2282,3.56%,0.08%
2020-01-01 00:01:20,13,3,1216,17,1199,1.86%,0.03%
2020-01-01 00:01:20,13,4,4920,403,4517,7.51%,0.61%
2020-01-01 00:01:20,13,5,8307,943,7364,12.68%,1.44%
2020-01-01 00:01:20,13,6,6125,509,5616,9.35%,0.78%
2020-01-01 00:01:20,13,7,4473,149,4324,6.83%,0.23%
2020-01-01 00:01:20,13,8,6231,327,5904,9.51%,0.50%
2020-01-01 00:01:20,13,9,8528,967,7561,13.01%,1.48%
2020-01-01 00:01:20,13,10,29545,6631,22914,45.08%,10.12%
2020-01-01 00:01:20,13,11,17399,2596,14803,26.55%,3.96%
2020-01-01 00:01:20,13,12,10540,1272,9268,16.08%,1.94%
2020-01-01 00:01:20,14,1,365,0,365,0.56%,0.00%
2020-01-01 00:01:20,14,2,2589,51,2538,3.95%,0.08%
2020-01-01 00:01:20,14,3,1938,23,1915,2.96%,0.04%
2020-01-01 00:01:20,14,4,4609,170,4439,7.03%,0.26%
2020-01-01 00:01:20,14,5,1412,15,1397,2.15%,0.02%
2020-01-01 00:01:20,14,6,5052,198,4854,7.71%,0.30%
2020-01-01 00:01:20,14,7,13260,1353,11907,20.23%,2.06%
2020-01-01 00:01:20,14,8,14901,1667,13234,22.74%,2.54%
2020-01-01 00:01:20,14,9,1611,17,1594,2.46%,0.03%
2020-01-01 00:01:20,14,10,4264,135,4129,6.51%,0.21%
2020-01-01 00:01:20,14,11,26537,4758,21779,40.49%,7.26%
2020-01-01 00:01:20,14,12,7176,370,6806,10.95%,0.56%
2020-01-01 00:01:20,15,1,415,2,413,0.63%,0.00%
2020-01-01 00:01:20,15,2,164,0,164,0.25%,0.00%
2020-01-01 00:01:20,15,3,4502,132,4370,6.87%,0.20%
2020-01-01 00:01:20,15,4,6474,403,6071,9.88%,0.61%
2020-01-01 00:01:20,15,5,11812,1036,10776,18.02%,1.58%
2020-01-01 00:01:20,15,6,6679,423,6256,10.19%,0.65%
2020-01-01 00:01:20,15,7,3831,128,3703,5.85%,0.20%
2020-01-01 00:01:20,15,8,5907,293,5614,9.01%,0.45%
2020-01-01 00:01:20,15,9,11965,1059,10906,18.26%,1.62%
2020-01-01 00:01:20,15,10,4532,164,4368,6.92%,0.25%
2020-01-01 00:01:20,15,11,10628,850,9778,16.22%,1.30%
2020-01-01 00:01:20,15,12,27867,5390,22477,42.52%,8.22%
2020-01-01 00:01:20,16,1,535,4,531,0.82%,0.01%
2020-01-01 00:01:20,16,2,335,4,331,0.51%,0.01%
2020-01-01 00:01:20,16,3,1419,22,1397,2.17%,0.03%
2020-01-01 00:01:20,16,4,3393,92,3301,5.18%,0.14%
2020-01-01 00:01:20,16,5,6746,424,6322,10.29%,0.65%
2020-01-01 00:01:20,16,6,4214,163,4051,6.43%,0.25%
2020-01-01 00:01:20,16,7,3457,72,3385,5.27%,0.11%
2020-01-01 00:01:20,16,8,8251,575,7676,12.59%,0.88%
2020-01-01 00:01:20,16,9,7196,472,6724,10.98%,0.72%
2020-01-01 00:01:20,16,10,1542,21,1521,2.35%,0.03%
2020-01-01 00:01:20,16,11,10049,883,9166,15.33%,1.35%
2020-01-01 00:01:20,16,12,26423,4984,21439,40.32%,7.60%
2020-01-01 00:01:30,1,1,21394,3092,18302,32.64%,4.72%
2020-01-01 00:01:30,1,2,8277,512,7765,12.63%,0.78%
2020-01-01 00:01:30,1,3,751,2,749,1.15%,0.00%
2020-01-01 00:01:30,1,4,12757,1178,11579,19.47%,1.80%
2020-01-01 00:01:30,1,5,12630,1155,11475,19.27%,1.76%
2020-01-01 00:01:30,1,6,12555,1137,11418,19.16%,1.73%
2020-01-01 00:01:30,1,7,7514,426,7088,11.47%,0.65%
2020-01-01 00:01:30,1,8,6861,345,6516,10.47%,0.53%
2020-01-01 00:01:30,1,9,12502,1128,11374,19.08%,1.72%
2020-01-01 00:01:30,1,10,6131,288,5843,9.36%,0.44%
2020-01-01 00:01:30,1,11,6195,292,5903,9.45%,0.45%
2020-01-01 00:01:30,1,12,12437,1120,11317,18.98%,1.71%
2020-01-01 00:01:30,2,1,1070,5,1065,1.63%,0.01%
2020-01-01 00:01:30,2,2,23809,3751,20058,36.33%,5.72%
2020-01-01 00:01:30,2,3,19621,2579,17042,29.94%,3.94%
2020-01-01 00:01:30,2,4,997,4,993,1.52%,0.01%
2020-01-01 00:01:30,2,5,11801,961,10840,18.01%,1.47%
2020-01-01 00:01:30,2,6,74,0,74,0.11%,0.00%
2020-01-01 00:01:30,2,7,3094,67,3027,4.72%,0.10%
2020-01-01 00:01:30,2,8,2161,34,2127,3.30%,0.05%
2020-01-01 00:01:30,2,9,11652,931,10721,17.78%,1.42%
2020-01-01 00:01:30,2,10,1513,15,1498,2.31%,0.02%
2020-01-01 00:01:30,2,11,1515,15,1500,2.31%,0.02%
2020-01-01 00:01:30,2,12,11480,901,10579,17.52%,1.37%
2020-01-01 00:01:30,3,1,1675,20,1655,2.56%,0.03%
2020-01-01 00:01:30,3,2,22885,3581,19304,34.92%,5.46%
2020-01-01 00:01:30,3,3,72543,28702,43841,110.69%,43.80%
2020-01-01 00:01:30,3,4,12440,1180,11260,18.98%,1.80%
2020-01-01 00:01:30,3,5,47529,13738,33791,72.52%,20.96%
2020-01-01 00:01:30,3,6,14275,1517,12758,21.78%,2.31%
2020-01-01 00:01:30,3,7,18648,2453,16195,28.45%,3.74%
2020-01-01 00:01:30,3,8,15650,1729,13921,23.88%,2.64%
2020-01-01 00:01:30,3,9,32510,6890,25620,49.61%,10.51%
2020-01-01 00:01:30,3,10,4769,178,4591,7.28%,0.27%
2020-01-01 00:01:30,3,11,1634,10,1624,2.49%,0.02%
2020-01-01 00:01:30,3,12,26062,4596,21466,39.77%,7.01%
2020-01-01 00:01:30,4,1,539,1,538,0.82%,0.00%
2020-01-01 00:01:30,4,2,324,1,323,0.49%,0.00%
2020-01-01 00:01:30,4,3,789,3,786,1.20%,0.00%
2020-01-01 00:01:30,4,4,27896,5093,22803,42.57%,7.77%
2020-01-01 00:01:30,4,5,18366,2272,16094,28.02%,3.47%
2020-01-01 00:01:30,4,6,24406,3928,20478,37.24%,5.99%
2020-01-01 00:01:30,4,7,4604,180,4424,7.03%,0.27%
2020-01-01 00:01:30,4,8,3021,83,2938,4.61%,0.13%
2020-01-01 00:01:30,4,9,16557,1903,14654,25.26%,2.90%
2020-01-01 00:01:30,4,10,1896,31,1865,2.89%,0.05%
2020-01-01 00:01:30,4,11,108,1,107,0.16%,0.00%
2020-01-01 00:01:30,4,12,13747,1336,12411,20.98%,2.04%
2020-01-01 00:01:30,5,1,3024,69,2955,4.61%,0.11%
2020-01-01 00:01:30,5,2,740,2,738,1.13%,0.00%
2020-01-01 00:01:30,5,3,2777,60,2717,4.24%,0.09%
2020-01-01 00:01:30,5,4,28658,5406,23252,43.73%,8.25%
2020-01-01 00:01:30,5,5,12426,1130,11296,18.96%,1.72%
2020-01-01 00:01:30,5,6,19387,2608,16779,29.58%,3.98%
2020-01-01 00:01:30,5,7,6399,298,6101,9.76%,0.45%
2020-01-01 00:01:30,5,8,4374,138,4236,6.67%,0.21%
2020-01-01 00:01:30,5,9,9554,676,8878,14.58%,1.03%
2020-01-01 00:01:30,5,10,1190,13,1177,1.82%,0.02%
2020-01-01 00:01:30,5,11,982,12,970,1.50%,0.02%
2020-01-01 00:01:30,5,12,7809,464,7345,11.92%,0.71%
2020-01-01 00:01:30,6,1,1042,7,1035,1.59%,0.01%
2020-01-01 00:01:30,6,2,1222,8,1214,1.86%,0.01%
2020-01-01 00:01:30,6,3,1889,27,1862,2.88%,0.04%
2020-01-01 00:01:30,6,4,963,19,944,1.47%,0.03%
2020-01-01 00:01:30,6,5,15414,1699,13715,23.52%,2.59%
2020-01-01 00:01:30,6,6,4383,175,4208,6.69%,0.27%
2020-01-01 00:01:30,6,7,2831,60,2771,4.32%,0.09%
2020-01-01 00:01:30,6,8,2227,38,2189,3.40%,0.06%
2020-01-01 00:01:30,6,9,8865,596,8269,13.53%,0.91%
2020-01-01 00:01:30,6,10,2006,39,1967,3.06%,0.06%
2020-01-01 00:01:30,6,11,374,2,372,0.57%,0.00%
2020-01-01 00:01:30,6,12,6793,347,6446,10.37%,0.53%
2020-01-01 00:01:30,7,1,468,2,466,0.71%,0.00%
2020-01-01 00:01:30,7,2,236,0,236,0.36%,0.00%
2020-01-01 00:01:30,7,3,1389,23,1366,2.12%,0.04%
2020-01-01 00:01:30,7,4,2140,57,2083,3.27%,0.09%
2020-01-01 00:01:30,7,5,7153,362,6791,10.91%,0.55%
2020-01-01 00:01:30,7,6,13474,1333,12141,20.56%,2.03%
2020-01-01 00:01:30,7,7,4165,153,4012,6.36%,0.23%
2020-01-01 00:01:30,7,8,1631,27,1604,2.49%,0.04%
2020-01-01 00:01:30,7,9,5631,232,5399,8.59%,0.35%
2020-01-01 00:01:30,7,10,1505,14,1491,2.30%,0.02%
2020-01-01 00:01:30,7,11,230,0,230,0.35%,0.00%
2020-01-01 00:01:30,7,12,4112,119,3993,6.27%,0.18%
2020-01-01 00:01:30,8,1,441,3,438,0.67%,0.00%
2020-01-01 00:01:30,8,2,100,0,100,0.15%,0.00%
2020-01-01 00:01:30,8,3,1432,7,1425,2.19%,0.01%
2020-01-01 00:01:30,8,4,3474,81,3393,5.30%,0.12%
2020-01-01 00:01:30,8,5,8184,454,7730,12.49%,0.69%
2020-01-01 00:01:30,8,6,16816,1998,14818,25.66%,3.05%
2020-01-01 00:01:30,8,7,4981,188,4793,7.60%,0.29%
2020-01-01 00:01:30,8,8,1996,34,1962,3.05%,0.05%
2020-01-01 00:01:30,8,9,6566,309,6257,10.02%,0.47%
2020-01-01 00:01:30,8,10,2370,60,2310,3.62%,0.09%
2020-01-01 00:01:30,8,11,356,2,354,0.54%,0.00%
2020-01-01 00:01:30,8,12,4081,127,3954,6.23%,0.19%
2020-01-01 00:01:30,9,1,872,8,864,1.33%,0.01%
2020-01-01 00:01:30,9,2,2747,68,2679,4.19%,0.10%
2020-01-01 00:01:30,9,3,1479,34,1445,2.26%,0.05%
2020-01-01 00:01:30,9,4,5223,216,5007,7.97%,0.33%
2020-01-01 00:01:30,9,5,424,1,423,0.65%,0.00%
2020-01-01 00:01:30,9,6,6003,263,5740,9.16%,0.40%
2020-01-01 00:01:30,9,7,25879,4471,21408,39.49%,6.82%
2020-01-01 00:01:30,9,8,10224,718,9506,15.60%,1.10%
2020-01-01 00:01:30,9,9,277,1,276,0.42%,0.00%
2020-01-01 00:01:30,9,10,3154,63,3091,4.81%,0.10%
2020-01-01 00:01:30,9,11,8862,534,8328,13.52%,0.81%
2020-01-01 00:01:30,9,12,5394,201,5193,8.23%,0.31%
2020-01-01 00:01:30,10,1,1365,361,1004,2.08%,0.55%
2020-01-01 00:01:30,10,2,3217,420,2797,4.91%,0.64%
2020-01-01 00:01:30,10,3,1679,21,1658,2.56%,0.03%
2020-01-01 00:01:30,10,4,4488,1182,3306,6.85%,1.80%
2020-01-01 00:01:30,10,5,710,6,704,1.08%,0.01%
2020-01-01 00:01:30,10,6,6128,1284,4844,9.35%,1.96%
2020-01-01 00:01:30,10,7,11288,2173,9115,17.22%,3.32%
2020-01-01 00:01:30,10,8,27838,6768,21070,42.48%,10.33%
2020-01-01 00:01:30,10,9,695,2,693,1.06%,0.00%
2020-01-01 00:01:30,10,10,3686,86,3600,5.62%,0.13%
2020-01-01 00:01:30,10,11,12923,1501,11422,19.72%,2.29%
2020-01-01 00:01:30,10,12,8735,908,7827,13.33%,1.39%
2020-01-01 00:01:30,11,1,2859,78,2781,4.36%,0.12%
2020-01-01 00:01:30,11,2,5061,197,4864,7.72%,0.30%
2020-01-01 00:01:30,11,3,2080,33,2047,3.17%,0.05%
2020-01-01 00:01:30,11,4,3663,112,3551,5.59%,0.17%
2020-01-01 00:01:30,11,5,145,0,145,0.22%,0.00%
2020-01-01 00:01:30,11,6,4428,151,4277,6.76%,0.23%
2020-01-01 00:01:30,11,7,11461,950,10511,17.49%,1.45%
2020-01-01 00:01:30,11,8,25933,4616,21317,39.57%,7.04%
2020-01-01 00:01:30,11,9,232,0,232,0.35%,0.00%
2020-01-01 00:01:30,11,10,3737,111,3626,5.70%,0.17%
2020-01-01 00:01:30,11,11,10644,854,9790,16.24%,1.30%
2020-01-01 00:01:30,11,12,6574,338,6236,10.03%,0.52%
2020-01-01 00:01:30,12,1,68,0,68,0.10%,0.00%
2020-01-01 00:01:30,12,2,680,283,397,1.04%,0.43%
2020-01-01 00:01:30,12,3,3820,365,3455,5.83%,0.56%
2020-01-01 00:01:30,12,4,3553,77,3476,5.42%,0.12%
2020-01-01 00:01:30,12,5,11332,1067,10265,17.29%,1.63%
2020-01-01 00:01:30,12,6,6658,254,6404,10.16%,0.39%
2020-01-01 00:01:30,12,7,2944,65,2879,4.49%,0.10%
2020-01-01 00:01:30,12,8,1309,327,982,2.00%,0.50%
2020-01-01 00:01:30,12,9,23427,4818,18609,35.75%,7.35%
2020-01-01 00:01:30,12,10,3661,388,3273,5.59%,0.59%
2020-01-01 00:01:30,12,11,1582,330,1252,2.41%,0.50%
2020-01-01 00:01:30,12,12,7749,1237,6512,11.82%,1.89%
2020-01-01 00:01:30,13,1,2291,34,2257,3.50%,0.05%
2020-01-01 00:01:30,13,2,2738,58,2680,4.18%,0.09%
2020-01-01 00:01:30,13,3,970,7,963,1.48%,0.01%
2020-01-01 00:01:30,13,4,4521,434,4087,6.90%,0.66%
2020-01-01 00:01:30,13,5,7422,818,6604,11.33%,1.25%
2020-01-01 00:01:30,13,6,5538,489,5049,8.45%,0.75%
2020-01-01 00:01:30,13,7,5146,197,4949,7.85%,0.30%
2020-01-01 00:01:30,13,8,7011,364,6647,10.70%,0.56%
2020-01-01 00:01:30,13,9,7645,836,6809,11.67%,1.28%
2020-01-01 00:01:30,13,10,27293,5597,21696,41.65%,8.54%
2020-01-01 00:01:30,13,11,16529,2268,14261,25.22%,3.46%
2020-01-01 00:01:30,13,12,8852,988,7864,13.51%,1.51%
2020-01-01 00:01:30,14,1,434,2,432,0.66%,0.00%
2020-01-01 00:01:30,14,2,2718,60,2658,4.15%,0.09%
2020-01-01 00:01:30,14,3,1741,23,1718,2.66%,0.04%
2020-01-01 00:01:30,14,4,5249,214,5035,8.01%,0.33%
2020-01-01 00:01:30,14,5,1443,14,1429,2.20%,0.02%
2020-01-01 00:01:30,14,6,5656,244,5412,8.63%,0.37%
2020-01-01 00:01:30,14,7,13851,1361,12490,21.13%,2.08%
2020-01-01 00:01:30,14,8,15518,1673,13845,23.68%,2.55%
2020-01-01 00:01:30,14,9,1627,16,1611,2.48%,0.02%
2020-01-01 00:01:30,14,10,4401,147,4254,6.72%,0.22%
2020-01-01 00:01:30,14,11,27045,4876,22169,41.27%,7.44%
2020-01-01 00:01:30,14,12,6888,336,6552,10.51%,0.51%
2020-01-01 00:01:30,15,1,482,4,478,0.74%,0.01%
2020-01-01 00:01:30,15,2,128,0,128,0.20%,0.00%
2020-01-01 00:01:30,15,3,3708,112,3596,5.66%,0.17%
2020-01-01 00:01:30,15,4,5614,273,5341,8.57%,0.42%
2020-01-01 00:01:30,15,5,10154,816,9338,15.49%,1.25%
2020-01-01 00:01:30,15,6,5791,291,5500,8.84%,0.44%
2020-01-01 00:01:30,15,7,3688,124,3564,5.63%,0.19%
2020-01-01 00:01:30,15,8,5815,271,5544,8.87%,0.41%
2020-01-01 00:01:30,15,9,10301,841,9460,15.72%,1.28%
2020-01-01 00:01:30,15,10,4291,136,4155,6.55%,0.21%
2020-01-01 00:01:30,15,11,10272,780,9492,15.67%,1.19%
2020-01-01 00:01:30,15,12,25681,4685,20996,39.19%,7.15%
2020-01-01 00:01:30,16,1,464,2,462,0.71%,0.00%
2020-01-01 00:01:30,16,2,335,1,334,0.51%,0.00%
2020-01-01 00:01:30,16,3,1372,15,1357,2.09%,0.02%
2020-01-01 00:01:30,16,4,5343,191,5152,8.15%,0.29%
2020-01-01 00:01:30,16,5,8780,582,8198,13.40%,0.89%
2020-01-01 00:01:30,16,6,5983,241,5742,9.13%,0.37%
2020-01-01 00:01:30,16,7,3168,103,3065,4.83%,0.16%
2020-01-01 00:01:30,16,8,6922,375,6547,10.56%,0.57%
2020-01-01 00:01:30,16,9,9233,646,8587,14.09%,0.99%
2020-01-01 00:01:30,16,10,1394,12,1382,2.13%,0.02%
2020-01-01 00:01:30,16,11,8610,552,8058,13.14%,0.84%
2020-01-01 00:01:30,16,12,26852,4905,21947,40.97%,7.48%
2020-01-01 00:01:40,1,1,17762,2248,15514,27.10%,3.43%
2020-01-01 00:01:40,1,2,6512,314,6198,9.94%,0.48%
2020-01-01 00:01:40,1,3,627,1,626,0.96%,0.00%
2020-01-01 00:01:40,1,4,10938,921,10017,16.69%,1.41%
2020-01-01 00:01:40,1,5,10648,865,9783,16.25%,1.32%
2020-01-01 00:01:40,1,6,10657,879,9778,16.26%,1.34%
2020-01-01 00:01:40,1,7,5871,253,5618,8.96%,0.39%
2020-01-01 00:01:40,1,8,4032,117,3915,6.15%,0.18%
2020-01-01 00:01:40,1,9,10579,861,9718,16.14%,1.31%
2020-01-01 00:01:40,1,10,3386,76,3310,5.17%,0.12%
2020-01-01 00:01:40,1,11,3468,81,3387,5.29%,0.12%
2020-01-01 00:01:40,1,12,10496,848,9648,16.02%,1.29%
2020-01-01 00:01:40,2,1,451,7,444,0.69%,0.01%
2020-01-01 00:01:40,2,2,22034,3347,18687,33.62%,5.11%
2020-01-01 00:01:40,2,3,18246,2358,15888,27.84%,3.60%
2020-01-01 00:01:40,2,4,297,7,290,0.45%,0.01%
2020-01-01 00:01:40,2,5,11984,1035,10949,18.29%,1.58%
2020-01-01 00:01:40,2,6,60,0,60,0.09%,0.00%
2020-01-01 00:01:40,2,7,3313,86,3227,5.06%,0.13%
2020-01-01 00:01:40,2,8,2127,38,2089,3.25%,0.06%
2020-01-01 00:01:40,2,9,11820,1005,10815,18.04%,1.53%
2020-01-01 00:01:40,2,10,1581,19,1562,2.41%,0.03%
2020-01-01 00:01:40,2,11,1586,19,1567,2.42%,0.03%
2020-01-01 00:01:40,2,12,11637,973,10664,17.76%,1.48%
2020-01-01 00:01:40,3,1,1278,10,1268,1.95%,0.02%
2020-01-01 00:01:40,3,2,22340,3374,18966,34.09%,5.15%
2020-01-01 00:01:40,3,3,69746,26939,42807,106.42%,41.11%
2020-01-01 00:01:40,3,4,11201,951,10250,17.09%,1.45%
2020-01-01 00:01:40,3,5,45861,12944,32917,69.98%,19.75%
2020-01-01 00:01:40,3,6,12856,1219,11637,19.62%,1.86%
2020-01-01 00:01:40,3,7,19183,2531,16652,29.27%,3.86%
2020-01-01 00:01:40,3,8,16191,1858,14333,24.71%,2.84%
2020-01-01 00:01:40,3,9,32216,6785,25431,49.16%,10.35%
2020-01-01 00:01:40,3,10,7240,404,6836,11.05%,0.62%
2020-01-01 00:01:40,3,11,1994,37,1957,3.04%,0.06%
2020-01-01 00:01:40,3,12,23292,3706,19586,35.54%,5.65%
2020-01-01 00:01:40,4,1,524,1,523,0.80%,0.00%
2020-01-01 00:01:40,4,2,313,0,313,0.48%,0.00%
2020-01-01 00:01:40,4,3,874,6,868,1.33%,0.01%
2020-01-01 00:01:40,4,4,29261,5632,23629,44.65%,8.59%
2020-01-01 00:01:40,4,5,19472,2710,16762,29.71%,4.14%
2020-01-01 00:01:40,4,6,25997,4533,21464,39.67%,6.92%
2020-01-01 00:01:40,4,7,4919,188,4731,7.51%,0.29%
2020-01-01 00:01:40,4,8,3095,77,3018,4.72%,0.12%
2020-01-01 00:01:40,4,9,17496,2192,15304,26.70%,3.34%
2020-01-01 00:01:40,4,10,2009,33,1976,3.07%,0.05%
2020-01-01 00:01:40,4,11,70,0,70,0.11%,0.00%
2020-01-01 00:01:40,4,12,14405,1518,12887,21.98%,2.32%
2020-01-01 00:01:40,5,1,2904,72,2832,4.43%,0.11%
2020-01-01 00:01:40,5,2,748,6,742,1.14%,0.01%
2020-01-01 00:01:40,5,3,712,9,703,1.09%,0.01%
2020-01-01 00:01:40,5,4,25786,4525,21261,39.35%,6.90%
2020-01-01 00:01:40,5,5,11451,966,10485,17.47%,1.47%
2020-01-01 00:01:40,5,6,16626,1972,14654,25.37%,3.01%
2020-01-01 00:01:40,5,7,4584,159,4425,6.99%,0.24%
2020-01-01 00:01:40,5,8,3494,96,3398,5.33%,0.15%
2020-01-01 00:01:40,5,9,9952,736,9216,15.19%,1.12%
2020-01-01 00:01:40,5,10,889,12,877,1.36%,0.02%
2020-01-01 00:01:40,5,11,900,15,885,1.37%,0.02%
2020-01-01 00:01:40,5,12,8669,568,8101,13.23%,0.87%
2020-01-01 00:01:40,6,1,1175,18,1157,1.79%,0.03%
2020-01-01 00:01:40,6,2,1386,21,1365,2.11%,0.03%
2020-01-01 00:01:40,6,3,1802,32,1770,2.75%,0.05%
2020-01-01 00:01:40,6,4,1263,6,1257,1.93%,0.01%
2020-01-01 00:01:40,6,5,17439,2153,15286,26.61%,3.29%
2020-01-01 00:01:40,6,6,5114,192,4922,7.80%,0.29%
2020-01-01 00:01:40,6,7,3252,85,3167,4.96%,0.13%
2020-01-01 00:01:40,6,8,2565,60,2505,3.91%,0.09%
2020-01-01 00:01:40,6,9,10279,767,9512,15.68%,1.17%
2020-01-01 00:01:40,6,10,2209,27,2182,3.37%,0.04%
2020-01-01 00:01:40,6,11,394,2,392,0.60%,0.00%
2020-01-01 00:01:40,6,12,8005,467,7538,12.21%,0.71%
2020-01-01 00:01:40,7,1,637,6,631,0.97%,0.01%
2020-01-01 00:01:40,7,2,71,0,71,0.11%,0.00%
2020-01-01 00:01:40,7,3,749,7,742,1.14%,0.01%
2020-01-01 00:01:40,7,4,2326,33,2293,3.55%,0.05%
2020-01-01 00:01:40,7,5,7182,380,6802,10.96%,0.58%
2020-01-01 00:01:40,7,6,13265,1286,11979,20.24%,1.96%
2020-01-01 00:01:40,7,7,3714,113,3601,5.67%,0.17%
2020-01-01 00:01:40,7,8,1532,28,1504,2.34%,0.04%
2020-01-01 00:01:40,7,9,6291,287,6004,9.60%,0.44%
2020-01-01 00:01:40,7,10,2375,34,2341,3.62%,0.05%
2020-01-01 00:01:40,7,11,238,1,237,0.36%,0.00%
2020-01-01 00:01:40,7,12,3918,121,3797,5.98%,0.18%
2020-01-01 00:01:40,8,1,522,2,520,0.80%,0.00%
2020-01-01 00:01:40,8,2,76,0,76,0.12%,0.00%
2020-01-01 00:01:40,8,3,1555,17,1538,2.37%,0.03%
2020-01-01 00:01:40,8,4,3667,90,3577,5.60%,0.14%
2020-01-01 00:01:40,8,5,7698,472,7226,11.75%,0.72%
2020-01-01 00:01:40,8,6,17497,2097,15400,26.70%,3.20%
2020-01-01 00:01:40,8,7,6023,287,5736,9.19%,0.44%
2020-01-01 00:01:40,8,8,3302,73,3229,5.04%,0.11%
2020-01-01 00:01:40,8,9,5983,272,5711,9.13%,0.42%
2020-01-01 00:01:40,8,10,1980,31,1949,3.02%,0.05%
2020-01-01 00:01:40,8,11,503,1,502,0.77%,0.00%
2020-01-01 00:01:40,8,12,3859,111,3748,5.89%,0.17%
2020-01-01 00:01:40,9,1,1209,5,1204,1.84%,0.01%
2020-01-01 00:01:40,9,2,5127,202,4925,7.82%,0.31%
2020-01-01 00:01:40,9,3,3555,94,3461,5.42%,0.14%
2020-01-01 00:01:40,9,4,5539,242,5297,8.45%,0.37%
2020-01-01 00:01:40,9,5,482,2,480,0.74%,0.00%
2020-01-01 00:01:40,9,6,6378,314,6064,9.73%,0.48%
2020-01-01 00:01:40,9,7,28134,5463,22671,42.93%,8.34%
2020-01-01 00:01:40,9,8,11017,867,10150,16.81%,1.32%
2020-01-01 00:01:40,9,9,440,1,439,0.67%,0.00%
2020-01-01 00:01:40,9,10,3125,61,3064,4.77%,0.09%
2020-01-01 00:01:40,9,11,9285,613,8672,14.17%,0.94%
2020-01-01 00:01:40,9,12,5784,248,5536,8.83%,0.38%
2020-01-01 00:01:40,10,1,1365,340,1025,2.08%,0.52%
2020-01-01 00:01:40,10,2,3008,396,2612,4.59%,0.60%
2020-01-01 00:01:40,10,3,1463,21,1442,2.23%,0.03%
2020-01-01 00:01:40,10,4,6216,1453,4763,9.48%,2.22%
2020-01-01 00:01:40,10,5,715,4,711,1.09%,0.01%
2020-01-01 00:01:40,10,6,7987,1602,6385,12.19%,2.44%
2020-01-01 00:01:40,10,7,13006,2566,10440,19.85%,3.92%
2020-01-01 00:01:40,10,8,29281,7350,21931,44.68%,11.22%
2020-01-01 00:01:40,10,9,780,3,777,1.19%,0.00%
2020-01-01 00:01:40,10,10,3281,76,3205,5.01%,0.12%
2020-01-01 00:01:40,10,11,12305,1445,10860,18.78%,2.20%
2020-01-01 00:01:40,10,12,8623,956,7667,13.16%,1.46%
2020-01-01 00:01:40,11,1,3113,83,3030,4.75%,0.13%
2020-01-01 00:01:40,11,2,4448,153,4295,6.79%,0.23%
2020-01-01 00:01:40,11,3,1160,7,1153,1.77%,0.01%
2020-01-01 00:01:40,11,4,4322,131,4191,6.59%,0.20%
2020-01-01 00:01:40,11,5,534,5,529,0.81%,0.01%
2020-01-01 00:01:40,11,6,5480,218,5262,8.36%,0.33%
2020-01-01 00:01:40,11,7,11851,1050,10801,18.08%,1.60%
2020-01-01 00:01:40,11,8,26127,4585,21542,39.87%,7.00%
2020-01-01 00:01:40,11,9,337,3,334,0.51%,0.00%
2020-01-01 00:01:40,11,10,3842,119,3723,5.86%,0.18%
2020-01-01 00:01:40,11,11,10779,792,9987,16.45%,1.21%
2020-01-01 00:01:40,11,12,6524,295,6229,9.95%,0.45%
2020-01-01 00:01:40,12,1,64,0,64,0.10%,0.00%
2020-01-01 00:01:40,12,2,656,278,378,1.00%,0.42%
2020-01-01 00:01:40,12,3,3313,357,2956,5.06%,0.54%
2020-01-01 00:01:40,12,4,3510,61,3449,5.36%,0.09%
2020-01-01 00:01:40,12,5,10741,1019,9722,16.39%,1.55%
2020-01-01 00:01:40,12,6,6527,248,6279,9.96%,0.38%
2020-01-01 00:01:40,12,7,2903,65,2838,4.43%,0.10%
2020-01-01 00:01:40,12,8,1716,325,1391,2.62%,0.50%
2020-01-01 00:01:40,12,9,23701,4864,18837,36.16%,7.42%
2020-01-01 00:01:40,12,10,4133,411,3722,6.31%,0.63%
2020-01-01 00:01:40,12,11,2122,337,1785,3.24%,0.51%
2020-01-01 00:01:40,12,12,7812,1158,6654,11.92%,1.77%
2020-01-01 00:01:40,13,1,2721,52,2669,4.15%,0.08%
2020-01-01 00:01:40,13,2,3036,67,2969,4.63%,0.10%
2020-01-01 00:01:40,13,3,817,3,814,1.25%,0.00%
2020-01-01 00:01:40,13,4,4064,432,3632,6.20%,0.66%
2020-01-01 00:01:40,13,5,6617,783,5834,10.10%,1.19%
2020-01-01 00:01:40,13,6,5046,503,4543,7.70%,0.77%
2020-01-01 00:01:40,13,7,5444,228,5216,8.31%,0.35%
2020-01-01 00:01:40,13,8,7190,391,6799,10.97%,0.60%
2020-01-01 00:01:40,13,9,6751,800,5951,10.30%,1.22%
2020-01-01 00:01:40,13,10,25741,5081,20660,39.28%,7.75%
2020-01-01 00:01:40,13,11,16440,2273,14167,25.09%,3.47%
2020-01-01 00:01:40,13,12,8679,937,7742,13.24%,1.43%
2020-01-01 00:01:40,14,1,412,1,411,0.63%,0.00%
2020-01-01 00:01:40,14,2,2407,47,2360,3.67%,0.07%
2020-01-01 00:01:40,14,3,1755,28,1727,2.68%,0.04%
2020-01-01 00:01:40,14,4,5852,263,5589,8.93%,0.40%
2020-01-01 00:01:40,14,5,1605,22,1583,2.45%,0.03%
2020-01-01 00:01:40,14,6,6230,300,5930,9.51%,0.46%
2020-01-01 00:01:40,14,7,14258,1455,12803,21.76%,2.22%
2020-01-01 00:01:40,14,8,16309,1857,14452,24.89%,2.83%
2020-01-01 00:01:40,14,9,1801,24,1777,2.75%,0.04%
2020-01-01 00:01:40,14,10,4893,170,4723,7.47%,0.26%
2020-01-01 00:01:40,14,11,28539,5401,23138,43.55%,8.24%
2020-01-01 00:01:40,14,12,7177,374,6803,10.95%,0.57%
2020-01-01 00:01:40,15,1,716,7,709,1.09%,0.01%
2020-01-01 00:01:40,15,2,160,0,160,0.24%,0.00%
2020-01-01 00:01:40,15,3,4656,126,4530,7.10%,0.19%
2020-01-01 00:01:40,15,4,5761,262,5499,8.79%,0.40%
2020-01-01 00:01:40,15,5,11376,992,10384,17.36%,1.51%
2020-01-01 00:01:40,15,6,5964,278,5686,9.10%,0.42%
2020-01-01 00:01:40,15,7,3707,130,3577,5.66%,0.20%
2020-01-01 00:01:40,15,8,6558,447,6111,10.01%,0.68%
2020-01-01 00:01:40,15,9,11526,1019,10507,17.59%,1.55%
2020-01-01 00:01:40,15,10,4600,162,4438,7.02%,0.25%
2020-01-01 00:01:40,15,11,11266,1018,10248,17.19%,1.55%
2020-01-01 00:01:40,15,12,27589,5285,22304,42.10%,8.06%
2020-01-01 00:01:40,16,1,483,2,481,0.74%,0.00%
2020-01-01 00:01:40,16,2,304,1,303,0.46%,0.00%
2020-01-01 00:01:40,16,3,1497,16,1481,2.28%,0.02%
2020-01-01 00:01:40,16,4,5783,272,5511,8.82%,0.42%
2020-01-01 00:01:40,16,5,9361,713,8648,14.28%,1.09%
2020-01-01 00:01:40,16,6,6565,363,6202,10.02%,0.55%
2020-01-01 00:01:40,16,7,2972,67,2905,4.53%,0.10%
2020-01-01 00:01:40,16,8,7123,394,6729,10.87%,0.60%
2020-01-01 00:01:40,16,9,9740,761,8979,14.86%,1.16%
2020-01-01 00:01:40,16,10,1354,9,1345,2.07%,0.01%
2020-01-01 00:01:40,16,11,8705,547,8158,13.28%,0.83%
2020-01-01 00:01:40,16,12,28047,5347,22700,42.80%,8.16%
2020-01-01 00:01:50,1,1,19677,2768,16909,30.02%,4.22%
2020-01-01 00:01:50,1,2,10270,811,9459,15.67%,1.24%
2020-01-01 00:01:50,1,3,741,2,739,1.13%,0.00%
2020-01-01 00:01:50,1,4,9118,677,8441,13.91%,1.03%
2020-01-01 00:01:50,1,5,8854,653,8201,13.51%,1.00%
2020-01-01 00:01:50,1,6,8771,641,8130,13.38%,0.98%
2020-01-01 00:01:50,1,7,9509,705,8804,14.51%,1.08%
2020-01-01 00:01:50,1,8,8529,552,7977,13.01%,0.84%
2020-01-01 00:01:50,1,9,8730,638,8092,13.32%,0.97%
2020-01-01 00:01:50,1,10,7532,438,7094,11.49%,0.67%
2020-01-01 00:01:50,1,11,7627,443,7184,11.64%,0.68%
2020-01-01 00:01:50,1,12,8624,624,8000,13.16%,0.95%
2020-01-01 00:01:50,2,1,461,1,460,0.70%,0.00%
2020-01-01 00:01:50,2,2,26114,4552,21562,39.85%,6.95%
2020-01-01 00:01:50,2,3,18608,2435,16173,28.39%,3.72%
2020-01-01 00:01:50,2,4,384,1,383,0.59%,0.00%
2020-01-01 00:01:50,2,5,12071,1077,10994,18.42%,1.64%
2020-01-01 00:01:50,2,6,60,0,60,0.09%,0.00%
2020-01-01 00:01:50,2,7,7024,378,6646,10.72%,0.58%
2020-01-01 00:01:50,2,8,4339,147,4192,6.62%,0.22%
2020-01-01 00:01:50,2,9,11875,1041,10834,18.12%,1.59%
2020-01-01 00:01:50,2,10,3742,108,3634,5.71%,0.16%
2020-01-01 00:01:50,2,11,3748,108,3640,5.72%,0.16%
2020-01-01 00:01:50,2,12,11715,1017,10698,17.88%,1.55%
2020-01-01 00:01:50,3,1,1091,16,1075,1.66%,0.02%
2020-01-01 00:01:50,3,2,23898,3843,20055,36.47%,5.86%
2020-01-01 00:01:50,3,3,72303,28420,43883,110.33%,43.37%
2020-01-01 00:01:50,3,4,11503,929,10574,17.55%,1.42%
2020-01-01 00:01:50,3,5,46055,12918,33137,70.27%,19.71%
2020-01-01 00:01:50,3,6,14365,1420,12945,21.92%,2.17%
2020-01-01 00:01:50,3,7,20939,3015,17924,31.95%,4.60%
2020-01-01 00:01:50,3,8,17987,2266,15721,27.45%,3.46%
2020-01-01 00:01:50,3,9,31082,6343,24739,47.43%,9.68%
2020-01-01 00:01:50,3,10,4019,114,3905,6.13%,0.17%
2020-01-01 00:01:50,3,11,1967,28,1939,3.00%,0.04%
2020-01-01 00:01:50,3,12,24965,4198,20767,38.09%,6.41%
2020-01-01 00:01:50,4,1,523,5,518,0.80%,0.01%
2020-01-01 00:01:50,4,2,335,1,334,0.51%,0.00%
2020-01-01 00:01:50,4,3,1144,7,1137,1.75%,0.01%
2020-01-01 00:01:50,4,4,27794,5102,22692,42.41%,7.79%
2020-01-01 00:01:50,4,5,18876,2501,16375,28.80%,3.82%
2020-01-01 00:01:50,4,6,24641,4082,20559,37.60%,6.23%
2020-01-01 00:01:50,4,7,4343,135,4208,6.63%,0.21%
2020-01-01 00:01:50,4,8,2748,59,2689,4.19%,0.09%
2020-01-01 00:01:50,4,9,16539,1990,14549,25.24%,3.04%
2020-01-01 00:01:50,4,10,1850,30,1820,2.82%,0.05%
2020-01-01 00:01:50,4,11,87,0,87,0.13%,0.00%
2020-01-01 00:01:50,4,12,13733,1410,12323,20.95%,2.15%
2020-01-01 00:01:50,5,1,2726,59,2667,4.16%,0.09%
2020-01-01 00:01:50,5,2,681,4,677,1.04%,0.01%
2020-01-01 00:01:50,5,3,683,7,676,1.04%,0.01%
2020-01-01 00:01:50,5,4,27555,5113,22442,42.05%,7.80%
2020-01-01 00:01:50,5,5,11478,977,10501,17.51%,1.49%
2020-01-01 00:01:50,5,6,17118,2122,14996,26.12%,3.24%
2020-01-01 00:01:50,5,7,5065,216,4849,7.73%,0.33%
2020-01-01 00:01:50,5,8,3806,120,3686,5.81%,0.18%
2020-01-01 00:01:50,5,9,10560,819,9741,16.11%,1.25%
2020-01-01 00:01:50,5,10,1440,22,1418,2.20%,0.03%
2020-01-01 00:01:50,5,11,837,8,829,1.28%,0.01%
2020-01-01 00:01:50,5,12,8578,548,8030,13.09%,0.84%
2020-01-01 00:01:50,6,1,1167,7,1160,1.78%,0.01%
2020-01-01 00:01:50,6,2,1336,12,1324,2.04%,0.02%
2020-01-01 00:01:50,6,3,1584,18,1566,2.42%,0.03%
2020-01-01 00:01:50,6,4,1402,6,1396,2.14%,0.01%
2020-01-01 00:01:50,6,5,16472,1876,14596,25.13%,2.86%
2020-01-01 00:01:50,6,6,4597,168,4429,7.01%,0.26%
2020-01-01 00:01:50,6,7,2720,70,2650,4.15%,0.11%
2020-01-01 00:01:50,6,8,2047,54,1993,3.12%,0.08%
2020-01-01 00:01:50,6,9,10047,740,9307,15.33%,1.13%
2020-01-01 00:01:50,6,10,2127,32,2095,3.25%,0.05%
2020-01-01 00:01:50,6,11,413,0,413,0.63%,0.00%
2020-01-01 00:01:50,6,12,7853,459,7394,11.98%,0.70%
2020-01-01 00:01:50,7,1,666,2,664,1.02%,0.00%
2020-01-01 00:01:50,7,2,56,0,56,0.09%,0.00%
2020-01-01 00:01:50,7,3,1678,14,1664,2.56%,0.02%
2020-01-01 00:01:50,7,4,1674,24,1650,2.55%,0.04%
2020-01-01 00:01:50,7,5,7090,389,6701,10.82%,0.59%
2020-01-01 00:01:50,7,6,12544,1116,11428,19.14%,1.70%
2020-01-01 00:01:50,7,7,3746,98,3648,5.72%,0.15%
2020-01-01 00:01:50,7,8,1480,26,1454,2.26%,0.04%
2020-01-01 00:01:50,7,9,5274,209,5065,8.05%,0.32%
2020-01-01 00:01:50,7,10,1618,22,1596,2.47%,0.03%
2020-01-01 00:01:50,7,11,236,0,236,0.36%,0.00%
2020-01-01 00:01:50,7,12,3653,103,3550,5.57%,0.16%
2020-01-01 00:01:50,8,1,506,1,505,0.77%,0.00%
2020-01-01 00:01:50,8,2,78,0,78,0.12%,0.00%
2020-01-01 00:01:50,8,3,1185,11,1174,1.81%,0.02%
2020-01-01 00:01:50,8,4,3139,62,3077,4.79%,0.09%
2020-01-01 00:01:50,8,5,7401,431,6970,11.29%,0.66%
2020-01-01 00:01:50,8,6,15723,1761,13962,23.99%,2.69%
2020-01-01 00:01:50,8,7,5079,208,4871,7.75%,0.32%
2020-01-01 00:01:50,8,8,2345,45,2300,3.58%,0.07%
2020-01-01 00:01:50,8,9,6053,282,5771,9.24%,0.43%
2020-01-01 00:01:50,8,10,2046,38,2008,3.12%,0.06%
2020-01-01 00:01:50,8,11,520,0,520,0.79%,0.00%
2020-01-01 00:01:50,8,12,3882,115,3767,5.92%,0.18%
2020-01-01 00:01:50,9,1,649,4,645,0.99%,0.01%
2020-01-01 00:01:50,9,2,2950,70,2880,4.50%,0.11%
2020-01-01 00:01:50,9,3,1946,29,1917,2.97%,0.04%
2020-01-01 00:01:50,9,4,7297,393,6904,11.13%,0.60%
2020-01-01 00:01:50,9,5,579,2,577,0.88%,0.00%
2020-01-01 00:01:50,9,6,8182,495,7687,12.48%,0.76%
2020-01-01 00:01:50,9,7,28131,5222,22909,42.92%,7.97%
2020-01-01 00:01:50,9,8,11969,1009,10960,18.26%,1.54%
2020-01-01 00:01:50,9,9,550,2,548,0.84%,0.00%
2020-01-01 00:01:50,9,10,3439,79,3360,5.25%,0.12%
2020-01-01 00:01:50,9,11,10216,703,9513,15.59%,1.07%
2020-01-01 00:01:50,9,12,6505,279,6226,9.93%,0.43%
2020-01-01 00:01:50,10,1,1499,340,1159,2.29%,0.52%
2020-01-01 00:01:50,10,2,3190,409,2781,4.87%,0.62%
2020-01-01 00:01:50,10,3,1489,28,1461,2.27%,0.04%
2020-01-01 00:01:50,10,4,4935,1290,3645,7.53%,1.97%
2020-01-01 00:01:50,10,5,735,3,732,1.12%,0.00%
2020-01-01 00:01:50,10,6,6853,1431,5422,10.46%,2.18%
2020-01-01 00:01:50,10,7,12110,2352,9758,18.48%,3.59%
2020-01-01 00:01:50,10,8,27779,6899,20880,42.39%,10.53%
2020-01-01 00:01:50,10,9,780,4,776,1.19%,0.01%
2020-01-01 00:01:50,10,10,3011,71,2940,4.59%,0.11%
2020-01-01 00:01:50,10,11,12411,1489,10922,18.94%,2.27%
2020-01-01 00:01:50,10,12,8915,988,7927,13.60%,1.51%
2020-01-01 00:01:50,11,1,3233,95,3138,4.93%,0.14%
2020-01-01 00:01:50,11,2,4155,157,3998,6.34%,0.24%
2020-01-01 00:01:50,11,3,738,4,734,1.13%,0.01%
2020-01-01 00:01:50,11,4,3863,92,3771,5.89%,0.14%
2020-01-01 00:01:50,11,5,166,1,165,0.25%,0.00%
2020-01-01 00:01:50,11,6,4539,123,4416,6.93%,0.19%
2020-01-01 00:01:50,11,7,10709,836,9873,16.34%,1.28%
2020-01-01 00:01:50,11,8,24308,4143,20165,37.09%,6.32%
2020-01-01 00:01:50,11,9,311,1,310,0.47%,0.00%
2020-01-01 00:01:50,11,10,4003,108,3895,6.11%,0.16%
2020-01-01 00:01:50,11,11,10181,791,9390,15.53%,1.21%
2020-01-01 00:01:50,11,12,5848,278,5570,8.92%,0.42%
2020-01-01 00:01:50,12,1,48,0,48,0.07%,0.00%
2020-01-01 00:01:50,12,2,679,274,405,1.04%,0.42%
2020-01-01 00:01:50,12,3,3578,359,3219,5.46%,0.55%
2020-01-01 00:01:50,12,4,3447,81,3366,5.26%,0.12%
2020-01-01 00:01:50,12,5,10924,1128,9796,16.67%,1.72%
2020-01-01 00:01:50,12,6,6564,338,6226,10.02%,0.52%
2020-01-01 00:01:50,12,7,2977,66,2911,4.54%,0.10%
2020-01-01 00:01:50,12,8,1742,324,1418,2.66%,0.49%
2020-01-01 00:01:50,12,9,23546,4876,18670,35.93%,7.44%
2020-01-01 00:01:50,12,10,4466,417,4049,6.81%,0.64%
2020-01-01 00:01:50,12,11,2151,329,1822,3.28%,0.50%
2020-01-01 00:01:50,12,12,7236,1145,6091,11.04%,1.75%
2020-01-01 00:01:50,13,1,2898,59,2839,4.42%,0.09%
2020-01-01 00:01:50,13,2,3199,70,3129,4.88%,0.11%
2020-01-01 00:01:50,13,3,923,4,919,1.41%,0.01%
2020-01-01 00:01:50,13,4,4248,415,3833,6.48%,0.63%
2020-01-01 00:01:50,13,5,6907,749,6158,10.54%,1.14%
2020-01-01 00:01:50,13,6,5227,473,4754,7.98%,0.72%
2020-01-01 00:01:50,13,7,5858,226,5632,8.94%,0.34%
2020-01-01 00:01:50,13,8,7546,396,7150,11.51%,0.60%
2020-01-01 00:01:50,13,9,7110,765,6345,10.85%,1.17%
2020-01-01 00:01:50,13,10,27581,5728,21853,42.09%,8.74%
2020-01-01 00:01:50,13,11,17533,2557,14976,26.75%,3.90%
2020-01-01 00:01:50,13,12,9587,1114,8473,14.63%,1.70%
2020-01-01 00:01:50,14,1,406,1,405,0.62%,0.00%
2020-01-01 00:01:50,14,2,1966,37,1929,3.00%,0.06%
2020-01-01 00:01:50,14,3,1316,14,1302,2.01%,0.02%
2020-01-01 00:01:50,14,4,6523,285,6238,9.95%,0.43%
2020-01-01 00:01:50,14,5,1277,12,1265,1.95%,0.02%
2020-01-01 00:01:50,14,6,6828,301,6527,10.42%,0.46%
2020-01-01 00:01:50,14,7,14017,1415,12602,21.39%,2.16%
2020-01-01 00:01:50,14,8,15853,1771,14082,24.19%,2.70%
2020-01-01 00:01:50,14,9,1432,14,1418,2.19%,0.02%
2020-01-01 00:01:50,14,10,3904,92,3812,5.96%,0.14%
2020-01-01 00:01:50,14,11,26506,4728,21778,40.44%,7.21%
2020-01-01 00:01:50,14,12,6577,303,6274,10.04%,0.46%
2020-01-01 00:01:50,15,1,619,9,610,0.94%,0.01%
2020-01-01 00:01:50,15,2,176,0,176,0.27%,0.00%
2020-01-01 00:01:50,15,3,3970,106,3864,6.06%,0.16%
2020-01-01 00:01:50,15,4,5240,180,5060,8.00%,0.27%
2020-01-01 00:01:50,15,5,10353,786,9567,15.80%,1.20%
2020-01-01 00:01:50,15,6,5431,202,5229,8.29%,0.31%
2020-01-01 00:01:50,15,7,3658,140,3518,5.58%,0.21%
2020-01-01 00:01:50,15,8,5995,314,5681,9.15%,0.48%
2020-01-01 00:01:50,15,9,10515,813,9702,16.04%,1.24%
2020-01-01 00:01:50,15,10,4404,137,4267,6.72%,0.21%
2020-01-01 00:01:50,15,11,10519,865,9654,16.05%,1.32%
2020-01-01 00:01:50,15,12,25590,4600,20990,39.05%,7.02%
2020-01-01 00:01:50,16,1,605,3,602,0.92%,0.00%
2020-01-01 00:01:50,16,2,367,2,365,0.56%,0.00%
2020-01-01 00:01:50,16,3,2665,51,2614,4.07%,0.08%
2020-01-01 00:01:50,16,4,5778,253,5525,8.82%,0.39%
2020-01-01 00:01:50,16,5,10279,860,9419,15.68%,1.31%
2020-01-01 00:01:50,16,6,6412,311,6101,9.78%,0.47%
2020-01-01 00:01:50,16,7,2874,75,2799,4.39%,0.11%
2020-01-01 00:01:50,16,8,7006,407,6599,10.69%,0.62%
2020-01-01 00:01:50,16,9,10690,907,9783,16.31%,1.38%
2020-01-01 00:01:50,16,10,1399,20,1379,2.13%,0.03%
2020-01-01 00:01:50,16,11,8598,599,7999,13.12%,0.91%
2020-01-01 00:01:50,16,12,28325,5536,22789,43.22%,8.45%
2020-01-01 00:02:00,1,1,23752,3864,19888,36.24%,5.90%
2020-01-01 00:02:00,1,2,8863,548,8315,13.52%,0.84%
2020-01-01 00:02:00,1,3,697,3,694,1.06%,0.00%
2020-01-01 00:02:00,1,4,14586,1541,13045,22.26%,2.35%
2020-01-01 00:02:00,1,5,14387,1505,12882,21.95%,2.30%
2020-01-01 00:02:00,1,6,14284,1483,12801,21.80%,2.26%
2020-01-01 00:02:00,1,7,8149,467,7682,12.43%,0.71%
2020-01-01 00:02:00,1,8,6681,305,6376,10.19%,0.47%
2020-01-01 00:02:00,1,9,14241,1473,12768,21.73%,2.25%
2020-01-01 00:02:00,1,10,5793,238,5555,8.84%,0.36%
2020-01-01 00:02:00,1,11,5863,241,5622,8.95%,0.37%
2020-01-01 00:02:00,1,12,14209,1467,12742,21.68%,2.24%
2020-01-01 00:02:00,2,1,867,3,864,1.32%,0.00%
2020-01-01 00:02:00,2,2,23045,3686,19359,35.16%,5.62%
2020-01-01 00:02:00,2,3,18139,2286,15853,27.68%,3.49%
2020-01-01 00:02:00,2,4,791,2,789,1.21%,0.00%
2020-01-01 00:02:00,2,5,11176,904,10272,17.05%,1.38%
2020-01-01 00:02:00,2,6,66,0,66,0.10%,0.00%
2020-01-01 00:02:00,2,7,4022,134,3888,6.14%,0.20%
2020-01-01 00:02:00,2,8,1983,29,1954,3.03%,0.04%
2020-01-01 00:02:00,2,9,10983,873,10110,16.76%,1.33%
2020-01-01 00:02:00,2,10,1378,15,1363,2.10%,0.02%
2020-01-01 00:02:00,2,11,1381,15,1366,2.11%,0.02%
2020-01-01 00:02:00,2,12,10861,861,10000,16.57%,1.31%
2020-01-01 00:02:00,3,1,1266,10,1256,1.93%,0.02%
2020-01-01 00:02:00,3,2,23702,3818,19884,36.17%,5.83%
2020-01-01 00:02:00,3,3,71595,28021,43574,109.25%,42.76%
2020-01-01 00:02:00,3,4,8457,520,7937,12.90%,0.79%
2020-01-01 00:02:00,3,5,46830,13337,33493,71.46%,20.35%
2020-01-01 00:02:00,3,6,11422,905,10517,17.43%,1.38%
2020-01-01 00:02:00,3,7,20587,2886,17701,31.41%,4.40%
2020-01-01 00:02:00,3,8,17434,2105,15329,26.60%,3.21%
2020-01-01 00:02:00,3,9,34916,7924,26992,53.28%,12.09%
2020-01-01 00:02:00,3,10,4121,124,3997,6.29%,0.19%
2020-01-01 00:02:00,3,11,2078,28,2050,3.17%,0.04%
2020-01-01 00:02:00,3,12,29086,5643,23443,44.38%,8.61%
2020-01-01 00:02:00,4,1,522,1,521,0.80%,0.00%
2020-01-01 00:02:00,4,2,300,1,299,0.46%,0.00%
2020-01-01 00:02:00,4,3,1324,11,1313,2.02%,0.02%
2020-01-01 00:02:00,4,4,28550,5312,23238,43.56%,8.11%
2020-01-01 00:02:00,4,5,19393,2589,16804,29.59%,3.95%
2020-01-01 00:02:00,4,6,25140,4225,20915,38.36%,6.45%
2020-01-01 00:02:00,4,7,4532,149,4383,6.92%,0.23%
2020-01-01 00:02:00,4,8,3055,60,2995,4.66%,0.09%
2020-01-01 00:02:00,4,9,16880,1991,14889,25.76%,3.04%
2020-01-01 00:02:00,4,10,1961,22,1939,2.99%,0.03%
2020-01-01 00:02:00,4,11,120,0,120,0.18%,0.00%
2020-01-01 00:02:00,4,12,13832,1315,12517,21.11%,2.01%
2020-01-01 00:02:00,5,1,2767,56,2711,4.22%,0.09%
2020-01-01 00:02:00,5,2,715,6,709,1.09%,0.01%
2020-01-01 00:02:00,5,3,1587,25,1562,2.42%,0.04%
2020-01-01 00:02:00,5,4,26160,4557,21603,39.92%,6.95%
2020-01-01 00:02:00,5,5,11256,922,10334,17.18%,1.41%
2020-01-01 00:02:00,5,6,16399,1840,14559,25.02%,2.81%
2020-01-01 00:02:00,5,7,4613,166,4447,7.04%,0.25%
2020-01-01 00:02:00,5,8,3515,99,3416,5.36%,0.15%
2020-01-01 00:02:00,5,9,9531,670,8861,14.54%,1.02%
2020-01-01 00:02:00,5,10,1548,12,1536,2.36%,0.02%
2020-01-01 00:02:00,5,11,940,10,930,1.43%,0.02%
2020-01-01 00:02:00,5,12,7564,443,7121,11.54%,0.68%
2020-01-01 00:02:00,6,1,1087,9,1078,1.66%,0.01%
2020-01-01 00:02:00,6,2,1284,12,1272,1.96%,0.02%
2020-01-01 00:02:00,6,3,1866,31,1835,2.85%,0.05%
2020-01-01 00:02:00,6,4,1520,8,1512,2.32%,0.01%
2020-01-01 00:02:00,6,5,15370,1677,13693,23.45%,2.56%
2020-01-01 00:02:00,6,6,4584,148,4436,6.99%,0.23%
2020-01-01 00:02:00,6,7,2590,47,2543,3.95%,0.07%
2020-01-01 00:02:00,6,8,1983,30,1953,3.03%,0.05%
2020-01-01 00:02:00,6,9,8659,575,8084,13.21%,0.88%
2020-01-01 00:02:00,6,10,2180,39,2141,3.33%,0.06%
2020-01-01 00:02:00,6,11,344,3,341,0.52%,0.00%
2020-01-01 00:02:00,6,12,6389,304,6085,9.75%,0.46%
2020-01-01 00:02:00,7,1,620,10,610,0.95%,0.02%
2020-01-01 00:02:00,7,2,329,2,327,0.50%,0.00%
2020-01-01 00:02:00,7,3,1363,14,1349,2.08%,0.02%
2020-01-01 00:02:00,7,4,2293,87,2206,3.50%,0.13%
2020-01-01 00:02:00,7,5,6848,358,6490,10.45%,0.55%
2020-01-01 00:02:00,7,6,13254,1336,11918,20.22%,2.04%
2020-01-01 00:02:00,7,7,4100,122,3978,6.26%,0.19%
2020-01-01 00:02:00,7,8,1633,16,1617,2.49%,0.02%
2020-01-01 00:02:00,7,9,5358,222,5136,8.18%,0.34%
2020-01-01 00:02:00,7,10,1486,14,1472,2.27%,0.02%
2020-01-01 00:02:00,7,11,205,1,204,0.31%,0.00%
2020-01-01 00:02:00,7,12,3862,115,3747,5.89%,0.18%
2020-01-01 00:02:00,8,1,481,4,477,0.73%,0.01%
2020-01-01 00:02:00,8,2,54,0,54,0.08%,0.00%
2020-01-01 00:02:00,8,3,1273,10,1263,1.94%,0.02%
2020-01-01 00:02:00,8,4,2940,75,2865,4.49%,0.11%
2020-01-01 00:02:00,8,5,7877,457,7420,12.02%,0.70%
2020-01-01 00:02:00,8,6,15855,1824,14031,24.19%,2.78%
2020-01-01 00:02:00,8,7,4970,208,4762,7.58%,0.32%
2020-01-01 00:02:00,8,8,1824,31,1793,2.78%,0.05%
2020-01-01 00:02:00,8,9,6451,312,6139,9.84%,0.48%
2020-01-01 00:02:00,8,10,2110,26,2084,3.22%,0.04%
2020-01-01 00:02:00,8,11,366,1,365,0.56%,0.00%
2020-01-01 00:02:00,8,12,4225,122,4103,6.45%,0.19%
2020-01-01 00:02:00,9,1,335,1,334,0.51%,0.00%
2020-01-01 00:02:00,9,2,2248,40,2208,3.43%,0.06%
2020-01-01 00:02:00,9,3,1548,13,1535,2.36%,0.02%
2020-01-01 00:02:00,9,4,6399,319,6080,9.76%,0.49%
2020-01-01 00:02:00,9,5,450,1,449,0.69%,0.00%
2020-01-01 00:02:00,9,6,7085,376,6709,10.81%,0.57%
2020-01-01 00:02:00,9,7,26440,4577,21863,40.34%,6.98%
2020-01-01 00:02:00,9,8,12428,1069,11359,18.96%,1.63%
2020-01-01 00:02:00,9,9,416,1,415,0.63%,0.00%
2020-01-01 00:02:00,9,10,5032,196,4836,7.68%,0.30%
2020-01-01 00:02:00,9,11,10971,829,10142,16.74%,1.26%
2020-01-01 00:02:00,9,12,5651,230,5421,8.62%,0.35%
2020-01-01 00:02:00,10,1,1504,355,1149,2.29%,0.54%
2020-01-01 00:02:00,10,2,3411,414,2997,5.20%,0.63%
2020-01-01 00:02:00,10,3,1728,28,1700,2.64%,0.04%
2020-01-01 00:02:00,10,4,6078,1224,4854,9.27%,1.87%
2020-01-01 00:02:00,10,5,729,12,717,1.11%,0.02%
2020-01-01 00:02:00,10,6,8046,1414,6632,12.28%,2.16%
2020-01-01 00:02:00,10,7,13296,2411,10885,20.29%,3.68%
2020-01-01 00:02:00,10,8,29389,7217,22172,44.84%,11.01%
2020-01-01 00:02:00,10,9,876,5,871,1.34%,0.01%
2020-01-01 00:02:00,10,10,3814,139,3675,5.82%,0.21%
2020-01-01 00:02:00,10,11,13077,1555,11522,19.95%,2.37%
2020-01-01 00:02:00,10,12,8790,915,7875,13.41%,1.40%
2020-01-01 00:02:00,11,1,2974,60,2914,4.54%,0.09%
2020-01-01 00:02:00,11,2,4179,114,4065,6.38%,0.17%
2020-01-01 00:02:00,11,3,1039,8,1031,1.59%,0.01%
2020-01-01 00:02:00,11,4,4170,131,4039,6.36%,0.20%
2020-01-01 00:02:00,11,5,557,4,553,0.85%,0.01%
2020-01-01 00:02:00,11,6,5216,212,5004,7.96%,0.32%
2020-01-01 00:02:00,11,7,11454,910,10544,17.48%,1.39%
2020-01-01 00:02:00,11,8,25096,4205,20891,38.29%,6.42%
2020-01-01 00:02:00,11,9,224,0,224,0.34%,0.00%
2020-01-01 00:02:00,11,10,3615,95,3520,5.52%,0.14%
2020-01-01 00:02:00,11,11,10065,749,9316,15.36%,1.14%
2020-01-01 00:02:00,11,12,6194,298,5896,9.45%,0.45%
2020-01-01 00:02:00,12,1,32,0,32,0.05%,0.00%
2020-01-01 00:02:00,12,2,672,279,393,1.03%,0.43%
2020-01-01 00:02:00,12,3,3775,379,3396,5.76%,0.58%
2020-01-01 00:02:00,12,4,3481,117,3364,5.31%,0.18%
2020-01-01 00:02:00,12,5,11331,1214,10117,17.29%,1.85%
2020-01-01 00:02:00,12,6,6694,346,6348,10.21%,0.53%
2020-01-01 00:02:00,12,7,3079,78,3001,4.70%,0.12%
2020-01-01 00:02:00,12,8,1657,325,1332,2.53%,0.50%
2020-01-01 00:02:00,12,9,23726,4982,18744,36.20%,7.60%
2020-01-01 00:02:00,12,10,3973,421,3552,6.06%,0.64%
2020-01-01 00:02:00,12,11,1973,328,1645,3.01%,0.50%
2020-01-01 00:02:00,12,12,7551,1161,6390,11.52%,1.77%
2020-01-01 00:02:00,13,1,2272,40,2232,3.47%,0.06%
2020-01-01 00:02:00,13,2,2613,57,2556,3.99%,0.09%
2020-01-01 00:02:00,13,3,1031,5,1026,1.57%,0.01%
2020-01-01 00:02:00,13,4,5699,500,5199,8.70%,0.76%
2020-01-01 00:02:00,13,5,8877,965,7912,13.55%,1.47%
2020-01-01 00:02:00,13,6,6734,588,6146,10.28%,0.90%
2020-01-01 00:02:00,13,7,5056,187,4869,7.71%,0.29%
2020-01-01 00:02:00,13,8,6667,330,6337,10.17%,0.50%
2020-01-01 00:02:00,13,9,9043,982,8061,13.80%,1.50%
2020-01-01 00:02:00,13,10,28537,6074,22463,43.54%,9.27%
2020-01-01 00:02:00,13,11,16260,2231,14029,24.81%,3.40%
2020-01-01 00:02:00,13,12,9069,1005,8064,13.84%,1.53%
2020-01-01 00:02:00,14,1,447,3,444,0.68%,0.00%
2020-01-01 00:02:00,14,2,2057,32,2025,3.14%,0.05%
2020-01-01 00:02:00,14,3,1332,11,1321,2.03%,0.02%
2020-01-01 00:02:00,14,4,5582,213,5369,8.52%,0.33%
2020-01-01 00:02:00,14,5,1316,8,1308,2.01%,0.01%
2020-01-01 00:02:00,14,6,6024,249,5775,9.19%,0.38%
2020-01-01 00:02:00,14,7,13307,1229,12078,20.30%,1.88%
2020-01-01 00:02:00,14,8,14761,1525,13236,22.52%,2.33%
2020-01-01 00:02:00,14,9,1481,13,1468,2.26%,0.02%
2020-01-01 00:02:00,14,10,4068,122,3946,6.21%,0.19%
2020-01-01 00:02:00,14,11,25709,4304,21405,39.23%,6.57%
2020-01-01 00:02:00,14,12,6691,322,6369,10.21%,0.49%
2020-01-01 00:02:00,15,1,480,3,477,0.73%,0.00%
2020-01-01 00:02:00,15,2,148,0,148,0.23%,0.00%
2020-01-01 00:02:00,15,3,4007,111,3896,6.11%,0.17%
2020-01-01 00:02:00,15,4,5538,288,5250,8.45%,0.44%
2020-01-01 00:02:00,15,5,10555,845,9710,16.11%,1.29%
2020-01-01 00:02:00,15,6,5761,302,5459,8.79%,0.46%
2020-01-01 00:02:00,15,7,3616,87,3529,5.52%,0.13%
2020-01-01 00:02:00,15,8,5505,222,5283,8.40%,0.34%
2020-01-01 00:02:00,15,9,10726,887,9839,16.37%,1.35%
2020-01-01 00:02:00,15,10,4708,154,4554,7.18%,0.23%
2020-01-01 00:02:00,15,11,10387,771,9616,15.85%,1.18%
2020-01-01 00:02:00,15,12,26092,4802,21290,39.81%,7.33%
2020-01-01 00:02:00,16,1,538,1,537,0.82%,0.00%
2020-01-01 00:02:00,16,2,345,0,345,0.53%,0.00%
2020-01-01 00:02:00,16,3,1300,16,1284,1.98%,0.02%
2020-01-01 00:02:00,16,4,5044,180,4864,7.70%,0.27%
2020-01-01 00:02:00,16,5,8481,578,7903,12.94%,0.88%
2020-01-01 00:02:00,16,6,5720,232,5488,8.73%,0.35%
2020-01-01 00:02:00,16,7,3457,115,3342,5.27%,0.18%
2020-01-01 00:02:00,16,8,7462,439,7023,11.39%,0.67%
2020-01-01 00:02:00,16,9,8902,624,8278,13.58%,0.95%
2020-01-01 00:02:00,16,10,1516,26,1490,2.31%,0.04%
2020-01-01 00:02:00,16,11,9255,676,8579,14.12%,1.03%
2020-01-01 00:02:00,16,12,27380,5252,22128,41.78%,8.01%
2020-01-01 00:02:10,1,1,20277,2842,17435,30.94%,4.34%
2020-01-01 00:02:10,1,2,11002,864,10138,16.79%,1.32%
2020-01-01 00:02:10,1,3,553,0,553,0.84%,0.00%
2020-01-01 00:02:10,1,4,8988,646,8342,13.71%,0.99%
2020-01-01 00:02:10,1,5,8785,617,8168,13.40%,0.94%
2020-01-01 00:02:10,1,6,8705,611,8094,13.28%,0.93%
2020-01-01 00:02:10,1,7,10431,786,9645,15.92%,1.20%
2020-01-01 00:02:10,1,8,7041,395,6646,10.74%,0.60%
2020-01-01 00:02:10,1,9,8657,602,8055,13.21%,0.92%
2020-01-01 00:02:10,1,10,6135,289,5846,9.36%,0.44%
2020-01-01 00:02:10,1,11,6194,292,5902,9.45%,0.45%
2020-01-01 00:02:10,1,12,8638,601,8037,13.18%,0.92%
2020-01-01 00:02:10,2,1,1672,110,1562,2.55%,0.17%
2020-01-01 00:02:10,2,2,30370,6029,24341,46.34%,9.20%
2020-01-01 00:02:10,2,3,25086,4229,20857,38.28%,6.45%
2020-01-01 00:02:10,2,4,1578,105,1473,2.41%,0.16%
2020-01-01 00:02:10,2,5,17187,2108,15079,26.23%,3.22%
2020-01-01 00:02:10,2,6,74,0,74,0.11%,0.00%
2020-01-01 00:02:10,2,7,3579,93,3486,5.46%,0.14%
2020-01-01 00:02:10,2,8,2603,48,2555,3.97%,0.07%
2020-01-01 00:02:10,2,9,17035,2069,14966,25.99%,3.16%
2020-01-01 00:02:10,2,10,1857,23,1834,2.83%,0.04%
2020-01-01 00:02:10,2,11,1863,23,1840,2.84%,0.04%
2020-01-01 00:02:10,2,12,16906,2033,14873,25.80%,3.10%
2020-01-01 00:02:10,3,1,1559,23,1536,2.38%,0.04%
2020-01-01 00:02:10,3,2,24069,3950,20119,36.73%,6.03%
2020-01-01 00:02:10,3,3,71175,27658,43517,108.60%,42.20%
2020-01-01 00:02:10,3,4,9988,734,9254,15.24%,1.12%
2020-01-01 00:02:10,3,5,46118,12863,33255,70.37%,19.63%
2020-01-01 00:02:10,3,6,11127,900,10227,16.98%,1.37%
2020-01-01 00:02:10,3,7,17811,2279,15532,27.18%,3.48%
2020-01-01 00:02:10,3,8,14560,1527,13033,22.22%,2.33%
2020-01-01 00:02:10,3,9,34568,7598,26970,52.75%,11.59%
2020-01-01 00:02:10,3,10,7824,446,7378,11.94%,0.68%
2020-01-01 00:02:10,3,11,1643,23,1620,2.51%,0.04%
2020-01-01 00:02:10,3,12,24739,4145,20594,37.75%,6.32%
2020-01-01 00:02:10,4,1,521,0,521,0.79%,0.00%
2020-01-01 00:02:10,4,2,289,0,289,0.44%,0.00%
2020-01-01 00:02:10,4,3,1175,6,1169,1.79%,0.01%
2020-01-01 00:02:10,4,4,29028,5386,23642,44.29%,8.22%
2020-01-01 00:02:10,4,5,19019,2496,16523,29.02%,3.81%
2020-01-01 00:02:10,4,6,24796,4063,20733,37.84%,6.20%
2020-01-01 00:02:10,4,7,4422,124,4298,6.75%,0.19%
2020-01-01 00:02:10,4,8,2825,55,2770,4.31%,0.08%
2020-01-01 00:02:10,4,9,16588,1934,14654,25.31%,2.95%
2020-01-01 00:02:10,4,10,2314,37,2277,3.53%,0.06%
2020-01-01 00:02:10,4,11,110,0,110,0.17%,0.00%
2020-01-01 00:02:10,4,12,13321,1294,12027,20.33%,1.97%
2020-01-01 00:02:10,5,1,2616,50,2566,3.99%,0.08%
2020-01-01 00:02:10,5,2,732,4,728,1.12%,0.01%
2020-01-01 00:02:10,5,3,1404,13,1391,2.14%,0.02%
2020-01-01 00:02:10,5,4,23279,3697,19582,35.52%,5.64%
2020-01-01 00:02:10,5,5,10466,854,9612,15.97%,1.30%
2020-01-01 00:02:10,5,6,17136,2097,15039,26.15%,3.20%
2020-01-01 00:02:10,5,7,6083,301,5782,9.28%,0.46%
2020-01-01 00:02:10,5,8,4758,183,4575,7.26%,0.28%
2020-01-01 00:02:10,5,9,8955,639,8316,13.66%,0.98%
2020-01-01 00:02:10,5,10,1593,24,1569,2.43%,0.04%
2020-01-01 00:02:10,5,11,1194,14,1180,1.82%,0.02%
2020-01-01 00:02:10,5,12,6785,398,6387,10.35%,0.61%
2020-01-01 00:02:10,6,1,1121,18,1103,1.71%,0.03%
2020-01-01 00:02:10,6,2,1235,28,1207,1.88%,0.04%
2020-01-01 00:02:10,6,3,1592,37,1555,2.43%,0.06%
2020-01-01 00:02:10,6,4,1340,3,1337,2.04%,0.00%
2020-01-01 00:02:10,6,5,11595,990,10605,17.69%,1.51%
2020-01-01 00:02:10,6,6,3833,86,3747,5.85%,0.13%
2020-01-01 00:02:10,6,7,2113,32,2081,3.22%,0.05%
2020-01-01 00:02:10,6,8,1636,24,1612,2.50%,0.04%
2020-01-01 00:02:10,6,9,5959,286,5673,9.09%,0.44%
2020-01-01 00:02:10,6,10,1980,33,1947,3.02%,0.05%
2020-01-01 00:02:10,6,11,389,0,389,0.59%,0.00%
2020-01-01 00:02:10,6,12,3924,148,3776,5.99%,0.23%
2020-01-01 00:02:10,7,1,392,1,391,0.60%,0.00%
2020-01-01 00:02:10,7,2,702,2,700,1.07%,0.00%
2020-01-01 00:02:10,7,3,1048,5,1043,1.60%,0.01%
2020-01-01 00:02:10,7,4,1355,21,1334,2.07%,0.03%
2020-01-01 00:02:10,7,5,6167,278,5889,9.41%,0.42%
2020-01-01 00:02:10,7,6,12001,1031,10970,18.31%,1.57%
2020-01-01 00:02:10,7,7,4453,157,4296,6.79%,0.24%
2020-01-01 00:02:10,7,8,1655,17,1638,2.53%,0.03%
2020-01-01 00:02:10,7,9,5004,191,4813,7.64%,0.29%
2020-01-01 00:02:10,7,10,1137,5,1132,1.73%,0.01%
2020-01-01 00:02:10,7,11,169,0,169,0.26%,0.00%
2020-01-01 00:02:10,7,12,3830,123,3707,5.84%,0.19%
2020-01-01 00:02:10,8,1,375,0,375,0.57%,0.00%
2020-01-01 00:02:10,8,2,68,0,68,0.10%,0.00%
2020-01-01 00:02:10,8,3,1632,28,1604,2.49%,0.04%
2020-01-01 00:02:10,8,4,2587,44,2543,3.95%,0.07%
2020-01-01 00:02:10,8,5,8391,569,7822,12.80%,0.87%
2020-01-01 00:02:10,8,6,16704,2027,14677,25.49%,3.09%
2020-01-01 00:02:10,8,7,5634,274,5360,8.60%,0.42%
2020-01-01 00:02:10,8,8,3176,77,3099,4.85%,0.12%
2020-01-01 00:02:10,8,9,6618,345,6273,10.10%,0.53%
2020-01-01 00:02:10,8,10,2143,33,2110,3.27%,0.05%
2020-01-01 00:02:10,8,11,262,0,262,0.40%,0.00%
2020-01-01 00:02:10,8,12,4367,166,4201,6.66%,0.25%
2020-01-01 00:02:10,9,1,1127,4,1123,1.72%,0.01%
2020-01-01 00:02:10,9,2,6758,328,6430,10.31%,0.50%
2020-01-01 00:02:10,9,3,5196,198,4998,7.93%,0.30%
2020-01-01 00:02:10,9,4,6126,288,5838,9.35%,0.44%
2020-01-01 00:02:10,9,5,1043,15,1028,1.59%,0.02%
2020-01-01 00:02:10,9,6,7316,408,6908,11.16%,0.62%
2020-01-01 00:02:10,9,7,33084,7160,25924,50.48%,10.93%
2020-01-01 00:02:10,9,8,13346,1318,12028,20.36%,2.01%
2020-01-01 00:02:10,9,9,178,1,177,0.27%,0.00%
2020-01-01 00:02:10,9,10,5530,217,5313,8.44%,0.33%
2020-01-01 00:02:10,9,11,12467,1171,11296,19.02%,1.79%
2020-01-01 00:02:10,9,12,6482,319,6163,9.89%,0.49%
2020-01-01 00:02:10,10,1,1429,397,1032,2.18%,0.61%
2020-01-01 00:02:10,10,2,3381,480,2901,5.16%,0.73%
2020-01-01 00:02:10,10,3,1778,18,1760,2.71%,0.03%
2020-01-01 00:02:10,10,4,3630,843,2787,5.54%,1.29%
2020-01-01 00:02:10,10,5,757,7,750,1.16%,0.01%
2020-01-01 00:02:10,10,6,5415,932,4483,8.26%,1.42%
2020-01-01 00:02:10,10,7,10460,1781,8679,15.96%,2.72%
2020-01-01 00:02:10,10,8,26168,6031,20137,39.93%,9.20%
2020-01-01 00:02:10,10,9,804,6,798,1.23%,0.01%
2020-01-01 00:02:10,10,10,3631,119,3512,5.54%,0.18%
2020-01-01 00:02:10,10,11,13064,1542,11522,19.93%,2.35%
2020-01-01 00:02:10,10,12,8852,877,7975,13.51%,1.34%
2020-01-01 00:02:10,11,1,2177,35,2142,3.32%,0.05%
2020-01-01 00:02:10,11,2,3780,121,3659,5.77%,0.18%
2020-01-01 00:02:10,11,3,1448,24,1424,2.21%,0.04%
2020-01-01 00:02:10,11,4,3703,102,3601,5.65%,0.16%
2020-01-01 00:02:10,11,5,644,4,640,0.98%,0.01%
2020-01-01 00:02:10,11,6,4944,186,4758,7.54%,0.28%
2020-01-01 00:02:10,11,7,11072,920,10152,16.89%,1.40%
2020-01-01 00:02:10,11,8,24810,4263,20547,37.86%,6.50%
2020-01-01 00:02:10,11,9,282,0,282,0.43%,0.00%
2020-01-01 00:02:10,11,10,3731,108,3623,5.69%,0.16%
2020-01-01 00:02:10,11,11,10071,743,9328,15.37%,1.13%
2020-01-01 00:02:10,11,12,6121,280,5841,9.34%,0.43%
2020-01-01 00:02:10,12,1,23,1,22,0.04%,0.00%
2020-01-01 00:02:10,12,2,685,274,411,1.05%,0.42%
2020-01-01 00:02:10,12,3,3333,347,2986,5.09%,0.53%
2020-01-01 00:02:10,12,4,3443,65,3378,5.25%,0.10%
2020-01-01 00:02:10,12,5,10871,1029,9842,16.59%,1.57%
2020-01-01 00:02:10,12,6,6633,307,6326,10.12%,0.47%
2020-01-01 00:02:10,12,7,2929,89,2840,4.47%,0.14%
2020-01-01 00:02:10,12,8,2049,328,1721,3.13%,0.50%
2020-01-01 00:02:10,12,9,23938,4856,19082,36.53%,7.41%
2020-01-01 00:02:10,12,10,4602,426,4176,7.02%,0.65%
2020-01-01 00:02:10,12,11,2246,332,1914,3.43%,0.51%
2020-01-01 00:02:10,12,12,7341,1182,6159,11.20%,1.80%
2020-01-01 00:02:10,13,1,2064,39,2025,3.15%,0.06%
2020-01-01 00:02:10,13,2,2408,45,2363,3.67%,0.07%
2020-01-01 00:02:10,13,3,1510,392,1118,2.30%,0.60%
2020-01-01 00:02:10,13,4,5584,492,5092,8.52%,0.75%
2020-01-01 00:02:10,13,5,9972,1489,8483,15.22%,2.27%
2020-01-01 00:02:10,13,6,6759,606,6153,10.31%,0.92%
2020-01-01 00:02:10,13,7,4467,144,4323,6.82%,0.22%
2020-01-01 00:02:10,13,8,6242,298,5944,9.52%,0.45%
2020-01-01 00:02:10,13,9,10199,1526,8673,15.56%,2.33%
2020-01-01 00:02:10,13,10,30848,7123,23725,47.07%,10.87%
2020-01-01 00:02:10,13,11,17142,2472,14670,26.16%,3.77%
2020-01-01 00:02:10,13,12,10242,1259,8983,15.63%,1.92%
2020-01-01 00:02:10,14,1,304,0,304,0.46%,0.00%
2020-01-01 00:02:10,14,2,2434,39,2395,3.71%,0.06%
2020-01-01 00:02:10,14,3,1852,20,1832,2.83%,0.03%
2020-01-01 00:02:10,14,4,3943,132,3811,6.02%,0.20%
2020-01-01 00:02:10,14,5,1529,16,1513,2.33%,0.02%
2020-01-01 00:02:10,14,6,4265,147,4118,6.51%,0.22%
2020-01-01 00:02:10,14,7,12266,1081,11185,18.72%,1.65%
2020-01-01 00:02:10,14,8,13757,1335,12422,20.99%,2.04%
2020-01-01 00:02:10,14,9,1838,29,1809,2.80%,0.04%
2020-01-01 00:02:10,14,10,4172,113,4059,6.37%,0.17%
2020-01-01 00:02:10,14,11,24789,4112,20677,37.83%,6.27%
2020-01-01 00:02:10,14,12,6676,344,6332,10.19%,0.52%
2020-01-01 00:02:10,15,1,491,3,488,0.75%,0.00%
2020-01-01 00:02:10,15,2,157,0,157,0.24%,0.00%
2020-01-01 00:02:10,15,3,3648,103,3545,5.57%,0.16%
2020-01-01 00:02:10,15,4,7228,494,6734,11.03%,0.75%
2020-01-01 00:02:10,15,5,11847,1101,10746,18.08%,1.68%
2020-01-01 00:02:10,15,6,7486,516,6970,11.42%,0.79%
2020-01-01 00:02:10,15,7,3728,127,3601,5.69%,0.19%
2020-01-01 00:02:10,15,8,5989,315,5674,9.14%,0.48%
2020-01-01 00:02:10,15,9,12014,1129,10885,18.33%,1.72%
2020-01-01 00:02:10,15,10,3589,96,3493,5.48%,0.15%
2020-01-01 00:02:10,15,11,9715,760,8955,14.82%,1.16%
2020-01-01 00:02:10,15,12,26767,5136,21631,40.84%,7.84%
2020-01-01 00:02:10,16,1,484,1,483,0.74%,0.00%
2020-01-01 00:02:10,16,2,373,2,371,0.57%,0.00%
2020-01-01 00:02:10,16,3,1340,16,1324,2.04%,0.02%
2020-01-01 00:02:10,16,4,3327,100,3227,5.08%,0.15%
2020-01-01 00:02:10,16,5,6489,378,6111,9.90%,0.58%
2020-01-01 00:02:10,16,6,3991,144,3847,6.09%,0.22%
2020-01-01 00:02:10,16,7,3431,88,3343,5.24%,0.13%
2020-01-01 00:02:10,16,8,7506,585,6921,11.45%,0.89%
2020-01-01 00:02:10,16,9,6922,428,6494,10.56%,0.65%
2020-01-01 00:02:10,16,10,1535,20,1515,2.34%,0.03%
2020-01-01 00:02:10,16,11,9403,848,8555,14.35%,1.29%
2020-01-01 00:02:10,16,12,25137,4585,20552,38.36%,7.00%
2020-01-01 00:02:20,1,1,16908,2073,14835,25.80%,3.16%
2020-01-01 00:02:20,1,2,6743,378,6365,10.29%,0.58%
2020-01-01 00:02:20,1,3,645,4,641,0.98%,0.01%
2020-01-01 00:02:20,1,4,9842,778,9064,15.02%,1.19%
2020-01-01 00:02:20,1,5,9664,743,8921,14.75%,1.13%
2020-01-01 00:02:20,1,6,9614,746,8868,14.67%,1.14%
2020-01-01 00:02:20,1,7,6075,301,5774,9.27%,0.46%
2020-01-01 00:02:20,1,8,5338,219,5119,8.15%,0.33%
2020-01-01 00:02:20,1,9,9575,733,8842,14.61%,1.12%
2020-01-01 00:02:20,1,10,4105,127,3978,6.26%,0.19%
2020-01-01 00:02:20,1,11,4186,131,4055,6.39%,0.20%
2020-01-01 00:02:20,1,12,9489,715,8774,14.48%,1.09%
2020-01-01 00:02:20,2,1,937,2,935,1.43%,0.00%
2020-01-01 00:02:20,2,2,29688,5703,23985,45.30%,8.70%
2020-01-01 00:02:20,2,3,24488,3957,20531,37.37%,6.04%
2020-01-01 00:02:20,2,4,882,2,880,1.35%,0.00%
2020-01-01 00:02:20,2,5,13476,1308,12168,20.56%,2.00%
2020-01-01 00:02:20,2,6,68,0,68,0.10%,0.00%
2020-01-01 00:02:20,2,7,4248,128,4120,6.48%,0.20%
2020-01-01 00:02:20,2,8,3426,89,3337,5.23%,0.14%
2020-01-01 00:02:20,2,9,13281,1278,12003,20.27%,1.95%
2020-01-01 00:02:20,2,10,2741,53,2688,4.18%,0.08%
2020-01-01 00:02:20,2,11,2742,53,2689,4.18%,0.08%
2020-01-01 00:02:20,2,12,13121,1238,11883,20.02%,1.89%
2020-01-01 00:02:20,3,1,3165,80,3085,4.83%,0.12%
2020-01-01 00:02:20,3,2,24488,4026,20462,37.37%,6.14%
2020-01-01 00:02:20,3,3,72573,28647,43926,110.74%,43.71%
2020-01-01 00:02:20,3,4,10241,749,9492,15.63%,1.14%
2020-01-01 00:02:20,3,5,47147,13423,33724,71.94%,20.48%
2020-01-01 00:02:20,3,6,11354,896,10458,17.32%,1.37%
2020-01-01 00:02:20,3,7,19414,2561,16853,29.62%,3.91%
2020-01-01 00:02:20,3,8,16570,1916,14654,25.28%,2.92%
2020-01-01 00:02:20,3,9,35399,8038,27361,54.01%,12.27%
2020-01-01 00:02:20,3,10,5727,255,5472,8.74%,0.39%
2020-01-01 00:02:20,3,11,2049,31,2018,3.13%,0.05%
2020-01-01 00:02:20,3,12,27307,4939,22368,41.67%,7.54%
2020-01-01 00:02:20,4,1,466,0,466,0.71%,0.00%
2020-01-01 00:02:20,4,2,252,0,252,0.38%,0.00%
2020-01-01 00:02:20,4,3,1109,4,1105,1.69%,0.01%
2020-01-01 00:02:20,4,4,29604,5734,23870,45.17%,8.75%
2020-01-01 00:02:20,4,5,19201,2564,16637,29.30%,3.91%
2020-01-01 00:02:20,4,6,25152,4256,20896,38.38%,6.49%
2020-01-01 00:02:20,4,7,4623,161,4462,7.05%,0.25%
2020-01-01 00:02:20,4,8,2869,67,2802,4.38%,0.10%
2020-01-01 00:02:20,4,9,16947,2040,14907,25.86%,3.11%
2020-01-01 00:02:20,4,10,2228,37,2191,3.40%,0.06%
2020-01-01 00:02:20,4,11,154,1,153,0.23%,0.00%
2020-01-01 00:02:20,4,12,13564,1348,12216,20.70%,2.06%
2020-01-01 00:02:20,5,1,2638,73,2565,4.03%,0.11%
2020-01-01 00:02:20,5,2,738,4,734,1.13%,0.01%
2020-01-01 00:02:20,5,3,774,4,770,1.18%,0.01%
2020-01-01 00:02:20,5,4,23745,3892,19853,36.23%,5.94%
2020-01-01 00:02:20,5,5,10149,770,9379,15.49%,1.17%
2020-01-01 00:02:20,5,6,16076,1899,14177,24.53%,2.90%
2020-01-01 00:02:20,5,7,5278,230,5048,8.05%,0.35%
2020-01-01 00:02:20,5,8,4290,144,4146,6.55%,0.22%
2020-01-01 00:02:20,5,9,9241,646,8595,14.10%,0.99%
2020-01-01 00:02:20,5,10,1177,11,1166,1.80%,0.02%
2020-01-01 00:02:20,5,11,1266,18,1248,1.93%,0.03%
2020-01-01 00:02:20,5,12,7434,425,7009,11.34%,0.65%
2020-01-01 00:02:20,6,1,1093,10,1083,1.67%,0.02%
2020-01-01 00:02:20,6,2,1204,11,1193,1.84%,0.02%
2020-01-01 00:02:20,6,3,1588,16,1572,2.42%,0.02%
2020-01-01 00:02:20,6,4,1234,18,1216,1.88%,0.03%
2020-01-01 00:02:20,6,5,12138,1010,11128,18.52%,1.54%
2020-01-01 00:02:20,6,6,3793,127,3666,5.79%,0.19%
2020-01-01 00:02:20,6,7,2206,46,2160,3.37%,0.07%
2020-01-01 00:02:20,6,8,1687,29,1658,2.57%,0.04%
2020-01-01 00:02:20,6,9,6520,275,6245,9.95%,0.42%
2020-01-01 00:02:20,6,10,2127,29,2098,3.25%,0.04%
2020-01-01 00:02:20,6,11,413,1,412,0.63%,0.00%
2020-01-01 00:02:20,6,12,4338,130,4208,6.62%,0.20%
2020-01-01 00:02:20,7,1,485,0,485,0.74%,0.00%
2020-01-01 00:02:20,7,2,297,0,297,0.45%,0.00%
2020-01-01 00:02:20,7,3,1134,11,1123,1.73%,0.02%
2020-01-01 00:02:20,7,4,1263,9,1254,1.93%,0.01%
2020-01-01 00:02:20,7,5,7016,389,6627,10.71%,0.59%
2020-01-01 00:02:20,7,6,12604,1091,11513,19.23%,1.66%
2020-01-01 00:02:20,7,7,4316,127,4189,6.59%,0.19%
2020-01-01 00:02:20,7,8,1695,11,1684,2.59%,0.02%
2020-01-01 00:02:20,7,9,5761,266,5495,8.79%,0.41%
2020-01-01 00:02:20,7,10,1318,19,1299,2.01%,0.03%
2020-01-01 00:02:20,7,11,145,0,145,0.22%,0.00%
2020-01-01 00:02:20,7,12,4437,150,4287,6.77%,0.23%
2020-01-01 00:02:20,8,1,391,1,390,0.60%,0.00%
2020-01-01 00:02:20,8,2,66,0,66,0.10%,0.00%
2020-01-01 00:02:20,8,3,1642,20,1622,2.51%,0.03%
2020-01-01 00:02:20,8,4,2681,51,2630,4.09%,0.08%
2020-01-01 00:02:20,8,5,8179,506,7673,12.48%,0.77%
2020-01-01 00:02:20,8,6,15591,1694,13897,23.79%,2.58%
2020-01-01 00:02:20,8,7,4642,140,4502,7.08%,0.21%
2020-01-01 00:02:20,8,8,1650,22,1628,2.52%,0.03%
2020-01-01 00:02:20,8,9,6361,324,6037,9.71%,0.49%
2020-01-01 00:02:20,8,10,2156,33,2123,3.29%,0.05%
2020-01-01 00:02:20,8,11,209,0,209,0.32%,0.00%
2020-01-01 00:02:20,8,12,4097,142,3955,6.25%,0.22%
2020-01-01 00:02:20,9,1,1859,20,1839,2.84%,0.03%
2020-01-01 00:02:20,9,2,5917,266,5651,9.03%,0.41%
2020-01-01 00:02:20,9,3,3582,96,3486,5.47%,0.15%
2020-01-01 00:02:20,9,4,8645,530,8115,13.19%,0.81%
2020-01-01 00:02:20,9,5,824,4,820,1.26%,0.01%
2020-01-01 00:02:20,9,6,9605,662,8943,14.66%,1.01%
2020-01-01 00:02:20,9,7,32027,6888,25139,48.87%,10.51%
2020-01-01 00:02:20,9,8,9629,668,8961,14.69%,1.02%
2020-01-01 00:02:20,9,9,210,0,210,0.32%,0.00%
2020-01-01 00:02:20,9,10,3279,63,3216,5.00%,0.10%
2020-01-01 00:02:20,9,11,8873,576,8297,13.54%,0.88%
2020-01-01 00:02:20,9,12,5305,224,5081,8.09%,0.34%
2020-01-01 00:02:20,10,1,1494,399,1095,2.28%,0.61%
2020-01-01 00:02:20,10,2,4683,521,4162,7.15%,0.79%
2020-01-01 00:02:20,10,3,2987,63,2924,4.56%,0.10%
2020-01-01 00:02:20,10,4,3753,946,2807,5.73%,1.44%
2020-01-01 00:02:20,10,5,852,6,846,1.30%,0.01%
2020-01-01 00:02:20,10,6,5498,1048,4450,8.39%,1.60%
2020-01-01 00:02:20,10,7,11634,2027,9607,17.75%,3.09%
2020-01-01 00:02:20,10,8,27753,6440,21313,42.35%,9.83%
2020-01-01 00:02:20,10,9,782,1,781,1.19%,0.00%
2020-01-01 00:02:20,10,10,3593,103,3490,5.48%,0.16%
2020-01-01 00:02:20,10,11,12392,1366,11026,18.91%,2.08%
2020-01-01 00:02:20,10,12,8277,778,7499,12.63%,1.19%
2020-01-01 00:02:20,11,1,2228,36,2192,3.40%,0.05%
2020-01-01 00:02:20,11,2,4866,175,4691,7.42%,0.27%
2020-01-01 00:02:20,11,3,2443,52,2391,3.73%,0.08%
2020-01-01 00:02:20,11,4,3627,118,3509,5.53%,0.18%
2020-01-01 00:02:20,11,5,279,0,279,0.43%,0.00%
2020-01-01 00:02:20,11,6,4541,175,4366,6.93%,0.27%
2020-01-01 00:02:20,11,7,11256,918,10338,17.18%,1.40%
2020-01-01 00:02:20,11,8,25186,4285,20901,38.43%,6.54%
2020-01-01 00:02:20,11,9,406,0,406,0.62%,0.00%
2020-01-01 00:02:20,11,10,3466,84,3382,5.29%,0.13%
2020-01-01 00:02:20,11,11,9917,665,9252,15.13%,1.01%
2020-01-01 00:02:20,11,12,6243,282,5961,9.53%,0.43%
2020-01-01 00:02:20,12,1,36,0,36,0.05%,0.00%
2020-01-01 00:02:20,12,2,686,280,406,1.05%,0.43%
2020-01-01 00:02:20,12,3,3725,373,3352,5.68%,0.57%
2020-01-01 00:02:20,12,4,3626,69,3557,5.53%,0.11%
2020-01-01 00:02:20,12,5,11295,1155,10140,17.23%,1.76%
2020-01-01 00:02:20,12,6,6628,327,6301,10.11%,0.50%
2020-01-01 00:02:20,12,7,2747,62,2685,4.19%,0.09%
2020-01-01 00:02:20,12,8,1649,283,1366,2.52%,0.43%
2020-01-01 00:02:20,12,9,25404,5486,19918,38.76%,8.37%
2020-01-01 00:02:20,12,10,4722,429,4293,7.21%,0.65%
2020-01-01 00:02:20,12,11,1899,290,1609,2.90%,0.44%
2020-01-01 00:02:20,12,12,7917,1198,6719,12.08%,1.83%
2020-01-01 00:02:20,13,1,2065,21,2044,3.15%,0.03%
2020-01-01 00:02:20,13,2,2361,27,2334,3.60%,0.04%
2020-01-01 00:02:20,13,3,1011,4,1007,1.54%,0.01%
2020-01-01 00:02:20,13,4,5115,442,4673,7.80%,0.67%
2020-01-01 00:02:20,13,5,7869,882,6987,12.01%,1.35%
2020-01-01 00:02:20,13,6,5999,505,5494,9.15%,0.77%
2020-01-01 00:02:20,13,7,4473,146,4327,6.83%,0.22%
2020-01-01 00:02:20,13,8,6171,272,5899,9.42%,0.42%
2020-01-01 00:02:20,13,9,8079,901,7178,12.33%,1.37%
2020-01-01 00:02:20,13,10,28986,6152,22834,44.23%,9.39%
2020-01-01 00:02:20,13,11,17315,2474,14841,26.42%,3.78%
2020-01-01 00:02:20,13,12,10500,1242,9258,16.02%,1.90%
2020-01-01 00:02:20,14,1,268,0,268,0.41%,0.00%
2020-01-01 00:02:20,14,2,2363,45,2318,3.61%,0.07%
2020-01-01 00:02:20,14,3,1854,33,1821,2.83%,0.05%
2020-01-01 00:02:20,14,4,3772,105,3667,5.76%,0.16%
2020-01-01 00:02:20,14,5,1702,30,1672,2.60%,0.05%
2020-01-01 00:02:20,14,6,4054,120,3934,6.19%,0.18%
2020-01-01 00:02:20,14,7,11799,951,10848,18.00%,1.45%
2020-01-01 00:02:20,14,8,13345,1243,12102,20.36%,1.90%
2020-01-01 00:02:20,14,9,1891,37,1854,2.89%,0.06%
2020-01-01 00:02:20,14,10,4494,154,4340,6.86%,0.23%
2020-01-01 00:02:20,14,11,24994,4182,20812,38.14%,6.38%
2020-01-01 00:02:20,14,12,6908,366,6542,10.54%,0.56%
2020-01-01 00:02:20,15,1,420,1,419,0.64%,0.00%
2020-01-01 00:02:20,15,2,114,0,114,0.17%,0.00%
2020-01-01 00:02:20,15,3,3460,106,3354,5.28%,0.16%
2020-01-01 00:02:20,15,4,5458,312,5146,8.33%,0.48%
2020-01-01 00:02:20,15,5,9814,860,8954,14.97%,1.31%
2020-01-01 00:02:20,15,6,5660,324,5336,8.64%,0.49%
2020-01-01 00:02:20,15,7,3887,121,3766,5.93%,0.18%
2020-01-01 00:02:20,15,8,6520,339,6181,9.95%,0.52%
2020-01-01 00:02:20,15,9,9994,879,9115,15.25%,1.34%
2020-01-01 00:02:20,15,10,4166,118,4048,6.36%,0.18%
2020-01-01 00:02:20,15,11,10816,846,9970,16.50%,1.29%
2020-01-01 00:02:20,15,12,26193,4942,21251,39.97%,7.54%
2020-01-01 00:02:20,16,1,440,0,440,0.67%,0.00%
2020-01-01 00:02:20,16,2,346,1,345,0.53%,0.00%
2020-01-01 00:02:20,16,3,1399,11,1388,2.13%,0.02%
2020-01-01 00:02:20,16,4,3926,104,3822,5.99%,0.16%
2020-01-01 00:02:20,16,5,7136,433,6703,10.89%,0.66%
2020-01-01 00:02:20,16,6,4640,155,4485,7.08%,0.24%
2020-01-01 00:02:20,16,7,3241,105,3136,4.95%,0.16%
2020-01-01 00:02:20,16,8,7288,460,6828,11.12%,0.70%
2020-01-01 00:02:20,16,9,7580,479,7101,11.57%,0.73%
2020-01-01 00:02:20,16,10,1777,22,1755,2.71%,0.03%
2020-01-01 00:02:20,16,11,9404,703,8701,14.35%,1.07%
2020-01-01 00:02:20,16,12,26561,5090,21471,40.53%,7.77%
2020-01-01 00:02:30,1,1,21825,3266,18559,33.30%,4.98%
2020-01-01 00:02:30,1,2,10953,837,10116,16.71%,1.28%
2020-01-01 00:02:30,1,3,609,2,607,0.93%,0.00%
2020-01-01 00:02:30,1,4,10593,881,9712,16.16%,1.34%
2020-01-01 00:02:30,1,5,9928,782,9146,15.15%,1.19%
2020-01-01 00:02:30,1,6,9842,773,9069,15.02%,1.18%
2020-01-01 00:02:30,1,7,10331,738,9593,15.76%,1.13%
2020-01-01 00:02:30,1,8,8163,486,7677,12.46%,0.74%
2020-01-01 00:02:30,1,9,9819,771,9048,14.98%,1.18%
2020-01-01 00:02:30,1,10,7295,393,6902,11.13%,0.60%
2020-01-01 00:02:30,1,11,7345,398,6947,11.21%,0.61%
2020-01-01 00:02:30,1,12,9779,768,9011,14.92%,1.17%
2020-01-01 00:02:30,2,1,1721,4,1717,2.63%,0.01%
2020-01-01 00:02:30,2,2,33747,7445,26302,51.49%,11.36%
2020-01-01 00:02:30,2,3,25134,4383,20751,38.35%,6.69%
2020-01-01 00:02:30,2,4,1402,2,1400,2.14%,0.00%
2020-01-01 00:02:30,2,5,14114,1454,12660,21.54%,2.22%
2020-01-01 00:02:30,2,6,88,0,88,0.13%,0.00%
2020-01-01 00:02:30,2,7,6872,360,6512,10.49%,0.55%
2020-01-01 00:02:30,2,8,5618,243,5375,8.57%,0.37%
2020-01-01 00:02:30,2,9,13873,1393,12480,21.17%,2.13%
2020-01-01 00:02:30,2,10,4770,175,4595,7.28%,0.27%
2020-01-01 00:02:30,2,11,4773,175,4598,7.28%,0.27%
2020-01-01 00:02:30,2,12,13736,1365,12371,20.96%,2.08%
2020-01-01 00:02:30,3,1,1578,20,1558,2.41%,0.03%
2020-01-01 00:02:30,3,2,21491,3148,18343,32.79%,4.80%
2020-01-01 00:02:30,3,3,64808,23515,41293,98.89%,35.88%
2020-01-01 00:02:30,3,4,12879,1216,11663,19.65%,1.86%
2020-01-01 00:02:30,3,5,42252,11028,31224,64.47%,16.83%
2020-01-01 00:02:30,3,6,14074,1443,12631,21.48%,2.20%
2020-01-01 00:02:30,3,7,17879,2177,15702,27.28%,3.32%
2020-01-01 00:02:30,3,8,15441,1649,13792,23.56%,2.52%
2020-01-01 00:02:30,3,9,27709,5024,22685,42.28%,7.67%
2020-01-01 00:02:30,3,10,4438,153,4285,6.77%,0.23%
2020-01-01 00:02:30,3,11,2265,50,2215,3.46%,0.08%
2020-01-01 00:02:30,3,12,21975,3274,18701,33.53%,5.00%
2020-01-01 00:02:30,4,1,448,3,445,0.68%,0.00%
2020-01-01 00:02:30,4,2,264,0,264,0.40%,0.00%
2020-01-01 00:02:30,4,3,1048,7,1041,1.60%,0.01%
2020-01-01 00:02:30,4,4,30016,5940,24076,45.80%,9.06%
2020-01-01 00:02:30,4,5,18992,2518,16474,28.98%,3.84%
2020-01-01 00:02:30,4,6,25072,4246,20826,38.26%,6.48%
2020-01-01 00:02:30,4,7,4796,154,4642,7.32%,0.23%
2020-01-01 00:02:30,4,8,3108,72,3036,4.74%,0.11%
2020-01-01 00:02:30,4,9,16645,1975,14670,25.40%,3.01%
2020-01-01 00:02:30,4,10,2033,31,2002,3.10%,0.05%
2020-01-01 00:02:30,4,11,120,0,120,0.18%,0.00%
2020-01-01 00:02:30,4,12,13600,1305,12295,20.75%,1.99%
2020-01-01 00:02:30,5,1,2985,71,2914,4.55%,0.11%
2020-01-01 00:02:30,5,2,733,5,728,1.12%,0.01%
2020-01-01 00:02:30,5,3,3427,89,3338,5.23%,0.14%
2020-01-01 00:02:30,5,4,26189,4663,21526,39.96%,7.12%
2020-01-01 00:02:30,5,5,12384,1157,11227,18.90%,1.77%
2020-01-01 00:02:30,5,6,18289,2384,15905,27.91%,3.64%
2020-01-01 00:02:30,5,7,5169,226,4943,7.89%,0.34%
2020-01-01 00:02:30,5,8,4207,148,4059,6.42%,0.23%
2020-01-01 00:02:30,5,9,8791,614,8177,13.41%,0.94%
2020-01-01 00:02:30,5,10,1309,19,1290,2.00%,0.03%
2020-01-01 00:02:30,5,11,984,14,970,1.50%,0.02%
2020-01-01 00:02:30,5,12,6622,360,6262,10.10%,0.55%
2020-01-01 00:02:30,6,1,1254,10,1244,1.91%,0.02%
2020-01-01 00:02:30,6,2,1363,12,1351,2.08%,0.02%
2020-01-01 00:02:30,6,3,1843,21,1822,2.81%,0.03%
2020-01-01 00:02:30,6,4,1216,14,1202,1.86%,0.02%
2020-01-01 00:02:30,6,5,14336,1429,12907,21.88%,2.18%
2020-01-01 00:02:30,6,6,5232,186,5046,7.98%,0.28%
2020-01-01 00:02:30,6,7,3655,85,3570,5.58%,0.13%
2020-01-01 00:02:30,6,8,3162,63,3099,4.82%,0.10%
2020-01-01 00:02:30,6,9,6951,344,6607,10.61%,0.52%
2020-01-01 00:02:30,6,10,2602,53,2549,3.97%,0.08%
2020-01-01 00:02:30,6,11,319,1,318,0.49%,0.00%
2020-01-01 00:02:30,6,12,4278,138,4140,6.53%,0.21%
2020-01-01 00:02:30,7,1,362,1,361,0.55%,0.00%
2020-01-01 00:02:30,7,2,133,0,133,0.20%,0.00%
2020-01-01 00:02:30,7,3,499,4,495,0.76%,0.01%
2020-01-01 00:02:30,7,4,1519,20,1499,2.32%,0.03%
2020-01-01 00:02:30,7,5,7096,368,6728,10.83%,0.56%
2020-01-01 00:02:30,7,6,12660,1139,11521,19.32%,1.74%
2020-01-01 00:02:30,7,7,4025,170,3855,6.14%,0.26%
2020-01-01 00:02:30,7,8,1702,31,1671,2.60%,0.05%
2020-01-01 00:02:30,7,9,6465,306,6159,9.86%,0.47%
2020-01-01 00:02:30,7,10,2175,31,2144,3.32%,0.05%
2020-01-01 00:02:30,7,11,123,0,123,0.19%,0.00%
2020-01-01 00:02:30,7,12,4341,138,4203,6.62%,0.21%
2020-01-01 00:02:30,8,1,570,1,569,0.87%,0.00%
2020-01-01 00:02:30,8,2,121,2,119,0.18%,0.00%
2020-01-01 00:02:30,8,3,1364,16,1348,2.08%,0.02%
2020-01-01 00:02:30,8,4,2765,54,2711,4.22%,0.08%
2020-01-01 00:02:30,8,5,8046,494,7552,12.28%,0.75%
2020-01-01 00:02:30,8,6,15241,1667,13574,23.26%,2.54%
2020-01-01 00:02:30,8,7,4353,149,4204,6.64%,0.23%
2020-01-01 00:02:30,8,8,1419,16,1403,2.17%,0.02%
2020-01-01 00:02:30,8,9,6551,333,6218,10.00%,0.51%
2020-01-01 00:02:30,8,10,2147,31,2116,3.28%,0.05%
2020-01-01 00:02:30,8,11,280,0,280,0.43%,0.00%
2020-01-01 00:02:30,8,12,4338,139,4199,6.62%,0.21%
2020-01-01 00:02:30,9,1,495,1,494,0.76%,0.00%
2020-01-01 00:02:30,9,2,2335,38,2297,3.56%,0.06%
2020-01-01 00:02:30,9,3,1376,15,1361,2.10%,0.02%
2020-01-01 00:02:30,9,4,6425,324,6101,9.80%,0.49%
2020-01-01 00:02:30,9,5,253,0,253,0.39%,0.00%
2020-01-01 00:02:30,9,6,6933,383,6550,10.58%,0.58%
2020-01-01 00:02:30,9,7,27136,4933,22203,41.41%,7.53%
2020-01-01 00:02:30,9,8,12006,963,11043,18.32%,1.47%
2020-01-01 00:02:30,9,9,237,0,237,0.36%,0.00%
2020-01-01 00:02:30,9,10,4072,91,3981,6.21%,0.14%
2020-01-01 00:02:30,9,11,10965,800,10165,16.73%,1.22%
2020-01-01 00:02:30,9,12,6552,285,6267,10.00%,0.43%
2020-01-01 00:02:30,10,1,1448,408,1040,2.21%,0.62%
2020-01-01 00:02:30,10,2,3306,459,2847,5.04%,0.70%
2020-01-01 00:02:30,10,3,1605,19,1586,2.45%,0.03%
2020-01-01 00:02:30,10,4,3844,1022,2822,5.87%,1.56%
2020-01-01 00:02:30,10,5,922,9,913,1.41%,0.01%
2020-01-01 00:02:30,10,6,5670,1136,4534,8.65%,1.73%
2020-01-01 00:02:30,10,7,10605,1994,8611,16.18%,3.04%
2020-01-01 00:02:30,10,8,27524,6612,20912,42.00%,10.09%
2020-01-01 00:02:30,10,9,790,5,785,1.21%,0.01%
2020-01-01 00:02:30,10,10,4082,139,3943,6.23%,0.21%
2020-01-01 00:02:30,10,11,13702,1656,12046,20.91%,2.53%
2020-01-01 00:02:30,10,12,9087,926,8161,13.87%,1.41%
2020-01-01 00:02:30,11,1,2360,41,2319,3.60%,0.06%
2020-01-01 00:02:30,11,2,3435,90,3345,5.24%,0.14%
2020-01-01 00:02:30,11,3,911,7,904,1.39%,0.01%
2020-01-01 00:02:30,11,4,4689,170,4519,7.15%,0.26%
2020-01-01 00:02:30,11,5,603,6,597,0.92%,0.01%
2020-01-01 00:02:30,11,6,5808,257,5551,8.86%,0.39%
2020-01-01 00:02:30,11,7,11025,884,10141,16.82%,1.35%
2020-01-01 00:02:30,11,8,25142,4323,20819,38.36%,6.60%
2020-01-01 00:02:30,11,9,292,0,292,0.45%,0.00%
2020-01-01 00:02:30,11,10,3404,78,3326,5.19%,0.12%
2020-01-01 00:02:30,11,11,9847,695,9152,15.03%,1.06%
2020-01-01 00:02:30,11,12,6053,279,5774,9.24%,0.43%
2020-01-01 00:02:30,12,1,66,0,66,0.10%,0.00%
2020-01-01 00:02:30,12,2,694,286,408,1.06%,0.44%
2020-01-01 00:02:30,12,3,4627,393,4234,7.06%,0.60%
2020-01-01 00:02:30,12,4,3627,129,3498,5.53%,0.20%
2020-01-01 00:02:30,12,5,12396,1364,11032,18.91%,2.08%
2020-01-01 00:02:30,12,6,6786,405,6381,10.35%,0.62%
2020-01-01 00:02:30,12,7,2920,87,2833,4.46%,0.13%
2020-01-01 00:02:30,12,8,1534,292,1242,2.34%,0.45%
2020-01-01 00:02:30,12,9,25933,5608,20325,39.57%,8.56%
2020-01-01 00:02:30,12,10,4016,410,3606,6.13%,0.63%
2020-01-01 00:02:30,12,11,1691,296,1395,2.58%,0.45%
2020-01-01 00:02:30,12,12,7982,1224,6758,12.18%,1.87%
2020-01-01 00:02:30,13,1,2071,24,2047,3.16%,0.04%
2020-01-01 00:02:30,13,2,2471,37,2434,3.77%,0.06%
2020-01-01 00:02:30,13,3,923,9,914,1.41%,0.01%
2020-01-01 00:02:30,13,4,3902,417,3485,5.95%,0.64%
2020-01-01 00:02:30,13,5,6663,839,5824,10.17%,1.28%
2020-01-01 00:02:30,13,6,4895,471,4424,7.47%,0.72%
2020-01-01 00:02:30,13,7,4455,104,4351,6.80%,0.16%
2020-01-01 00:02:30,13,8,6308,255,6053,9.63%,0.39%
2020-01-01 00:02:30,13,9,6915,868,6047,10.55%,1.32%
2020-01-01 00:02:30,13,10,25759,5086,20673,39.31%,7.76%
2020-01-01 00:02:30,13,11,16482,2248,14234,25.15%,3.43%
2020-01-01 00:02:30,13,12,9545,1084,8461,14.56%,1.65%
2020-01-01 00:02:30,14,1,349,0,349,0.53%,0.00%
2020-01-01 00:02:30,14,2,2161,23,2138,3.30%,0.04%
2020-01-01 00:02:30,14,3,1604,15,1589,2.45%,0.02%
2020-01-01 00:02:30,14,4,4619,153,4466,7.05%,0.23%
2020-01-01 00:02:30,14,5,1780,25,1755,2.72%,0.04%
2020-01-01 00:02:30,14,6,4907,175,4732,7.49%,0.27%
2020-01-01 00:02:30,14,7,12142,1065,11077,18.53%,1.63%
2020-01-01 00:02:30,14,8,14215,1484,12731,21.69%,2.26%
2020-01-01 00:02:30,14,9,1976,33,1943,3.02%,0.05%
2020-01-01 00:02:30,14,10,4276,137,4139,6.52%,0.21%
2020-01-01 00:02:30,14,11,25379,4405,20974,38.73%,6.72%
2020-01-01 00:02:30,14,12,6663,327,6336,10.17%,0.50%
2020-01-01 00:02:30,15,1,491,2,489,0.75%,0.00%
2020-01-01 00:02:30,15,2,169,0,169,0.26%,0.00%
2020-01-01 00:02:30,15,3,4095,122,3973,6.25%,0.19%
2020-01-01 00:02:30,15,4,6011,365,5646,9.17%,0.56%
2020-01-01 00:02:30,15,5,10991,1110,9881,16.77%,1.69%
2020-01-01 00:02:30,15,6,6256,383,5873,9.55%,0.58%
2020-01-01 00:02:30,15,7,3388,100,3288,5.17%,0.15%
2020-01-01 00:02:30,15,8,6243,273,5970,9.53%,0.42%
2020-01-01 00:02:30,15,9,11156,1146,10010,17.02%,1.75%
2020-01-01 00:02:30,15,10,5241,199,5042,8.00%,0.30%
2020-01-01 00:02:30,15,11,11630,935,10695,17.75%,1.43%
2020-01-01 00:02:30,15,12,28124,5651,22473,42.91%,8.62%
2020-01-01 00:02:30,16,1,393,1,392,0.60%,0.00%
2020-01-01 00:02:30,16,2,310,2,308,0.47%,0.00%
2020-01-01 00:02:30,16,3,1367,13,1354,2.09%,0.02%
2020-01-01 00:02:30,16,4,3702,123,3579,5.65%,0.19%
2020-01-01 00:02:30,16,5,7049,460,6589,10.76%,0.70%
2020-01-01 00:02:30,16,6,4469,178,4291,6.82%,0.27%
2020-01-01 00:02:30,16,7,3250,91,3159,4.96%,0.14%
2020-01-01 00:02:30,16,8,6865,405,6460,10.48%,0.62%
2020-01-01 00:02:30,16,9,7505,509,6996,11.45%,0.78%
2020-01-01 00:02:30,16,10,1704,17,1687,2.60%,0.03%
2020-01-01 00:02:30,16,11,8924,651,8273,13.62%,0.99%
2020-01-01 00:02:30,16,12,26097,4773,21324,39.82%,7.28%
2020-01-01 00:02:40,1,1,24974,4286,20688,38.11%,6.54%
2020-01-01 00:02:40,1,2,12074,1054,11020,18.42%,1.61%
2020-01-01 00:02:40,1,3,787,3,784,1.20%,0.00%
2020-01-01 00:02:40,1,4,12634,1206,11428,19.28%,1.84%
2020-01-01 00:02:40,1,5,12444,1183,11261,18.99%,1.81%
2020-01-01 00:02:40,1,6,12392,1171,11221,18.91%,1.79%
2020-01-01 00:02:40,1,7,11276,913,10363,17.21%,1.39%
2020-01-01 00:02:40,1,8,5724,242,5482,8.73%,0.37%
2020-01-01 00:02:40,1,9,12339,1162,11177,18.83%,1.77%
2020-01-01 00:02:40,1,10,5181,202,4979,7.91%,0.31%
2020-01-01 00:02:40,1,11,5224,207,5017,7.97%,0.32%
2020-01-01 00:02:40,1,12,12311,1157,11154,18.79%,1.77%
2020-01-01 00:02:40,2,1,808,3,805,1.23%,0.00%
2020-01-01 00:02:40,2,2,33364,7294,26070,50.91%,11.13%
2020-01-01 00:02:40,2,3,25722,4457,21265,39.25%,6.80%
2020-01-01 00:02:40,2,4,767,2,765,1.17%,0.00%
2020-01-01 00:02:40,2,5,16133,1842,14291,24.62%,2.81%
2020-01-01 00:02:40,2,6,49,0,49,0.07%,0.00%
2020-01-01 00:02:40,2,7,6815,369,6446,10.40%,0.56%
2020-01-01 00:02:40,2,8,5718,264,5454,8.72%,0.40%
2020-01-01 00:02:40,2,9,15950,1810,14140,24.34%,2.76%
2020-01-01 00:02:40,2,10,4756,177,4579,7.26%,0.27%
2020-01-01 00:02:40,2,11,4760,178,4582,7.26%,0.27%
2020-01-01 00:02:40,2,12,15809,1774,14035,24.12%,2.71%
2020-01-01 00:02:40,3,1,1291,15,1276,1.97%,0.02%
2020-01-01 00:02:40,3,2,24290,3920,20370,37.06%,5.98%
2020-01-01 00:02:40,3,3,68248,25762,42486,104.14%,39.31%
2020-01-01 00:02:40,3,4,8046,480,7566,12.28%,0.73%
2020-01-01 00:02:40,3,5,42870,11321,31549,65.41%,17.27%
2020-01-01 00:02:40,3,6,9129,608,8521,13.93%,0.93%
2020-01-01 00:02:40,3,7,20999,2994,18005,32.04%,4.57%
2020-01-01 00:02:40,3,8,18361,2275,16086,28.02%,3.47%
2020-01-01 00:02:40,3,9,33312,7158,26154,50.83%,10.92%
2020-01-01 00:02:40,3,10,6305,286,6019,9.62%,0.44%
2020-01-01 00:02:40,3,11,2171,25,2146,3.31%,0.04%
2020-01-01 00:02:40,3,12,25692,4392,21300,39.20%,6.70%
2020-01-01 00:02:40,4,1,465,1,464,0.71%,0.00%
2020-01-01 00:02:40,4,2,271,0,271,0.41%,0.00%
2020-01-01 00:02:40,4,3,1230,7,1223,1.88%,0.01%
2020-01-01 00:02:40,4,4,28577,5337,23240,43.61%,8.14%
2020-01-01 00:02:40,4,5,19066,2426,16640,29.09%,3.70%
2020-01-01 00:02:40,4,6,24840,4112,20728,37.90%,6.27%
2020-01-01 00:02:40,4,7,4615,159,4456,7.04%,0.24%
2020-01-01 00:02:40,4,8,2923,70,2853,4.46%,0.11%
2020-01-01 00:02:40,4,9,16523,1907,14616,25.21%,2.91%
2020-01-01 00:02:40,4,10,1991,26,1965,3.04%,0.04%
2020-01-01 00:02:40,4,11,159,0,159,0.24%,0.00%
2020-01-01 00:02:40,4,12,13316,1247,12069,20.32%,1.90%
2020-01-01 00:02:40,5,1,2652,52,2600,4.05%,0.08%
2020-01-01 00:02:40,5,2,758,9,749,1.16%,0.01%
2020-01-01 00:02:40,5,3,1047,5,1042,1.60%,0.01%
2020-01-01 00:02:40,5,4,24638,4105,20533,37.59%,6.26%
2020-01-01 00:02:40,5,5,10110,784,9326,15.43%,1.20%
2020-01-01 00:02:40,5,6,16175,1861,14314,24.68%,2.84%
2020-01-01 00:02:40,5,7,5387,219,5168,8.22%,0.33%
2020-01-01 00:02:40,5,8,4463,146,4317,6.81%,0.22%
2020-01-01 00:02:40,5,9,8950,635,8315,13.66%,0.97%
2020-01-01 00:02:40,5,10,1329,11,1318,2.03%,0.02%
2020-01-01 00:02:40,5,11,1106,10,1096,1.69%,0.02%
2020-01-01 00:02:40,5,12,7078,406,6672,10.80%,0.62%
2020-01-01 00:02:40,6,1,1187,10,1177,1.81%,0.02%
2020-01-01 00:02:40,6,2,1302,13,1289,1.99%,0.02%
2020-01-01 00:02:40,6,3,1822,26,1796,2.78%,0.04%
2020-01-01 00:02:40,6,4,1590,13,1577,2.43%,0.02%
2020-01-01 00:02:40,6,5,15406,1648,13758,23.51%,2.51%
2020-01-01 00:02:40,6,6,5641,203,5438,8.61%,0.31%
2020-01-01 00:02:40,6,7,3513,85,3428,5.36%,0.13%
2020-01-01 00:02:40,6,8,3010,68,2942,4.59%,0.10%
2020-01-01 00:02:40,6,9,7673,449,7224,11.71%,0.69%
2020-01-01 00:02:40,6,10,2327,41,2286,3.55%,0.06%
2020-01-01 00:02:40,6,11,344,2,342,0.52%,0.00%
2020-01-01 00:02:40,6,12,5272,208,5064,8.04%,0.32%
2020-01-01 00:02:40,7,1,490,1,489,0.75%,0.00%
2020-01-01 00:02:40,7,2,110,0,110,0.17%,0.00%
2020-01-01 00:02:40,7,3,854,5,849,1.30%,0.01%
2020-01-01 00:02:40,7,4,1529,22,1507,2.33%,0.03%
2020-01-01 00:02:40,7,5,6810,364,6446,10.39%,0.56%
2020-01-01 00:02:40,7,6,12192,1157,11035,18.60%,1.77%
2020-01-01 00:02:40,7,7,3831,167,3664,5.85%,0.25%
2020-01-01 00:02:40,7,8,1460,13,1447,2.23%,0.02%
2020-01-01 00:02:40,7,9,5817,230,5587,8.88%,0.35%
2020-01-01 00:02:40,7,10,1639,15,1624,2.50%,0.02%
2020-01-01 00:02:40,7,11,124,1,123,0.19%,0.00%
2020-01-01 00:02:40,7,12,4163,126,4037,6.35%,0.19%
2020-01-01 00:02:40,8,1,613,3,610,0.94%,0.00%
2020-01-01 00:02:40,8,2,91,0,91,0.14%,0.00%
2020-01-01 00:02:40,8,3,1333,17,1316,2.03%,0.03%
2020-01-01 00:02:40,8,4,3040,70,2970,4.64%,0.11%
2020-01-01 00:02:40,8,5,7511,398,7113,11.46%,0.61%
2020-01-01 00:02:40,8,6,15413,1688,13725,23.52%,2.58%
2020-01-01 00:02:40,8,7,4754,176,4578,7.25%,0.27%
2020-01-01 00:02:40,8,8,1430,24,1406,2.18%,0.04%
2020-01-01 00:02:40,8,9,6025,261,5764,9.19%,0.40%
2020-01-01 00:02:40,8,10,2035,27,2008,3.11%,0.04%
2020-01-01 00:02:40,8,11,275,1,274,0.42%,0.00%
2020-01-01 00:02:40,8,12,3915,122,3793,5.97%,0.19%
2020-01-01 00:02:40,9,1,294,2,292,0.45%,0.00%
2020-01-01 00:02:40,9,2,2051,32,2019,3.13%,0.05%
2020-01-01 00:02:40,9,3,1278,13,1265,1.95%,0.02%
2020-01-01 00:02:40,9,4,8398,529,7869,12.81%,0.81%
2020-01-01 00:02:40,9,5,254,1,253,0.39%,0.00%
2020-01-01 00:02:40,9,6,9000,604,8396,13.73%,0.92%
2020-01-01 00:02:40,9,7,27893,5165,22728,42.56%,7.88%
2020-01-01 00:02:40,9,8,11324,936,10388,17.28%,1.43%
2020-01-01 00:02:40,9,9,233,1,232,0.36%,0.00%
2020-01-01 00:02:40,9,10,4580,134,4446,6.99%,0.20%
2020-01-01 00:02:40,9,11,10272,782,9490,15.67%,1.19%
2020-01-01 00:02:40,9,12,5403,247,5156,8.24%,0.38%
2020-01-01 00:02:40,10,1,1370,390,980,2.09%,0.60%
2020-01-01 00:02:40,10,2,3305,462,2843,5.04%,0.70%
2020-01-01 00:02:40,10,3,1750,31,1719,2.67%,0.05%
2020-01-01 00:02:40,10,4,3683,1003,2680,5.62%,1.53%
2020-01-01 00:02:40,10,5,824,3,821,1.26%,0.00%
2020-01-01 00:02:40,10,6,5486,1097,4389,8.37%,1.67%
2020-01-01 00:02:40,10,7,10390,1937,8453,15.85%,2.96%
2020-01-01 00:02:40,10,8,25912,5899,20013,39.54%,9.00%
2020-01-01 00:02:40,10,9,768,2,766,1.17%,0.00%
2020-01-01 00:02:40,10,10,3401,85,3316,5.19%,0.13%
2020-01-01 00:02:40,10,11,12529,1385,11144,19.12%,2.11%
2020-01-01 00:02:40,10,12,8568,828,7740,13.07%,1.26%
2020-01-01 00:02:40,11,1,2236,40,2196,3.41%,0.06%
2020-01-01 00:02:40,11,2,3558,105,3453,5.43%,0.16%
2020-01-01 00:02:40,11,3,1014,7,1007,1.55%,0.01%
2020-01-01 00:02:40,11,4,4626,200,4426,7.06%,0.31%
2020-01-01 00:02:40,11,5,356,0,356,0.54%,0.00%
2020-01-01 00:02:40,11,6,5496,258,5238,8.39%,0.39%
2020-01-01 00:02:40,11,7,11115,930,10185,16.96%,1.42%
2020-01-01 00:02:40,11,8,24304,4002,20302,37.08%,6.11%
2020-01-01 00:02:40,11,9,297,1,296,0.45%,0.00%
2020-01-01 00:02:40,11,10,3363,91,3272,5.13%,0.14%
2020-01-01 00:02:40,11,11,9169,646,8523,13.99%,0.99%
2020-01-01 00:02:40,11,12,5525,238,5287,8.43%,0.36%
2020-01-01 00:02:40,12,1,140,0,140,0.21%,0.00%
2020-01-01 00:02:40,12,2,674,278,396,1.03%,0.42%
2020-01-01 00:02:40,12,3,3686,361,3325,5.62%,0.55%
2020-01-01 00:02:40,12,4,3527,75,3452,5.38%,0.11%
2020-01-01 00:02:40,12,5,11095,1122,9973,16.93%,1.71%
2020-01-01 00:02:40,12,6,6533,302,6231,9.97%,0.46%
2020-01-01 00:02:40,12,7,2748,51,2697,4.19%,0.08%
2020-01-01 00:02:40,12,8,1599,317,1282,2.44%,0.48%
2020-01-01 00:02:40,12,9,24158,5015,19143,36.86%,7.65%
2020-01-01 00:02:40,12,10,4598,437,4161,7.02%,0.67%
2020-01-01 00:02:40,12,11,1850,320,1530,2.82%,0.49%
2020-01-01 00:02:40,12,12,7433,1176,6257,11.34%,1.79%
2020-01-01 00:02:40,13,1,1903,21,1882,2.90%,0.03%
2020-01-01 00:02:40,13,2,2204,33,2171,3.36%,0.05%
2020-01-01 00:02:40,13,3,998,8,990,1.52%,0.01%
2020-01-01 00:02:40,13,4,4116,385,3731,6.28%,0.59%
2020-01-01 00:02:40,13,5,6667,756,5911,10.17%,1.15%
2020-01-01 00:02:40,13,6,4897,427,4470,7.47%,0.65%
2020-01-01 00:02:40,13,7,4181,141,4040,6.38%,0.22%
2020-01-01 00:02:40,13,8,6178,315,5863,9.43%,0.48%
2020-01-01 00:02:40,13,9,6878,768,6110,10.49%,1.17%
2020-01-01 00:02:40,13,10,26337,5255,21082,40.19%,8.02%
2020-01-01 00:02:40,13,11,16789,2360,14429,25.62%,3.60%
2020-01-01 00:02:40,13,12,10022,1084,8938,15.29%,1.65%
2020-01-01 00:02:40,14,1,415,0,415,0.63%,0.00%
2020-01-01 00:02:40,14,2,2353,44,2309,3.59%,0.07%
2020-01-01 00:02:40,14,3,1761,28,1733,2.69%,0.04%
2020-01-01 00:02:40,14,4,4803,168,4635,7.33%,0.26%
2020-01-01 00:02:40,14,5,1314,13,1301,2.01%,0.02%
2020-01-01 00:02:40,14,6,5109,187,4922,7.80%,0.29%
2020-01-01 00:02:40,14,7,12612,1154,11458,19.24%,1.76%
2020-01-01 00:02:40,14,8,14209,1459,12750,21.68%,2.23%
2020-01-01 00:02:40,14,9,1482,18,1464,2.26%,0.03%
2020-01-01 00:02:40,14,10,4247,149,4098,6.48%,0.23%
2020-01-01 00:02:40,14,11,25471,4397,21074,38.87%,6.71%
2020-01-01 00:02:40,14,12,6808,347,6461,10.39%,0.53%
2020-01-01 00:02:40,15,1,494,2,492,0.75%,0.00%
2020-01-01 00:02:40,15,2,119,2,117,0.18%,0.00%
2020-01-01 00:02:40,15,3,4013,125,3888,6.12%,0.19%
2020-01-01 00:02:40,15,4,6097,370,5727,9.30%,0.56%
2020-01-01 00:02:40,15,5,11019,997,10022,16.81%,1.52%
2020-01-01 00:02:40,15,6,6384,398,5986,9.74%,0.61%
2020-01-01 00:02:40,15,7,3857,169,3688,5.89%,0.26%
2020-01-01 00:02:40,15,8,5828,318,5510,8.89%,0.49%
2020-01-01 00:02:40,15,9,11221,1025,10196,17.12%,1.56%
2020-01-01 00:02:40,15,10,4009,137,3872,6.12%,0.21%
2020-01-01 00:02:40,15,11,9977,805,9172,15.22%,1.23%
2020-01-01 00:02:40,15,12,26517,4976,21541,40.46%,7.59%
2020-01-01 00:02:40,16,1,450,5,445,0.69%,0.01%
2020-01-01 00:02:40,16,2,374,0,374,0.57%,0.00%
2020-01-01 00:02:40,16,3,1345,12,1333,2.05%,0.02%
2020-01-01 00:02:40,16,4,4108,129,3979,6.27%,0.20%
2020-01-01 00:02:40,16,5,7544,491,7053,11.51%,0.75%
2020-01-01 00:02:40,16,6,5009,175,4834,7.64%,0.27%
2020-01-01 00:02:40,16,7,3287,77,3210,5.02%,0.12%
2020-01-01 00:02:40,16,8,7099,424,6675,10.83%,0.65%
2020-01-01 00:02:40,16,9,7987,545,7442,12.19%,0.83%
2020-01-01 00:02:40,16,10,1698,21,1677,2.59%,0.03%
2020-01-01 00:02:40,16,11,9207,702,8505,14.05%,1.07%
2020-01-01 00:02:40,16,12,26559,4906,21653,40.53%,7.49%
2020-01-01 00:02:50,1,1,19985,2878,17107,30.49%,4.39%
2020-01-01 00:02:50,1,2,8531,592,7939,13.02%,0.90%
2020-01-01 00:02:50,1,3,844,5,839,1.29%,0.01%
2020-01-01 00:02:50,1,4,10983,902,10081,16.76%,1.38%
2020-01-01 00:02:50,1,5,10742,857,9885,16.39%,1.31%
2020-01-01 00:02:50,1,6,10692,854,9838,16.31%,1.30%
2020-01-01 00:02:50,1,7,7679,481,7198,11.72%,0.73%
2020-01-01 00:02:50,1,8,4357,163,4194,6.65%,0.25%
2020-01-01 00:02:50,1,9,10663,848,9815,16.27%,1.29%
2020-01-01 00:02:50,1,10,3921,131,3790,5.98%,0.20%
2020-01-01 00:02:50,1,11,3999,143,3856,6.10%,0.22%
2020-01-01 00:02:50,1,12,10636,843,9793,16.23%,1.29%
2020-01-01 00:02:50,2,1,870,2,868,1.33%,0.00%
2020-01-01 00:02:50,2,2,25210,4192,21018,38.47%,6.40%
2020-01-01 00:02:50,2,3,20858,2968,17890,31.83%,4.53%
2020-01-01 00:02:50,2,4,820,2,818,1.25%,0.00%
2020-01-01 00:02:50,2,5,12507,1084,11423,19.08%,1.65%
2020-01-01 00:02:50,2,6,132,0,132,0.20%,0.00%
2020-01-01 00:02:50,2,7,3447,89,3358,5.26%,0.14%
2020-01-01 00:02:50,2,8,2041,31,2010,3.11%,0.05%
2020-01-01 00:02:50,2,9,12325,1050,11275,18.81%,1.60%
2020-01-01 00:02:50,2,10,1300,11,1289,1.98%,0.02%
2020-01-01 00:02:50,2,11,1302,11,1291,1.99%,0.02%
2020-01-01 00:02:50,2,12,12159,1027,11132,18.55%,1.57%
2020-01-01 00:02:50,3,1,1229,20,1209,1.88%,0.03%
2020-01-01 00:02:50,3,2,21069,3053,18016,32.15%,4.66%
2020-01-01 00:02:50,3,3,72151,28398,43753,110.09%,43.33%
2020-01-01 00:02:50,3,4,11112,861,10251,16.96%,1.31%
2020-01-01 00:02:50,3,5,48871,14434,34437,74.57%,22.02%
2020-01-01 00:02:50,3,6,12484,1078,11406,19.05%,1.64%
2020-01-01 00:02:50,3,7,17643,2166,15477,26.92%,3.31%
2020-01-01 00:02:50,3,8,14997,1581,13416,22.88%,2.41%
2020-01-01 00:02:50,3,9,35913,8237,27676,54.80%,12.57%
2020-01-01 00:02:50,3,10,7102,366,6736,10.84%,0.56%
2020-01-01 00:02:50,3,11,2324,35,2289,3.55%,0.05%
2020-01-01 00:02:50,3,12,27456,5063,22393,41.89%,7.73%
2020-01-01 00:02:50,4,1,437,0,437,0.67%,0.00%
2020-01-01 00:02:50,4,2,279,0,279,0.43%,0.00%
2020-01-01 00:02:50,4,3,1351,10,1341,2.06%,0.02%
2020-01-01 00:02:50,4,4,28898,5515,23383,44.09%,8.42%
2020-01-01 00:02:50,4,5,19553,2687,16866,29.84%,4.10%
2020-01-01 00:02:50,4,6,25369,4313,21056,38.71%,6.58%
2020-01-01 00:02:50,4,7,4644,150,4494,7.09%,0.23%
2020-01-01 00:02:50,4,8,2947,67,2880,4.50%,0.10%
2020-01-01 00:02:50,4,9,16949,2075,14874,25.86%,3.17%
2020-01-01 00:02:50,4,10,1761,34,1727,2.69%,0.05%
2020-01-01 00:02:50,4,11,184,0,184,0.28%,0.00%
2020-01-01 00:02:50,4,12,13956,1395,12561,21.30%,2.13%
2020-01-01 00:02:50,5,1,2698,49,2649,4.12%,0.07%
2020-01-01 00:02:50,5,2,763,4,759,1.16%,0.01%
2020-01-01 00:02:50,5,3,2135,30,2105,3.26%,0.05%
2020-01-01 00:02:50,5,4,26133,4571,21562,39.88%,6.97%
2020-01-01 00:02:50,5,5,11344,956,10388,17.31%,1.46%
2020-01-01 00:02:50,5,6,16878,2027,14851,25.75%,3.09%
2020-01-01 00:02:50,5,7,4918,223,4695,7.50%,0.34%
2020-01-01 00:02:50,5,8,4089,146,3943,6.24%,0.22%
2020-01-01 00:02:50,5,9,9043,638,8405,13.80%,0.97%
2020-01-01 00:02:50,5,10,1048,19,1029,1.60%,0.03%
2020-01-01 00:02:50,5,11,1307,22,1285,1.99%,0.03%
2020-01-01 00:02:50,5,12,7522,454,7068,11.48%,0.69%
2020-01-01 00:02:50,6,1,1143,11,1132,1.74%,0.02%
2020-01-01 00:02:50,6,2,1277,13,1264,1.95%,0.02%
2020-01-01 00:02:50,6,3,1697,26,1671,2.59%,0.04%
2020-01-01 00:02:50,6,4,1573,12,1561,2.40%,0.02%
2020-01-01 00:02:50,6,5,17288,2163,15125,26.38%,3.30%
2020-01-01 00:02:50,6,6,5103,190,4913,7.79%,0.29%
2020-01-01 00:02:50,6,7,3117,89,3028,4.76%,0.14%
2020-01-01 00:02:50,6,8,2517,56,2461,3.84%,0.09%
2020-01-01 00:02:50,6,9,10195,756,9439,15.56%,1.15%
2020-01-01 00:02:50,6,10,1804,31,1773,2.75%,0.05%
2020-01-01 00:02:50,6,11,306,1,305,0.47%,0.00%
2020-01-01 00:02:50,6,12,8343,520,7823,12.73%,0.79%
2020-01-01 00:02:50,7,1,446,2,444,0.68%,0.00%
2020-01-01 00:02:50,7,2,84,0,84,0.13%,0.00%
2020-01-01 00:02:50,7,3,1068,8,1060,1.63%,0.01%
2020-01-01 00:02:50,7,4,1705,20,1685,2.60%,0.03%
2020-01-01 00:02:50,7,5,8099,505,7594,12.36%,0.77%
2020-01-01 00:02:50,7,6,13319,1287,12032,20.32%,1.96%
2020-01-01 00:02:50,7,7,3475,71,3404,5.30%,0.11%
2020-01-01 00:02:50,7,8,1413,16,1397,2.16%,0.02%
2020-01-01 00:02:50,7,9,6907,396,6511,10.54%,0.60%
2020-01-01 00:02:50,7,10,1987,27,1960,3.03%,0.04%
2020-01-01 00:02:50,7,11,186,0,186,0.28%,0.00%
2020-01-01 00:02:50,7,12,4918,173,4745,7.50%,0.26%
2020-01-01 00:02:50,8,1,593,3,590,0.90%,0.00%
2020-01-01 00:02:50,8,2,87,0,87,0.13%,0.00%
2020-01-01 00:02:50,8,3,1307,11,1296,1.99%,0.02%
2020-01-01 00:02:50,8,4,2860,60,2800,4.36%,0.09%
2020-01-01 00:02:50,8,5,8072,452,7620,12.32%,0.69%
2020-01-01 00:02:50,8,6,15957,1771,14186,24.35%,2.70%
2020-01-01 00:02:50,8,7,4947,159,4788,7.55%,0.24%
2020-01-01 00:02:50,8,8,1589,14,1575,2.42%,0.02%
2020-01-01 00:02:50,8,9,6510,283,6227,9.93%,0.43%
2020-01-01 00:02:50,8,10,2193,36,2157,3.35%,0.05%
2020-01-01 00:02:50,8,11,295,0,295,0.45%,0.00%
2020-01-01 00:02:50,8,12,4277,126,4151,6.53%,0.19%
2020-01-01 00:02:50,9,1,169,0,169,0.26%,0.00%
2020-01-01 00:02:50,9,2,2193,37,2156,3.35%,0.06%
2020-01-01 00:02:50,9,3,1525,14,1511,2.33%,0.02%
2020-01-01 00:02:50,9,4,4640,166,4474,7.08%,0.25%
2020-01-01 00:02:50,9,5,306,1,305,0.47%,0.00%
2020-01-01 00:02:50,9,6,5671,243,5428,8.65%,0.37%
2020-01-01 00:02:50,9,7,22370,3355,19015,34.13%,5.12%
2020-01-01 00:02:50,9,8,9008,588,8420,13.75%,0.90%
2020-01-01 00:02:50,9,9,292,1,291,0.45%,0.00%
2020-01-01 00:02:50,9,10,2427,34,2393,3.70%,0.05%
2020-01-01 00:02:50,9,11,7755,449,7306,11.83%,0.69%
2020-01-01 00:02:50,9,12,5150,211,4939,7.86%,0.32%
2020-01-01 00:02:50,10,1,1341,395,946,2.05%,0.60%
2020-01-01 00:02:50,10,2,3580,495,3085,5.46%,0.76%
2020-01-01 00:02:50,10,3,2063,61,2002,3.15%,0.09%
2020-01-01 00:02:50,10,4,4049,1169,2880,6.18%,1.78%
2020-01-01 00:02:50,10,5,961,9,952,1.47%,0.01%
2020-01-01 00:02:50,10,6,6451,1325,5126,9.84%,2.02%
2020-01-01 00:02:50,10,7,11562,2226,9336,17.64%,3.40%
2020-01-01 00:02:50,10,8,26525,6273,20252,40.47%,9.57%
2020-01-01 00:02:50,10,9,639,3,636,0.98%,0.00%
2020-01-01 00:02:50,10,10,2678,55,2623,4.09%,0.08%
2020-01-01 00:02:50,10,11,12242,1386,10856,18.68%,2.11%
2020-01-01 00:02:50,10,12,8835,894,7941,13.48%,1.36%
2020-01-01 00:02:50,11,1,2497,44,2453,3.81%,0.07%
2020-01-01 00:02:50,11,2,3532,88,3444,5.39%,0.13%
2020-01-01 00:02:50,11,3,857,4,853,1.31%,0.01%
2020-01-01 00:02:50,11,4,3747,87,3660,5.72%,0.13%
2020-01-01 00:02:50,11,5,375,1,374,0.57%,0.00%
2020-01-01 00:02:50,11,6,4935,159,4776,7.53%,0.24%
2020-01-01 00:02:50,11,7,10217,727,9490,15.59%,1.11%
2020-01-01 00:02:50,11,8,24577,3951,20626,37.50%,6.03%
2020-01-01 00:02:50,11,9,267,0,267,0.41%,0.00%
2020-01-01 00:02:50,11,10,3732,89,3643,5.69%,0.14%
2020-01-01 00:02:50,11,11,10372,775,9597,15.83%,1.18%
2020-01-01 00:02:50,11,12,6326,342,5984,9.65%,0.52%
2020-01-01 00:02:50,12,1,36,0,36,0.05%,0.00%
2020-01-01 00:02:50,12,2,743,280,463,1.13%,0.43%
2020-01-01 00:02:50,12,3,3959,382,3577,6.04%,0.58%
2020-01-01 00:02:50,12,4,3340,85,3255,5.10%,0.13%
2020-01-01 00:02:50,12,5,10762,1096,9666,16.42%,1.67%
2020-01-01 00:02:50,12,6,5872,253,5619,8.96%,0.39%
2020-01-01 00:02:50,12,7,2438,40,2398,3.72%,0.06%
2020-01-01 00:02:50,12,8,1391,313,1078,2.12%,0.48%
2020-01-01 00:02:50,12,9,23635,4991,18644,36.06%,7.62%
2020-01-01 00:02:50,12,10,4258,431,3827,6.50%,0.66%
2020-01-01 00:02:50,12,11,1562,315,1247,2.38%,0.48%
2020-01-01 00:02:50,12,12,7624,1238,6386,11.63%,1.89%
2020-01-01 00:02:50,13,1,2445,58,2387,3.73%,0.09%
2020-01-01 00:02:50,13,2,2660,67,2593,4.06%,0.10%
2020-01-01 00:02:50,13,3,914,0,914,1.39%,0.00%
2020-01-01 00:02:50,13,4,4187,547,3640,6.39%,0.83%
2020-01-01 00:02:50,13,5,7268,927,6341,11.09%,1.41%
2020-01-01 00:02:50,13,6,5344,614,4730,8.15%,0.94%
2020-01-01 00:02:50,13,7,4818,160,4658,7.35%,0.24%
2020-01-01 00:02:50,13,8,6410,296,6114,9.78%,0.45%
2020-01-01 00:02:50,13,9,7471,943,6528,11.40%,1.44%
2020-01-01 00:02:50,13,10,28232,6088,22144,43.08%,9.29%
2020-01-01 00:02:50,13,11,16980,2503,14477,25.91%,3.82%
2020-01-01 00:02:50,13,12,10184,1288,8896,15.54%,1.97%
2020-01-01 00:02:50,14,1,297,0,297,0.45%,0.00%
2020-01-01 00:02:50,14,2,2068,36,2032,3.16%,0.05%
2020-01-01 00:02:50,14,3,1480,20,1460,2.26%,0.03%
2020-01-01 00:02:50,14,4,6035,228,5807,9.21%,0.35%
2020-01-01 00:02:50,14,5,1402,20,1382,2.14%,0.03%
2020-01-01 00:02:50,14,6,6252,240,6012,9.54%,0.37%
2020-01-01 00:02:50,14,7,13043,1207,11836,19.90%,1.84%
2020-01-01 00:02:50,14,8,14831,1547,13284,22.63%,2.36%
2020-01-01 00:02:50,14,9,1586,23,1563,2.42%,0.04%
2020-01-01 00:02:50,14,10,4184,140,4044,6.38%,0.21%
2020-01-01 00:02:50,14,11,26251,4583,21668,40.06%,6.99%
2020-01-01 00:02:50,14,12,6984,362,6622,10.66%,0.55%
2020-01-01 00:02:50,15,1,637,4,633,0.97%,0.01%
2020-01-01 00:02:50,15,2,141,0,141,0.22%,0.00%
2020-01-01 00:02:50,15,3,3791,114,3677,5.78%,0.17%
2020-01-01 00:02:50,15,4,5645,211,5434,8.61%,0.32%
2020-01-01 00:02:50,15,5,10202,755,9447,15.57%,1.15%
2020-01-01 00:02:50,15,6,5886,230,5656,8.98%,0.35%
2020-01-01 00:02:50,15,7,3768,158,3610,5.75%,0.24%
2020-01-01 00:02:50,15,8,5679,317,5362,8.67%,0.48%
2020-01-01 00:02:50,15,9,10367,779,9588,15.82%,1.19%
2020-01-01 00:02:50,15,10,5749,249,5500,8.77%,0.38%
2020-01-01 00:02:50,15,11,11533,1025,10508,17.60%,1.56%
2020-01-01 00:02:50,15,12,27489,5351,22138,41.94%,8.16%
2020-01-01 00:02:50,16,1,465,0,465,0.71%,0.00%
2020-01-01 00:02:50,16,2,348,2,346,0.53%,0.00%
2020-01-01 00:02:50,16,3,2050,36,2014,3.13%,0.05%
2020-01-01 00:02:50,16,4,7663,481,7182,11.69%,0.73%
2020-01-01 00:02:50,16,5,11827,1149,10678,18.05%,1.75%
2020-01-01 00:02:50,16,6,8450,564,7886,12.89%,0.86%
2020-01-01 00:02:50,16,7,3035,60,2975,4.63%,0.09%
2020-01-01 00:02:50,16,8,8401,594,7807,12.82%,0.91%
2020-01-01 00:02:50,16,9,12273,1219,11054,18.73%,1.86%
2020-01-01 00:02:50,16,10,1398,18,1380,2.13%,0.03%
2020-01-01 00:02:50,16,11,10031,801,9230,15.31%,1.22%
2020-01-01 00:02:50,16,12,31929,6832,25097,48.72%,10.42%
2020-01-01 00:03:00,1,1,19477,2775,16702,29.72%,4.23%
2020-01-01 00:03:00,1,2,7715,502,7213,11.77%,0.77%
2020-01-01 00:03:00,1,3,682,3,679,1.04%,0.00%
2020-01-01 00:03:00,1,4,11414,1019,10395,17.42%,1.55%
2020-01-01 00:03:00,1,5,11128,966,10162,16.98%,1.47%
2020-01-01 00:03:00,1,6,11044,954,10090,16.85%,1.46%
2020-01-01 00:03:00,1,7,7011,414,6597,10.70%,0.63%
2020-01-01 00:03:00,1,8,3010,88,2922,4.59%,0.13%
2020-01-01 00:03:00,1,9,11016,951,10065,16.81%,1.45%
2020-01-01 00:03:00,1,10,2565,64,2501,3.91%,0.10%
2020-01-01 00:03:00,1,11,2661,71,2590,4.06%,0.11%
2020-01-01 00:03:00,1,12,10991,947,10044,16.77%,1.45%
2020-01-01 00:03:00,2,1,1188,6,1182,1.81%,0.01%
2020-01-01 00:03:00,2,2,24538,4107,20431,37.44%,6.27%
2020-01-01 00:03:00,2,3,19973,2830,17143,30.48%,4.32%
2020-01-01 00:03:00,2,4,1152,6,1146,1.76%,0.01%
2020-01-01 00:03:00,2,5,13723,1352,12371,20.94%,2.06%
2020-01-01 00:03:00,2,6,52,0,52,0.08%,0.00%
2020-01-01 00:03:00,2,7,3355,78,3277,5.12%,0.12%
2020-01-01 00:03:00,2,8,2139,34,2105,3.26%,0.05%
2020-01-01 00:03:00,2,9,13536,1312,12224,20.65%,2.00%
2020-01-01 00:03:00,2,10,1318,13,1305,2.01%,0.02%
2020-01-01 00:03:00,2,11,1327,13,1314,2.02%,0.02%
2020-01-01 00:03:00,2,12,13356,1280,12076,20.38%,1.95%
2020-01-01 00:03:00,3,1,1228,16,1212,1.87%,0.02%
2020-01-01 00:03:00,3,2,22791,3647,19144,34.78%,5.56%
2020-01-01 00:03:00,3,3,68796,26285,42511,104.97%,40.11%
2020-01-01 00:03:00,3,4,11688,933,10755,17.83%,1.42%
2020-01-01 00:03:00,3,5,43639,11834,31805,66.59%,18.06%
2020-01-01 00:03:00,3,6,13349,1224,12125,20.37%,1.87%
2020-01-01 00:03:00,3,7,19885,2803,17082,30.34%,4.28%
2020-01-01 00:03:00,3,8,16117,1886,14231,24.59%,2.88%
2020-01-01 00:03:00,3,9,29764,5935,23829,45.42%,9.06%
2020-01-01 00:03:00,3,10,2982,66,2916,4.55%,0.10%
2020-01-01 00:03:00,3,11,2487,38,2449,3.79%,0.06%
2020-01-01 00:03:00,3,12,25469,4431,21038,38.86%,6.76%
2020-01-01 00:03:00,4,1,480,0,480,0.73%,0.00%
2020-01-01 00:03:00,4,2,317,0,317,0.48%,0.00%
2020-01-01 00:03:00,4,3,1172,9,1163,1.79%,0.01%
2020-01-01 00:03:00,4,4,28632,5400,23232,43.69%,8.24%
2020-01-01 00:03:00,4,5,18893,2415,16478,28.83%,3.68%
2020-01-01 00:03:00,4,6,24853,4129,20724,37.92%,6.30%
2020-01-01 00:03:00,4,7,4757,172,4585,7.26%,0.26%
2020-01-01 00:03:00,4,8,3125,70,3055,4.77%,0.11%
2020-01-01 00:03:00,4,9,16496,1870,14626,25.17%,2.85%
2020-01-01 00:03:00,4,10,1804,27,1777,2.75%,0.04%
2020-01-01 00:03:00,4,11,175,1,174,0.27%,0.00%
2020-01-01 00:03:00,4,12,13724,1309,12415,20.94%,2.00%
2020-01-01 00:03:00,5,1,2681,44,2637,4.09%,0.07%
2020-01-01 00:03:00,5,2,768,6,762,1.17%,0.01%
2020-01-01 00:03:00,5,3,3555,85,3470,5.42%,0.13%
2020-01-01 00:03:00,5,4,27176,5058,22118,41.47%,7.72%
2020-01-01 00:03:00,5,5,12665,1128,11537,19.33%,1.72%
2020-01-01 00:03:00,5,6,18584,2408,16176,28.36%,3.67%
2020-01-01 00:03:00,5,7,5367,237,5130,8.19%,0.36%
2020-01-01 00:03:00,5,8,4408,151,4257,6.73%,0.23%
2020-01-01 00:03:00,5,9,8986,581,8405,13.71%,0.89%
2020-01-01 00:03:00,5,10,973,10,963,1.48%,0.02%
2020-01-01 00:03:00,5,11,1396,18,1378,2.13%,0.03%
2020-01-01 00:03:00,5,12,7722,431,7291,11.78%,0.66%
2020-01-01 00:03:00,6,1,1095,9,1086,1.67%,0.01%
2020-01-01 00:03:00,6,2,1223,10,1213,1.87%,0.02%
2020-01-01 00:03:00,6,3,1551,14,1537,2.37%,0.02%
2020-01-01 00:03:00,6,4,1414,16,1398,2.16%,0.02%
2020-01-01 00:03:00,6,5,17697,2178,15519,27.00%,3.32%
2020-01-01 00:03:00,6,6,5537,269,5268,8.45%,0.41%
2020-01-01 00:03:00,6,7,3650,124,3526,5.57%,0.19%
2020-01-01 00:03:00,6,8,3018,86,2932,4.61%,0.13%
2020-01-01 00:03:00,6,9,10325,732,9593,15.75%,1.12%
2020-01-01 00:03:00,6,10,2368,34,2334,3.61%,0.05%
2020-01-01 00:03:00,6,11,369,1,368,0.56%,0.00%
2020-01-01 00:03:00,6,12,7892,435,7457,12.04%,0.66%
2020-01-01 00:03:00,7,1,489,0,489,0.75%,0.00%
2020-01-01 00:03:00,7,2,112,0,112,0.17%,0.00%
2020-01-01 00:03:00,7,3,1256,10,1246,1.92%,0.02%
2020-01-01 00:03:00,7,4,1342,14,1328,2.05%,0.02%
2020-01-01 00:03:00,7,5,7391,369,7022,11.28%,0.56%
2020-01-01 00:03:00,7,6,12052,1053,10999,18.39%,1.61%
2020-01-01 00:03:00,7,7,3273,88,3185,4.99%,0.13%
2020-01-01 00:03:00,7,8,1295,21,1274,1.98%,0.03%
2020-01-01 00:03:00,7,9,6023,257,5766,9.19%,0.39%
2020-01-01 00:03:00,7,10,1322,17,1305,2.02%,0.03%
2020-01-01 00:03:00,7,11,237,0,237,0.36%,0.00%
2020-01-01 00:03:00,7,12,4700,156,4544,7.17%,0.24%
2020-01-01 00:03:00,8,1,446,0,446,0.68%,0.00%
2020-01-01 00:03:00,8,2,138,0,138,0.21%,0.00%
2020-01-01 00:03:00,8,3,1224,6,1218,1.87%,0.01%
2020-01-01 00:03:00,8,4,2694,56,2638,4.11%,0.09%
2020-01-01 00:03:00,8,5,7471,379,7092,11.40%,0.58%
2020-01-01 00:03:00,8,6,15328,1652,13676,23.39%,2.52%
2020-01-01 00:03:00,8,7,5070,204,4866,7.74%,0.31%
2020-01-01 00:03:00,8,8,1636,38,1598,2.50%,0.06%
2020-01-01 00:03:00,8,9,6087,256,5831,9.29%,0.39%
2020-01-01 00:03:00,8,10,2011,35,1976,3.07%,0.05%
2020-01-01 00:03:00,8,11,242,0,242,0.37%,0.00%
2020-01-01 00:03:00,8,12,3974,110,3864,6.06%,0.17%
2020-01-01 00:03:00,9,1,1045,4,1041,1.59%,0.01%
2020-01-01 00:03:00,9,2,3684,105,3579,5.62%,0.16%
2020-01-01 00:03:00,9,3,2174,52,2122,3.32%,0.08%
2020-01-01 00:03:00,9,4,9793,702,9091,14.94%,1.07%
2020-01-01 00:03:00,9,5,1203,14,1189,1.84%,0.02%
2020-01-01 00:03:00,9,6,11693,997,10696,17.84%,1.52%
2020-01-01 00:03:00,9,7,32110,6863,25247,49.00%,10.47%
2020-01-01 00:03:00,9,8,10651,828,9823,16.25%,1.26%
2020-01-01 00:03:00,9,9,251,0,251,0.38%,0.00%
2020-01-01 00:03:00,9,10,4189,109,4080,6.39%,0.17%
2020-01-01 00:03:00,9,11,9635,655,8980,14.70%,1.00%
2020-01-01 00:03:00,9,12,5228,209,5019,7.98%,0.32%
2020-01-01 00:03:00,10,1,1395,394,1001,2.13%,0.60%
2020-01-01 00:03:00,10,2,3818,487,3331,5.83%,0.74%
2020-01-01 00:03:00,10,3,2243,45,2198,3.42%,0.07%
2020-01-01 00:03:00,10,4,3839,1173,2666,5.86%,1.79%
2020-01-01 00:03:00,10,5,837,5,832,1.28%,0.01%
2020-01-01 00:03:00,10,6,5914,1285,4629,9.02%,1.96%
2020-01-01 00:03:00,10,7,11431,2253,9178,17.44%,3.44%
2020-01-01 00:03:00,10,8,26395,6135,20260,40.28%,9.36%
2020-01-01 00:03:00,10,9,565,2,563,0.86%,0.00%
2020-01-01 00:03:00,10,10,2704,57,2647,4.13%,0.09%
2020-01-01 00:03:00,10,11,12460,1359,11101,19.01%,2.07%
2020-01-01 00:03:00,10,12,9017,877,8140,13.76%,1.34%
2020-01-01 00:03:00,11,1,2131,43,2088,3.25%,0.07%
2020-01-01 00:03:00,11,2,3235,96,3139,4.94%,0.15%
2020-01-01 00:03:00,11,3,971,11,960,1.48%,0.02%
2020-01-01 00:03:00,11,4,3613,107,3506,5.51%,0.16%
2020-01-01 00:03:00,11,5,528,3,525,0.81%,0.00%
2020-01-01 00:03:00,11,6,5100,204,4896,7.78%,0.31%
2020-01-01 00:03:00,11,7,10026,754,9272,15.30%,1.15%
2020-01-01 00:03:00,11,8,23544,3712,19832,35.93%,5.66%
2020-01-01 00:03:00,11,9,252,0,252,0.38%,0.00%
2020-01-01 00:03:00,11,10,3549,98,3451,5.42%,0.15%
2020-01-01 00:03:00,11,11,9701,679,9022,14.80%,1.04%
2020-01-01 00:03:00,11,12,5851,240,5611,8.93%,0.37%
2020-01-01 00:03:00,12,1,20,1,19,0.03%,0.00%
2020-01-01 00:03:00,12,2,693,277,416,1.06%,0.42%
2020-01-01 00:03:00,12,3,3981,378,3603,6.07%,0.58%
2020-01-01 00:03:00,12,4,3450,81,3369,5.26%,0.12%
2020-01-01 00:03:00,12,5,10925,1111,9814,16.67%,1.70%
2020-01-01 00:03:00,12,6,5992,283,5709,9.14%,0.43%
2020-01-01 00:03:00,12,7,2435,72,2363,3.72%,0.11%
2020-01-01 00:03:00,12,8,1167,288,879,1.78%,0.44%
2020-01-01 00:03:00,12,9,23721,4933,18788,36.20%,7.53%
2020-01-01 00:03:00,12,10,3878,367,3511,5.92%,0.56%
2020-01-01 00:03:00,12,11,1366,289,1077,2.08%,0.44%
2020-01-01 00:03:00,12,12,7880,1202,6678,12.02%,1.83%
2020-01-01 00:03:00,13,1,2229,38,2191,3.40%,0.06%
2020-01-01 00:03:00,13,2,2473,52,2421,3.77%,0.08%
2020-01-01 00:03:00,13,3,885,8,877,1.35%,0.01%
2020-01-01 00:03:00,13,4,4369,555,3814,6.67%,0.85%
2020-01-01 00:03:00,13,5,7656,981,6675,11.68%,1.50%
2020-01-01 00:03:00,13,6,5551,621,4930,8.47%,0.95%
2020-01-01 00:03:00,13,7,4680,150,4530,7.14%,0.23%
2020-01-01 00:03:00,13,8,6635,327,6308,10.12%,0.50%
2020-01-01 00:03:00,13,9,7839,996,6843,11.96%,1.52%
2020-01-01 00:03:00,13,10,27935,5919,22016,42.63%,9.03%
2020-01-01 00:03:00,13,11,16475,2346,14129,25.14%,3.58%
2020-01-01 00:03:00,13,12,9391,1134,8257,14.33%,1.73%
2020-01-01 00:03:00,14,1,374,0,374,0.57%,0.00%
2020-01-01 00:03:00,14,2,2149,36,2113,3.28%,0.05%
2020-01-01 00:03:00,14,3,1450,14,1436,2.21%,0.02%
2020-01-01 00:03:00,14,4,5895,246,5649,9.00%,0.38%
2020-01-01 00:03:00,14,5,1457,17,1440,2.22%,0.03%
2020-01-01 00:03:00,14,6,6251,282,5969,9.54%,0.43%
2020-01-01 00:03:00,14,7,13425,1222,12203,20.48%,1.86%
2020-01-01 00:03:00,14,8,15310,1604,13706,23.36%,2.45%
2020-01-01 00:03:00,14,9,1664,22,1642,2.54%,0.03%
2020-01-01 00:03:00,14,10,4447,130,4317,6.79%,0.20%
2020-01-01 00:03:00,14,11,26969,4897,22072,41.15%,7.47%
2020-01-01 00:03:00,14,12,6953,387,6566,10.61%,0.59%
2020-01-01 00:03:00,15,1,395,3,392,0.60%,0.00%
2020-01-01 00:03:00,15,2,153,1,152,0.23%,0.00%
2020-01-01 00:03:00,15,3,3692,98,3594,5.63%,0.15%
2020-01-01 00:03:00,15,4,5507,209,5298,8.40%,0.32%
2020-01-01 00:03:00,15,5,9978,692,9286,15.23%,1.06%
2020-01-01 00:03:00,15,6,5764,230,5534,8.80%,0.35%
2020-01-01 00:03:00,15,7,3965,135,3830,6.05%,0.21%
2020-01-01 00:03:00,15,8,6292,305,5987,9.60%,0.47%
2020-01-01 00:03:00,15,9,10129,707,9422,15.46%,1.08%
2020-01-01 00:03:00,15,10,4091,118,3973,6.24%,0.18%
2020-01-01 00:03:00,15,11,10483,800,9683,16.00%,1.22%
2020-01-01 00:03:00,15,12,25768,4664,21104,39.32%,7.12%
2020-01-01 00:03:00,16,1,461,2,459,0.70%,0.00%
2020-01-01 00:03:00,16,2,356,1,355,0.54%,0.00%
2020-01-01 00:03:00,16,3,1462,15,1447,2.23%,0.02%
2020-01-01 00:03:00,16,4,4155,128,4027,6.34%,0.20%
2020-01-01 00:03:00,16,5,7687,579,7108,11.73%,0.88%
2020-01-01 00:03:00,16,6,4880,171,4709,7.45%,0.26%
2020-01-01 00:03:00,16,7,3213,71,3142,4.90%,0.11%
2020-01-01 00:03:00,16,8,10231,756,9475,15.61%,1.15%
2020-01-01 00:03:00,16,9,8062,616,7446,12.30%,0.94%
2020-01-01 00:03:00,16,10,1519,16,1503,2.32%,0.02%
2020-01-01 00:03:00,16,11,11945,977,10968,18.23%,1.49%
2020-01-01 00:03:00,16,12,29818,5890,23928,45.50%,8.99%
2020-01-01 00:03:10,1,1,18279,2350,15929,27.89%,3.59%
2020-01-01 00:03:10,1,2,7137,401,6736,10.89%,0.61%
2020-01-01 00:03:10,1,3,782,5,777,1.19%,0.01%
2020-01-01 00:03:10,1,4,10694,862,9832,16.32%,1.32%
2020-01-01 00:03:10,1,5,9982,765,9217,15.23%,1.17%
2020-01-01 00:03:10,1,6,9874,756,9118,15.07%,1.15%
2020-01-01 00:03:10,1,7,6343,332,6011,9.68%,0.51%
2020-01-01 00:03:10,1,8,3747,116,3631,5.72%,0.18%
2020-01-01 00:03:10,1,9,9823,751,9072,14.99%,1.15%
2020-01-01 00:03:10,1,10,3195,78,3117,4.88%,0.12%
2020-01-01 00:03:10,1,11,3278,87,3191,5.00%,0.13%
2020-01-01 00:03:10,1,12,9804,751,9053,14.96%,1.15%
2020-01-01 00:03:10,2,1,911,7,904,1.39%,0.01%
2020-01-01 00:03:10,2,2,24828,4126,20702,37.88%,6.30%
2020-01-01 00:03:10,2,3,20155,2809,17346,30.75%,4.29%
2020-01-01 00:03:10,2,4,817,5,812,1.25%,0.01%
2020-01-01 00:03:10,2,5,13953,1371,12582,21.29%,2.09%
2020-01-01 00:03:10,2,6,60,0,60,0.09%,0.00%
2020-01-01 00:03:10,2,7,3734,104,3630,5.70%,0.16%
2020-01-01 00:03:10,2,8,2111,37,2074,3.22%,0.06%
2020-01-01 00:03:10,2,9,13773,1334,12439,21.02%,2.04%
2020-01-01 00:03:10,2,10,1279,14,1265,1.95%,0.02%
2020-01-01 00:03:10,2,11,1288,14,1274,1.97%,0.02%
2020-01-01 00:03:10,2,12,13577,1300,12277,20.72%,1.98%
2020-01-01 00:03:10,3,1,1405,24,1381,2.14%,0.04%
2020-01-01 00:03:10,3,2,23371,3759,19612,35.66%,5.74%
2020-01-01 00:03:10,3,3,68011,25644,42367,103.78%,39.13%
2020-01-01 00:03:10,3,4,9208,646,8562,14.05%,0.99%
2020-01-01 00:03:10,3,5,40811,10432,30379,62.27%,15.92%
2020-01-01 00:03:10,3,6,10412,795,9617,15.89%,1.21%
2020-01-01 00:03:10,3,7,20396,2926,17470,31.12%,4.46%
2020-01-01 00:03:10,3,8,17933,2245,15688,27.36%,3.43%
2020-01-01 00:03:10,3,9,29950,5924,24026,45.70%,9.04%
2020-01-01 00:03:10,3,10,4708,144,4564,7.18%,0.22%
2020-01-01 00:03:10,3,11,2499,34,2465,3.81%,0.05%
2020-01-01 00:03:10,3,12,23914,3867,20047,36.49%,5.90%
2020-01-01 00:03:10,4,1,485,2,483,0.74%,0.00%
2020-01-01 00:03:10,4,2,290,0,290,0.44%,0.00%
2020-01-01 00:03:10,4,3,1142,8,1134,1.74%,0.01%
2020-01-01 00:03:10,4,4,29488,5774,23714,45.00%,8.81%
2020-01-01 00:03:10,4,5,19528,2658,16870,29.80%,4.06%
2020-01-01 00:03:10,4,6,25202,4332,20870,38.46%,6.61%
2020-01-01 00:03:10,4,7,4475,156,4319,6.83%,0.24%
2020-01-01 00:03:10,4,8,2853,56,2797,4.35%,0.09%
2020-01-01 00:03:10,4,9,17117,2056,15061,26.12%,3.14%
2020-01-01 00:03:10,4,10,1883,26,1857,2.87%,0.04%
2020-01-01 00:03:10,4,11,128,0,128,0.20%,0.00%
2020-01-01 00:03:10,4,12,14030,1432,12598,21.41%,2.19%
2020-01-01 00:03:10,5,1,2744,71,2673,4.19%,0.11%
2020-01-01 00:03:10,5,2,716,9,707,1.09%,0.01%
2020-01-01 00:03:10,5,3,2528,35,2493,3.86%,0.05%
2020-01-01 00:03:10,5,4,29890,5950,23940,45.61%,9.08%
2020-01-01 00:03:10,5,5,12703,1197,11506,19.38%,1.83%
2020-01-01 00:03:10,5,6,19397,2628,16769,29.60%,4.01%
2020-01-01 00:03:10,5,7,6193,293,5900,9.45%,0.45%
2020-01-01 00:03:10,5,8,5149,188,4961,7.86%,0.29%
2020-01-01 00:03:10,5,9,10066,763,9303,15.36%,1.16%
2020-01-01 00:03:10,5,10,982,7,975,1.50%,0.01%
2020-01-01 00:03:10,5,11,1151,11,1140,1.76%,0.02%
2020-01-01 00:03:10,5,12,8737,586,8151,13.33%,0.89%
2020-01-01 00:03:10,6,1,952,11,941,1.45%,0.02%
2020-01-01 00:03:10,6,2,1081,11,1070,1.65%,0.02%
2020-01-01 00:03:10,6,3,1324,15,1309,2.02%,0.02%
2020-01-01 00:03:10,6,4,1526,19,1507,2.33%,0.03%
2020-01-01 00:03:10,6,5,17539,2155,15384,26.76%,3.29%
2020-01-01 00:03:10,6,6,5156,198,4958,7.87%,0.30%
2020-01-01 00:03:10,6,7,3088,73,3015,4.71%,0.11%
2020-01-01 00:03:10,6,8,2495,51,2444,3.81%,0.08%
2020-01-01 00:03:10,6,9,10729,806,9923,16.37%,1.23%
2020-01-01 00:03:10,6,10,2321,32,2289,3.54%,0.05%
2020-01-01 00:03:10,6,11,389,1,388,0.59%,0.00%
2020-01-01 00:03:10,6,12,8350,493,7857,12.74%,0.75%
2020-01-01 00:03:10,7,1,345,1,344,0.53%,0.00%
2020-01-01 00:03:10,7,2,96,0,96,0.15%,0.00%
2020-01-01 00:03:10,7,3,1424,14,1410,2.17%,0.02%
2020-01-01 00:03:10,7,4,1088,16,1072,1.66%,0.02%
2020-01-01 00:03:10,7,5,7608,411,7197,11.61%,0.63%
2020-01-01 00:03:10,7,6,12175,1063,11112,18.58%,1.62%
2020-01-01 00:03:10,7,7,3439,86,3353,5.25%,0.13%
2020-01-01 00:03:10,7,8,1249,9,1240,1.91%,0.01%
2020-01-01 00:03:10,7,9,6045,267,5778,9.22%,0.41%
2020-01-01 00:03:10,7,10,1387,23,1364,2.12%,0.04%
2020-01-01 00:03:10,7,11,223,0,223,0.34%,0.00%
2020-01-01 00:03:10,7,12,4651,152,4499,7.10%,0.23%
2020-01-01 00:03:10,8,1,381,0,381,0.58%,0.00%
2020-01-01 00:03:10,8,2,114,1,113,0.17%,0.00%
2020-01-01 00:03:10,8,3,1305,10,1295,1.99%,0.02%
2020-01-01 00:03:10,8,4,2516,41,2475,3.84%,0.06%
2020-01-01 00:03:10,8,5,7466,403,7063,11.39%,0.61%
2020-01-01 00:03:10,8,6,14993,1618,13375,22.88%,2.47%
2020-01-01 00:03:10,8,7,4963,185,4778,7.57%,0.28%
2020-01-01 00:03:10,8,8,1657,40,1617,2.53%,0.06%
2020-01-01 00:03:10,8,9,6001,279,5722,9.16%,0.43%
2020-01-01 00:03:10,8,10,1814,29,1785,2.77%,0.04%
2020-01-01 00:03:10,8,11,273,4,269,0.42%,0.01%
2020-01-01 00:03:10,8,12,4135,133,4002,6.31%,0.20%
2020-01-01 00:03:10,9,1,1058,0,1058,1.61%,0.00%
2020-01-01 00:03:10,9,2,3965,94,3871,6.05%,0.14%
2020-01-01 00:03:10,9,3,2316,34,2282,3.53%,0.05%
2020-01-01 00:03:10,9,4,5639,242,5397,8.60%,0.37%
2020-01-01 00:03:10,9,5,1183,11,1172,1.81%,0.02%
2020-01-01 00:03:10,9,6,7204,407,6797,10.99%,0.62%
2020-01-01 00:03:10,9,7,27766,5161,22605,42.37%,7.88%
2020-01-01 00:03:10,9,8,10960,898,10062,16.72%,1.37%
2020-01-01 00:03:10,9,9,298,2,296,0.45%,0.00%
2020-01-01 00:03:10,9,10,4560,168,4392,6.96%,0.26%
2020-01-01 00:03:10,9,11,9743,717,9026,14.87%,1.09%
2020-01-01 00:03:10,9,12,4901,194,4707,7.48%,0.30%
2020-01-01 00:03:10,10,1,1392,399,993,2.12%,0.61%
2020-01-01 00:03:10,10,2,3755,505,3250,5.73%,0.77%
2020-01-01 00:03:10,10,3,2192,52,2140,3.34%,0.08%
2020-01-01 00:03:10,10,4,5610,1301,4309,8.56%,1.99%
2020-01-01 00:03:10,10,5,827,3,824,1.26%,0.00%
2020-01-01 00:03:10,10,6,7721,1457,6264,11.78%,2.22%
2020-01-01 00:03:10,10,7,13400,2571,10829,20.45%,3.92%
2020-01-01 00:03:10,10,8,29319,7173,22146,44.74%,10.95%
2020-01-01 00:03:10,10,9,709,2,707,1.08%,0.00%
2020-01-01 00:03:10,10,10,3580,107,3473,5.46%,0.16%
2020-01-01 00:03:10,10,11,13298,1498,11800,20.29%,2.29%
2020-01-01 00:03:10,10,12,9080,852,8228,13.85%,1.30%
2020-01-01 00:03:10,11,1,2538,70,2468,3.87%,0.11%
2020-01-01 00:03:10,11,2,3832,144,3688,5.85%,0.22%
2020-01-01 00:03:10,11,3,1083,10,1073,1.65%,0.02%
2020-01-01 00:03:10,11,4,4028,127,3901,6.15%,0.19%
2020-01-01 00:03:10,11,5,203,4,199,0.31%,0.01%
2020-01-01 00:03:10,11,6,4867,187,4680,7.43%,0.29%
2020-01-01 00:03:10,11,7,10410,829,9581,15.88%,1.26%
2020-01-01 00:03:10,11,8,24737,4172,20565,37.75%,6.37%
2020-01-01 00:03:10,11,9,234,1,233,0.36%,0.00%
2020-01-01 00:03:10,11,10,4093,121,3972,6.25%,0.18%
2020-01-01 00:03:10,11,11,10569,829,9740,16.13%,1.26%
2020-01-01 00:03:10,11,12,6112,301,5811,9.33%,0.46%
2020-01-01 00:03:10,12,1,34,0,34,0.05%,0.00%
2020-01-01 00:03:10,12,2,709,282,427,1.08%,0.43%
2020-01-01 00:03:10,12,3,3538,357,3181,5.40%,0.54%
2020-01-01 00:03:10,12,4,3820,110,3710,5.83%,0.17%
2020-01-01 00:03:10,12,5,11100,1048,10052,16.94%,1.60%
2020-01-01 00:03:10,12,6,6585,273,6312,10.05%,0.42%
2020-01-01 00:03:10,12,7,2659,37,2622,4.06%,0.06%
2020-01-01 00:03:10,12,8,1418,292,1126,2.16%,0.45%
2020-01-01 00:03:10,12,9,24137,4975,19162,36.83%,7.59%
2020-01-01 00:03:10,12,10,3830,362,3468,5.84%,0.55%
2020-01-01 00:03:10,12,11,1557,294,1263,2.38%,0.45%
2020-01-01 00:03:10,12,12,8256,1306,6950,12.60%,1.99%
2020-01-01 00:03:10,13,1,1980,31,1949,3.02%,0.05%
2020-01-01 00:03:10,13,2,2272,42,2230,3.47%,0.06%
2020-01-01 00:03:10,13,3,872,8,864,1.33%,0.01%
2020-01-01 00:03:10,13,4,4881,525,4356,7.45%,0.80%
2020-01-01 00:03:10,13,5,8233,971,7262,12.56%,1.48%
2020-01-01 00:03:10,13,6,6004,600,5404,9.16%,0.92%
2020-01-01 00:03:10,13,7,4303,133,4170,6.57%,0.20%
2020-01-01 00:03:10,13,8,6278,283,5995,9.58%,0.43%
2020-01-01 00:03:10,13,9,8396,986,7410,12.81%,1.50%
2020-01-01 00:03:10,13,10,26793,5599,21194,40.88%,8.54%
2020-01-01 00:03:10,13,11,15406,2201,13205,23.51%,3.36%
2020-01-01 00:03:10,13,12,8730,1048,7682,13.32%,1.60%
2020-01-01 00:03:10,14,1,552,2,550,0.84%,0.00%
2020-01-01 00:03:10,14,2,2538,54,2484,3.87%,0.08%
2020-01-01 00:03:10,14,3,1706,28,1678,2.60%,0.04%
2020-01-01 00:03:10,14,4,4351,143,4208,6.64%,0.22%
2020-01-01 00:03:10,14,5,1935,29,1906,2.95%,0.04%
2020-01-01 00:03:10,14,6,4649,161,4488,7.09%,0.25%
2020-01-01 00:03:10,14,7,11972,1060,10912,18.27%,1.62%
2020-01-01 00:03:10,14,8,13931,1398,12533,21.26%,2.13%
2020-01-01 00:03:10,14,9,2158,40,2118,3.29%,0.06%
2020-01-01 00:03:10,14,10,4690,147,4543,7.16%,0.22%
2020-01-01 00:03:10,14,11,25733,4428,21305,39.27%,6.76%
2020-01-01 00:03:10,14,12,6911,340,6571,10.55%,0.52%
2020-01-01 00:03:10,15,1,351,1,350,0.54%,0.00%
2020-01-01 00:03:10,15,2,232,0,232,0.35%,0.00%
2020-01-01 00:03:10,15,3,4290,139,4151,6.55%,0.21%
2020-01-01 00:03:10,15,4,6025,255,5770,9.19%,0.39%
2020-01-01 00:03:10,15,5,11278,884,10394,17.21%,1.35%
2020-01-01 00:03:10,15,6,6266,270,5996,9.56%,0.41%
2020-01-01 00:03:10,15,7,3903,147,3756,5.96%,0.22%
2020-01-01 00:03:10,15,8,5785,302,5483,8.83%,0.46%
2020-01-01 00:03:10,15,9,11468,912,10556,17.50%,1.39%
2020-01-01 00:03:10,15,10,4506,160,4346,6.88%,0.24%
2020-01-01 00:03:10,15,11,10459,877,9582,15.96%,1.34%
2020-01-01 00:03:10,15,12,27006,5131,21875,41.21%,7.83%
2020-01-01 00:03:10,16,1,517,1,516,0.79%,0.00%
2020-01-01 00:03:10,16,2,444,1,443,0.68%,0.00%
2020-01-01 00:03:10,16,3,2357,35,2322,3.60%,0.05%
2020-01-01 00:03:10,16,4,4567,143,4424,6.97%,0.22%
2020-01-01 00:03:10,16,5,9284,712,8572,14.17%,1.09%
2020-01-01 00:03:10,16,6,5473,220,5253,8.35%,0.34%
2020-01-01 00:03:10,16,7,3323,110,3213,5.07%,0.17%
2020-01-01 00:03:10,16,8,8038,574,7464,12.27%,0.88%
2020-01-01 00:03:10,16,9,9679,764,8915,14.77%,1.17%
2020-01-01 00:03:10,16,10,1373,6,1367,2.10%,0.01%
2020-01-01 00:03:10,16,11,9694,774,8920,14.79%,1.18%
2020-01-01 00:03:10,16,12,29262,5720,23542,44.65%,8.73%
2020-01-01 00:03:20,1,1,16856,2142,14714,25.72%,3.27%
2020-01-01 00:03:20,1,2,7116,391,6725,10.86%,0.60%
2020-01-01 00:03:20,1,3,861,2,859,1.31%,0.00%
2020-01-01 00:03:20,1,4,9336,716,8620,14.25%,1.09%
2020-01-01 00:03:20,1,5,9148,680,8468,13.96%,1.04%
2020-01-01 00:03:20,1,6,9052,667,8385,13.81%,1.02%
2020-01-01 00:03:20,1,7,6236,316,5920,9.52%,0.48%
2020-01-01 00:03:20,1,8,2775,65,2710,4.23%,0.10%
2020-01-01 00:03:20,1,9,9029,664,8365,13.78%,1.01%
2020-01-01 00:03:20,1,10,2137,37,2100,3.26%,0.06%
2020-01-01 00:03:20,1,11,2224,40,2184,3.39%,0.06%
2020-01-01 00:03:20,1,12,9003,659,8344,13.74%,1.01%
2020-01-01 00:03:20,2,1,900,3,897,1.37%,0.00%
2020-01-01 00:03:20,2,2,25389,4309,21080,38.74%,6.58%
2020-01-01 00:03:20,2,3,21747,3195,18552,33.18%,4.88%
2020-01-01 00:03:20,2,4,850,3,847,1.30%,0.00%
2020-01-01 00:03:20,2,5,13788,1333,12455,21.04%,2.03%
2020-01-01 00:03:20,2,6,31,0,31,0.05%,0.00%
2020-01-01 00:03:20,2,7,2711,50,2661,4.14%,0.08%
2020-01-01 00:03:20,2,8,1808,25,1783,2.76%,0.04%
2020-01-01 00:03:20,2,9,13644,1294,12350,20.82%,1.97%
2020-01-01 00:03:20,2,10,997,7,990,1.52%,0.01%
2020-01-01 00:03:20,2,11,1001,7,994,1.53%,0.01%
2020-01-01 00:03:20,2,12,13466,1262,12204,20.55%,1.93%
2020-01-01 00:03:20,3,1,1253,10,1243,1.91%,0.02%
2020-01-01 00:03:20,3,2,24045,3985,20060,36.69%,6.08%
2020-01-01 00:03:20,3,3,66003,24461,41542,100.71%,37.32%
2020-01-01 00:03:20,3,4,9748,683,9065,14.87%,1.04%
2020-01-01 00:03:20,3,5,40423,10327,30096,61.68%,15.76%
2020-01-01 00:03:20,3,6,11102,894,10208,16.94%,1.36%
2020-01-01 00:03:20,3,7,21104,3087,18017,32.20%,4.71%
2020-01-01 00:03:20,3,8,18678,2413,16265,28.50%,3.68%
2020-01-01 00:03:20,3,9,28864,5525,23339,44.04%,8.43%
2020-01-01 00:03:20,3,10,3322,66,3256,5.07%,0.10%
2020-01-01 00:03:20,3,11,2808,52,2756,4.28%,0.08%
2020-01-01 00:03:20,3,12,24084,3982,20102,36.75%,6.08%
2020-01-01 00:03:20,4,1,500,0,500,0.76%,0.00%
2020-01-01 00:03:20,4,2,311,0,311,0.47%,0.00%
2020-01-01 00:03:20,4,3,1033,5,1028,1.58%,0.01%
2020-01-01 00:03:20,4,4,30099,6025,24074,45.93%,9.19%
2020-01-01 00:03:20,4,5,19682,2739,16943,30.03%,4.18%
2020-01-01 00:03:20,4,6,25733,4502,21231,39.27%,6.87%
2020-01-01 00:03:20,4,7,4802,164,4638,7.33%,0.25%
2020-01-01 00:03:20,4,8,2992,60,2932,4.57%,0.09%
2020-01-01 00:03:20,4,9,17393,2121,15272,26.54%,3.24%
2020-01-01 00:03:20,4,10,1666,31,1635,2.54%,0.05%
2020-01-01 00:03:20,4,11,122,0,122,0.19%,0.00%
2020-01-01 00:03:20,4,12,14440,1490,12950,22.03%,2.27%
2020-01-01 00:03:20,5,1,2722,52,2670,4.15%,0.08%
2020-01-01 00:03:20,5,2,656,4,652,1.00%,0.01%
2020-01-01 00:03:20,5,3,957,8,949,1.46%,0.01%
2020-01-01 00:03:20,5,4,29143,5668,23475,44.47%,8.65%
2020-01-01 00:03:20,5,5,10844,880,9964,16.55%,1.34%
2020-01-01 00:03:20,5,6,16476,1951,14525,25.14%,2.98%
2020-01-01 00:03:20,5,7,4961,214,4747,7.57%,0.33%
2020-01-01 00:03:20,5,8,3912,129,3783,5.97%,0.20%
2020-01-01 00:03:20,5,9,9720,703,9017,14.83%,1.07%
2020-01-01 00:03:20,5,10,897,11,886,1.37%,0.02%
2020-01-01 00:03:20,5,11,859,14,845,1.31%,0.02%
2020-01-01 00:03:20,5,12,8420,530,7890,12.85%,0.81%
2020-01-01 00:03:20,6,1,1204,13,1191,1.84%,0.02%
2020-01-01 00:03:20,6,2,1359,18,1341,2.07%,0.03%
2020-01-01 00:03:20,6,3,1817,27,1790,2.77%,0.04%
2020-01-01 00:03:20,6,4,1316,6,1310,2.01%,0.01%
2020-01-01 00:03:20,6,5,17298,2113,15185,26.39%,3.22%
2020-01-01 00:03:20,6,6,4978,206,4772,7.60%,0.31%
2020-01-01 00:03:20,6,7,3040,78,2962,4.64%,0.12%
2020-01-01 00:03:20,6,8,2449,49,2400,3.74%,0.07%
2020-01-01 00:03:20,6,9,10243,798,9445,15.63%,1.22%
2020-01-01 00:03:20,6,10,2150,31,2119,3.28%,0.05%
2020-01-01 00:03:20,6,11,326,3,323,0.50%,0.00%
2020-01-01 00:03:20,6,12,8019,499,7520,12.24%,0.76%
2020-01-01 00:03:20,7,1,485,4,481,0.74%,0.01%
2020-01-01 00:03:20,7,2,91,0,91,0.14%,0.00%
2020-01-01 00:03:20,7,3,1165,9,1156,1.78%,0.01%
2020-01-01 00:03:20,7,4,1848,17,1831,2.82%,0.03%
2020-01-01 00:03:20,7,5,8473,504,7969,12.93%,0.77%
2020-01-01 00:03:20,7,6,13599,1314,12285,20.75%,2.01%
2020-01-01 00:03:20,7,7,3230,95,3135,4.93%,0.14%
2020-01-01 00:03:20,7,8,1180,15,1165,1.80%,0.02%
2020-01-01 00:03:20,7,9,7168,358,6810,10.94%,0.55%
2020-01-01 00:03:20,7,10,2378,34,2344,3.63%,0.05%
2020-01-01 00:03:20,7,11,250,2,248,0.38%,0.00%
2020-01-01 00:03:20,7,12,4807,151,4656,7.33%,0.23%
2020-01-01 00:03:20,8,1,484,1,483,0.74%,0.00%
2020-01-01 00:03:20,8,2,79,0,79,0.12%,0.00%
2020-01-01 00:03:20,8,3,1330,8,1322,2.03%,0.01%
2020-01-01 00:03:20,8,4,2661,56,2605,4.06%,0.09%
2020-01-01 00:03:20,8,5,7539,408,7131,11.50%,0.62%
2020-01-01 00:03:20,8,6,15611,1744,13867,23.82%,2.66%
2020-01-01 00:03:20,8,7,5317,210,5107,8.11%,0.32%
2020-01-01 00:03:20,8,8,2071,42,2029,3.16%,0.06%
2020-01-01 00:03:20,8,9,6004,254,5750,9.16%,0.39%
2020-01-01 00:03:20,8,10,1857,18,1839,2.83%,0.03%
2020-01-01 00:03:20,8,11,269,3,266,0.41%,0.00%
2020-01-01 00:03:20,8,12,4066,115,3951,6.20%,0.18%
2020-01-01 00:03:20,9,1,1102,5,1097,1.68%,0.01%
2020-01-01 00:03:20,9,2,4406,152,4254,6.72%,0.23%
2020-01-01 00:03:20,9,3,2815,48,2767,4.30%,0.07%
2020-01-01 00:03:20,9,4,4898,172,4726,7.47%,0.26%
2020-01-01 00:03:20,9,5,342,0,342,0.52%,0.00%
2020-01-01 00:03:20,9,6,5544,221,5323,8.46%,0.34%
2020-01-01 00:03:20,9,7,24844,4341,20503,37.91%,6.62%
2020-01-01 00:03:20,9,8,9955,779,9176,15.19%,1.19%
2020-01-01 00:03:20,9,9,329,0,329,0.50%,0.00%
2020-01-01 00:03:20,9,10,3561,80,3481,5.43%,0.12%
2020-01-01 00:03:20,9,11,8635,607,8028,13.18%,0.93%
2020-01-01 00:03:20,9,12,4752,181,4571,7.25%,0.28%
2020-01-01 00:03:20,10,1,1338,402,936,2.04%,0.61%
2020-01-01 00:03:20,10,2,3436,454,2982,5.24%,0.69%
2020-01-01 00:03:20,10,3,1898,23,1875,2.90%,0.04%
2020-01-01 00:03:20,10,4,4324,1302,3022,6.60%,1.99%
2020-01-01 00:03:20,10,5,853,3,850,1.30%,0.00%
2020-01-01 00:03:20,10,6,6628,1447,5181,10.11%,2.21%
2020-01-01 00:03:20,10,7,12041,2372,9669,18.37%,3.62%
2020-01-01 00:03:20,10,8,28227,6903,21324,43.07%,10.53%
2020-01-01 00:03:20,10,9,746,3,743,1.14%,0.00%
2020-01-01 00:03:20,10,10,3384,93,3291,5.16%,0.14%
2020-01-01 00:03:20,10,11,13667,1694,11973,20.85%,2.58%
2020-01-01 00:03:20,10,12,9576,981,8595,14.61%,1.50%
2020-01-01 00:03:20,11,1,2386,33,2353,3.64%,0.05%
2020-01-01 00:03:20,11,2,3731,91,3640,5.69%,0.14%
2020-01-01 00:03:20,11,3,1164,4,1160,1.78%,0.01%
2020-01-01 00:03:20,11,4,3409,99,3310,5.20%,0.15%
2020-01-01 00:03:20,11,5,598,5,593,0.91%,0.01%
2020-01-01 00:03:20,11,6,4731,190,4541,7.22%,0.29%
2020-01-01 00:03:20,11,7,10222,753,9469,15.60%,1.15%
2020-01-01 00:03:20,11,8,24676,4227,20449,37.65%,6.45%
2020-01-01 00:03:20,11,9,230,1,229,0.35%,0.00%
2020-01-01 00:03:20,11,10,3650,124,3526,5.57%,0.19%
2020-01-01 00:03:20,11,11,10486,814,9672,16.00%,1.24%
2020-01-01 00:03:20,11,12,6447,297,6150,9.84%,0.45%
2020-01-01 00:03:20,12,1,40,0,40,0.06%,0.00%
2020-01-01 00:03:20,12,2,683,286,397,1.04%,0.44%
2020-01-01 00:03:20,12,3,4270,422,3848,6.52%,0.64%
2020-01-01 00:03:20,12,4,3836,125,3711,5.85%,0.19%
2020-01-01 00:03:20,12,5,11760,1283,10477,17.94%,1.96%
2020-01-01 00:03:20,12,6,6519,318,6201,9.95%,0.49%
2020-01-01 00:03:20,12,7,2570,46,2524,3.92%,0.07%
2020-01-01 00:03:20,12,8,1430,289,1141,2.18%,0.44%
2020-01-01 00:03:20,12,9,25474,5423,20051,38.87%,8.27%
2020-01-01 00:03:20,12,10,4240,389,3851,6.47%,0.59%
2020-01-01 00:03:20,12,11,1582,290,1292,2.41%,0.44%
2020-01-01 00:03:20,12,12,8209,1286,6923,12.53%,1.96%
2020-01-01 00:03:20,13,1,2404,43,2361,3.67%,0.07%
2020-01-01 00:03:20,13,2,2776,60,2716,4.24%,0.09%
2020-01-01 00:03:20,13,3,933,10,923,1.42%,0.02%
2020-01-01 00:03:20,13,4,5598,501,5097,8.54%,0.76%
2020-01-01 00:03:20,13,5,9071,1014,8057,13.84%,1.55%
2020-01-01 00:03:20,13,6,6673,594,6079,10.18%,0.91%
2020-01-01 00:03:20,13,7,4876,177,4699,7.44%,0.27%
2020-01-01 00:03:20,13,8,6823,347,6476,10.41%,0.53%
2020-01-01 00:03:20,13,9,9326,1042,8284,14.23%,1.59%
2020-01-01 00:03:20,13,10,29709,6365,23344,45.33%,9.71%
2020-01-01 00:03:20,13,11,16707,2350,14357,25.49%,3.59%
2020-01-01 00:03:20,13,12,9351,1110,8241,14.27%,1.69%
2020-01-01 00:03:20,14,1,646,3,643,0.99%,0.00%
2020-01-01 00:03:20,14,2,2498,45,2453,3.81%,0.07%
2020-01-01 00:03:20,14,3,1553,21,1532,2.37%,0.03%
2020-01-01 00:03:20,14,4,5219,197,5022,7.96%,0.30%
2020-01-01 00:03:20,14,5,1812,26,1786,2.76%,0.04%
2020-01-01 00:03:20,14,6,5549,228,5321,8.47%,0.35%
2020-01-01 00:03:20,14,7,12805,1198,11607,19.54%,1.83%
2020-01-01 00:03:20,14,8,14792,1592,13200,22.57%,2.43%
2020-01-01 00:03:20,14,9,2006,36,1970,3.06%,0.05%
2020-01-01 00:03:20,14,10,5083,197,4886,7.76%,0.30%
2020-01-01 00:03:20,14,11,26804,4871,21933,40.90%,7.43%
2020-01-01 00:03:20,14,12,6640,332,6308,10.13%,0.51%
2020-01-01 00:03:20,15,1,448,2,446,0.68%,0.00%
2020-01-01 00:03:20,15,2,164,0,164,0.25%,0.00%
2020-01-01 00:03:20,15,3,4131,122,4009,6.30%,0.19%
2020-01-01 00:03:20,15,4,5173,173,5000,7.89%,0.26%
2020-01-01 00:03:20,15,5,10519,721,9798,16.05%,1.10%
2020-01-01 00:03:20,15,6,5409,192,5217,8.25%,0.29%
2020-01-01 00:03:20,15,7,3812,126,3686,5.82%,0.19%
2020-01-01 00:03:20,15,8,6341,307,6034,9.68%,0.47%
2020-01-01 00:03:20,15,9,10700,743,9957,16.33%,1.13%
2020-01-01 00:03:20,15,10,4624,157,4467,7.06%,0.24%
2020-01-01 00:03:20,15,11,11112,895,10217,16.96%,1.37%
2020-01-01 00:03:20,15,12,27596,5277,22319,42.11%,8.05%
2020-01-01 00:03:20,16,1,511,1,510,0.78%,0.00%
2020-01-01 00:03:20,16,2,334,0,334,0.51%,0.00%
2020-01-01 00:03:20,16,3,2374,58,2316,3.62%,0.09%
2020-01-01 00:03:20,16,4,3392,95,3297,5.18%,0.14%
2020-01-01 00:03:20,16,5,8349,664,7685,12.74%,1.01%
2020-01-01 00:03:20,16,6,4292,164,4128,6.55%,0.25%
2020-01-01 00:03:20,16,7,3144,74,3070,4.80%,0.11%
2020-01-01 00:03:20,16,8,8518,625,7893,13.00%,0.95%
2020-01-01 00:03:20,16,9,8769,710,8059,13.38%,1.08%
2020-01-01 00:03:20,16,10,1507,18,1489,2.30%,0.03%
2020-01-01 00:03:20,16,11,10267,886,9381,15.67%,1.35%
2020-01-01 00:03:20,16,12,28618,5565,23053,43.67%,8.49%
2020-01-01 00:03:30,1,1,24737,4201,20536,37.75%,6.41%
2020-01-01 00:03:30,1,2,9852,714,9138,15.03%,1.09%
2020-01-01 00:03:30,1,3,809,5,804,1.23%,0.01%
2020-01-01 00:03:30,1,4,14523,1568,12955,22.16%,2.39%
2020-01-01 00:03:30,1,5,14375,1538,12837,21.93%,2.35%
2020-01-01 00:03:30,1,6,14277,1518,12759,21.78%,2.32%
2020-01-01 00:03:30,1,7,9024,600,8424,13.77%,0.92%
2020-01-01 00:03:30,1,8,4410,131,4279,6.73%,0.20%
2020-01-01 00:03:30,1,9,14225,1509,12716,21.71%,2.30%
2020-01-01 00:03:30,1,10,3955,106,3849,6.03%,0.16%
2020-01-01 00:03:30,1,11,3989,109,3880,6.09%,0.17%
2020-01-01 00:03:30,1,12,14191,1505,12686,21.65%,2.30%
2020-01-01 00:03:30,2,1,841,1,840,1.28%,0.00%
2020-01-01 00:03:30,2,2,23493,3708,19785,35.85%,5.66%
2020-01-01 00:03:30,2,3,19372,2578,16794,29.56%,3.93%
2020-01-01 00:03:30,2,4,746,0,746,1.14%,0.00%
2020-01-01 00:03:30,2,5,12194,1047,11147,18.61%,1.60%
2020-01-01 00:03:30,2,6,58,0,58,0.09%,0.00%
2020-01-01 00:03:30,2,7,3265,81,3184,4.98%,0.12%
2020-01-01 00:03:30,2,8,2056,39,2017,3.14%,0.06%
2020-01-01 00:03:30,2,9,11954,1002,10952,18.24%,1.53%
2020-01-01 00:03:30,2,10,1401,19,1382,2.14%,0.03%
2020-01-01 00:03:30,2,11,1406,19,1387,2.15%,0.03%
2020-01-01 00:03:30,2,12,11794,980,10814,18.00%,1.50%
2020-01-01 00:03:30,3,1,1459,21,1438,2.23%,0.03%
2020-01-01 00:03:30,3,2,23094,3547,19547,35.24%,5.41%
2020-01-01 00:03:30,3,3,67425,25279,42146,102.88%,38.57%
2020-01-01 00:03:30,3,4,9844,702,9142,15.02%,1.07%
2020-01-01 00:03:30,3,5,41381,10654,30727,63.14%,16.26%
2020-01-01 00:03:30,3,6,11157,896,10261,17.02%,1.37%
2020-01-01 00:03:30,3,7,20032,2705,17327,30.57%,4.13%
2020-01-01 00:03:30,3,8,16751,1948,14803,25.56%,2.97%
2020-01-01 00:03:30,3,9,29562,5734,23828,45.11%,8.75%
2020-01-01 00:03:30,3,10,4284,150,4134,6.54%,0.23%
2020-01-01 00:03:30,3,11,2432,36,2396,3.71%,0.05%
2020-01-01 00:03:30,3,12,23653,3782,19871,36.09%,5.77%
2020-01-01 00:03:30,4,1,457,2,455,0.70%,0.00%
2020-01-01 00:03:30,4,2,292,1,291,0.45%,0.00%
2020-01-01 00:03:30,4,3,759,8,751,1.16%,0.01%
2020-01-01 00:03:30,4,4,27164,4939,22225,41.45%,7.54%
2020-01-01 00:03:30,4,5,18067,2295,15772,27.57%,3.50%
2020-01-01 00:03:30,4,6,23589,3770,19819,35.99%,5.75%
2020-01-01 00:03:30,4,7,4308,143,4165,6.57%,0.22%
2020-01-01 00:03:30,4,8,2745,63,2682,4.19%,0.10%
2020-01-01 00:03:30,4,9,16087,1819,14268,24.55%,2.78%
2020-01-01 00:03:30,4,10,1764,17,1747,2.69%,0.03%
2020-01-01 00:03:30,4,11,103,0,103,0.16%,0.00%
2020-01-01 00:03:30,4,12,13118,1227,11891,20.02%,1.87%
2020-01-01 00:03:30,5,1,2719,43,2676,4.15%,0.07%
2020-01-01 00:03:30,5,2,747,4,743,1.14%,0.01%
2020-01-01 00:03:30,5,3,534,3,531,0.81%,0.00%
2020-01-01 00:03:30,5,4,22386,3482,18904,34.16%,5.31%
2020-01-01 00:03:30,5,5,10556,843,9713,16.11%,1.29%
2020-01-01 00:03:30,5,6,16166,1920,14246,24.67%,2.93%
2020-01-01 00:03:30,5,7,4903,209,4694,7.48%,0.32%
2020-01-01 00:03:30,5,8,4443,174,4269,6.78%,0.27%
2020-01-01 00:03:30,5,9,9896,743,9153,15.10%,1.13%
2020-01-01 00:03:30,5,10,1285,13,1272,1.96%,0.02%
2020-01-01 00:03:30,5,11,825,10,815,1.26%,0.02%
2020-01-01 00:03:30,5,12,8179,514,7665,12.48%,0.78%
2020-01-01 00:03:30,6,1,1155,10,1145,1.76%,0.02%
2020-01-01 00:03:30,6,2,1301,14,1287,1.99%,0.02%
2020-01-01 00:03:30,6,3,1691,28,1663,2.58%,0.04%
2020-01-01 00:03:30,6,4,1014,9,1005,1.55%,0.01%
2020-01-01 00:03:30,6,5,16455,1938,14517,25.11%,2.96%
2020-01-01 00:03:30,6,6,5271,219,5052,8.04%,0.33%
2020-01-01 00:03:30,6,7,3686,130,3556,5.62%,0.20%
2020-01-01 00:03:30,6,8,2986,99,2887,4.56%,0.15%
2020-01-01 00:03:30,6,9,9164,596,8568,13.98%,0.91%
2020-01-01 00:03:30,6,10,1710,12,1698,2.61%,0.02%
2020-01-01 00:03:30,6,11,280,0,280,0.43%,0.00%
2020-01-01 00:03:30,6,12,7401,389,7012,11.29%,0.59%
2020-01-01 00:03:30,7,1,395,2,393,0.60%,0.00%
2020-01-01 00:03:30,7,2,56,0,56,0.09%,0.00%
2020-01-01 00:03:30,7,3,947,9,938,1.45%,0.01%
2020-01-01 00:03:30,7,4,1875,42,1833,2.86%,0.06%
2020-01-01 00:03:30,7,5,7617,476,7141,11.62%,0.73%
2020-01-01 00:03:30,7,6,12907,1243,11664,19.69%,1.90%
2020-01-01 00:03:30,7,7,3375,83,3292,5.15%,0.13%
2020-01-01 00:03:30,7,8,1250,12,1238,1.91%,0.02%
2020-01-01 00:03:30,7,9,6542,377,6165,9.98%,0.58%
2020-01-01 00:03:30,7,10,1607,29,1578,2.45%,0.04%
2020-01-01 00:03:30,7,11,221,1,220,0.34%,0.00%
2020-01-01 00:03:30,7,12,4923,209,4714,7.51%,0.32%
2020-01-01 00:03:30,8,1,430,1,429,0.66%,0.00%
2020-01-01 00:03:30,8,2,98,1,97,0.15%,0.00%
2020-01-01 00:03:30,8,3,1190,4,1186,1.82%,0.01%
2020-01-01 00:03:30,8,4,3123,58,3065,4.77%,0.09%
2020-01-01 00:03:30,8,5,7620,458,7162,11.63%,0.70%
2020-01-01 00:03:30,8,6,15191,1699,13492,23.18%,2.59%
2020-01-01 00:03:30,8,7,4381,150,4231,6.68%,0.23%
2020-01-01 00:03:30,8,8,1486,23,1463,2.27%,0.04%
2020-01-01 00:03:30,8,9,6257,324,5933,9.55%,0.49%
2020-01-01 00:03:30,8,10,2285,43,2242,3.49%,0.07%
2020-01-01 00:03:30,8,11,266,1,265,0.41%,0.00%
2020-01-01 00:03:30,8,12,3923,140,3783,5.99%,0.21%
2020-01-01 00:03:30,9,1,207,0,207,0.32%,0.00%
2020-01-01 00:03:30,9,2,4753,177,4576,7.25%,0.27%
2020-01-01 00:03:30,9,3,4172,138,4034,6.37%,0.21%
2020-01-01 00:03:30,9,4,14327,1564,12763,21.86%,2.39%
2020-01-01 00:03:30,9,5,255,1,254,0.39%,0.00%
2020-01-01 00:03:30,9,6,14999,1694,13305,22.89%,2.58%
2020-01-01 00:03:30,9,7,36198,8408,27790,55.23%,12.83%
2020-01-01 00:03:30,9,8,12059,1031,11028,18.40%,1.57%
2020-01-01 00:03:30,9,9,195,1,194,0.30%,0.00%
2020-01-01 00:03:30,9,10,5401,212,5189,8.24%,0.32%
2020-01-01 00:03:30,9,11,11003,852,10151,16.79%,1.30%
2020-01-01 00:03:30,9,12,5357,210,5147,8.17%,0.32%
2020-01-01 00:03:30,10,1,1447,385,1062,2.21%,0.59%
2020-01-01 00:03:30,10,2,3273,437,2836,4.99%,0.67%
2020-01-01 00:03:30,10,3,1640,13,1627,2.50%,0.02%
2020-01-01 00:03:30,10,4,4166,1140,3026,6.36%,1.74%
2020-01-01 00:03:30,10,5,715,8,707,1.09%,0.01%
2020-01-01 00:03:30,10,6,5806,1235,4571,8.86%,1.88%
2020-01-01 00:03:30,10,7,10640,2081,8559,16.24%,3.18%
2020-01-01 00:03:30,10,8,27251,6382,20869,41.58%,9.74%
2020-01-01 00:03:30,10,9,711,2,709,1.08%,0.00%
2020-01-01 00:03:30,10,10,3779,114,3665,5.77%,0.17%
2020-01-01 00:03:30,10,11,13597,1607,11990,20.75%,2.45%
2020-01-01 00:03:30,10,12,9137,888,8249,13.94%,1.35%
2020-01-01 00:03:30,11,1,2051,41,2010,3.13%,0.06%
2020-01-01 00:03:30,11,2,3101,80,3021,4.73%,0.12%
2020-01-01 00:03:30,11,3,912,7,905,1.39%,0.01%
2020-01-01 00:03:30,11,4,4439,153,4286,6.77%,0.23%
2020-01-01 00:03:30,11,5,655,1,654,1.00%,0.00%
2020-01-01 00:03:30,11,6,5715,244,5471,8.72%,0.37%
2020-01-01 00:03:30,11,7,10532,841,9691,16.07%,1.28%
2020-01-01 00:03:30,11,8,23688,3898,19790,36.15%,5.95%
2020-01-01 00:03:30,11,9,169,0,169,0.26%,0.00%
2020-01-01 00:03:30,11,10,3441,95,3346,5.25%,0.14%
2020-01-01 00:03:30,11,11,9513,669,8844,14.52%,1.02%
2020-01-01 00:03:30,11,12,5761,250,5511,8.79%,0.38%
2020-01-01 00:03:30,12,1,25,0,25,0.04%,0.00%
2020-01-01 00:03:30,12,2,608,267,341,0.93%,0.41%
2020-01-01 00:03:30,12,3,3332,345,2987,5.08%,0.53%
2020-01-01 00:03:30,12,4,4079,96,3983,6.22%,0.15%
2020-01-01 00:03:30,12,5,10698,1021,9677,16.32%,1.56%
2020-01-01 00:03:30,12,6,6605,280,6325,10.08%,0.43%
2020-01-01 00:03:30,12,7,2423,31,2392,3.70%,0.05%
2020-01-01 00:03:30,12,8,1382,298,1084,2.11%,0.45%
2020-01-01 00:03:30,12,9,31693,7829,23864,48.36%,11.95%
2020-01-01 00:03:30,12,10,4168,399,3769,6.36%,0.61%
2020-01-01 00:03:30,12,11,1634,301,1333,2.49%,0.46%
2020-01-01 00:03:30,12,12,15810,2766,13044,24.12%,4.22%
2020-01-01 00:03:30,13,1,2215,41,2174,3.38%,0.06%
2020-01-01 00:03:30,13,2,2469,50,2419,3.77%,0.08%
2020-01-01 00:03:30,13,3,792,2,790,1.21%,0.00%
2020-01-01 00:03:30,13,4,3855,407,3448,5.88%,0.62%
2020-01-01 00:03:30,13,5,6277,739,5538,9.58%,1.13%
2020-01-01 00:03:30,13,6,4588,461,4127,7.00%,0.70%
2020-01-01 00:03:30,13,7,4366,133,4233,6.66%,0.20%
2020-01-01 00:03:30,13,8,6297,278,6019,9.61%,0.42%
2020-01-01 00:03:30,13,9,6477,754,5723,9.88%,1.15%
2020-01-01 00:03:30,13,10,24789,4816,19973,37.83%,7.35%
2020-01-01 00:03:30,13,11,15554,2116,13438,23.73%,3.23%
2020-01-01 00:03:30,13,12,8793,1040,7753,13.42%,1.59%
2020-01-01 00:03:30,14,1,383,0,383,0.58%,0.00%
2020-01-01 00:03:30,14,2,2103,33,2070,3.21%,0.05%
2020-01-01 00:03:30,14,3,1502,19,1483,2.29%,0.03%
2020-01-01 00:03:30,14,4,3922,122,3800,5.98%,0.19%
2020-01-01 00:03:30,14,5,1539,11,1528,2.35%,0.02%
2020-01-01 00:03:30,14,6,4250,142,4108,6.48%,0.22%
2020-01-01 00:03:30,14,7,11005,889,10116,16.79%,1.36%
2020-01-01 00:03:30,14,8,12809,1167,11642,19.54%,1.78%
2020-01-01 00:03:30,14,9,1702,14,1688,2.60%,0.02%
2020-01-01 00:03:30,14,10,4042,106,3936,6.17%,0.16%
2020-01-01 00:03:30,14,11,24381,4000,20381,37.20%,6.10%
2020-01-01 00:03:30,14,12,7257,408,6849,11.07%,0.62%
2020-01-01 00:03:30,15,1,417,2,415,0.64%,0.00%
2020-01-01 00:03:30,15,2,145,0,145,0.22%,0.00%
2020-01-01 00:03:30,15,3,3765,110,3655,5.74%,0.17%
2020-01-01 00:03:30,15,4,5560,297,5263,8.48%,0.45%
2020-01-01 00:03:30,15,5,10319,868,9451,15.75%,1.32%
2020-01-01 00:03:30,15,6,6049,331,5718,9.23%,0.51%
2020-01-01 00:03:30,15,7,3051,132,2919,4.66%,0.20%
2020-01-01 00:03:30,15,8,5218,289,4929,7.96%,0.44%
2020-01-01 00:03:30,15,9,10487,899,9588,16.00%,1.37%
2020-01-01 00:03:30,15,10,5025,172,4853,7.67%,0.26%
2020-01-01 00:03:30,15,11,10369,862,9507,15.82%,1.32%
2020-01-01 00:03:30,15,12,26205,4903,21302,39.99%,7.48%
2020-01-01 00:03:30,16,1,531,1,530,0.81%,0.00%
2020-01-01 00:03:30,16,2,335,1,334,0.51%,0.00%
2020-01-01 00:03:30,16,3,2296,35,2261,3.50%,0.05%
2020-01-01 00:03:30,16,4,3481,113,3368,5.31%,0.17%
2020-01-01 00:03:30,16,5,8038,611,7427,12.27%,0.93%
2020-01-01 00:03:30,16,6,4370,194,4176,6.67%,0.30%
2020-01-01 00:03:30,16,7,3124,97,3027,4.77%,0.15%
2020-01-01 00:03:30,16,8,6536,366,6170,9.97%,0.56%
2020-01-01 00:03:30,16,9,8524,661,7863,13.01%,1.01%
2020-01-01 00:03:30,16,10,1573,19,1554,2.40%,0.03%
2020-01-01 00:03:30,16,11,8318,569,7749,12.69%,0.87%
2020-01-01 00:03:30,16,12,26008,4764,21244,39.69%,7.27%
2020-01-01 00:03:40,1,1,27340,5089,22251,41.72%,7.77%
2020-01-01 00:03:40,1,2,9411,659,8752,14.36%,1.01%
2020-01-01 00:03:40,1,3,1205,14,1191,1.84%,0.02%
2020-01-01 00:03:40,1,4,17646,2234,15412,26.93%,3.41%
2020-01-01 00:03:40,1,5,17364,2160,15204,26.50%,3.30%
2020-01-01 00:03:40,1,6,17313,2141,15172,26.42%,3.27%
2020-01-01 00:03:40,1,7,8197,501,7696,12.51%,0.76%
2020-01-01 00:03:40,1,8,5111,204,4907,7.80%,0.31%
2020-01-01 00:03:40,1,9,17271,2130,15141,26.35%,3.25%
2020-01-01 00:03:40,1,10,4415,150,4265,6.74%,0.23%
2020-01-01 00:03:40,1,11,4460,154,4306,6.81%,0.23%
2020-01-01 00:03:40,1,12,17250,2126,15124,26.32%,3.24%
2020-01-01 00:03:40,2,1,1327,8,1319,2.02%,0.01%
2020-01-01 00:03:40,2,2,28507,5406,23101,43.50%,8.25%
2020-01-01 00:03:40,2,3,24263,4046,20217,37.02%,6.17%
2020-01-01 00:03:40,2,4,1192,2,1190,1.82%,0.00%
2020-01-01 00:03:40,2,5,16003,1829,14174,24.42%,2.79%
2020-01-01 00:03:40,2,6,58,0,58,0.09%,0.00%
2020-01-01 00:03:40,2,7,2894,75,2819,4.42%,0.11%
2020-01-01 00:03:40,2,8,1705,25,1680,2.60%,0.04%
2020-01-01 00:03:40,2,9,15816,1786,14030,24.13%,2.73%
2020-01-01 00:03:40,2,10,1088,8,1080,1.66%,0.01%
2020-01-01 00:03:40,2,11,1093,8,1085,1.67%,0.01%
2020-01-01 00:03:40,2,12,15668,1757,13911,23.91%,2.68%
2020-01-01 00:03:40,3,1,1463,14,1449,2.23%,0.02%
2020-01-01 00:03:40,3,2,23170,3565,19605,35.35%,5.44%
2020-01-01 00:03:40,3,3,71445,27872,43573,109.02%,42.53%
2020-01-01 00:03:40,3,4,8151,512,7639,12.44%,0.78%
2020-01-01 00:03:40,3,5,45553,12679,32874,69.51%,19.35%
2020-01-01 00:03:40,3,6,9464,687,8777,14.44%,1.05%
2020-01-01 00:03:40,3,7,20112,2733,17379,30.69%,4.17%
2020-01-01 00:03:40,3,8,17622,2141,15481,26.89%,3.27%
2020-01-01 00:03:40,3,9,35681,8144,27537,54.44%,12.43%
2020-01-01 00:03:40,3,10,2638,55,2583,4.03%,0.08%
2020-01-01 00:03:40,3,11,2481,41,2440,3.79%,0.06%
2020-01-01 00:03:40,3,12,31539,6514,25025,48.12%,9.94%
2020-01-01 00:03:40,4,1,432,1,431,0.66%,0.00%
2020-01-01 00:03:40,4,2,284,0,284,0.43%,0.00%
2020-01-01 00:03:40,4,3,964,9,955,1.47%,0.01%
2020-01-01 00:03:40,4,4,27734,5033,22701,42.32%,7.68%
2020-01-01 00:03:40,4,5,18458,2324,16134,28.16%,3.55%
2020-01-01 00:03:40,4,6,24006,3849,20157,36.63%,5.87%
2020-01-01 00:03:40,4,7,4374,145,4229,6.67%,0.22%
2020-01-01 00:03:40,4,8,2704,66,2638,4.13%,0.10%
2020-01-01 00:03:40,4,9,16237,1846,14391,24.78%,2.82%
2020-01-01 00:03:40,4,10,1605,14,1591,2.45%,0.02%
2020-01-01 00:03:40,4,11,109,0,109,0.17%,0.00%
2020-01-01 00:03:40,4,12,13505,1314,12191,20.61%,2.01%
2020-01-01 00:03:40,5,1,2585,49,2536,3.94%,0.07%
2020-01-01 00:03:40,5,2,662,2,660,1.01%,0.00%
2020-01-01 00:03:40,5,3,622,3,619,0.95%,0.00%
2020-01-01 00:03:40,5,4,21490,3168,18322,32.79%,4.83%
2020-01-01 00:03:40,5,5,10263,769,9494,15.66%,1.17%
2020-01-01 00:03:40,5,6,14856,1519,13337,22.67%,2.32%
2020-01-01 00:03:40,5,7,4042,134,3908,6.17%,0.20%
2020-01-01 00:03:40,5,8,3489,86,3403,5.32%,0.13%
2020-01-01 00:03:40,5,9,9514,667,8847,14.52%,1.02%
2020-01-01 00:03:40,5,10,1283,10,1273,1.96%,0.02%
2020-01-01 00:03:40,5,11,794,11,783,1.21%,0.02%
2020-01-01 00:03:40,5,12,7764,455,7309,11.85%,0.69%
2020-01-01 00:03:40,6,1,1387,13,1374,2.12%,0.02%
2020-01-01 00:03:40,6,2,1520,20,1500,2.32%,0.03%
2020-01-01 00:03:40,6,3,1876,28,1848,2.86%,0.04%
2020-01-01 00:03:40,6,4,1387,9,1378,2.12%,0.01%
2020-01-01 00:03:40,6,5,16360,1929,14431,24.96%,2.94%
2020-01-01 00:03:40,6,6,4466,160,4306,6.81%,0.24%
2020-01-01 00:03:40,6,7,2627,70,2557,4.01%,0.11%
2020-01-01 00:03:40,6,8,1932,42,1890,2.95%,0.06%
2020-01-01 00:03:40,6,9,9792,687,9105,14.94%,1.05%
2020-01-01 00:03:40,6,10,1860,25,1835,2.84%,0.04%
2020-01-01 00:03:40,6,11,376,1,375,0.57%,0.00%
2020-01-01 00:03:40,6,12,7876,448,7428,12.02%,0.68%
2020-01-01 00:03:40,7,1,400,1,399,0.61%,0.00%
2020-01-01 00:03:40,7,2,66,0,66,0.10%,0.00%
2020-01-01 00:03:40,7,3,1511,18,1493,2.31%,0.03%
2020-01-01 00:03:40,7,4,1372,12,1360,2.09%,0.02%
2020-01-01 00:03:40,7,5,7686,453,7233,11.73%,0.69%
2020-01-01 00:03:40,7,6,12659,1265,11394,19.32%,1.93%
2020-01-01 00:03:40,7,7,3565,147,3418,5.44%,0.22%
2020-01-01 00:03:40,7,8,1392,10,1382,2.12%,0.02%
2020-01-01 00:03:40,7,9,6038,296,5742,9.21%,0.45%
2020-01-01 00:03:40,7,10,1856,20,1836,2.83%,0.03%
2020-01-01 00:03:40,7,11,237,1,236,0.36%,0.00%
2020-01-01 00:03:40,7,12,4192,143,4049,6.40%,0.22%
2020-01-01 00:03:40,8,1,386,2,384,0.59%,0.00%
2020-01-01 00:03:40,8,2,84,0,84,0.13%,0.00%
2020-01-01 00:03:40,8,3,1299,10,1289,1.98%,0.02%
2020-01-01 00:03:40,8,4,3021,73,2948,4.61%,0.11%
2020-01-01 00:03:40,8,5,7942,471,7471,12.12%,0.72%
2020-01-01 00:03:40,8,6,16282,1909,14373,24.84%,2.91%
2020-01-01 00:03:40,8,7,5207,213,4994,7.95%,0.33%
2020-01-01 00:03:40,8,8,2138,37,2101,3.26%,0.06%
2020-01-01 00:03:40,8,9,6380,313,6067,9.74%,0.48%
2020-01-01 00:03:40,8,10,2246,34,2212,3.43%,0.05%
2020-01-01 00:03:40,8,11,199,0,199,0.30%,0.00%
2020-01-01 00:03:40,8,12,4064,133,3931,6.20%,0.20%
2020-01-01 00:03:40,9,1,149,1,148,0.23%,0.00%
2020-01-01 00:03:40,9,2,3339,98,3241,5.09%,0.15%
2020-01-01 00:03:40,9,3,2811,71,2740,4.29%,0.11%
2020-01-01 00:03:40,9,4,8874,657,8217,13.54%,1.00%
2020-01-01 00:03:40,9,5,292,2,290,0.45%,0.00%
2020-01-01 00:03:40,9,6,9610,745,8865,14.66%,1.14%
2020-01-01 00:03:40,9,7,29121,5665,23456,44.44%,8.64%
2020-01-01 00:03:40,9,8,11294,909,10385,17.23%,1.39%
2020-01-01 00:03:40,9,9,267,2,265,0.41%,0.00%
2020-01-01 00:03:40,9,10,3786,113,3673,5.78%,0.17%
2020-01-01 00:03:40,9,11,10085,731,9354,15.39%,1.12%
2020-01-01 00:03:40,9,12,5978,248,5730,9.12%,0.38%
2020-01-01 00:03:40,10,1,1452,379,1073,2.22%,0.58%
2020-01-01 00:03:40,10,2,3374,433,2941,5.15%,0.66%
2020-01-01 00:03:40,10,3,1787,28,1759,2.73%,0.04%
2020-01-01 00:03:40,10,4,3989,1123,2866,6.09%,1.71%
2020-01-01 00:03:40,10,5,733,6,727,1.12%,0.01%
2020-01-01 00:03:40,10,6,6014,1233,4781,9.18%,1.88%
2020-01-01 00:03:40,10,7,10815,2082,8733,16.50%,3.18%
2020-01-01 00:03:40,10,8,27110,6366,20744,41.37%,9.71%
2020-01-01 00:03:40,10,9,680,1,679,1.04%,0.00%
2020-01-01 00:03:40,10,10,3892,96,3796,5.94%,0.15%
2020-01-01 00:03:40,10,11,13245,1496,11749,20.21%,2.28%
2020-01-01 00:03:40,10,12,8759,880,7879,13.37%,1.34%
2020-01-01 00:03:40,11,1,2236,39,2197,3.41%,0.06%
2020-01-01 00:03:40,11,2,3373,84,3289,5.15%,0.13%
2020-01-01 00:03:40,11,3,906,8,898,1.38%,0.01%
2020-01-01 00:03:40,11,4,4988,192,4796,7.61%,0.29%
2020-01-01 00:03:40,11,5,283,0,283,0.43%,0.00%
2020-01-01 00:03:40,11,6,5991,269,5722,9.14%,0.41%
2020-01-01 00:03:40,11,7,11297,947,10350,17.24%,1.45%
2020-01-01 00:03:40,11,8,24456,4127,20329,37.32%,6.30%
2020-01-01 00:03:40,11,9,240,0,240,0.37%,0.00%
2020-01-01 00:03:40,11,10,3614,106,3508,5.51%,0.16%
2020-01-01 00:03:40,11,11,9765,730,9035,14.90%,1.11%
2020-01-01 00:03:40,11,12,5879,272,5607,8.97%,0.42%
2020-01-01 00:03:40,12,1,28,0,28,0.04%,0.00%
2020-01-01 00:03:40,12,2,649,268,381,0.99%,0.41%
2020-01-01 00:03:40,12,3,3682,367,3315,5.62%,0.56%
2020-01-01 00:03:40,12,4,3927,83,3844,5.99%,0.13%
2020-01-01 00:03:40,12,5,10961,1114,9847,16.73%,1.70%
2020-01-01 00:03:40,12,6,6474,263,6211,9.88%,0.40%
2020-01-01 00:03:40,12,7,2434,28,2406,3.71%,0.04%
2020-01-01 00:03:40,12,8,1355,279,1076,2.07%,0.43%
2020-01-01 00:03:40,12,9,26931,5921,21010,41.09%,9.03%
2020-01-01 00:03:40,12,10,3911,372,3539,5.97%,0.57%
2020-01-01 00:03:40,12,11,1548,282,1266,2.36%,0.43%
2020-01-01 00:03:40,12,12,11120,1620,9500,16.97%,2.47%
2020-01-01 00:03:40,13,1,2543,57,2486,3.88%,0.09%
2020-01-01 00:03:40,13,2,2868,67,2801,4.38%,0.10%
2020-01-01 00:03:40,13,3,1078,6,1072,1.64%,0.01%
2020-01-01 00:03:40,13,4,3517,378,3139,5.37%,0.58%
2020-01-01 00:03:40,13,5,6222,727,5495,9.49%,1.11%
2020-01-01 00:03:40,13,6,4308,420,3888,6.57%,0.64%
2020-01-01 00:03:40,13,7,4838,181,4657,7.38%,0.28%
2020-01-01 00:03:40,13,8,6499,310,6189,9.92%,0.47%
2020-01-01 00:03:40,13,9,6456,743,5713,9.85%,1.13%
2020-01-01 00:03:40,13,10,25017,4890,20127,38.17%,7.46%
2020-01-01 00:03:40,13,11,16309,2265,14044,24.89%,3.46%
2020-01-01 00:03:40,13,12,9310,1067,8243,14.21%,1.63%
2020-01-01 00:03:40,14,1,258,0,258,0.39%,0.00%
2020-01-01 00:03:40,14,2,1975,23,1952,3.01%,0.04%
2020-01-01 00:03:40,14,3,1450,8,1442,2.21%,0.01%
2020-01-01 00:03:40,14,4,4058,131,3927,6.19%,0.20%
2020-01-01 00:03:40,14,5,1834,37,1797,2.80%,0.06%
2020-01-01 00:03:40,14,6,4349,157,4192,6.64%,0.24%
2020-01-01 00:03:40,14,7,10875,886,9989,16.59%,1.35%
2020-01-01 00:03:40,14,8,12811,1218,11593,19.55%,1.86%
2020-01-01 00:03:40,14,9,2002,43,1959,3.05%,0.07%
2020-01-01 00:03:40,14,10,4328,141,4187,6.60%,0.22%
2020-01-01 00:03:40,14,11,23927,3945,19982,36.51%,6.02%
2020-01-01 00:03:40,14,12,6554,325,6229,10.00%,0.50%
2020-01-01 00:03:40,15,1,565,4,561,0.86%,0.01%
2020-01-01 00:03:40,15,2,177,1,176,0.27%,0.00%
2020-01-01 00:03:40,15,3,4008,128,3880,6.12%,0.20%
2020-01-01 00:03:40,15,4,6462,260,6202,9.86%,0.40%
2020-01-01 00:03:40,15,5,11251,942,10309,17.17%,1.44%
2020-01-01 00:03:40,15,6,6782,303,6479,10.35%,0.46%
2020-01-01 00:03:40,15,7,3057,104,2953,4.66%,0.16%
2020-01-01 00:03:40,15,8,4775,207,4568,7.29%,0.32%
2020-01-01 00:03:40,15,9,11447,967,10480,17.47%,1.48%
2020-01-01 00:03:40,15,10,4127,132,3995,6.30%,0.20%
2020-01-01 00:03:40,15,11,9130,666,8464,13.93%,1.02%
2020-01-01 00:03:40,15,12,25495,4633,20862,38.90%,7.07%
2020-01-01 00:03:40,16,1,357,1,356,0.54%,0.00%
2020-01-01 00:03:40,16,2,335,0,335,0.51%,0.00%
2020-01-01 00:03:40,16,3,1473,18,1455,2.25%,0.03%
2020-01-01 00:03:40,16,4,3457,83,3374,5.27%,0.13%
2020-01-01 00:03:40,16,5,7118,479,6639,10.86%,0.73%
2020-01-01 00:03:40,16,6,4310,135,4175,6.58%,0.21%
2020-01-01 00:03:40,16,7,3082,85,2997,4.70%,0.13%
2020-01-01 00:03:40,16,8,6649,385,6264,10.15%,0.59%
2020-01-01 00:03:40,16,9,7731,536,7195,11.80%,0.82%
2020-01-01 00:03:40,16,10,2347,43,2304,3.58%,0.07%
2020-01-01 00:03:40,16,11,9191,665,8526,14.02%,1.01%
2020-01-01 00:03:40,16,12,26070,4668,21402,39.78%,7.12%
2020-01-01 00:03:50,1,1,26244,4569,21675,40.05%,6.97%
2020-01-01 00:03:50,1,2,8287,504,7783,12.64%,0.77%
2020-01-01 00:03:50,1,3,1978,35,1943,3.02%,0.05%
2020-01-01 00:03:50,1,4,17479,2143,15336,26.67%,3.27%
2020-01-01 00:03:50,1,5,17322,2119,15203,26.43%,3.23%
2020-01-01 00:03:50,1,6,17219,2091,15128,26.27%,3.19%
2020-01-01 00:03:50,1,7,6298,291,6007,9.61%,0.44%
2020-01-01 00:03:50,1,8,4742,150,4592,7.24%,0.23%
2020-01-01 00:03:50,1,9,17182,2082,15100,26.22%,3.18%
2020-01-01 00:03:50,1,10,4013,103,3910,6.12%,0.16%
2020-01-01 00:03:50,1,11,4072,108,3964,6.21%,0.16%
2020-01-01 00:03:50,1,12,17157,2078,15079,26.18%,3.17%
2020-01-01 00:03:50,2,1,384,0,384,0.59%,0.00%
2020-01-01 00:03:50,2,2,27764,5184,22580,42.36%,7.91%
2020-01-01 00:03:50,2,3,24063,3931,20132,36.72%,6.00%
2020-01-01 00:03:50,2,4,315,0,315,0.48%,0.00%
2020-01-01 00:03:50,2,5,13435,1285,12150,20.50%,1.96%
2020-01-01 00:03:50,2,6,205,1,204,0.31%,0.00%
2020-01-01 00:03:50,2,7,3295,88,3207,5.03%,0.13%
2020-01-01 00:03:50,2,8,1919,32,1887,2.93%,0.05%
2020-01-01 00:03:50,2,9,13260,1245,12015,20.23%,1.90%
2020-01-01 00:03:50,2,10,1239,15,1224,1.89%,0.02%
2020-01-01 00:03:50,2,11,1244,15,1229,1.90%,0.02%
2020-01-01 00:03:50,2,12,13110,1217,11893,20.00%,1.86%
2020-01-01 00:03:50,3,1,1465,16,1449,2.24%,0.02%
2020-01-01 00:03:50,3,2,21215,3090,18125,32.37%,4.71%
2020-01-01 00:03:50,3,3,64933,23820,41113,99.08%,36.35%
2020-01-01 00:03:50,3,4,9449,656,8793,14.42%,1.00%
2020-01-01 00:03:50,3,5,42750,11347,31403,65.23%,17.31%
2020-01-01 00:03:50,3,6,10812,877,9935,16.50%,1.34%
2020-01-01 00:03:50,3,7,18048,2258,15790,27.54%,3.45%
2020-01-01 00:03:50,3,8,15739,1749,13990,24.02%,2.67%
2020-01-01 00:03:50,3,9,31529,6436,25093,48.11%,9.82%
2020-01-01 00:03:50,3,10,4373,130,4243,6.67%,0.20%
2020-01-01 00:03:50,3,11,2328,40,2288,3.55%,0.06%
2020-01-01 00:03:50,3,12,25783,4469,21314,39.34%,6.82%
2020-01-01 00:03:50,4,1,529,4,525,0.81%,0.01%
2020-01-01 00:03:50,4,2,349,1,348,0.53%,0.00%
2020-01-01 00:03:50,4,3,1105,6,1099,1.69%,0.01%
2020-01-01 00:03:50,4,4,28591,5360,23231,43.63%,8.18%
2020-01-01 00:03:50,4,5,19508,2567,16941,29.77%,3.92%
2020-01-01 00:03:50,4,6,24696,4069,20627,37.68%,6.21%
2020-01-01 00:03:50,4,7,4077,119,3958,6.22%,0.18%
2020-01-01 00:03:50,4,8,2489,60,2429,3.80%,0.09%
2020-01-01 00:03:50,4,9,17405,2093,15312,26.56%,3.19%
2020-01-01 00:03:50,4,10,1802,22,1780,2.75%,0.03%
2020-01-01 00:03:50,4,11,91,0,91,0.14%,0.00%
2020-01-01 00:03:50,4,12,14345,1452,12893,21.89%,2.22%
2020-01-01 00:03:50,5,1,2798,58,2740,4.27%,0.09%
2020-01-01 00:03:50,5,2,754,3,751,1.15%,0.00%
2020-01-01 00:03:50,5,3,2113,42,2071,3.22%,0.06%
2020-01-01 00:03:50,5,4,24203,3901,20302,36.93%,5.95%
2020-01-01 00:03:50,5,5,11853,1005,10848,18.09%,1.53%
2020-01-01 00:03:50,5,6,16937,1957,14980,25.84%,2.99%
2020-01-01 00:03:50,5,7,4468,161,4307,6.82%,0.25%
2020-01-01 00:03:50,5,8,3706,117,3589,5.65%,0.18%
2020-01-01 00:03:50,5,9,9605,665,8940,14.66%,1.01%
2020-01-01 00:03:50,5,10,1429,11,1418,2.18%,0.02%
2020-01-01 00:03:50,5,11,937,19,918,1.43%,0.03%
2020-01-01 00:03:50,5,12,7836,441,7395,11.96%,0.67%
2020-01-01 00:03:50,6,1,1122,14,1108,1.71%,0.02%
2020-01-01 00:03:50,6,2,1276,14,1262,1.95%,0.02%
2020-01-01 00:03:50,6,3,1901,21,1880,2.90%,0.03%
2020-01-01 00:03:50,6,4,975,3,972,1.49%,0.00%
2020-01-01 00:03:50,6,5,16718,1926,14792,25.51%,2.94%
2020-01-01 00:03:50,6,6,4226,133,4093,6.45%,0.20%
2020-01-01 00:03:50,6,7,2654,52,2602,4.05%,0.08%
2020-01-01 00:03:50,6,8,1995,33,1962,3.04%,0.05%
2020-01-01 00:03:50,6,9,10277,809,9468,15.68%,1.23%
2020-01-01 00:03:50,6,10,2284,48,2236,3.49%,0.07%
2020-01-01 00:03:50,6,11,389,0,389,0.59%,0.00%
2020-01-01 00:03:50,6,12,7938,487,7451,12.11%,0.74%
2020-01-01 00:03:50,7,1,405,0,405,0.62%,0.00%
2020-01-01 00:03:50,7,2,69,0,69,0.11%,0.00%
2020-01-01 00:03:50,7,3,1226,10,1216,1.87%,0.02%
2020-01-01 00:03:50,7,4,1720,28,1692,2.62%,0.04%
2020-01-01 00:03:50,7,5,7338,403,6935,11.20%,0.61%
2020-01-01 00:03:50,7,6,12996,1277,11719,19.83%,1.95%
2020-01-01 00:03:50,7,7,3904,148,3756,5.96%,0.23%
2020-01-01 00:03:50,7,8,1471,24,1447,2.24%,0.04%
2020-01-01 00:03:50,7,9,5992,295,5697,9.14%,0.45%
2020-01-01 00:03:50,7,10,1397,14,1383,2.13%,0.02%
2020-01-01 00:03:50,7,11,207,0,207,0.32%,0.00%
2020-01-01 00:03:50,7,12,4603,156,4447,7.02%,0.24%
2020-01-01 00:03:50,8,1,563,1,562,0.86%,0.00%
2020-01-01 00:03:50,8,2,64,1,63,0.10%,0.00%
2020-01-01 00:03:50,8,3,1349,17,1332,2.06%,0.03%
2020-01-01 00:03:50,8,4,2781,49,2732,4.24%,0.07%
2020-01-01 00:03:50,8,5,8331,479,7852,12.71%,0.73%
2020-01-01 00:03:50,8,6,18564,2322,16242,28.33%,3.54%
2020-01-01 00:03:50,8,7,7219,379,6840,11.02%,0.58%
2020-01-01 00:03:50,8,8,3759,109,3650,5.74%,0.17%
2020-01-01 00:03:50,8,9,6840,322,6518,10.44%,0.49%
2020-01-01 00:03:50,8,10,2439,35,2404,3.72%,0.05%
2020-01-01 00:03:50,8,11,186,0,186,0.28%,0.00%
2020-01-01 00:03:50,8,12,4362,140,4222,6.66%,0.21%
2020-01-01 00:03:50,9,1,167,0,167,0.25%,0.00%
2020-01-01 00:03:50,9,2,1959,25,1934,2.99%,0.04%
2020-01-01 00:03:50,9,3,1339,10,1329,2.04%,0.02%
2020-01-01 00:03:50,9,4,8781,568,8213,13.40%,0.87%
2020-01-01 00:03:50,9,5,400,2,398,0.61%,0.00%
2020-01-01 00:03:50,9,6,9799,713,9086,14.95%,1.09%
2020-01-01 00:03:50,9,7,27668,5139,22529,42.22%,7.84%
2020-01-01 00:03:50,9,8,10331,782,9549,15.76%,1.19%
2020-01-01 00:03:50,9,9,355,1,354,0.54%,0.00%
2020-01-01 00:03:50,9,10,2403,45,2358,3.67%,0.07%
2020-01-01 00:03:50,9,11,9043,599,8444,13.80%,0.91%
2020-01-01 00:03:50,9,12,6323,302,6021,9.65%,0.46%
2020-01-01 00:03:50,10,1,1485,400,1085,2.27%,0.61%
2020-01-01 00:03:50,10,2,3411,473,2938,5.20%,0.72%
2020-01-01 00:03:50,10,3,1762,22,1740,2.69%,0.03%
2020-01-01 00:03:50,10,4,4111,1178,2933,6.27%,1.80%
2020-01-01 00:03:50,10,5,862,6,856,1.32%,0.01%
2020-01-01 00:03:50,10,6,6294,1297,4997,9.60%,1.98%
2020-01-01 00:03:50,10,7,11024,2179,8845,16.82%,3.32%
2020-01-01 00:03:50,10,8,27507,6551,20956,41.97%,10.00%
2020-01-01 00:03:50,10,9,691,6,685,1.05%,0.01%
2020-01-01 00:03:50,10,10,2861,59,2802,4.37%,0.09%
2020-01-01 00:03:50,10,11,13226,1496,11730,20.18%,2.28%
2020-01-01 00:03:50,10,12,9641,943,8698,14.71%,1.44%
2020-01-01 00:03:50,11,1,2332,46,2286,3.56%,0.07%
2020-01-01 00:03:50,11,2,3696,130,3566,5.64%,0.20%
2020-01-01 00:03:50,11,3,1047,12,1035,1.60%,0.02%
2020-01-01 00:03:50,11,4,3561,83,3478,5.43%,0.13%
2020-01-01 00:03:50,11,5,553,3,550,0.84%,0.00%
2020-01-01 00:03:50,11,6,4841,168,4673,7.39%,0.26%
2020-01-01 00:03:50,11,7,10604,837,9767,16.18%,1.28%
2020-01-01 00:03:50,11,8,25026,4321,20705,38.19%,6.59%
2020-01-01 00:03:50,11,9,272,0,272,0.42%,0.00%
2020-01-01 00:03:50,11,10,3812,101,3711,5.82%,0.15%
2020-01-01 00:03:50,11,11,10457,839,9618,15.96%,1.28%
2020-01-01 00:03:50,11,12,6389,345,6044,9.75%,0.53%
2020-01-01 00:03:50,12,1,28,0,28,0.04%,0.00%
2020-01-01 00:03:50,12,2,752,282,470,1.15%,0.43%
2020-01-01 00:03:50,12,3,3422,355,3067,5.22%,0.54%
2020-01-01 00:03:50,12,4,3667,78,3589,5.60%,0.12%
2020-01-01 00:03:50,12,5,10919,1043,9876,16.66%,1.59%
2020-01-01 00:03:50,12,6,6646,257,6389,10.14%,0.39%
2020-01-01 00:03:50,12,7,2859,64,2795,4.36%,0.10%
2020-01-01 00:03:50,12,8,989,237,752,1.51%,0.36%
2020-01-01 00:03:50,12,9,24110,5125,18985,36.79%,7.82%
2020-01-01 00:03:50,12,10,3889,352,3537,5.93%,0.54%
2020-01-01 00:03:50,12,11,1213,241,972,1.85%,0.37%
2020-01-01 00:03:50,12,12,8345,1372,6973,12.73%,2.09%
2020-01-01 00:03:50,13,1,1931,32,1899,2.95%,0.05%
2020-01-01 00:03:50,13,2,2208,45,2163,3.37%,0.07%
2020-01-01 00:03:50,13,3,1054,9,1045,1.61%,0.01%
2020-01-01 00:03:50,13,4,4420,472,3948,6.74%,0.72%
2020-01-01 00:03:50,13,5,7452,867,6585,11.37%,1.32%
2020-01-01 00:03:50,13,6,5234,528,4706,7.99%,0.81%
2020-01-01 00:03:50,13,7,4207,132,4075,6.42%,0.20%
2020-01-01 00:03:50,13,8,6165,266,5899,9.41%,0.41%
2020-01-01 00:03:50,13,9,7647,891,6756,11.67%,1.36%
2020-01-01 00:03:50,13,10,26443,5232,21211,40.35%,7.98%
2020-01-01 00:03:50,13,11,15982,2097,13885,24.39%,3.20%
2020-01-01 00:03:50,13,12,9286,992,8294,14.17%,1.51%
2020-01-01 00:03:50,14,1,438,1,437,0.67%,0.00%
2020-01-01 00:03:50,14,2,2497,39,2458,3.81%,0.06%
2020-01-01 00:03:50,14,3,1649,23,1626,2.52%,0.04%
2020-01-01 00:03:50,14,4,4614,184,4430,7.04%,0.28%
2020-01-01 00:03:50,14,5,1733,21,1712,2.64%,0.03%
2020-01-01 00:03:50,14,6,4872,203,4669,7.43%,0.31%
2020-01-01 00:03:50,14,7,12340,1119,11221,18.83%,1.71%
2020-01-01 00:03:50,14,8,14255,1478,12777,21.75%,2.26%
2020-01-01 00:03:50,14,9,1890,22,1868,2.88%,0.03%
2020-01-01 00:03:50,14,10,4746,167,4579,7.24%,0.25%
2020-01-01 00:03:50,14,11,26779,4892,21887,40.86%,7.46%
2020-01-01 00:03:50,14,12,7542,465,7077,11.51%,0.71%
2020-01-01 00:03:50,15,1,471,1,470,0.72%,0.00%
2020-01-01 00:03:50,15,2,175,1,174,0.27%,0.00%
2020-01-01 00:03:50,15,3,3987,112,3875,6.08%,0.17%
2020-01-01 00:03:50,15,4,6438,340,6098,9.82%,0.52%
2020-01-01 00:03:50,15,5,11112,986,10126,16.96%,1.50%
2020-01-01 00:03:50,15,6,6704,364,6340,10.23%,0.56%
2020-01-01 00:03:50,15,7,3483,116,3367,5.31%,0.18%
2020-01-01 00:03:50,15,8,5313,230,5083,8.11%,0.35%
2020-01-01 00:03:50,15,9,11287,1008,10279,17.22%,1.54%
2020-01-01 00:03:50,15,10,3746,94,3652,5.72%,0.14%
2020-01-01 00:03:50,15,11,9325,645,8680,14.23%,0.98%
2020-01-01 00:03:50,15,12,25571,4777,20794,39.02%,7.29%
2020-01-01 00:03:50,16,1,396,0,396,0.60%,0.00%
2020-01-01 00:03:50,16,2,364,0,364,0.56%,0.00%
2020-01-01 00:03:50,16,3,1588,17,1571,2.42%,0.03%
2020-01-01 00:03:50,16,4,3818,121,3697,5.83%,0.18%
2020-01-01 00:03:50,16,5,7586,542,7044,11.58%,0.83%
2020-01-01 00:03:50,16,6,4635,177,4458,7.07%,0.27%
2020-01-01 00:03:50,16,7,3307,105,3202,5.05%,0.16%
2020-01-01 00:03:50,16,8,6952,404,6548,10.61%,0.62%
2020-01-01 00:03:50,16,9,8013,591,7422,12.23%,0.90%
2020-01-01 00:03:50,16,10,2027,32,1995,3.09%,0.05%
2020-01-01 00:03:50,16,11,9167,655,8512,13.99%,1.00%
2020-01-01 00:03:50,16,12,26820,5047,21773,40.92%,7.70%
2020-01-01 00:04:00,1,1,21943,3406,18537,33.48%,5.20%
2020-01-01 00:04:00,1,2,10236,826,9410,15.62%,1.26%
2020-01-01 00:04:00,1,3,704,3,701,1.07%,0.00%
2020-01-01 00:04:00,1,4,11396,1033,10363,17.39%,1.58%
2020-01-01 00:04:00,1,5,11191,989,10202,17.08%,1.51%
2020-01-01 00:04:00,1,6,11111,977,10134,16.95%,1.49%
2020-01-01 00:04:00,1,7,9506,720,8786,14.51%,1.10%
2020-01-01 00:04:00,1,8,4103,131,3972,6.26%,0.20%
2020-01-01 00:04:00,1,9,11067,971,10096,16.89%,1.48%
2020-01-01 00:04:00,1,10,3319,69,3250,5.06%,0.11%
2020-01-01 00:04:00,1,11,3393,76,3317,5.18%,0.12%
2020-01-01 00:04:00,1,12,11035,965,10070,16.84%,1.47%
2020-01-01 00:04:00,2,1,1104,5,1099,1.68%,0.01%
2020-01-01 00:04:00,2,2,28195,5288,22907,43.02%,8.07%
2020-01-01 00:04:00,2,3,22224,3347,18877,33.91%,5.11%
2020-01-01 00:04:00,2,4,287,2,285,0.44%,0.00%
2020-01-01 00:04:00,2,5,11662,993,10669,17.79%,1.52%
2020-01-01 00:04:00,2,6,135,0,135,0.21%,0.00%
2020-01-01 00:04:00,2,7,4839,187,4652,7.38%,0.29%
2020-01-01 00:04:00,2,8,3407,93,3314,5.20%,0.14%
2020-01-01 00:04:00,2,9,11505,969,10536,17.56%,1.48%
2020-01-01 00:04:00,2,10,2550,55,2495,3.89%,0.08%
2020-01-01 00:04:00,2,11,2557,56,2501,3.90%,0.09%
2020-01-01 00:04:00,2,12,11330,938,10392,17.29%,1.43%
2020-01-01 00:04:00,3,1,1543,11,1532,2.35%,0.02%
2020-01-01 00:04:00,3,2,25642,4401,21241,39.13%,6.72%
2020-01-01 00:04:00,3,3,66703,24901,41802,101.78%,38.00%
2020-01-01 00:04:00,3,4,8479,510,7969,12.94%,0.78%
2020-01-01 00:04:00,3,5,40310,10295,30015,61.51%,15.71%
2020-01-01 00:04:00,3,6,9828,693,9135,15.00%,1.06%
2020-01-01 00:04:00,3,7,22112,3331,18781,33.74%,5.08%
2020-01-01 00:04:00,3,8,19582,2663,16919,29.88%,4.06%
2020-01-01 00:04:00,3,9,30120,6044,24076,45.96%,9.22%
2020-01-01 00:04:00,3,10,3605,89,3516,5.50%,0.14%
2020-01-01 00:04:00,3,11,1852,25,1827,2.83%,0.04%
2020-01-01 00:04:00,3,12,25322,4374,20948,38.64%,6.67%
2020-01-01 00:04:00,4,1,434,2,432,0.66%,0.00%
2020-01-01 00:04:00,4,2,290,0,290,0.44%,0.00%
2020-01-01 00:04:00,4,3,1083,4,1079,1.65%,0.01%
2020-01-01 00:04:00,4,4,27785,5217,22568,42.40%,7.96%
2020-01-01 00:04:00,4,5,18720,2493,16227,28.56%,3.80%
2020-01-01 00:04:00,4,6,24048,4045,20003,36.69%,6.17%
2020-01-01 00:04:00,4,7,4288,175,4113,6.54%,0.27%
2020-01-01 00:04:00,4,8,2752,77,2675,4.20%,0.12%
2020-01-01 00:04:00,4,9,16496,1976,14520,25.17%,3.02%
2020-01-01 00:04:00,4,10,1806,31,1775,2.76%,0.05%
2020-01-01 00:04:00,4,11,118,0,118,0.18%,0.00%
2020-01-01 00:04:00,4,12,13601,1349,12252,20.75%,2.06%
2020-01-01 00:04:00,5,1,2656,60,2596,4.05%,0.09%
2020-01-01 00:04:00,5,2,736,7,729,1.12%,0.01%
2020-01-01 00:04:00,5,3,1725,26,1699,2.63%,0.04%
2020-01-01 00:04:00,5,4,26124,4639,21485,39.86%,7.08%
2020-01-01 00:04:00,5,5,11483,995,10488,17.52%,1.52%
2020-01-01 00:04:00,5,6,16344,1934,14410,24.94%,2.95%
2020-01-01 00:04:00,5,7,4329,156,4173,6.61%,0.24%
2020-01-01 00:04:00,5,8,3437,104,3333,5.24%,0.16%
2020-01-01 00:04:00,5,9,8891,614,8277,13.57%,0.94%
2020-01-01 00:04:00,5,10,1103,11,1092,1.68%,0.02%
2020-01-01 00:04:00,5,11,910,15,895,1.39%,0.02%
2020-01-01 00:04:00,5,12,7349,443,6906,11.21%,0.68%
2020-01-01 00:04:00,6,1,1336,20,1316,2.04%,0.03%
2020-01-01 00:04:00,6,2,1516,26,1490,2.31%,0.04%
2020-01-01 00:04:00,6,3,1764,30,1734,2.69%,0.05%
2020-01-01 00:04:00,6,4,1318,17,1301,2.01%,0.03%
2020-01-01 00:04:00,6,5,15977,1862,14115,24.38%,2.84%
2020-01-01 00:04:00,6,6,4513,148,4365,6.89%,0.23%
2020-01-01 00:04:00,6,7,2733,59,2674,4.17%,0.09%
2020-01-01 00:04:00,6,8,2205,40,2165,3.36%,0.06%
2020-01-01 00:04:00,6,9,9381,677,8704,14.31%,1.03%
2020-01-01 00:04:00,6,10,1781,22,1759,2.72%,0.03%
2020-01-01 00:04:00,6,11,287,1,286,0.44%,0.00%
2020-01-01 00:04:00,6,12,7553,457,7096,11.52%,0.70%
2020-01-01 00:04:00,7,1,363,3,360,0.55%,0.00%
2020-01-01 00:04:00,7,2,88,0,88,0.13%,0.00%
2020-01-01 00:04:00,7,3,1527,18,1509,2.33%,0.03%
2020-01-01 00:04:00,7,4,1995,44,1951,3.04%,0.07%
2020-01-01 00:04:00,7,5,7723,426,7297,11.78%,0.65%
2020-01-01 00:04:00,7,6,13972,1387,12585,21.32%,2.12%
2020-01-01 00:04:00,7,7,4207,133,4074,6.42%,0.20%
2020-01-01 00:04:00,7,8,1287,14,1273,1.96%,0.02%
2020-01-01 00:04:00,7,9,6062,268,5794,9.25%,0.41%
2020-01-01 00:04:00,7,10,1378,16,1362,2.10%,0.02%
2020-01-01 00:04:00,7,11,174,0,174,0.27%,0.00%
2020-01-01 00:04:00,7,12,4722,163,4559,7.21%,0.25%
2020-01-01 00:04:00,8,1,469,1,468,0.72%,0.00%
2020-01-01 00:04:00,8,2,59,0,59,0.09%,0.00%
2020-01-01 00:04:00,8,3,1247,5,1242,1.90%,0.01%
2020-01-01 00:04:00,8,4,2610,55,2555,3.98%,0.08%
2020-01-01 00:04:00,8,5,8046,497,7549,12.28%,0.76%
2020-01-01 00:04:00,8,6,15912,1767,14145,24.28%,2.70%
2020-01-01 00:04:00,8,7,5188,218,4970,7.92%,0.33%
2020-01-01 00:04:00,8,8,1965,39,1926,3.00%,0.06%
2020-01-01 00:04:00,8,9,6486,335,6151,9.90%,0.51%
2020-01-01 00:04:00,8,10,2007,24,1983,3.06%,0.04%
2020-01-01 00:04:00,8,11,215,0,215,0.33%,0.00%
2020-01-01 00:04:00,8,12,4419,179,4240,6.74%,0.27%
2020-01-01 00:04:00,9,1,231,0,231,0.35%,0.00%
2020-01-01 00:04:00,9,2,1853,20,1833,2.83%,0.03%
2020-01-01 00:04:00,9,3,1117,7,1110,1.70%,0.01%
2020-01-01 00:04:00,9,4,10874,826,10048,16.59%,1.26%
2020-01-01 00:04:00,9,5,258,0,258,0.39%,0.00%
2020-01-01 00:04:00,9,6,11705,979,10726,17.86%,1.49%
2020-01-01 00:04:00,9,7,30151,5872,24279,46.01%,8.96%
2020-01-01 00:04:00,9,8,11785,943,10842,17.98%,1.44%
2020-01-01 00:04:00,9,9,237,0,237,0.36%,0.00%
2020-01-01 00:04:00,9,10,5460,198,5262,8.33%,0.30%
2020-01-01 00:04:00,9,11,10312,750,9562,15.73%,1.14%
2020-01-01 00:04:00,9,12,4480,147,4333,6.84%,0.22%
2020-01-01 00:04:00,10,1,1373,400,973,2.10%,0.61%
2020-01-01 00:04:00,10,2,3362,445,2917,5.13%,0.68%
2020-01-01 00:04:00,10,3,1825,21,1804,2.78%,0.03%
2020-01-01 00:04:00,10,4,4491,1179,3312,6.85%,1.80%
2020-01-01 00:04:00,10,5,800,7,793,1.22%,0.01%
2020-01-01 00:04:00,10,6,6794,1353,5441,10.37%,2.06%
2020-01-01 00:04:00,10,7,11629,2162,9467,17.74%,3.30%
2020-01-01 00:04:00,10,8,26719,6288,20431,40.77%,9.59%
2020-01-01 00:04:00,10,9,679,6,673,1.04%,0.01%
2020-01-01 00:04:00,10,10,3232,81,3151,4.93%,0.12%
2020-01-01 00:04:00,10,11,12454,1388,11066,19.00%,2.12%
2020-01-01 00:04:00,10,12,8410,817,7593,12.83%,1.25%
2020-01-01 00:04:00,11,1,2183,43,2140,3.33%,0.07%
2020-01-01 00:04:00,11,2,3489,100,3389,5.32%,0.15%
2020-01-01 00:04:00,11,3,1100,6,1094,1.68%,0.01%
2020-01-01 00:04:00,11,4,8315,545,7770,12.69%,0.83%
2020-01-01 00:04:00,11,5,208,3,205,0.32%,0.00%
2020-01-01 00:04:00,11,6,9129,640,8489,13.93%,0.98%
2020-01-01 00:04:00,11,7,14424,1521,12903,22.01%,2.32%
2020-01-01 00:04:00,11,8,28571,5410,23161,43.60%,8.26%
2020-01-01 00:04:00,11,9,287,1,286,0.44%,0.00%
2020-01-01 00:04:00,11,10,4017,120,3897,6.13%,0.18%
2020-01-01 00:04:00,11,11,10406,769,9637,15.88%,1.17%
2020-01-01 00:04:00,11,12,6152,277,5875,9.39%,0.42%
2020-01-01 00:04:00,12,1,42,0,42,0.06%,0.00%
2020-01-01 00:04:00,12,2,698,278,420,1.07%,0.42%
2020-01-01 00:04:00,12,3,4156,365,3791,6.34%,0.56%
2020-01-01 00:04:00,12,4,3432,77,3355,5.24%,0.12%
2020-01-01 00:04:00,12,5,11031,1037,9994,16.83%,1.58%
2020-01-01 00:04:00,12,6,5971,232,5739,9.11%,0.35%
2020-01-01 00:04:00,12,7,2412,32,2380,3.68%,0.05%
2020-01-01 00:04:00,12,8,1445,305,1140,2.20%,0.47%
2020-01-01 00:04:00,12,9,24485,5136,19349,37.36%,7.84%
2020-01-01 00:04:00,12,10,4358,402,3956,6.65%,0.61%
2020-01-01 00:04:00,12,11,1658,310,1348,2.53%,0.47%
2020-01-01 00:04:00,12,12,8017,1283,6734,12.23%,1.96%
2020-01-01 00:04:00,13,1,2302,34,2268,3.51%,0.05%
2020-01-01 00:04:00,13,2,2550,37,2513,3.89%,0.06%
2020-01-01 00:04:00,13,3,934,0,934,1.43%,0.00%
2020-01-01 00:04:00,13,4,4160,454,3706,6.35%,0.69%
2020-01-01 00:04:00,13,5,6968,817,6151,10.63%,1.25%
2020-01-01 00:04:00,13,6,5043,507,4536,7.70%,0.77%
2020-01-01 00:04:00,13,7,4710,136,4574,7.19%,0.21%
2020-01-01 00:04:00,13,8,6611,303,6308,10.09%,0.46%
2020-01-01 00:04:00,13,9,7166,839,6327,10.93%,1.28%
2020-01-01 00:04:00,13,10,26264,5171,21093,40.08%,7.89%
2020-01-01 00:04:00,13,11,15423,2013,13410,23.53%,3.07%
2020-01-01 00:04:00,13,12,8365,928,7437,12.76%,1.42%
2020-01-01 00:04:00,14,1,283,1,282,0.43%,0.00%
2020-01-01 00:04:00,14,2,2530,64,2466,3.86%,0.10%
2020-01-01 00:04:00,14,3,1928,36,1892,2.94%,0.05%
2020-01-01 00:04:00,14,4,4240,132,4108,6.47%,0.20%
2020-01-01 00:04:00,14,5,1524,15,1509,2.33%,0.02%
2020-01-01 00:04:00,14,6,4557,150,4407,6.95%,0.23%
2020-01-01 00:04:00,14,7,11800,973,10827,18.01%,1.48%
2020-01-01 00:04:00,14,8,13536,1286,12250,20.65%,1.96%
2020-01-01 00:04:00,14,9,1703,17,1686,2.60%,0.03%
2020-01-01 00:04:00,14,10,4374,112,4262,6.67%,0.17%
2020-01-01 00:04:00,14,11,25791,4438,21353,39.35%,6.77%
2020-01-01 00:04:00,14,12,7653,434,7219,11.68%,0.66%
2020-01-01 00:04:00,15,1,474,1,473,0.72%,0.00%
2020-01-01 00:04:00,15,2,132,1,131,0.20%,0.00%
2020-01-01 00:04:00,15,3,3624,103,3521,5.53%,0.16%
2020-01-01 00:04:00,15,4,7249,386,6863,11.06%,0.59%
2020-01-01 00:04:00,15,5,11497,932,10565,17.54%,1.42%
2020-01-01 00:04:00,15,6,7484,413,7071,11.42%,0.63%
2020-01-01 00:04:00,15,7,3429,114,3315,5.23%,0.17%
2020-01-01 00:04:00,15,8,5254,246,5008,8.02%,0.38%
2020-01-01 00:04:00,15,9,11678,970,10708,17.82%,1.48%
2020-01-01 00:04:00,15,10,3782,102,3680,5.77%,0.16%
2020-01-01 00:04:00,15,11,9167,651,8516,13.99%,0.99%
2020-01-01 00:04:00,15,12,25744,4713,21031,39.28%,7.19%
2020-01-01 00:04:00,16,1,423,1,422,0.65%,0.00%
2020-01-01 00:04:00,16,2,452,2,450,0.69%,0.00%
2020-01-01 00:04:00,16,3,1651,29,1622,2.52%,0.04%
2020-01-01 00:04:00,16,4,3748,99,3649,5.72%,0.15%
2020-01-01 00:04:00,16,5,7569,513,7056,11.55%,0.78%
2020-01-01 00:04:00,16,6,4558,144,4414,6.95%,0.22%
2020-01-01 00:04:00,16,7,3000,73,2927,4.58%,0.11%
2020-01-01 00:04:00,16,8,6239,331,5908,9.52%,0.51%
2020-01-01 00:04:00,16,9,8088,570,7518,12.34%,0.87%
2020-01-01 00:04:00,16,10,1526,22,1504,2.33%,0.03%
2020-01-01 00:04:00,16,11,7961,546,7415,12.15%,0.83%
2020-01-01 00:04:00,16,12,25567,4520,21047,39.01%,6.90%
2020-01-01 00:04:10,1,1,20517,2895,17622,31.31%,4.42%
2020-01-01 00:04:10,1,2,7003,332,6671,10.69%,0.51%
2020-01-01 00:04:10,1,3,500,1,499,0.76%,0.00%
2020-01-01 00:04:10,1,4,13191,1258,11933,20.13%,1.92%
2020-01-01 00:04:10,1,5,10534,887,9647,16.07%,1.35%
2020-01-01 00:04:10,1,6,10519,888,9631,16.05%,1.35%
2020-01-01 00:04:10,1,7,6481,297,6184,9.89%,0.45%
2020-01-01 00:04:10,1,8,3397,84,3313,5.18%,0.13%
2020-01-01 00:04:10,1,9,10471,880,9591,15.98%,1.34%
2020-01-01 00:04:10,1,10,2798,57,2741,4.27%,0.09%
2020-01-01 00:04:10,1,11,2851,61,2790,4.35%,0.09%
2020-01-01 00:04:10,1,12,10449,872,9577,15.94%,1.33%
2020-01-01 00:04:10,2,1,368,1,367,0.56%,0.00%
2020-01-01 00:04:10,2,2,31173,6214,24959,47.57%,9.48%
2020-01-01 00:04:10,2,3,27294,4882,22412,41.65%,7.45%
2020-01-01 00:04:10,2,4,309,1,308,0.47%,0.00%
2020-01-01 00:04:10,2,5,17863,2163,15700,27.26%,3.30%
2020-01-01 00:04:10,2,6,76,0,76,0.12%,0.00%
2020-01-01 00:04:10,2,7,3496,70,3426,5.33%,0.11%
2020-01-01 00:04:10,2,8,2487,45,2442,3.79%,0.07%
2020-01-01 00:04:10,2,9,17672,2119,15553,26.97%,3.23%
2020-01-01 00:04:10,2,10,1498,18,1480,2.29%,0.03%
2020-01-01 00:04:10,2,11,1508,19,1489,2.30%,0.03%
2020-01-01 00:04:10,2,12,17486,2065,15421,26.68%,3.15%
2020-01-01 00:04:10,3,1,1177,9,1168,1.80%,0.01%
2020-01-01 00:04:10,3,2,20767,2903,17864,31.69%,4.43%
2020-01-01 00:04:10,3,3,67026,25181,41845,102.27%,38.42%
2020-01-01 00:04:10,3,4,11923,1045,10878,18.19%,1.59%
2020-01-01 00:04:10,3,5,45395,12737,32658,69.27%,19.44%
2020-01-01 00:04:10,3,6,13298,1298,12000,20.29%,1.98%
2020-01-01 00:04:10,3,7,17650,2133,15517,26.93%,3.25%
2020-01-01 00:04:10,3,8,15180,1641,13539,23.16%,2.50%
2020-01-01 00:04:10,3,9,31587,6520,25067,48.20%,9.95%
2020-01-01 00:04:10,3,10,3914,104,3810,5.97%,0.16%
2020-01-01 00:04:10,3,11,1999,24,1975,3.05%,0.04%
2020-01-01 00:04:10,3,12,26179,4613,21566,39.95%,7.04%
2020-01-01 00:04:10,4,1,479,1,478,0.73%,0.00%
2020-01-01 00:04:10,4,2,285,1,284,0.43%,0.00%
2020-01-01 00:04:10,4,3,1090,4,1086,1.66%,0.01%
2020-01-01 00:04:10,4,4,28664,5362,23302,43.74%,8.18%
2020-01-01 00:04:10,4,5,19126,2476,16650,29.18%,3.78%
2020-01-01 00:04:10,4,6,25015,4197,20818,38.17%,6.40%
2020-01-01 00:04:10,4,7,4769,176,4593,7.28%,0.27%
2020-01-01 00:04:10,4,8,3129,83,3046,4.77%,0.13%
2020-01-01 00:04:10,4,9,16783,1933,14850,25.61%,2.95%
2020-01-01 00:04:10,4,10,2033,36,1997,3.10%,0.05%
2020-01-01 00:04:10,4,11,146,0,146,0.22%,0.00%
2020-01-01 00:04:10,4,12,13415,1232,12183,20.47%,1.88%
2020-01-01 00:04:10,5,1,2549,44,2505,3.89%,0.07%
2020-01-01 00:04:10,5,2,617,2,615,0.94%,0.00%
2020-01-01 00:04:10,5,3,967,3,964,1.48%,0.00%
2020-01-01 00:04:10,5,4,26790,4888,21902,40.88%,7.46%
2020-01-01 00:04:10,5,5,10067,741,9326,15.36%,1.13%
2020-01-01 00:04:10,5,6,16628,1979,14649,25.37%,3.02%
2020-01-01 00:04:10,5,7,5916,300,5616,9.03%,0.46%
2020-01-01 00:04:10,5,8,4670,156,4514,7.13%,0.24%
2020-01-01 00:04:10,5,9,8659,565,8094,13.21%,0.86%
2020-01-01 00:04:10,5,10,1417,19,1398,2.16%,0.03%
2020-01-01 00:04:10,5,11,1146,11,1135,1.75%,0.02%
2020-01-01 00:04:10,5,12,6570,334,6236,10.03%,0.51%
2020-01-01 00:04:10,6,1,1228,9,1219,1.87%,0.01%
2020-01-01 00:04:10,6,2,1356,12,1344,2.07%,0.02%
2020-01-01 00:04:10,6,3,1927,22,1905,2.94%,0.03%
2020-01-01 00:04:10,6,4,1086,7,1079,1.66%,0.01%
2020-01-01 00:04:10,6,5,13349,1223,12126,20.37%,1.87%
2020-01-01 00:04:10,6,6,3830,112,3718,5.84%,0.17%
2020-01-01 00:04:10,6,7,2330,52,2278,3.56%,0.08%
2020-01-01 00:04:10,6,8,1845,36,1809,2.82%,0.05%
2020-01-01 00:04:10,6,9,7352,404,6948,11.22%,0.62%
2020-01-01 00:04:10,6,10,2069,44,2025,3.16%,0.07%
2020-01-01 00:04:10,6,11,361,0,361,0.55%,0.00%
2020-01-01 00:04:10,6,12,5231,207,5024,7.98%,0.32%
2020-01-01 00:04:10,7,1,423,2,421,0.65%,0.00%
2020-01-01 00:04:10,7,2,131,0,131,0.20%,0.00%
2020-01-01 00:04:10,7,3,2041,44,1997,3.11%,0.07%
2020-01-01 00:04:10,7,4,1454,18,1436,2.22%,0.03%
2020-01-01 00:04:10,7,5,8119,554,7565,12.39%,0.85%
2020-01-01 00:04:10,7,6,13699,1438,12261,20.90%,2.19%
2020-01-01 00:04:10,7,7,4105,186,3919,6.26%,0.28%
2020-01-01 00:04:10,7,8,1725,21,1704,2.63%,0.03%
2020-01-01 00:04:10,7,9,5951,281,5670,9.08%,0.43%
2020-01-01 00:04:10,7,10,1610,13,1597,2.46%,0.02%
2020-01-01 00:04:10,7,11,174,0,174,0.27%,0.00%
2020-01-01 00:04:10,7,12,4363,164,4199,6.66%,0.25%
2020-01-01 00:04:10,8,1,446,0,446,0.68%,0.00%
2020-01-01 00:04:10,8,2,81,0,81,0.12%,0.00%
2020-01-01 00:04:10,8,3,1261,10,1251,1.92%,0.02%
2020-01-01 00:04:10,8,4,2821,59,2762,4.30%,0.09%
2020-01-01 00:04:10,8,5,7956,492,7464,12.14%,0.75%
2020-01-01 00:04:10,8,6,15741,1781,13960,24.02%,2.72%
2020-01-01 00:04:10,8,7,4877,184,4693,7.44%,0.28%
2020-01-01 00:04:10,8,8,1772,29,1743,2.70%,0.04%
2020-01-01 00:04:10,8,9,6476,337,6139,9.88%,0.51%
2020-01-01 00:04:10,8,10,1929,40,1889,2.94%,0.06%
2020-01-01 00:04:10,8,11,272,0,272,0.42%,0.00%
2020-01-01 00:04:10,8,12,4423,149,4274,6.75%,0.23%
2020-01-01 00:04:10,9,1,418,2,416,0.64%,0.00%
2020-01-01 00:04:10,9,2,7882,434,7448,12.03%,0.66%
2020-01-01 00:04:10,9,3,6969,338,6631,10.63%,0.52%
2020-01-01 00:04:10,9,4,6551,342,6209,10.00%,0.52%
2020-01-01 00:04:10,9,5,232,0,232,0.35%,0.00%
2020-01-01 00:04:10,9,6,7086,394,6692,10.81%,0.60%
2020-01-01 00:04:10,9,7,30556,6080,24476,46.62%,9.28%
2020-01-01 00:04:10,9,8,10619,787,9832,16.20%,1.20%
2020-01-01 00:04:10,9,9,223,0,223,0.34%,0.00%
2020-01-01 00:04:10,9,10,4307,126,4181,6.57%,0.19%
2020-01-01 00:04:10,9,11,9676,659,9017,14.76%,1.01%
2020-01-01 00:04:10,9,12,5041,173,4868,7.69%,0.26%
2020-01-01 00:04:10,10,1,1369,392,977,2.09%,0.60%
2020-01-01 00:04:10,10,2,3126,435,2691,4.77%,0.66%
2020-01-01 00:04:10,10,3,1641,17,1624,2.50%,0.03%
2020-01-01 00:04:10,10,4,3809,1026,2783,5.81%,1.57%
2020-01-01 00:04:10,10,5,787,5,782,1.20%,0.01%
2020-01-01 00:04:10,10,6,5582,1114,4468,8.52%,1.70%
2020-01-01 00:04:10,10,7,10227,1920,8307,15.61%,2.93%
2020-01-01 00:04:10,10,8,26839,6206,20633,40.95%,9.47%
2020-01-01 00:04:10,10,9,675,2,673,1.03%,0.00%
2020-01-01 00:04:10,10,10,3468,98,3370,5.29%,0.15%
2020-01-01 00:04:10,10,11,13483,1544,11939,20.57%,2.36%
2020-01-01 00:04:10,10,12,9403,922,8481,14.35%,1.41%
2020-01-01 00:04:10,11,1,2355,61,2294,3.59%,0.09%
2020-01-01 00:04:10,11,2,3633,120,3513,5.54%,0.18%
2020-01-01 00:04:10,11,3,1048,8,1040,1.60%,0.01%
2020-01-01 00:04:10,11,4,5252,197,5055,8.01%,0.30%
2020-01-01 00:04:10,11,5,673,2,671,1.03%,0.00%
2020-01-01 00:04:10,11,6,6491,293,6198,9.90%,0.45%
2020-01-01 00:04:10,11,7,11942,1003,10939,18.22%,1.53%
2020-01-01 00:04:10,11,8,25352,4283,21069,38.68%,6.54%
2020-01-01 00:04:10,11,9,250,0,250,0.38%,0.00%
2020-01-01 00:04:10,11,10,3437,117,3320,5.24%,0.18%
2020-01-01 00:04:10,11,11,9479,634,8845,14.46%,0.97%
2020-01-01 00:04:10,11,12,5849,243,5606,8.92%,0.37%
2020-01-01 00:04:10,12,1,63,0,63,0.10%,0.00%
2020-01-01 00:04:10,12,2,680,276,404,1.04%,0.42%
2020-01-01 00:04:10,12,3,3954,388,3566,6.03%,0.59%
2020-01-01 00:04:10,12,4,3823,93,3730,5.83%,0.14%
2020-01-01 00:04:10,12,5,11248,1131,10117,17.16%,1.73%
2020-01-01 00:04:10,12,6,6389,267,6122,9.75%,0.41%
2020-01-01 00:04:10,12,7,2319,42,2277,3.54%,0.06%
2020-01-01 00:04:10,12,8,1192,266,926,1.82%,0.41%
2020-01-01 00:04:10,12,9,23860,4974,18886,36.41%,7.59%
2020-01-01 00:04:10,12,10,4023,363,3660,6.14%,0.55%
2020-01-01 00:04:10,12,11,1374,267,1107,2.10%,0.41%
2020-01-01 00:04:10,12,12,7669,1273,6396,11.70%,1.94%
2020-01-01 00:04:10,13,1,1930,26,1904,2.94%,0.04%
2020-01-01 00:04:10,13,2,2148,33,2115,3.28%,0.05%
2020-01-01 00:04:10,13,3,1026,2,1024,1.57%,0.00%
2020-01-01 00:04:10,13,4,4184,384,3800,6.38%,0.59%
2020-01-01 00:04:10,13,5,6831,751,6080,10.42%,1.15%
2020-01-01 00:04:10,13,6,4926,420,4506,7.52%,0.64%
2020-01-01 00:04:10,13,7,4155,142,4013,6.34%,0.22%
2020-01-01 00:04:10,13,8,6204,281,5923,9.47%,0.43%
2020-01-01 00:04:10,13,9,7024,767,6257,10.72%,1.17%
2020-01-01 00:04:10,13,10,25747,5134,20613,39.29%,7.83%
2020-01-01 00:04:10,13,11,15762,2121,13641,24.05%,3.24%
2020-01-01 00:04:10,13,12,8964,974,7990,13.68%,1.49%
2020-01-01 00:04:10,14,1,329,3,326,0.50%,0.00%
2020-01-01 00:04:10,14,2,2081,31,2050,3.18%,0.05%
2020-01-01 00:04:10,14,3,1567,16,1551,2.39%,0.02%
2020-01-01 00:04:10,14,4,3894,110,3784,5.94%,0.17%
2020-01-01 00:04:10,14,5,1316,15,1301,2.01%,0.02%
2020-01-01 00:04:10,14,6,4301,136,4165,6.56%,0.21%
2020-01-01 00:04:10,14,7,11312,901,10411,17.26%,1.37%
2020-01-01 00:04:10,14,8,12719,1138,11581,19.41%,1.74%
2020-01-01 00:04:10,14,9,1491,21,1470,2.28%,0.03%
2020-01-01 00:04:10,14,10,4062,132,3930,6.20%,0.20%
2020-01-01 00:04:10,14,11,23743,3774,19969,36.23%,5.76%
2020-01-01 00:04:10,14,12,6762,345,6417,10.32%,0.53%
2020-01-01 00:04:10,15,1,471,2,469,0.72%,0.00%
2020-01-01 00:04:10,15,2,111,0,111,0.17%,0.00%
2020-01-01 00:04:10,15,3,3855,99,3756,5.88%,0.15%
2020-01-01 00:04:10,15,4,7407,466,6941,11.30%,0.71%
2020-01-01 00:04:10,15,5,12125,1079,11046,18.50%,1.65%
2020-01-01 00:04:10,15,6,7688,495,7193,11.73%,0.76%
2020-01-01 00:04:10,15,7,3502,103,3399,5.34%,0.16%
2020-01-01 00:04:10,15,8,5595,244,5351,8.54%,0.37%
2020-01-01 00:04:10,15,9,12320,1118,11202,18.80%,1.71%
2020-01-01 00:04:10,15,10,3902,116,3786,5.95%,0.18%
2020-01-01 00:04:10,15,11,9646,667,8979,14.72%,1.02%
2020-01-01 00:04:10,15,12,27445,5250,22195,41.88%,8.01%
2020-01-01 00:04:10,16,1,530,3,527,0.81%,0.00%
2020-01-01 00:04:10,16,2,358,0,358,0.55%,0.00%
2020-01-01 00:04:10,16,3,1730,29,1701,2.64%,0.04%
2020-01-01 00:04:10,16,4,4744,174,4570,7.24%,0.27%
2020-01-01 00:04:10,16,5,8672,642,8030,13.23%,0.98%
2020-01-01 00:04:10,16,6,5659,239,5420,8.63%,0.36%
2020-01-01 00:04:10,16,7,3376,102,3274,5.15%,0.16%
2020-01-01 00:04:10,16,8,7937,582,7355,12.11%,0.89%
2020-01-01 00:04:10,16,9,9053,684,8369,13.81%,1.04%
2020-01-01 00:04:10,16,10,2566,50,2516,3.92%,0.08%
2020-01-01 00:04:10,16,11,10949,955,9994,16.71%,1.46%
2020-01-01 00:04:10,16,12,29428,5914,23514,44.90%,9.02%
2020-01-01 00:04:20,1,1,19077,2419,16658,29.11%,3.69%
2020-01-01 00:04:20,1,2,7318,392,6926,11.17%,0.60%
2020-01-01 00:04:20,1,3,622,1,621,0.95%,0.00%
2020-01-01 00:04:20,1,4,11403,821,10582,17.40%,1.25%
2020-01-01 00:04:20,1,5,7943,472,7471,12.12%,0.72%
2020-01-01 00:04:20,1,6,7932,470,7462,12.10%,0.72%
2020-01-01 00:04:20,1,7,6690,333,6357,10.21%,0.51%
2020-01-01 00:04:20,1,8,4954,174,4780,7.56%,0.27%
2020-01-01 00:04:20,1,9,7880,468,7412,12.02%,0.71%
2020-01-01 00:04:20,1,10,4024,110,3914,6.14%,0.17%
2020-01-01 00:04:20,1,11,4078,113,3965,6.22%,0.17%
2020-01-01 00:04:20,1,12,7856,465,7391,11.99%,0.71%
2020-01-01 00:04:20,2,1,812,3,809,1.24%,0.00%
2020-01-01 00:04:20,2,2,23497,3745,19752,35.85%,5.71%
2020-01-01 00:04:20,2,3,19262,2616,16646,29.39%,3.99%
2020-01-01 00:04:20,2,4,764,1,763,1.17%,0.00%
2020-01-01 00:04:20,2,5,11413,937,10476,17.41%,1.43%
2020-01-01 00:04:20,2,6,87,0,87,0.13%,0.00%
2020-01-01 00:04:20,2,7,3409,82,3327,5.20%,0.13%
2020-01-01 00:04:20,2,8,2266,41,2225,3.46%,0.06%
2020-01-01 00:04:20,2,9,11212,912,10300,17.11%,1.39%
2020-01-01 00:04:20,2,10,1358,15,1343,2.07%,0.02%
2020-01-01 00:04:20,2,11,1362,15,1347,2.08%,0.02%
2020-01-01 00:04:20,2,12,11053,889,10164,16.87%,1.36%
2020-01-01 00:04:20,3,1,1600,21,1579,2.44%,0.03%
2020-01-01 00:04:20,3,2,24508,4134,20374,37.40%,6.31%
2020-01-01 00:04:20,3,3,73604,29387,44217,112.31%,44.84%
2020-01-01 00:04:20,3,4,11063,891,10172,16.88%,1.36%
2020-01-01 00:04:20,3,5,46796,13394,33402,71.41%,20.44%
2020-01-01 00:04:20,3,6,12231,1094,11137,18.66%,1.67%
2020-01-01 00:04:20,3,7,20811,3012,17799,31.76%,4.60%
2020-01-01 00:04:20,3,8,18329,2356,15973,27.97%,3.59%
2020-01-01 00:04:20,3,9,34108,7538,26570,52.04%,11.50%
2020-01-01 00:04:20,3,10,4440,128,4312,6.77%,0.20%
2020-01-01 00:04:20,3,11,2565,58,2507,3.91%,0.09%
2020-01-01 00:04:20,3,12,27793,5196,22597,42.41%,7.93%
2020-01-01 00:04:20,4,1,455,1,454,0.69%,0.00%
2020-01-01 00:04:20,4,2,273,0,273,0.42%,0.00%
2020-01-01 00:04:20,4,3,1444,17,1427,2.20%,0.03%
2020-01-01 00:04:20,4,4,29970,5940,24030,45.73%,9.06%
2020-01-01 00:04:20,4,5,19864,2696,17168,30.31%,4.11%
2020-01-01 00:04:20,4,6,26068,4550,21518,39.78%,6.94%
2020-01-01 00:04:20,4,7,4887,212,4675,7.46%,0.32%
2020-01-01 00:04:20,4,8,3398,106,3292,5.18%,0.16%
2020-01-01 00:04:20,4,9,17078,2002,15076,26.06%,3.05%
2020-01-01 00:04:20,4,10,2059,30,2029,3.14%,0.05%
2020-01-01 00:04:20,4,11,81,0,81,0.12%,0.00%
2020-01-01 00:04:20,4,12,13607,1318,12289,20.76%,2.01%
2020-01-01 00:04:20,5,1,2814,59,2755,4.29%,0.09%
2020-01-01 00:04:20,5,2,845,3,842,1.29%,0.00%
2020-01-01 00:04:20,5,3,1943,20,1923,2.96%,0.03%
2020-01-01 00:04:20,5,4,27607,5145,22462,42.12%,7.85%
2020-01-01 00:04:20,5,5,11078,947,10131,16.90%,1.45%
2020-01-01 00:04:20,5,6,18767,2574,16193,28.64%,3.93%
2020-01-01 00:04:20,5,7,7113,377,6736,10.85%,0.58%
2020-01-01 00:04:20,5,8,5787,255,5532,8.83%,0.39%
2020-01-01 00:04:20,5,9,8600,576,8024,13.12%,0.88%
2020-01-01 00:04:20,5,10,1367,13,1354,2.09%,0.02%
2020-01-01 00:04:20,5,11,1144,12,1132,1.75%,0.02%
2020-01-01 00:04:20,5,12,6743,352,6391,10.29%,0.54%
2020-01-01 00:04:20,6,1,1273,12,1261,1.94%,0.02%
2020-01-01 00:04:20,6,2,1394,13,1381,2.13%,0.02%
2020-01-01 00:04:20,6,3,1923,24,1899,2.93%,0.04%
2020-01-01 00:04:20,6,4,1364,10,1354,2.08%,0.02%
2020-01-01 00:04:20,6,5,13239,1218,12021,20.20%,1.86%
2020-01-01 00:04:20,6,6,4765,169,4596,7.27%,0.26%
2020-01-01 00:04:20,6,7,2937,77,2860,4.48%,0.12%
2020-01-01 00:04:20,6,8,2370,58,2312,3.62%,0.09%
2020-01-01 00:04:20,6,9,6306,294,6012,9.62%,0.45%
2020-01-01 00:04:20,6,10,1997,17,1980,3.05%,0.03%
2020-01-01 00:04:20,6,11,392,1,391,0.60%,0.00%
2020-01-01 00:04:20,6,12,4260,135,4125,6.50%,0.21%
2020-01-01 00:04:20,7,1,433,0,433,0.66%,0.00%
2020-01-01 00:04:20,7,2,100,0,100,0.15%,0.00%
2020-01-01 00:04:20,7,3,640,2,638,0.98%,0.00%
2020-01-01 00:04:20,7,4,2142,47,2095,3.27%,0.07%
2020-01-01 00:04:20,7,5,6765,359,6406,10.32%,0.55%
2020-01-01 00:04:20,7,6,12886,1128,11758,19.66%,1.72%
2020-01-01 00:04:20,7,7,3958,113,3845,6.04%,0.17%
2020-01-01 00:04:20,7,8,1608,35,1573,2.45%,0.05%
2020-01-01 00:04:20,7,9,5979,272,5707,9.12%,0.42%
2020-01-01 00:04:20,7,10,1533,16,1517,2.34%,0.02%
2020-01-01 00:04:20,7,11,246,0,246,0.38%,0.00%
2020-01-01 00:04:20,7,12,4435,154,4281,6.77%,0.23%
2020-01-01 00:04:20,8,1,378,1,377,0.58%,0.00%
2020-01-01 00:04:20,8,2,75,1,74,0.11%,0.00%
2020-01-01 00:04:20,8,3,1449,20,1429,2.21%,0.03%
2020-01-01 00:04:20,8,4,2419,36,2383,3.69%,0.05%
2020-01-01 00:04:20,8,5,8537,530,8007,13.03%,0.81%
2020-01-01 00:04:20,8,6,16248,1779,14469,24.79%,2.71%
2020-01-01 00:04:20,8,7,5199,202,4997,7.93%,0.31%
2020-01-01 00:04:20,8,8,2184,31,2153,3.33%,0.05%
2020-01-01 00:04:20,8,9,6955,345,6610,10.61%,0.53%
2020-01-01 00:04:20,8,10,2071,32,2039,3.16%,0.05%
2020-01-01 00:04:20,8,11,284,0,284,0.43%,0.00%
2020-01-01 00:04:20,8,12,4729,171,4558,7.22%,0.26%
2020-01-01 00:04:20,9,1,348,0,348,0.53%,0.00%
2020-01-01 00:04:20,9,2,2855,72,2783,4.36%,0.11%
2020-01-01 00:04:20,9,3,2000,36,1964,3.05%,0.05%
2020-01-01 00:04:20,9,4,8616,508,8108,13.15%,0.78%
2020-01-01 00:04:20,9,5,229,0,229,0.35%,0.00%
2020-01-01 00:04:20,9,6,9171,587,8584,13.99%,0.90%
2020-01-01 00:04:20,9,7,27143,5002,22141,41.42%,7.63%
2020-01-01 00:04:20,9,8,10028,730,9298,15.30%,1.11%
2020-01-01 00:04:20,9,9,203,0,203,0.31%,0.00%
2020-01-01 00:04:20,9,10,3410,83,3327,5.20%,0.13%
2020-01-01 00:04:20,9,11,8914,576,8338,13.60%,0.88%
2020-01-01 00:04:20,9,12,5151,204,4947,7.86%,0.31%
2020-01-01 00:04:20,10,1,1412,411,1001,2.15%,0.63%
2020-01-01 00:04:20,10,2,3324,466,2858,5.07%,0.71%
2020-01-01 00:04:20,10,3,1725,24,1701,2.63%,0.04%
2020-01-01 00:04:20,10,4,3798,1061,2737,5.80%,1.62%
2020-01-01 00:04:20,10,5,839,7,832,1.28%,0.01%
2020-01-01 00:04:20,10,6,5795,1165,4630,8.84%,1.78%
2020-01-01 00:04:20,10,7,10686,2073,8613,16.31%,3.16%
2020-01-01 00:04:20,10,8,28525,6781,21744,43.53%,10.35%
2020-01-01 00:04:20,10,9,854,3,851,1.30%,0.00%
2020-01-01 00:04:20,10,10,4452,134,4318,6.79%,0.20%
2020-01-01 00:04:20,10,11,14497,1716,12781,22.12%,2.62%
2020-01-01 00:04:20,10,12,9364,920,8444,14.29%,1.40%
2020-01-01 00:04:20,11,1,2377,53,2324,3.63%,0.08%
2020-01-01 00:04:20,11,2,3712,125,3587,5.66%,0.19%
2020-01-01 00:04:20,11,3,1107,12,1095,1.69%,0.02%
2020-01-01 00:04:20,11,4,3970,146,3824,6.06%,0.22%
2020-01-01 00:04:20,11,5,496,1,495,0.76%,0.00%
2020-01-01 00:04:20,11,6,5055,230,4825,7.71%,0.35%
2020-01-01 00:04:20,11,7,10739,889,9850,16.39%,1.36%
2020-01-01 00:04:20,11,8,24752,4257,20495,37.77%,6.50%
2020-01-01 00:04:20,11,9,349,0,349,0.53%,0.00%
2020-01-01 00:04:20,11,10,3541,84,3457,5.40%,0.13%
2020-01-01 00:04:20,11,11,10112,754,9358,15.43%,1.15%
2020-01-01 00:04:20,11,12,6257,296,5961,9.55%,0.45%
2020-01-01 00:04:20,12,1,50,0,50,0.08%,0.00%
2020-01-01 00:04:20,12,2,716,286,430,1.09%,0.44%
2020-01-01 00:04:20,12,3,3302,366,2936,5.04%,0.56%
2020-01-01 00:04:20,12,4,4352,127,4225,6.64%,0.19%
2020-01-01 00:04:20,12,5,11680,1190,10490,17.82%,1.82%
2020-01-01 00:04:20,12,6,7414,374,7040,11.31%,0.57%
2020-01-01 00:04:20,12,7,2879,68,2811,4.39%,0.10%
2020-01-01 00:04:20,12,8,1567,251,1316,2.39%,0.38%
2020-01-01 00:04:20,12,9,25132,5438,19694,38.35%,8.30%
2020-01-01 00:04:20,12,10,4800,417,4383,7.32%,0.64%
2020-01-01 00:04:20,12,11,1766,254,1512,2.69%,0.39%
2020-01-01 00:04:20,12,12,7615,1345,6270,11.62%,2.05%
2020-01-01 00:04:20,13,1,2165,38,2127,3.30%,0.06%
2020-01-01 00:04:20,13,2,2529,50,2479,3.86%,0.08%
2020-01-01 00:04:20,13,3,1236,8,1228,1.89%,0.01%
2020-01-01 00:04:20,13,4,4433,447,3986,6.76%,0.68%
2020-01-01 00:04:20,13,5,7489,915,6574,11.43%,1.40%
2020-01-01 00:04:20,13,6,5397,514,4883,8.24%,0.78%
2020-01-01 00:04:20,13,7,4640,169,4471,7.08%,0.26%
2020-01-01 00:04:20,13,8,6495,322,6173,9.91%,0.49%
2020-01-01 00:04:20,13,9,7722,942,6780,11.78%,1.44%
2020-01-01 00:04:20,13,10,28392,5913,22479,43.32%,9.02%
2020-01-01 00:04:20,13,11,17475,2401,15074,26.66%,3.66%
2020-01-01 00:04:20,13,12,10299,1059,9240,15.72%,1.62%
2020-01-01 00:04:20,14,1,357,0,357,0.54%,0.00%
2020-01-01 00:04:20,14,2,2155,37,2118,3.29%,0.06%
2020-01-01 00:04:20,14,3,1629,19,1610,2.49%,0.03%
2020-01-01 00:04:20,14,4,4462,135,4327,6.81%,0.21%
2020-01-01 00:04:20,14,5,1354,12,1342,2.07%,0.02%
2020-01-01 00:04:20,14,6,4763,152,4611,7.27%,0.23%
2020-01-01 00:04:20,14,7,12019,938,11081,18.34%,1.43%
2020-01-01 00:04:20,14,8,13589,1239,12350,20.74%,1.89%
2020-01-01 00:04:20,14,9,1505,14,1491,2.30%,0.02%
2020-01-01 00:04:20,14,10,4067,127,3940,6.21%,0.19%
2020-01-01 00:04:20,14,11,24497,4085,20412,37.38%,6.23%
2020-01-01 00:04:20,14,12,6619,337,6282,10.10%,0.51%
2020-01-01 00:04:20,15,1,605,2,603,0.92%,0.00%
2020-01-01 00:04:20,15,2,85,0,85,0.13%,0.00%
2020-01-01 00:04:20,15,3,3981,103,3878,6.07%,0.16%
2020-01-01 00:04:20,15,4,5939,336,5603,9.06%,0.51%
2020-01-01 00:04:20,15,5,10948,891,10057,16.71%,1.36%
2020-01-01 00:04:20,15,6,6158,344,5814,9.40%,0.52%
2020-01-01 00:04:20,15,7,3948,164,3784,6.02%,0.25%
2020-01-01 00:04:20,15,8,6487,375,6112,9.90%,0.57%
2020-01-01 00:04:20,15,9,11140,922,10218,17.00%,1.41%
2020-01-01 00:04:20,15,10,4449,177,4272,6.79%,0.27%
2020-01-01 00:04:20,15,11,11040,941,10099,16.85%,1.44%
2020-01-01 00:04:20,15,12,27215,5232,21983,41.53%,7.98%
2020-01-01 00:04:20,16,1,372,0,372,0.57%,0.00%
2020-01-01 00:04:20,16,2,355,3,352,0.54%,0.00%
2020-01-01 00:04:20,16,3,1714,27,1687,2.62%,0.04%
2020-01-01 00:04:20,16,4,5314,245,5069,8.11%,0.37%
2020-01-01 00:04:20,16,5,9244,711,8533,14.11%,1.08%
2020-01-01 00:04:20,16,6,6304,319,5985,9.62%,0.49%
2020-01-01 00:04:20,16,7,3227,99,3128,4.92%,0.15%
2020-01-01 00:04:20,16,8,7284,418,6866,11.11%,0.64%
2020-01-01 00:04:20,16,9,9658,765,8893,14.74%,1.17%
2020-01-01 00:04:20,16,10,1414,19,1395,2.16%,0.03%
2020-01-01 00:04:20,16,11,9104,627,8477,13.89%,0.96%
2020-01-01 00:04:20,16,12,28175,5386,22789,42.99%,8.22%
2020-01-01 00:04:30,1,1,23071,3551,19520,35.20%,5.42%
2020-01-01 00:04:30,1,2,10881,810,10071,16.60%,1.24%
2020-01-01 00:04:30,1,3,2098,32,2066,3.20%,0.05%
2020-01-01 00:04:30,1,4,11776,984,10792,17.97%,1.50%
2020-01-01 00:04:30,1,5,8301,566,7735,12.67%,0.86%
2020-01-01 00:04:30,1,6,8293,566,7727,12.65%,0.86%
2020-01-01 00:04:30,1,7,8760,536,8224,13.37%,0.82%
2020-01-01 00:04:30,1,8,5880,255,5625,8.97%,0.39%
2020-01-01 00:04:30,1,9,8241,560,7681,12.57%,0.85%
2020-01-01 00:04:30,1,10,4735,164,4571,7.23%,0.25%
2020-01-01 00:04:30,1,11,4796,169,4627,7.32%,0.26%
2020-01-01 00:04:30,1,12,8218,557,7661,12.54%,0.85%
2020-01-01 00:04:30,2,1,577,5,572,0.88%,0.01%
2020-01-01 00:04:30,2,2,27103,4951,22152,41.36%,7.55%
2020-01-01 00:04:30,2,3,23787,3915,19872,36.30%,5.97%
2020-01-01 00:04:30,2,4,548,5,543,0.84%,0.01%
2020-01-01 00:04:30,2,5,14322,1536,12786,21.85%,2.34%
2020-01-01 00:04:30,2,6,68,0,68,0.10%,0.00%
2020-01-01 00:04:30,2,7,2718,67,2651,4.15%,0.10%
2020-01-01 00:04:30,2,8,1960,35,1925,2.99%,0.05%
2020-01-01 00:04:30,2,9,14162,1502,12660,21.61%,2.29%
2020-01-01 00:04:30,2,10,1277,12,1265,1.95%,0.02%
2020-01-01 00:04:30,2,11,1283,12,1271,1.96%,0.02%
2020-01-01 00:04:30,2,12,14018,1479,12539,21.39%,2.26%
2020-01-01 00:04:30,3,1,1107,10,1097,1.69%,0.02%
2020-01-01 00:04:30,3,2,20181,2790,17391,30.79%,4.26%
2020-01-01 00:04:30,3,3,70480,27357,43123,107.54%,41.74%
2020-01-01 00:04:30,3,4,11141,887,10254,17.00%,1.35%
2020-01-01 00:04:30,3,5,49334,14603,34731,75.28%,22.28%
2020-01-01 00:04:30,3,6,12264,1059,11205,18.71%,1.62%
2020-01-01 00:04:30,3,7,17323,2080,15243,26.43%,3.17%
2020-01-01 00:04:30,3,8,14938,1588,13350,22.79%,2.42%
2020-01-01 00:04:30,3,9,36647,8458,28189,55.92%,12.91%
2020-01-01 00:04:30,3,10,5519,219,5300,8.42%,0.33%
2020-01-01 00:04:30,3,11,2203,40,2163,3.36%,0.06%
2020-01-01 00:04:30,3,12,29778,5778,24000,45.44%,8.82%
2020-01-01 00:04:30,4,1,445,1,444,0.68%,0.00%
2020-01-01 00:04:30,4,2,258,0,258,0.39%,0.00%
2020-01-01 00:04:30,4,3,1528,14,1514,2.33%,0.02%
2020-01-01 00:04:30,4,4,27665,5104,22561,42.21%,7.79%
2020-01-01 00:04:30,4,5,18460,2416,16044,28.17%,3.69%
2020-01-01 00:04:30,4,6,24212,4040,20172,36.94%,6.16%
2020-01-01 00:04:30,4,7,4482,161,4321,6.84%,0.25%
2020-01-01 00:04:30,4,8,3069,79,2990,4.68%,0.12%
2020-01-01 00:04:30,4,9,15858,1816,14042,24.20%,2.77%
2020-01-01 00:04:30,4,10,1933,33,1900,2.95%,0.05%
2020-01-01 00:04:30,4,11,136,0,136,0.21%,0.00%
2020-01-01 00:04:30,4,12,12910,1211,11699,19.70%,1.85%
2020-01-01 00:04:30,5,1,2692,63,2629,4.11%,0.10%
2020-01-01 00:04:30,5,2,780,9,771,1.19%,0.01%
2020-01-01 00:04:30,5,3,2148,37,2111,3.28%,0.06%
2020-01-01 00:04:30,5,4,30225,6070,24155,46.12%,9.26%
2020-01-01 00:04:30,5,5,11700,999,10701,17.85%,1.52%
2020-01-01 00:04:30,5,6,17146,2131,15015,26.16%,3.25%
2020-01-01 00:04:30,5,7,4851,191,4660,7.40%,0.29%
2020-01-01 00:04:30,5,8,4297,140,4157,6.56%,0.21%
2020-01-01 00:04:30,5,9,9393,670,8723,14.33%,1.02%
2020-01-01 00:04:30,5,10,1545,19,1526,2.36%,0.03%
2020-01-01 00:04:30,5,11,1132,19,1113,1.73%,0.03%
2020-01-01 00:04:30,5,12,7390,434,6956,11.28%,0.66%
2020-01-01 00:04:30,6,1,986,8,978,1.50%,0.01%
2020-01-01 00:04:30,6,2,1080,9,1071,1.65%,0.01%
2020-01-01 00:04:30,6,3,1378,14,1364,2.10%,0.02%
2020-01-01 00:04:30,6,4,1171,5,1166,1.79%,0.01%
2020-01-01 00:04:30,6,5,12594,1229,11365,19.22%,1.88%
2020-01-01 00:04:30,6,6,4960,201,4759,7.57%,0.31%
2020-01-01 00:04:30,6,7,3359,58,3301,5.13%,0.09%
2020-01-01 00:04:30,6,8,2782,41,2741,4.24%,0.06%
2020-01-01 00:04:30,6,9,5923,319,5604,9.04%,0.49%
2020-01-01 00:04:30,6,10,2158,32,2126,3.29%,0.05%
2020-01-01 00:04:30,6,11,364,6,358,0.56%,0.01%
2020-01-01 00:04:30,6,12,3706,147,3559,5.65%,0.22%
2020-01-01 00:04:30,7,1,359,4,355,0.55%,0.01%
2020-01-01 00:04:30,7,2,118,0,118,0.18%,0.00%
2020-01-01 00:04:30,7,3,510,0,510,0.78%,0.00%
2020-01-01 00:04:30,7,4,1678,24,1654,2.56%,0.04%
2020-01-01 00:04:30,7,5,7345,394,6951,11.21%,0.60%
2020-01-01 00:04:30,7,6,13163,1322,11841,20.09%,2.02%
2020-01-01 00:04:30,7,7,4135,122,4013,6.31%,0.19%
2020-01-01 00:04:30,7,8,1848,49,1799,2.82%,0.07%
2020-01-01 00:04:30,7,9,6727,316,6411,10.26%,0.48%
2020-01-01 00:04:30,7,10,2013,30,1983,3.07%,0.05%
2020-01-01 00:04:30,7,11,256,1,255,0.39%,0.00%
2020-01-01 00:04:30,7,12,4726,179,4547,7.21%,0.27%
2020-01-01 00:04:30,8,1,381,0,381,0.58%,0.00%
2020-01-01 00:04:30,8,2,73,1,72,0.11%,0.00%
2020-01-01 00:04:30,8,3,1203,10,1193,1.84%,0.02%
2020-01-01 00:04:30,8,4,2794,61,2733,4.26%,0.09%
2020-01-01 00:04:30,8,5,7652,419,7233,11.68%,0.64%
2020-01-01 00:04:30,8,6,15959,1782,14177,24.35%,2.72%
2020-01-01 00:04:30,8,7,5411,217,5194,8.26%,0.33%
2020-01-01 00:04:30,8,8,2659,53,2606,4.06%,0.08%
2020-01-01 00:04:30,8,9,6316,266,6050,9.64%,0.41%
2020-01-01 00:04:30,8,10,2171,27,2144,3.31%,0.04%
2020-01-01 00:04:30,8,11,263,0,263,0.40%,0.00%
2020-01-01 00:04:30,8,12,4076,110,3966,6.22%,0.17%
2020-01-01 00:04:30,9,1,384,1,383,0.59%,0.00%
2020-01-01 00:04:30,9,2,6210,304,5906,9.48%,0.46%
2020-01-01 00:04:30,9,3,5372,232,5140,8.20%,0.35%
2020-01-01 00:04:30,9,4,6901,355,6546,10.53%,0.54%
2020-01-01 00:04:30,9,5,264,0,264,0.40%,0.00%
2020-01-01 00:04:30,9,6,7546,425,7121,11.51%,0.65%
2020-01-01 00:04:30,9,7,28658,5419,23239,43.73%,8.27%
2020-01-01 00:04:30,9,8,10624,813,9811,16.21%,1.24%
2020-01-01 00:04:30,9,9,246,0,246,0.38%,0.00%
2020-01-01 00:04:30,9,10,3701,93,3608,5.65%,0.14%
2020-01-01 00:04:30,9,11,9437,664,8773,14.40%,1.01%
2020-01-01 00:04:30,9,12,5366,251,5115,8.19%,0.38%
2020-01-01 00:04:30,10,1,1326,381,945,2.02%,0.58%
2020-01-01 00:04:30,10,2,3303,435,2868,5.04%,0.66%
2020-01-01 00:04:30,10,3,1722,19,1703,2.63%,0.03%
2020-01-01 00:04:30,10,4,3567,969,2598,5.44%,1.48%
2020-01-01 00:04:30,10,5,746,4,742,1.14%,0.01%
2020-01-01 00:04:30,10,6,5360,1058,4302,8.18%,1.61%
2020-01-01 00:04:30,10,7,10330,1874,8456,15.76%,2.86%
2020-01-01 00:04:30,10,8,26350,6098,20252,40.21%,9.30%
2020-01-01 00:04:30,10,9,987,6,981,1.51%,0.01%
2020-01-01 00:04:30,10,10,3207,73,3134,4.89%,0.11%
2020-01-01 00:04:30,10,11,13344,1507,11837,20.36%,2.30%
2020-01-01 00:04:30,10,12,9528,946,8582,14.54%,1.44%
2020-01-01 00:04:30,11,1,2269,51,2218,3.46%,0.08%
2020-01-01 00:04:30,11,2,3460,100,3360,5.28%,0.15%
2020-01-01 00:04:30,11,3,987,5,982,1.51%,0.01%
2020-01-01 00:04:30,11,4,6464,350,6114,9.86%,0.53%
2020-01-01 00:04:30,11,5,517,2,515,0.79%,0.00%
2020-01-01 00:04:30,11,6,7720,491,7229,11.78%,0.75%
2020-01-01 00:04:30,11,7,13090,1247,11843,19.97%,1.90%
2020-01-01 00:04:30,11,8,26627,4784,21843,40.63%,7.30%
2020-01-01 00:04:30,11,9,474,1,473,0.72%,0.00%
2020-01-01 00:04:30,11,10,3591,88,3503,5.48%,0.13%
2020-01-01 00:04:30,11,11,9797,737,9060,14.95%,1.12%
2020-01-01 00:04:30,11,12,5984,273,5711,9.13%,0.42%
2020-01-01 00:04:30,12,1,36,1,35,0.05%,0.00%
2020-01-01 00:04:30,12,2,657,271,386,1.00%,0.41%
2020-01-01 00:04:30,12,3,3106,337,2769,4.74%,0.51%
2020-01-01 00:04:30,12,4,3514,82,3432,5.36%,0.13%
2020-01-01 00:04:30,12,5,10376,1045,9331,15.83%,1.59%
2020-01-01 00:04:30,12,6,6389,308,6081,9.75%,0.47%
2020-01-01 00:04:30,12,7,2685,63,2622,4.10%,0.10%
2020-01-01 00:04:30,12,8,1319,262,1057,2.01%,0.40%
2020-01-01 00:04:30,12,9,22845,4671,18174,34.86%,7.13%
2020-01-01 00:04:30,12,10,3856,356,3500,5.88%,0.54%
2020-01-01 00:04:30,12,11,1508,264,1244,2.30%,0.40%
2020-01-01 00:04:30,12,12,7536,1236,6300,11.50%,1.89%
2020-01-01 00:04:30,13,1,2130,27,2103,3.25%,0.04%
2020-01-01 00:04:30,13,2,2531,43,2488,3.86%,0.07%
2020-01-01 00:04:30,13,3,1193,7,1186,1.82%,0.01%
2020-01-01 00:04:30,13,4,3983,419,3564,6.08%,0.64%
2020-01-01 00:04:30,13,5,7027,834,6193,10.72%,1.27%
2020-01-01 00:04:30,13,6,4929,471,4458,7.52%,0.72%
2020-01-01 00:04:30,13,7,4639,147,4492,7.08%,0.22%
2020-01-01 00:04:30,13,8,6172,280,5892,9.42%,0.43%
2020-01-01 00:04:30,13,9,7251,854,6397,11.06%,1.30%
2020-01-01 00:04:30,13,10,27631,5682,21949,42.16%,8.67%
2020-01-01 00:04:30,13,11,16721,2291,14430,25.51%,3.50%
2020-01-01 00:04:30,13,12,9821,1043,8778,14.99%,1.59%
2020-01-01 00:04:30,14,1,327,0,327,0.50%,0.00%
2020-01-01 00:04:30,14,2,2050,30,2020,3.13%,0.05%
2020-01-01 00:04:30,14,3,1549,19,1530,2.36%,0.03%
2020-01-01 00:04:30,14,4,4526,124,4402,6.91%,0.19%
2020-01-01 00:04:30,14,5,1372,11,1361,2.09%,0.02%
2020-01-01 00:04:30,14,6,4803,144,4659,7.33%,0.22%
2020-01-01 00:04:30,14,7,11632,948,10684,17.75%,1.45%
2020-01-01 00:04:30,14,8,13371,1246,12125,20.40%,1.90%
2020-01-01 00:04:30,14,9,1544,11,1533,2.36%,0.02%
2020-01-01 00:04:30,14,10,3967,99,3868,6.05%,0.15%
2020-01-01 00:04:30,14,11,24159,3857,20302,36.86%,5.89%
2020-01-01 00:04:30,14,12,6596,311,6285,10.06%,0.47%
2020-01-01 00:04:30,15,1,505,4,501,0.77%,0.01%
2020-01-01 00:04:30,15,2,120,0,120,0.18%,0.00%
2020-01-01 00:04:30,15,3,4184,161,4023,6.38%,0.25%
2020-01-01 00:04:30,15,4,5914,372,5542,9.02%,0.57%
2020-01-01 00:04:30,15,5,10967,1013,9954,16.73%,1.55%
2020-01-01 00:04:30,15,6,6163,390,5773,9.40%,0.60%
2020-01-01 00:04:30,15,7,3685,111,3574,5.62%,0.17%
2020-01-01 00:04:30,15,8,6325,316,6009,9.65%,0.48%
2020-01-01 00:04:30,15,9,11133,1041,10092,16.99%,1.59%
2020-01-01 00:04:30,15,10,3688,105,3583,5.63%,0.16%
2020-01-01 00:04:30,15,11,10140,782,9358,15.47%,1.19%
2020-01-01 00:04:30,15,12,26288,4999,21289,40.11%,7.63%
2020-01-01 00:04:30,16,1,428,2,426,0.65%,0.00%
2020-01-01 00:04:30,16,2,332,1,331,0.51%,0.00%
2020-01-01 00:04:30,16,3,2691,56,2635,4.11%,0.09%
2020-01-01 00:04:30,16,4,3402,74,3328,5.19%,0.11%
2020-01-01 00:04:30,16,5,8142,540,7602,12.42%,0.82%
2020-01-01 00:04:30,16,6,4303,139,4164,6.57%,0.21%
2020-01-01 00:04:30,16,7,3330,94,3236,5.08%,0.14%
2020-01-01 00:04:30,16,8,6492,367,6125,9.91%,0.56%
2020-01-01 00:04:30,16,9,8521,583,7938,13.00%,0.89%
2020-01-01 00:04:30,16,10,2997,64,2933,4.57%,0.10%
2020-01-01 00:04:30,16,11,9762,729,9033,14.90%,1.11%
2020-01-01 00:04:30,16,12,27145,5116,22029,41.42%,7.81%
2020-01-01 00:04:40,1,1,24235,3919,20316,36.98%,5.98%
2020-01-01 00:04:40,1,2,7847,496,7351,11.97%,0.76%
2020-01-01 00:04:40,1,3,1289,14,1275,1.97%,0.02%
2020-01-01 00:04:40,1,4,15989,1802,14187,24.40%,2.75%
2020-01-01 00:04:40,1,5,12488,1115,11373,19.06%,1.70%
2020-01-01 00:04:40,1,6,12458,1110,11348,19.01%,1.69%
2020-01-01 00:04:40,1,7,6536,362,6174,9.97%,0.55%
2020-01-01 00:04:40,1,8,4287,183,4104,6.54%,0.28%
2020-01-01 00:04:40,1,9,12394,1100,11294,18.91%,1.68%
2020-01-01 00:04:40,1,10,3068,93,2975,4.68%,0.14%
2020-01-01 00:04:40,1,11,3138,96,3042,4.79%,0.15%
2020-01-01 00:04:40,1,12,12376,1096,11280,18.88%,1.67%
2020-01-01 00:04:40,2,1,729,1,728,1.11%,0.00%
2020-01-01 00:04:40,2,2,26119,4560,21559,39.85%,6.96%
2020-01-01 00:04:40,2,3,21806,3248,18558,33.27%,4.96%
2020-01-01 00:04:40,2,4,676,0,676,1.03%,0.00%
2020-01-01 00:04:40,2,5,13451,1322,12129,20.52%,2.02%
2020-01-01 00:04:40,2,6,96,0,96,0.15%,0.00%
2020-01-01 00:04:40,2,7,3553,93,3460,5.42%,0.14%
2020-01-01 00:04:40,2,8,2491,42,2449,3.80%,0.06%
2020-01-01 00:04:40,2,9,13247,1291,11956,20.21%,1.97%
2020-01-01 00:04:40,2,10,1672,20,1652,2.55%,0.03%
2020-01-01 00:04:40,2,11,1672,20,1652,2.55%,0.03%
2020-01-01 00:04:40,2,12,13095,1254,11841,19.98%,1.91%
2020-01-01 00:04:40,3,1,1262,14,1248,1.93%,0.02%
2020-01-01 00:04:40,3,2,24586,4067,20519,37.52%,6.21%
2020-01-01 00:04:40,3,3,69699,26790,42909,106.35%,40.88%
2020-01-01 00:04:40,3,4,10854,884,9970,16.56%,1.35%
2020-01-01 00:04:40,3,5,44138,12050,32088,67.35%,18.39%
2020-01-01 00:04:40,3,6,12030,1063,10967,18.36%,1.62%
2020-01-01 00:04:40,3,7,21707,3208,18499,33.12%,4.90%
2020-01-01 00:04:40,3,8,19274,2574,16700,29.41%,3.93%
2020-01-01 00:04:40,3,9,31604,6552,25052,48.22%,10.00%
2020-01-01 00:04:40,3,10,4505,141,4364,6.87%,0.22%
2020-01-01 00:04:40,3,11,2230,45,2185,3.40%,0.07%
2020-01-01 00:04:40,3,12,25448,4362,21086,38.83%,6.66%
2020-01-01 00:04:40,4,1,450,2,448,0.69%,0.00%
2020-01-01 00:04:40,4,2,279,1,278,0.43%,0.00%
2020-01-01 00:04:40,4,3,1078,5,1073,1.64%,0.01%
2020-01-01 00:04:40,4,4,28172,5237,22935,42.99%,7.99%
2020-01-01 00:04:40,4,5,18517,2355,16162,28.25%,3.59%
2020-01-01 00:04:40,4,6,24360,3971,20389,37.17%,6.06%
2020-01-01 00:04:40,4,7,4683,179,4504,7.15%,0.27%
2020-01-01 00:04:40,4,8,3086,76,3010,4.71%,0.12%
2020-01-01 00:04:40,4,9,16188,1775,14413,24.70%,2.71%
2020-01-01 00:04:40,4,10,1617,18,1599,2.47%,0.03%
2020-01-01 00:04:40,4,11,101,0,101,0.15%,0.00%
2020-01-01 00:04:40,4,12,13461,1246,12215,20.54%,1.90%
2020-01-01 00:04:40,5,1,2778,75,2703,4.24%,0.11%
2020-01-01 00:04:40,5,2,775,8,767,1.18%,0.01%
2020-01-01 00:04:40,5,3,1028,7,1021,1.57%,0.01%
2020-01-01 00:04:40,5,4,27936,5209,22727,42.63%,7.95%
2020-01-01 00:04:40,5,5,10485,817,9668,16.00%,1.25%
2020-01-01 00:04:40,5,6,16476,1917,14559,25.14%,2.93%
2020-01-01 00:04:40,5,7,5374,223,5151,8.20%,0.34%
2020-01-01 00:04:40,5,8,4326,145,4181,6.60%,0.22%
2020-01-01 00:04:40,5,9,9321,627,8694,14.22%,0.96%
2020-01-01 00:04:40,5,10,1189,12,1177,1.81%,0.02%
2020-01-01 00:04:40,5,11,1145,16,1129,1.75%,0.02%
2020-01-01 00:04:40,5,12,7734,437,7297,11.80%,0.67%
2020-01-01 00:04:40,6,1,1210,13,1197,1.85%,0.02%
2020-01-01 00:04:40,6,2,1349,18,1331,2.06%,0.03%
2020-01-01 00:04:40,6,3,1781,27,1754,2.72%,0.04%
2020-01-01 00:04:40,6,4,964,10,954,1.47%,0.02%
2020-01-01 00:04:40,6,5,13445,1381,12064,20.52%,2.11%
2020-01-01 00:04:40,6,6,5095,233,4862,7.77%,0.36%
2020-01-01 00:04:40,6,7,3424,111,3313,5.22%,0.17%
2020-01-01 00:04:40,6,8,2539,77,2462,3.87%,0.12%
2020-01-01 00:04:40,6,9,6328,284,6044,9.66%,0.43%
2020-01-01 00:04:40,6,10,2310,37,2273,3.52%,0.06%
2020-01-01 00:04:40,6,11,368,1,367,0.56%,0.00%
2020-01-01 00:04:40,6,12,3952,129,3823,6.03%,0.20%
2020-01-01 00:04:40,7,1,463,6,457,0.71%,0.01%
2020-01-01 00:04:40,7,2,79,0,79,0.12%,0.00%
2020-01-01 00:04:40,7,3,1430,21,1409,2.18%,0.03%
2020-01-01 00:04:40,7,4,1787,19,1768,2.73%,0.03%
2020-01-01 00:04:40,7,5,7562,409,7153,11.54%,0.62%
2020-01-01 00:04:40,7,6,13042,1221,11821,19.90%,1.86%
2020-01-01 00:04:40,7,7,3679,101,3578,5.61%,0.15%
2020-01-01 00:04:40,7,8,1414,15,1399,2.16%,0.02%
2020-01-01 00:04:40,7,9,5997,265,5732,9.15%,0.40%
2020-01-01 00:04:40,7,10,1298,13,1285,1.98%,0.02%
2020-01-01 00:04:40,7,11,212,1,211,0.32%,0.00%
2020-01-01 00:04:40,7,12,4684,158,4526,7.15%,0.24%
2020-01-01 00:04:40,8,1,437,1,436,0.67%,0.00%
2020-01-01 00:04:40,8,2,84,0,84,0.13%,0.00%
2020-01-01 00:04:40,8,3,1212,6,1206,1.85%,0.01%
2020-01-01 00:04:40,8,4,2774,68,2706,4.23%,0.10%
2020-01-01 00:04:40,8,5,7356,416,6940,11.22%,0.63%
2020-01-01 00:04:40,8,6,15331,1672,13659,23.39%,2.55%
2020-01-01 00:04:40,8,7,5131,194,4937,7.83%,0.30%
2020-01-01 00:04:40,8,8,1970,21,1949,3.01%,0.03%
2020-01-01 00:04:40,8,9,6061,281,5780,9.25%,0.43%
2020-01-01 00:04:40,8,10,1858,32,1826,2.84%,0.05%
2020-01-01 00:04:40,8,11,278,0,278,0.42%,0.00%
2020-01-01 00:04:40,8,12,4136,115,4021,6.31%,0.18%
2020-01-01 00:04:40,9,1,279,2,277,0.43%,0.00%
2020-01-01 00:04:40,9,2,5547,260,5287,8.46%,0.40%
2020-01-01 00:04:40,9,3,4821,193,4628,7.36%,0.29%
2020-01-01 00:04:40,9,4,5889,291,5598,8.99%,0.44%
2020-01-01 00:04:40,9,5,218,0,218,0.33%,0.00%
2020-01-01 00:04:40,9,6,6472,357,6115,9.88%,0.54%
2020-01-01 00:04:40,9,7,28752,5522,23230,43.87%,8.43%
2020-01-01 00:04:40,9,8,10988,918,10070,16.77%,1.40%
2020-01-01 00:04:40,9,9,175,0,175,0.27%,0.00%
2020-01-01 00:04:40,9,10,4311,150,4161,6.58%,0.23%
2020-01-01 00:04:40,9,11,9951,781,9170,15.18%,1.19%
2020-01-01 00:04:40,9,12,5199,226,4973,7.93%,0.34%
2020-01-01 00:04:40,10,1,1294,398,896,1.97%,0.61%
2020-01-01 00:04:40,10,2,3291,468,2823,5.02%,0.71%
2020-01-01 00:04:40,10,3,1806,31,1775,2.76%,0.05%
2020-01-01 00:04:40,10,4,3604,1001,2603,5.50%,1.53%
2020-01-01 00:04:40,10,5,813,7,806,1.24%,0.01%
2020-01-01 00:04:40,10,6,5612,1118,4494,8.56%,1.71%
2020-01-01 00:04:40,10,7,10740,1971,8769,16.39%,3.01%
2020-01-01 00:04:40,10,8,26948,6253,20695,41.12%,9.54%
2020-01-01 00:04:40,10,9,967,4,963,1.48%,0.01%
2020-01-01 00:04:40,10,10,3220,94,3126,4.91%,0.14%
2020-01-01 00:04:40,10,11,12764,1384,11380,19.48%,2.11%
2020-01-01 00:04:40,10,12,8963,822,8141,13.68%,1.25%
2020-01-01 00:04:40,11,1,2115,27,2088,3.23%,0.04%
2020-01-01 00:04:40,11,2,3312,68,3244,5.05%,0.10%
2020-01-01 00:04:40,11,3,1005,7,998,1.53%,0.01%
2020-01-01 00:04:40,11,4,3154,79,3075,4.81%,0.12%
2020-01-01 00:04:40,11,5,607,1,606,0.93%,0.00%
2020-01-01 00:04:40,11,6,4659,172,4487,7.11%,0.26%
2020-01-01 00:04:40,11,7,9799,681,9118,14.95%,1.04%
2020-01-01 00:04:40,11,8,24473,4063,20410,37.34%,6.20%
2020-01-01 00:04:40,11,9,355,0,355,0.54%,0.00%
2020-01-01 00:04:40,11,10,4006,122,3884,6.11%,0.19%
2020-01-01 00:04:40,11,11,10378,795,9583,15.84%,1.21%
2020-01-01 00:04:40,11,12,6140,280,5860,9.37%,0.43%
2020-01-01 00:04:40,12,1,71,0,71,0.11%,0.00%
2020-01-01 00:04:40,12,2,712,277,435,1.09%,0.42%
2020-01-01 00:04:40,12,3,3224,342,2882,4.92%,0.52%
2020-01-01 00:04:40,12,4,3492,85,3407,5.33%,0.13%
2020-01-01 00:04:40,12,5,10345,982,9363,15.79%,1.50%
2020-01-01 00:04:40,12,6,6248,279,5969,9.53%,0.43%
2020-01-01 00:04:40,12,7,2640,58,2582,4.03%,0.09%
2020-01-01 00:04:40,12,8,1588,273,1315,2.42%,0.42%
2020-01-01 00:04:40,12,9,23286,4823,18463,35.53%,7.36%
2020-01-01 00:04:40,12,10,4176,377,3799,6.37%,0.58%
2020-01-01 00:04:40,12,11,1821,280,1541,2.78%,0.43%
2020-01-01 00:04:40,12,12,7790,1323,6467,11.89%,2.02%
2020-01-01 00:04:40,13,1,2227,34,2193,3.40%,0.05%
2020-01-01 00:04:40,13,2,2595,51,2544,3.96%,0.08%
2020-01-01 00:04:40,13,3,1097,8,1089,1.67%,0.01%
2020-01-01 00:04:40,13,4,4326,427,3899,6.60%,0.65%
2020-01-01 00:04:40,13,5,6879,842,6037,10.50%,1.28%
2020-01-01 00:04:40,13,6,4971,463,4508,7.59%,0.71%
2020-01-01 00:04:40,13,7,4941,170,4771,7.54%,0.26%
2020-01-01 00:04:40,13,8,6690,322,6368,10.21%,0.49%
2020-01-01 00:04:40,13,9,7160,870,6290,10.93%,1.33%
2020-01-01 00:04:40,13,10,26896,5439,21457,41.04%,8.30%
2020-01-01 00:04:40,13,11,16199,2184,14015,24.72%,3.33%
2020-01-01 00:04:40,13,12,8945,959,7986,13.65%,1.46%
2020-01-01 00:04:40,14,1,384,0,384,0.59%,0.00%
2020-01-01 00:04:40,14,2,2279,40,2239,3.48%,0.06%
2020-01-01 00:04:40,14,3,1679,32,1647,2.56%,0.05%
2020-01-01 00:04:40,14,4,4674,167,4507,7.13%,0.25%
2020-01-01 00:04:40,14,5,1441,15,1426,2.20%,0.02%
2020-01-01 00:04:40,14,6,4990,197,4793,7.61%,0.30%
2020-01-01 00:04:40,14,7,12234,1065,11169,18.67%,1.63%
2020-01-01 00:04:40,14,8,13960,1377,12583,21.30%,2.10%
2020-01-01 00:04:40,14,9,1577,18,1559,2.41%,0.03%
2020-01-01 00:04:40,14,10,4471,147,4324,6.82%,0.22%
2020-01-01 00:04:40,14,11,25894,4479,21415,39.51%,6.83%
2020-01-01 00:04:40,14,12,7233,377,6856,11.04%,0.58%
2020-01-01 00:04:40,15,1,568,2,566,0.87%,0.00%
2020-01-01 00:04:40,15,2,143,0,143,0.22%,0.00%
2020-01-01 00:04:40,15,3,3916,140,3776,5.98%,0.21%
2020-01-01 00:04:40,15,4,6252,313,5939,9.54%,0.48%
2020-01-01 00:04:40,15,5,11077,939,10138,16.90%,1.43%
2020-01-01 00:04:40,15,6,6577,346,6231,10.04%,0.53%
2020-01-01 00:04:40,15,7,3639,106,3533,5.55%,0.16%
2020-01-01 00:04:40,15,8,5716,259,5457,8.72%,0.40%
2020-01-01 00:04:40,15,9,11243,958,10285,17.16%,1.46%
2020-01-01 00:04:40,15,10,4701,179,4522,7.17%,0.27%
2020-01-01 00:04:40,15,11,10564,831,9733,16.12%,1.27%
2020-01-01 00:04:40,15,12,26539,4942,21597,40.50%,7.54%
2020-01-01 00:04:40,16,1,628,7,621,0.96%,0.01%
2020-01-01 00:04:40,16,2,351,0,351,0.54%,0.00%
2020-01-01 00:04:40,16,3,2879,64,2815,4.39%,0.10%
2020-01-01 00:04:40,16,4,3679,140,3539,5.61%,0.21%
2020-01-01 00:04:40,16,5,8721,662,8059,13.31%,1.01%
2020-01-01 00:04:40,16,6,4527,192,4335,6.91%,0.29%
2020-01-01 00:04:40,16,7,3250,80,3170,4.96%,0.12%
2020-01-01 00:04:40,16,8,7011,404,6607,10.70%,0.62%
2020-01-01 00:04:40,16,9,9172,711,8461,14.00%,1.08%
2020-01-01 00:04:40,16,10,3362,83,3279,5.13%,0.13%
2020-01-01 00:04:40,16,11,10590,877,9713,16.16%,1.34%
2020-01-01 00:04:40,16,12,29179,5839,23340,44.52%,8.91%
