2020-01-01 00:00:10,1,1,19316,2621,16695,29.47%,13.57%
2020-01-01 00:00:10,1,2,4689,166,4523,7.15%,3.54%
2020-01-01 00:00:10,1,3,855,7,848,1.30%,0.82%
2020-01-01 00:00:10,1,4,14277,1499,12778,21.78%,10.50%
2020-01-01 00:00:10,1,5,13771,1401,12370,21.01%,10.17%
2020-01-01 00:00:10,1,6,13676,1384,12292,20.87%,10.12%
2020-01-01 00:00:10,1,7,3810,117,3693,5.81%,3.07%
2020-01-01 00:00:10,1,8,2981,55,2926,4.55%,1.84%
2020-01-01 00:00:10,1,9,13642,1378,12264,20.82%,10.10%
2020-01-01 00:00:10,1,10,2642,47,2595,4.03%,1.78%
2020-01-01 00:00:10,1,11,2690,48,2642,4.10%,1.78%
2020-01-01 00:00:10,1,12,13614,1371,12243,20.77%,10.07%
2020-01-01 00:00:10,2,1,455,1,454,0.69%,0.22%
2020-01-01 00:00:10,2,2,27614,5000,22614,42.14%,18.11%
2020-01-01 00:00:10,2,3,22691,3470,19221,34.62%,15.29%
2020-01-01 00:00:10,2,4,349,0,349,0.53%,0.00%
2020-01-01 00:00:10,2,5,13442,1262,12180,20.51%,9.39%
2020-01-01 00:00:10,2,6,58,0,58,0.09%,0.00%
2020-01-01 00:00:10,2,7,4455,153,4302,6.80%,3.43%
2020-01-01 00:00:10,2,8,3264,83,3181,4.98%,2.54%
2020-01-01 00:00:10,2,9,13410,1257,12153,20.46%,9.37%
2020-01-01 00:00:10,2,10,2549,58,2491,3.89%,2.27%
2020-01-01 00:00:10,2,11,2555,58,2497,3.90%,2.27%
2020-01-01 00:00:10,2,12,13264,1235,12029,20.24%,9.31%
2020-01-01 00:00:10,3,1,1770,36,1734,2.70%,2.03%
2020-01-01 00:00:10,3,2,22512,3380,19132,34.35%,15.01%
2020-01-01 00:00:10,3,3,71519,27951,43568,109.13%,39.08%
2020-01-01 00:00:10,3,4,7290,398,6892,11.12%,5.46%
2020-01-01 00:00:10,3,5,47833,13870,33963,72.99%,29.00%
2020-01-01 00:00:10,3,6,8484,517,7967,12.95%,6.09%
2020-01-01 00:00:10,3,7,19137,2431,16706,29.20%,12.70%
2020-01-01 00:00:10,3,8,15850,1683,14167,24.19%,10.62%
2020-01-01 00:00:10,3,9,38921,9587,29334,59.39%,24.63%
2020-01-01 00:00:10,3,10,6409,315,6094,9.78%,4.91%
2020-01-01 00:00:10,3,11,1880,21,1859,2.87%,1.12%
2020-01-01 00:00:10,3,12,28507,5411,23096,43.50%,18.98%
2020-01-01 00:00:10,4,1,457,0,457,0.70%,0.00%
2020-01-01 00:00:10,4,2,240,0,240,0.37%,0.00%
2020-01-01 00:00:10,4,3,846,6,840,1.29%,0.71%
2020-01-01 00:00:10,4,4,28679,5480,23199,43.76%,19.11%
2020-01-01 00:00:10,4,5,17674,2197,15477,26.97%,12.43%
2020-01-01 00:00:10,4,6,24282,4002,20280,37.05%,16.48%
2020-01-01 00:00:10,4,7,5262,225,5037,8.03%,4.28%
2020-01-01 00:00:10,4,8,2475,43,2432,3.78%,1.74%
2020-01-01 00:00:10,4,9,15488,1722,13766,23.63%,11.12%
2020-01-01 00:00:10,4,10,2009,36,1973,3.07%,1.79%
2020-01-01 00:00:10,4,11,99,0,99,0.15%,0.00%
2020-01-01 00:00:10,4,12,12666,1158,11508,19.33%,9.14%
2020-01-01 00:00:10,5,1,2763,57,2706,4.22%,2.06%
2020-01-01 00:00:10,5,2,734,6,728,1.12%,0.82%
2020-01-01 00:00:10,5,3,431,3,428,0.66%,0.69%
2020-01-01 00:00:10,5,4,24608,4058,20550,37.55%,16.49%
2020-01-01 00:00:10,5,5,10617,836,9781,16.20%,7.87%
2020-01-01 00:00:10,5,6,15392,1706,13686,23.49%,11.08%
2020-01-01 00:00:10,5,7,4326,179,4147,6.60%,4.14%
2020-01-01 00:00:10,5,8,3335,106,3229,5.09%,3.18%
2020-01-01 00:00:10,5,9,9994,747,9247,15.25%,7.47%
2020-01-01 00:00:10,5,10,1152,13,1139,1.76%,1.13%
2020-01-01 00:00:10,5,11,699,6,693,1.07%,0.86%
2020-01-01 00:00:10,5,12,8361,525,7836,12.76%,6.28%
2020-01-01 00:00:10,6,1,1097,6,1091,1.67%,0.55%
2020-01-01 00:00:10,6,2,1189,6,1183,1.81%,0.50%
2020-01-01 00:00:10,6,3,1616,19,1597,2.47%,1.18%
2020-01-01 00:00:10,6,4,1487,14,1473,2.27%,0.94%
2020-01-01 00:00:10,6,5,12459,1082,11377,19.01%,8.68%
2020-01-01 00:00:10,6,6,4384,158,4226,6.69%,3.60%
2020-01-01 00:00:10,6,7,2324,44,2280,3.55%,1.89%
2020-01-01 00:00:10,6,8,1348,23,1325,2.06%,1.70%
2020-01-01 00:00:10,6,9,6123,238,5885,9.34%,3.89%
2020-01-01 00:00:10,6,10,1966,22,1944,3.00%,1.12%
2020-01-01 00:00:10,6,11,472,4,468,0.72%,0.85%
2020-01-01 00:00:10,6,12,4090,115,3975,6.24%,2.81%
2020-01-01 00:00:10,7,1,515,1,514,0.79%,0.19%
2020-01-01 00:00:10,7,2,93,0,93,0.14%,0.00%
2020-01-01 00:00:10,7,3,434,1,433,0.66%,0.23%
2020-01-01 00:00:10,7,4,2367,31,2336,3.61%,1.31%
2020-01-01 00:00:10,7,5,7685,439,7246,11.73%,5.71%
2020-01-01 00:00:10,7,6,13312,1271,12041,20.31%,9.55%
2020-01-01 00:00:10,7,7,3147,67,3080,4.80%,2.13%
2020-01-01 00:00:10,7,8,1025,6,1019,1.56%,0.58%
2020-01-01 00:00:10,7,9,7075,361,6714,10.80%,5.10%
2020-01-01 00:00:10,7,10,1456,10,1446,2.22%,0.69%
2020-01-01 00:00:10,7,11,89,0,89,0.14%,0.00%
2020-01-01 00:00:10,7,12,5604,226,5378,8.55%,4.03%
2020-01-01 00:00:10,8,1,489,3,486,0.75%,0.61%
2020-01-01 00:00:10,8,2,103,0,103,0.16%,0.00%
2020-01-01 00:00:10,8,3,1209,6,1203,1.84%,0.50%
2020-01-01 00:00:10,8,4,2726,54,2672,4.16%,1.98%
2020-01-01 00:00:10,8,5,7572,395,7177,11.55%,5.22%
2020-01-01 00:00:10,8,6,16110,1835,14275,24.58%,11.39%
2020-01-01 00:00:10,8,7,5715,245,5470,8.72%,4.29%
2020-01-01 00:00:10,8,8,2190,41,2149,3.34%,1.87%
2020-01-01 00:00:10,8,9,6134,255,5879,9.36%,4.16%
2020-01-01 00:00:10,8,10,1415,10,1405,2.16%,0.71%
2020-01-01 00:00:10,8,11,262,0,262,0.40%,0.00%
2020-01-01 00:00:10,8,12,4589,160,4429,7.00%,3.49%
2020-01-01 00:00:10,9,1,282,1,281,0.43%,0.35%
2020-01-01 00:00:10,9,2,5244,190,5054,8.00%,3.62%
2020-01-01 00:00:10,9,3,4583,145,4438,6.99%,3.16%
2020-01-01 00:00:10,9,4,5755,241,5514,8.78%,4.19%
2020-01-01 00:00:10,9,5,391,2,389,0.60%,0.51%
2020-01-01 00:00:10,9,6,6672,330,6342,10.18%,4.95%
2020-01-01 00:00:10,9,7,28164,5259,22905,42.97%,18.67%
2020-01-01 00:00:10,9,8,10819,846,9973,16.51%,7.82%
2020-01-01 00:00:10,9,9,286,2,284,0.44%,0.70%
2020-01-01 00:00:10,9,10,3375,76,3299,5.15%,2.25%
2020-01-01 00:00:10,9,11,9645,678,8967,14.72%,7.03%
2020-01-01 00:00:10,9,12,5824,239,5585,8.89%,4.10%
2020-01-01 00:00:10,10,1,1421,172,1249,2.17%,12.10%
2020-01-01 00:00:10,10,2,4266,261,4005,6.51%,6.12%
2020-01-01 00:00:10,10,3,2654,46,2608,4.05%,1.73%
2020-01-01 00:00:10,10,4,3920,944,2976,5.98%,24.08%
2020-01-01 00:00:10,10,5,696,1,695,1.06%,0.14%
2020-01-01 00:00:10,10,6,5707,1027,4680,8.71%,17.99%
2020-01-01 00:00:10,10,7,11523,1798,9725,17.58%,15.60%
2020-01-01 00:00:10,10,8,29634,7401,22233,45.22%,24.97%
2020-01-01 00:00:10,10,9,588,2,586,0.90%,0.34%
2020-01-01 00:00:10,10,10,2207,39,2168,3.37%,1.77%
2020-01-01 00:00:10,10,11,13592,1877,11715,20.74%,13.81%
2020-01-01 00:00:10,10,12,10918,1411,9507,16.66%,12.92%
2020-01-01 00:00:10,11,1,2771,67,2704,4.23%,2.42%
2020-01-01 00:00:10,11,2,5014,199,4815,7.65%,3.97%
2020-01-01 00:00:10,11,3,2090,36,2054,3.19%,1.72%
2020-01-01 00:00:10,11,4,3728,145,3583,5.69%,3.89%
2020-01-01 00:00:10,11,5,167,0,167,0.25%,0.00%
2020-01-01 00:00:10,11,6,4445,189,4256,6.78%,4.25%
2020-01-01 00:00:10,11,7,11290,967,10323,17.23%,8.56%
2020-01-01 00:00:10,11,8,24344,4024,20320,37.15%,16.53%
2020-01-01 00:00:10,11,9,347,0,347,0.53%,0.00%
2020-01-01 00:00:10,11,10,2746,44,2702,4.19%,1.60%
2020-01-01 00:00:10,11,11,9430,639,8791,14.39%,6.78%
2020-01-01 00:00:10,11,12,6326,295,6031,9.65%,4.66%
2020-01-01 00:00:10,12,1,109,0,109,0.17%,0.00%
2020-01-01 00:00:10,12,2,688,218,470,1.05%,31.64%
2020-01-01 00:00:10,12,3,2526,255,2271,3.85%,10.09%
2020-01-01 00:00:10,12,4,2396,37,2359,3.66%,1.54%
2020-01-01 00:00:10,12,5,8321,725,7596,12.70%,8.71%
2020-01-01 00:00:10,12,6,5036,209,4827,7.68%,4.15%
2020-01-01 00:00:10,12,7,2373,64,2309,3.62%,2.70%
2020-01-01 00:00:10,12,8,1164,295,869,1.78%,25.32%
2020-01-01 00:00:10,12,9,21821,4289,17532,33.30%,19.65%
2020-01-01 00:00:10,12,10,4376,398,3978,6.68%,9.09%
2020-01-01 00:00:10,12,11,1597,299,1298,2.44%,18.71%
2020-01-01 00:00:10,12,12,8177,1134,7043,12.48%,13.87%
2020-01-01 00:00:10,13,1,2306,51,2255,3.52%,2.21%
2020-01-01 00:00:10,13,2,2743,69,2674,4.19%,2.51%
2020-01-01 00:00:10,13,3,669,6,663,1.02%,0.90%
2020-01-01 00:00:10,13,4,6217,627,5590,9.49%,10.08%
2020-01-01 00:00:10,13,5,8282,982,7300,12.64%,11.86%
2020-01-01 00:00:10,13,6,6797,676,6121,10.37%,9.94%
2020-01-01 00:00:10,13,7,5320,238,5082,8.12%,4.47%
2020-01-01 00:00:10,13,8,7369,407,6962,11.24%,5.52%
2020-01-01 00:00:10,13,9,8625,1033,7592,13.16%,11.98%
2020-01-01 00:00:10,13,10,28142,6070,22072,42.94%,21.57%
2020-01-01 00:00:10,13,11,16797,2470,14327,25.63%,14.70%
2020-01-01 00:00:10,13,12,8856,1127,7729,13.51%,12.72%
2020-01-01 00:00:10,14,1,250,0,250,0.38%,0.00%
2020-01-01 00:00:10,14,2,1493,9,1484,2.28%,0.60%
2020-01-01 00:00:10,14,3,986,6,980,1.50%,0.61%
2020-01-01 00:00:10,14,4,5512,234,5278,8.41%,4.24%
2020-01-01 00:00:10,14,5,1143,10,1133,1.74%,0.87%
2020-01-01 00:00:10,14,6,5649,249,5400,8.62%,4.41%
2020-01-01 00:00:10,14,7,13253,1299,11954,20.22%,9.80%
2020-01-01 00:00:10,14,8,14745,1545,13200,22.50%,10.48%
2020-01-01 00:00:10,14,9,1557,21,1536,2.38%,1.35%
2020-01-01 00:00:10,14,10,4451,134,4317,6.79%,3.01%
2020-01-01 00:00:10,14,11,28138,5280,22858,42.94%,18.76%
2020-01-01 00:00:10,14,12,8708,554,8154,13.29%,6.36%
2020-01-01 00:00:10,15,1,493,3,490,0.75%,0.61%
2020-01-01 00:00:10,15,2,197,2,195,0.30%,1.01%
2020-01-01 00:00:10,15,3,4011,121,3890,6.12%,3.02%
2020-01-01 00:00:10,15,4,5575,267,5308,8.51%,4.79%
2020-01-01 00:00:10,15,5,11140,948,10192,17.00%,8.51%
2020-01-01 00:00:10,15,6,5793,283,5510,8.84%,4.88%
2020-01-01 00:00:10,15,7,4328,154,4174,6.60%,3.56%
2020-01-01 00:00:10,15,8,7277,414,6863,11.10%,5.69%
2020-01-01 00:00:10,15,9,11338,974,10364,17.30%,8.59%
2020-01-01 00:00:10,15,10,4848,298,4550,7.40%,6.15%
2020-01-01 00:00:10,15,11,12296,1224,11072,18.76%,9.95%
2020-01-01 00:00:10,15,12,30680,6603,24077,46.81%,21.52%
2020-01-01 00:00:10,16,1,508,4,504,0.78%,0.79%
2020-01-01 00:00:10,16,2,244,1,243,0.37%,0.41%
2020-01-01 00:00:10,16,3,1365,18,1347,2.08%,1.32%
2020-01-01 00:00:10,16,4,4035,106,3929,6.16%,2.63%
2020-01-01 00:00:10,16,5,7317,411,6906,11.16%,5.62%
2020-01-01 00:00:10,16,6,4805,152,4653,7.33%,3.16%
2020-01-01 00:00:10,16,7,3885,114,3771,5.93%,2.93%
2020-01-01 00:00:10,16,8,8162,564,7598,12.45%,6.91%
2020-01-01 00:00:10,16,9,7778,453,7325,11.87%,5.82%
2020-01-01 00:00:10,16,10,1629,19,1610,2.49%,1.17%
2020-01-01 00:00:10,16,11,9945,784,9161,15.17%,7.88%
2020-01-01 00:00:10,16,12,25461,4438,21023,38.85%,17.43%
2020-01-01 00:00:20,1,1,20242,2935,17307,30.89%,14.50%
2020-01-01 00:00:20,1,2,9264,640,8624,14.14%,6.91%
2020-01-01 00:00:20,1,3,419,4,415,0.64%,0.95%
2020-01-01 00:00:20,1,4,10469,856,9613,15.97%,8.18%
2020-01-01 00:00:20,1,5,10125,810,9315,15.45%,8.00%
2020-01-01 00:00:20,1,6,10045,799,9246,15.33%,7.95%
2020-01-01 00:00:20,1,7,8823,574,8249,13.46%,6.50%
2020-01-01 00:00:20,1,8,6283,293,5990,9.59%,4.66%
2020-01-01 00:00:20,1,9,9976,789,9187,15.22%,7.91%
2020-01-01 00:00:20,1,10,5497,227,5270,8.39%,4.13%
2020-01-01 00:00:20,1,11,5674,239,5435,8.66%,4.21%
2020-01-01 00:00:20,1,12,9958,786,9172,15.19%,7.89%
2020-01-01 00:00:20,2,1,502,3,499,0.77%,0.60%
2020-01-01 00:00:20,2,2,22444,3468,18976,34.25%,15.45%
2020-01-01 00:00:20,2,3,17772,2209,15563,27.12%,12.43%
2020-01-01 00:00:20,2,4,403,1,402,0.61%,0.25%
2020-01-01 00:00:20,2,5,10332,760,9572,15.77%,7.36%
2020-01-01 00:00:20,2,6,45,0,45,0.07%,0.00%
2020-01-01 00:00:20,2,7,4149,132,4017,6.33%,3.18%
2020-01-01 00:00:20,2,8,3151,78,3073,4.81%,2.47%
2020-01-01 00:00:20,2,9,10296,755,9541,15.71%,7.33%
2020-01-01 00:00:20,2,10,2389,50,2339,3.65%,2.09%
2020-01-01 00:00:20,2,11,2405,50,2355,3.67%,2.08%
2020-01-01 00:00:20,2,12,10144,736,9408,15.48%,7.25%
2020-01-01 00:00:20,3,1,1465,19,1446,2.24%,1.30%
2020-01-01 00:00:20,3,2,24362,3970,20392,37.17%,16.30%
2020-01-01 00:00:20,3,3,75842,30671,45171,115.73%,40.44%
2020-01-01 00:00:20,3,4,12906,1194,11712,19.69%,9.25%
2020-01-01 00:00:20,3,5,50466,15107,35359,77.01%,29.93%
2020-01-01 00:00:20,3,6,14244,1424,12820,21.73%,10.00%
2020-01-01 00:00:20,3,7,21078,3011,18067,32.16%,14.28%
2020-01-01 00:00:20,3,8,17352,2113,15239,26.48%,12.18%
2020-01-01 00:00:20,3,9,35877,8232,27645,54.74%,22.94%
2020-01-01 00:00:20,3,10,5990,260,5730,9.14%,4.34%
2020-01-01 00:00:20,3,11,1893,26,1867,2.89%,1.37%
2020-01-01 00:00:20,3,12,25529,4335,21194,38.95%,16.98%
2020-01-01 00:00:20,4,1,616,1,615,0.94%,0.16%
2020-01-01 00:00:20,4,2,396,0,396,0.60%,0.00%
2020-01-01 00:00:20,4,3,746,3,743,1.14%,0.40%
2020-01-01 00:00:20,4,4,29003,5524,23479,44.26%,19.05%
2020-01-01 00:00:20,4,5,17944,2228,15716,27.38%,12.42%
2020-01-01 00:00:20,4,6,24713,4073,20640,37.71%,16.48%
2020-01-01 00:00:20,4,7,5716,241,5475,8.72%,4.22%
2020-01-01 00:00:20,4,8,3372,76,3296,5.15%,2.25%
2020-01-01 00:00:20,4,9,15866,1732,14134,24.21%,10.92%
2020-01-01 00:00:20,4,10,2023,45,1978,3.09%,2.22%
2020-01-01 00:00:20,4,11,135,0,135,0.21%,0.00%
2020-01-01 00:00:20,4,12,12548,1089,11459,19.15%,8.68%
2020-01-01 00:00:20,5,1,3065,76,2989,4.68%,2.48%
2020-01-01 00:00:20,5,2,754,5,749,1.15%,0.66%
2020-01-01 00:00:20,5,3,484,2,482,0.74%,0.41%
2020-01-01 00:00:20,5,4,23517,3785,19732,35.88%,16.09%
2020-01-01 00:00:20,5,5,8297,520,7777,12.66%,6.27%
2020-01-01 00:00:20,5,6,13605,1345,12260,20.76%,9.89%
2020-01-01 00:00:20,5,7,4849,171,4678,7.40%,3.53%
2020-01-01 00:00:20,5,8,3690,99,3591,5.63%,2.68%
2020-01-01 00:00:20,5,9,7664,455,7209,11.69%,5.94%
2020-01-01 00:00:20,5,10,909,8,901,1.39%,0.88%
2020-01-01 00:00:20,5,11,525,6,519,0.80%,1.14%
2020-01-01 00:00:20,5,12,6639,345,6294,10.13%,5.20%
2020-01-01 00:00:20,6,1,1157,8,1149,1.77%,0.69%
2020-01-01 00:00:20,6,2,1202,8,1194,1.83%,0.67%
2020-01-01 00:00:20,6,3,1872,23,1849,2.86%,1.23%
2020-01-01 00:00:20,6,4,1364,11,1353,2.08%,0.81%
2020-01-01 00:00:20,6,5,14135,1425,12710,21.57%,10.08%
2020-01-01 00:00:20,6,6,4540,131,4409,6.93%,2.88%
2020-01-01 00:00:20,6,7,2559,47,2512,3.90%,1.84%
2020-01-01 00:00:20,6,8,1803,27,1776,2.75%,1.50%
2020-01-01 00:00:20,6,9,7501,435,7066,11.45%,5.80%
2020-01-01 00:00:20,6,10,2338,43,2295,3.57%,1.84%
2020-01-01 00:00:20,6,11,441,2,439,0.67%,0.45%
2020-01-01 00:00:20,6,12,5110,198,4912,7.80%,3.87%
2020-01-01 00:00:20,7,1,462,3,459,0.70%,0.65%
2020-01-01 00:00:20,7,2,181,2,179,0.28%,1.10%
2020-01-01 00:00:20,7,3,563,1,562,0.86%,0.18%
2020-01-01 00:00:20,7,4,1646,23,1623,2.51%,1.40%
2020-01-01 00:00:20,7,5,7685,448,7237,11.73%,5.83%
2020-01-01 00:00:20,7,6,13185,1293,11892,20.12%,9.81%
2020-01-01 00:00:20,7,7,3769,86,3683,5.75%,2.28%
2020-01-01 00:00:20,7,8,1459,18,1441,2.23%,1.23%
2020-01-01 00:00:20,7,9,7052,373,6679,10.76%,5.29%
2020-01-01 00:00:20,7,10,1553,10,1543,2.37%,0.64%
2020-01-01 00:00:20,7,11,122,0,122,0.19%,0.00%
2020-01-01 00:00:20,7,12,5455,236,5219,8.32%,4.33%
2020-01-01 00:00:20,8,1,435,0,435,0.66%,0.00%
2020-01-01 00:00:20,8,2,72,0,72,0.11%,0.00%
2020-01-01 00:00:20,8,3,1794,19,1775,2.74%,1.06%
2020-01-01 00:00:20,8,4,2695,66,2629,4.11%,2.45%
2020-01-01 00:00:20,8,5,8352,508,7844,12.74%,6.08%
2020-01-01 00:00:20,8,6,15996,1845,14151,24.41%,11.53%
2020-01-01 00:00:20,8,7,4723,155,4568,7.21%,3.28%
2020-01-01 00:00:20,8,8,1941,19,1922,2.96%,0.98%
2020-01-01 00:00:20,8,9,6306,316,5990,9.62%,5.01%
2020-01-01 00:00:20,8,10,1584,17,1567,2.42%,1.07%
2020-01-01 00:00:20,8,11,128,1,127,0.20%,0.78%
2020-01-01 00:00:20,8,12,4687,182,4505,7.15%,3.88%
2020-01-01 00:00:20,9,1,473,3,470,0.72%,0.63%
2020-01-01 00:00:20,9,2,3043,74,2969,4.64%,2.43%
2020-01-01 00:00:20,9,3,2234,33,2201,3.41%,1.48%
2020-01-01 00:00:20,9,4,3664,86,3578,5.59%,2.35%
2020-01-01 00:00:20,9,5,186,0,186,0.28%,0.00%
2020-01-01 00:00:20,9,6,4660,140,4520,7.11%,3.00%
2020-01-01 00:00:20,9,7,26143,4652,21491,39.89%,17.79%
2020-01-01 00:00:20,9,8,9099,650,8449,13.88%,7.14%
2020-01-01 00:00:20,9,9,127,0,127,0.19%,0.00%
2020-01-01 00:00:20,9,10,2866,85,2781,4.37%,2.96%
2020-01-01 00:00:20,9,11,7910,497,7413,12.07%,6.28%
2020-01-01 00:00:20,9,12,4729,184,4545,7.22%,3.89%
2020-01-01 00:00:20,10,1,1139,170,969,1.74%,14.91%
2020-01-01 00:00:20,10,2,4488,303,4185,6.85%,6.75%
2020-01-01 00:00:20,10,3,3187,69,3118,4.86%,2.16%
2020-01-01 00:00:20,10,4,4528,1119,3409,6.91%,24.71%
2020-01-01 00:00:20,10,5,709,53,656,1.08%,7.46%
2020-01-01 00:00:20,10,6,6255,1279,4976,9.54%,20.44%
2020-01-01 00:00:20,10,7,12696,2153,10543,19.37%,16.96%
2020-01-01 00:00:20,10,8,30111,7528,22583,45.95%,25.00%
2020-01-01 00:00:20,10,9,822,0,822,1.25%,0.00%
2020-01-01 00:00:20,10,10,2420,36,2384,3.69%,1.49%
2020-01-01 00:00:20,10,11,13754,1710,12044,20.99%,12.43%
2020-01-01 00:00:20,10,12,10613,1226,9387,16.19%,11.55%
2020-01-01 00:00:20,11,1,2670,51,2619,4.07%,1.91%
2020-01-01 00:00:20,11,2,4289,156,4133,6.54%,3.64%
2020-01-01 00:00:20,11,3,1439,47,1392,2.20%,3.26%
2020-01-01 00:00:20,11,4,4476,158,4318,6.83%,3.53%
2020-01-01 00:00:20,11,5,262,0,262,0.40%,0.00%
2020-01-01 00:00:20,11,6,5422,226,5196,8.27%,4.17%
2020-01-01 00:00:20,11,7,11365,950,10415,17.34%,8.36%
2020-01-01 00:00:20,11,8,27618,4992,22626,42.14%,18.07%
2020-01-01 00:00:20,11,9,316,0,316,0.48%,0.00%
2020-01-01 00:00:20,11,10,4169,129,4040,6.36%,3.09%
2020-01-01 00:00:20,11,11,11565,985,10580,17.65%,8.52%
2020-01-01 00:00:20,11,12,7060,385,6675,10.77%,5.45%
2020-01-01 00:00:20,12,1,38,0,38,0.06%,0.00%
2020-01-01 00:00:20,12,2,709,169,540,1.08%,23.80%
2020-01-01 00:00:20,12,3,2716,232,2484,4.14%,8.54%
2020-01-01 00:00:20,12,4,3809,79,3730,5.81%,2.07%
2020-01-01 00:00:20,12,5,9472,794,8678,14.45%,8.38%
2020-01-01 00:00:20,12,6,5937,235,5702,9.06%,3.96%
2020-01-01 00:00:20,12,7,1908,31,1877,2.91%,1.62%
2020-01-01 00:00:20,12,8,1623,289,1334,2.48%,17.80%
2020-01-01 00:00:20,12,9,22663,4274,18389,34.58%,18.86%
2020-01-01 00:00:20,12,10,4416,417,3999,6.74%,9.44%
2020-01-01 00:00:20,12,11,1748,293,1455,2.67%,16.75%
2020-01-01 00:00:20,12,12,8258,951,7307,12.60%,11.51%
2020-01-01 00:00:20,13,1,2292,49,2243,3.50%,2.14%
2020-01-01 00:00:20,13,2,2659,101,2558,4.06%,3.80%
2020-01-01 00:00:20,13,3,702,4,698,1.07%,0.57%
2020-01-01 00:00:20,13,4,5996,628,5368,9.15%,10.47%
2020-01-01 00:00:20,13,5,8211,954,7257,12.53%,11.62%
2020-01-01 00:00:20,13,6,6709,693,6016,10.24%,10.33%
2020-01-01 00:00:20,13,7,4734,247,4487,7.22%,5.22%
2020-01-01 00:00:20,13,8,7345,460,6885,11.21%,6.26%
2020-01-01 00:00:20,13,9,8565,992,7573,13.07%,11.58%
2020-01-01 00:00:20,13,10,30774,7196,23578,46.96%,23.38%
2020-01-01 00:00:20,13,11,19378,3340,16038,29.57%,17.24%
2020-01-01 00:00:20,13,12,11609,1726,9883,17.71%,14.87%
2020-01-01 00:00:20,14,1,213,0,213,0.33%,0.00%
2020-01-01 00:00:20,14,2,1288,21,1267,1.97%,1.63%
2020-01-01 00:00:20,14,3,885,10,875,1.35%,1.13%
2020-01-01 00:00:20,14,4,5217,200,5017,7.96%,3.83%
2020-01-01 00:00:20,14,5,1152,13,1139,1.76%,1.13%
2020-01-01 00:00:20,14,6,5552,219,5333,8.47%,3.94%
2020-01-01 00:00:20,14,7,12794,1183,11611,19.52%,9.25%
2020-01-01 00:00:20,14,8,14412,1493,12919,21.99%,10.36%
2020-01-01 00:00:20,14,9,1269,15,1254,1.94%,1.18%
2020-01-01 00:00:20,14,10,3382,78,3304,5.16%,2.31%
2020-01-01 00:00:20,14,11,26274,4576,21698,40.09%,17.42%
2020-01-01 00:00:20,14,12,8132,457,7675,12.41%,5.62%
2020-01-01 00:00:20,15,1,556,3,553,0.85%,0.54%
2020-01-01 00:00:20,15,2,171,0,171,0.26%,0.00%
2020-01-01 00:00:20,15,3,4222,145,4077,6.44%,3.43%
2020-01-01 00:00:20,15,4,5054,177,4877,7.71%,3.50%
2020-01-01 00:00:20,15,5,10146,747,9399,15.48%,7.36%
2020-01-01 00:00:20,15,6,5284,200,5084,8.06%,3.78%
2020-01-01 00:00:20,15,7,3687,144,3543,5.63%,3.90%
2020-01-01 00:00:20,15,8,6118,329,5789,9.34%,5.38%
2020-01-01 00:00:20,15,9,10301,766,9535,15.72%,7.44%
2020-01-01 00:00:20,15,10,5303,188,5115,8.09%,3.54%
2020-01-01 00:00:20,15,11,11565,963,10602,17.65%,8.33%
2020-01-01 00:00:20,15,12,27152,5199,21953,41.43%,19.15%
2020-01-01 00:00:20,16,1,569,3,566,0.87%,0.53%
2020-01-01 00:00:20,16,2,325,1,324,0.50%,0.31%
2020-01-01 00:00:20,16,3,1864,24,1840,2.84%,1.29%
2020-01-01 00:00:20,16,4,3699,88,3611,5.64%,2.38%
2020-01-01 00:00:20,16,5,7485,443,7042,11.42%,5.92%
2020-01-01 00:00:20,16,6,4430,143,4287,6.76%,3.23%
2020-01-01 00:00:20,16,7,3760,101,3659,5.74%,2.69%
2020-01-01 00:00:20,16,8,7460,498,6962,11.38%,6.67%
2020-01-01 00:00:20,16,9,7909,490,7419,12.07%,6.19%
2020-01-01 00:00:20,16,10,1415,18,1397,2.16%,1.27%
2020-01-01 00:00:20,16,11,9161,676,8485,13.98%,7.38%
2020-01-01 00:00:20,16,12,24902,4186,20716,38.00%,16.81%
2020-01-01 00:00:30,1,1,16422,1917,14505,25.06%,11.67%
2020-01-01 00:00:30,1,2,5334,227,5107,8.14%,4.25%
2020-01-01 00:00:30,1,3,573,3,570,0.87%,0.52%
2020-01-01 00:00:30,1,4,10718,844,9874,16.35%,7.87%
2020-01-01 00:00:30,1,5,10502,816,9686,16.02%,7.77%
2020-01-01 00:00:30,1,6,10476,807,9669,15.99%,7.70%
2020-01-01 00:00:30,1,7,4745,179,4566,7.24%,3.77%
2020-01-01 00:00:30,1,8,3894,119,3775,5.94%,3.06%
2020-01-01 00:00:30,1,9,10396,794,9602,15.86%,7.64%
2020-01-01 00:00:30,1,10,3281,93,3188,5.01%,2.83%
2020-01-01 00:00:30,1,11,3391,97,3294,5.17%,2.86%
2020-01-01 00:00:30,1,12,10379,792,9587,15.84%,7.63%
2020-01-01 00:00:30,2,1,1648,2,1646,2.51%,0.12%
2020-01-01 00:00:30,2,2,26189,4621,21568,39.96%,17.64%
2020-01-01 00:00:30,2,3,19321,2575,16746,29.48%,13.33%
2020-01-01 00:00:30,2,4,1538,2,1536,2.35%,0.13%
2020-01-01 00:00:30,2,5,12678,1113,11565,19.35%,8.78%
2020-01-01 00:00:30,2,6,52,0,52,0.08%,0.00%
2020-01-01 00:00:30,2,7,5212,210,5002,7.95%,4.03%
2020-01-01 00:00:30,2,8,4067,120,3947,6.21%,2.95%
2020-01-01 00:00:30,2,9,12563,1091,11472,19.17%,8.68%
2020-01-01 00:00:30,2,10,3400,85,3315,5.19%,2.50%
2020-01-01 00:00:30,2,11,3452,89,3363,5.27%,2.58%
2020-01-01 00:00:30,2,12,12312,1055,11257,18.79%,8.57%
2020-01-01 00:00:30,3,1,1547,16,1531,2.36%,1.03%
2020-01-01 00:00:30,3,2,22106,3311,18795,33.73%,14.98%
2020-01-01 00:00:30,3,3,74655,30242,44413,113.91%,40.51%
2020-01-01 00:00:30,3,4,9031,608,8423,13.78%,6.73%
2020-01-01 00:00:30,3,5,51167,15815,35352,78.07%,30.91%
2020-01-01 00:00:30,3,6,10538,819,9719,16.08%,7.77%
2020-01-01 00:00:30,3,7,19136,2519,16617,29.20%,13.16%
2020-01-01 00:00:30,3,8,15580,1748,13832,23.77%,11.22%
2020-01-01 00:00:30,3,9,40260,10294,29966,61.43%,25.57%
2020-01-01 00:00:30,3,10,5190,195,4995,7.92%,3.76%
2020-01-01 00:00:30,3,11,1579,20,1559,2.41%,1.27%
2020-01-01 00:00:30,3,12,33136,7206,25930,50.56%,21.75%
2020-01-01 00:00:30,4,1,501,4,497,0.76%,0.80%
2020-01-01 00:00:30,4,2,323,3,320,0.49%,0.93%
2020-01-01 00:00:30,4,3,740,7,733,1.13%,0.94%
2020-01-01 00:00:30,4,4,26383,4671,21712,40.26%,17.70%
2020-01-01 00:00:30,4,5,16845,1990,14855,25.70%,11.81%
2020-01-01 00:00:30,4,6,22627,3519,19108,34.53%,15.55%
2020-01-01 00:00:30,4,7,4529,174,4355,6.91%,3.84%
2020-01-01 00:00:30,4,8,2675,62,2613,4.08%,2.32%
2020-01-01 00:00:30,4,9,15025,1577,13448,22.93%,10.50%
2020-01-01 00:00:30,4,10,1958,37,1921,2.99%,1.89%
2020-01-01 00:00:30,4,11,108,0,108,0.16%,0.00%
2020-01-01 00:00:30,4,12,12415,1063,11352,18.94%,8.56%
2020-01-01 00:00:30,5,1,2907,71,2836,4.44%,2.44%
2020-01-01 00:00:30,5,2,699,4,695,1.07%,0.57%
2020-01-01 00:00:30,5,3,542,2,540,0.83%,0.37%
2020-01-01 00:00:30,5,4,27668,5080,22588,42.22%,18.36%
2020-01-01 00:00:30,5,5,9485,656,8829,14.47%,6.92%
2020-01-01 00:00:30,5,6,15146,1621,13525,23.11%,10.70%
2020-01-01 00:00:30,5,7,5186,209,4977,7.91%,4.03%
2020-01-01 00:00:30,5,8,3310,79,3231,5.05%,2.39%
2020-01-01 00:00:30,5,9,8796,576,8220,13.42%,6.55%
2020-01-01 00:00:30,5,10,1003,6,997,1.53%,0.60%
2020-01-01 00:00:30,5,11,895,5,890,1.37%,0.56%
2020-01-01 00:00:30,5,12,7549,452,7097,11.52%,5.99%
2020-01-01 00:00:30,6,1,1143,4,1139,1.74%,0.35%
2020-01-01 00:00:30,6,2,1256,5,1251,1.92%,0.40%
2020-01-01 00:00:30,6,3,1756,17,1739,2.68%,0.97%
2020-01-01 00:00:30,6,4,1364,9,1355,2.08%,0.66%
2020-01-01 00:00:30,6,5,17436,2104,15332,26.61%,12.07%
2020-01-01 00:00:30,6,6,4490,134,4356,6.85%,2.98%
2020-01-01 00:00:30,6,7,2588,54,2534,3.95%,2.09%
2020-01-01 00:00:30,6,8,2134,36,2098,3.26%,1.69%
2020-01-01 00:00:30,6,9,10888,862,10026,16.61%,7.92%
2020-01-01 00:00:30,6,10,2620,67,2553,4.00%,2.56%
2020-01-01 00:00:30,6,11,428,3,425,0.65%,0.70%
2020-01-01 00:00:30,6,12,8119,474,7645,12.39%,5.84%
2020-01-01 00:00:30,7,1,295,1,294,0.45%,0.34%
2020-01-01 00:00:30,7,2,278,2,276,0.42%,0.72%
2020-01-01 00:00:30,7,3,1441,10,1431,2.20%,0.69%
2020-01-01 00:00:30,7,4,1498,21,1477,2.29%,1.40%
2020-01-01 00:00:30,7,5,7953,478,7475,12.14%,6.01%
2020-01-01 00:00:30,7,6,13176,1174,12002,20.10%,8.91%
2020-01-01 00:00:30,7,7,3690,90,3600,5.63%,2.44%
2020-01-01 00:00:30,7,8,1447,11,1436,2.21%,0.76%
2020-01-01 00:00:30,7,9,6431,292,6139,9.81%,4.54%
2020-01-01 00:00:30,7,10,2005,19,1986,3.06%,0.95%
2020-01-01 00:00:30,7,11,103,0,103,0.16%,0.00%
2020-01-01 00:00:30,7,12,4413,136,4277,6.73%,3.08%
2020-01-01 00:00:30,8,1,366,3,363,0.56%,0.82%
2020-01-01 00:00:30,8,2,101,1,100,0.15%,0.98%
2020-01-01 00:00:30,8,3,1695,21,1674,2.59%,1.24%
2020-01-01 00:00:30,8,4,2555,47,2508,3.90%,1.84%
2020-01-01 00:00:30,8,5,8355,546,7809,12.75%,6.53%
2020-01-01 00:00:30,8,6,15801,1752,14049,24.11%,11.09%
2020-01-01 00:00:30,8,7,4788,158,4630,7.31%,3.30%
2020-01-01 00:00:30,8,8,1777,24,1753,2.71%,1.35%
2020-01-01 00:00:30,8,9,6451,333,6118,9.84%,5.16%
2020-01-01 00:00:30,8,10,2020,39,1981,3.08%,1.93%
2020-01-01 00:00:30,8,11,147,0,147,0.22%,0.00%
2020-01-01 00:00:30,8,12,4323,160,4163,6.60%,3.70%
2020-01-01 00:00:30,9,1,308,1,307,0.47%,0.32%
2020-01-01 00:00:30,9,2,6685,360,6325,10.20%,5.38%
2020-01-01 00:00:30,9,3,5845,280,5565,8.92%,4.79%
2020-01-01 00:00:30,9,4,11858,993,10865,18.09%,8.37%
2020-01-01 00:00:30,9,5,292,0,292,0.45%,0.00%
2020-01-01 00:00:30,9,6,12356,1093,11263,18.85%,8.85%
2020-01-01 00:00:30,9,7,33818,7429,26389,51.60%,21.97%
2020-01-01 00:00:30,9,8,9773,726,9047,14.91%,7.43%
2020-01-01 00:00:30,9,9,174,0,174,0.27%,0.00%
2020-01-01 00:00:30,9,10,2518,58,2460,3.84%,2.30%
2020-01-01 00:00:30,9,11,8395,539,7856,12.81%,6.42%
2020-01-01 00:00:30,9,12,5569,226,5343,8.50%,4.06%
2020-01-01 00:00:30,10,1,1112,272,840,1.70%,24.44%
2020-01-01 00:00:30,10,2,2944,331,2613,4.49%,11.24%
2020-01-01 00:00:30,10,3,1589,41,1548,2.42%,2.58%
2020-01-01 00:00:30,10,4,3650,923,2727,5.57%,25.28%
2020-01-01 00:00:30,10,5,510,5,505,0.78%,0.98%
2020-01-01 00:00:30,10,6,5541,1037,4504,8.45%,18.71%
2020-01-01 00:00:30,10,7,10181,1756,8425,15.53%,17.25%
2020-01-01 00:00:30,10,8,26451,6467,19984,40.36%,24.45%
2020-01-01 00:00:30,10,9,688,4,684,1.05%,0.58%
2020-01-01 00:00:30,10,10,2508,34,2474,3.83%,1.36%
2020-01-01 00:00:30,10,11,12201,1392,10809,18.62%,11.41%
2020-01-01 00:00:30,10,12,8828,923,7905,13.47%,10.45%
2020-01-01 00:00:30,11,1,1809,28,1781,2.76%,1.55%
2020-01-01 00:00:30,11,2,3579,74,3505,5.46%,2.07%
2020-01-01 00:00:30,11,3,1600,9,1591,2.44%,0.56%
2020-01-01 00:00:30,11,4,4046,131,3915,6.17%,3.24%
2020-01-01 00:00:30,11,5,209,0,209,0.32%,0.00%
2020-01-01 00:00:30,11,6,4839,190,4649,7.38%,3.93%
2020-01-01 00:00:30,11,7,10422,787,9635,15.90%,7.55%
2020-01-01 00:00:30,11,8,24364,3972,20392,37.18%,16.30%
2020-01-01 00:00:30,11,9,222,0,222,0.34%,0.00%
2020-01-01 00:00:30,11,10,3338,78,3260,5.09%,2.34%
2020-01-01 00:00:30,11,11,10471,740,9731,15.98%,7.07%
2020-01-01 00:00:30,11,12,6940,342,6598,10.59%,4.93%
2020-01-01 00:00:30,12,1,17,0,17,0.03%,0.00%
2020-01-01 00:00:30,12,2,639,218,421,0.98%,34.06%
2020-01-01 00:00:30,12,3,2392,247,2145,3.65%,10.32%
2020-01-01 00:00:30,12,4,2586,43,2543,3.95%,1.66%
2020-01-01 00:00:30,12,5,9280,780,8500,14.16%,8.40%
2020-01-01 00:00:30,12,6,6061,262,5799,9.25%,4.32%
2020-01-01 00:00:30,12,7,3346,85,3261,5.11%,2.54%
2020-01-01 00:00:30,12,8,1201,174,1027,1.83%,14.48%
2020-01-01 00:00:30,12,9,20998,3913,17085,32.04%,18.63%
2020-01-01 00:00:30,12,10,3989,279,3710,6.09%,6.99%
2020-01-01 00:00:30,12,11,1429,178,1251,2.18%,12.45%
2020-01-01 00:00:30,12,12,7087,967,6120,10.81%,13.64%
2020-01-01 00:00:30,13,1,2388,48,2340,3.64%,2.01%
2020-01-01 00:00:30,13,2,2872,66,2806,4.38%,2.30%
2020-01-01 00:00:30,13,3,627,3,624,0.96%,0.48%
2020-01-01 00:00:30,13,4,5171,701,4470,7.89%,13.55%
2020-01-01 00:00:30,13,5,7748,991,6757,11.82%,12.79%
2020-01-01 00:00:30,13,6,6281,779,5502,9.58%,12.40%
2020-01-01 00:00:30,13,7,5687,236,5451,8.68%,4.15%
2020-01-01 00:00:30,13,8,7946,430,7516,12.12%,5.41%
2020-01-01 00:00:30,13,9,7939,1008,6931,12.11%,12.70%
2020-01-01 00:00:30,13,10,28562,6141,22421,43.58%,21.50%
2020-01-01 00:00:30,13,11,18126,2683,15443,27.66%,14.80%
2020-01-01 00:00:30,13,12,9523,1091,8432,14.53%,11.46%
2020-01-01 00:00:30,14,1,450,0,450,0.69%,0.00%
2020-01-01 00:00:30,14,2,1722,16,1706,2.63%,0.93%
2020-01-01 00:00:30,14,3,1149,5,1144,1.75%,0.43%
2020-01-01 00:00:30,14,4,4261,129,4132,6.50%,3.03%
2020-01-01 00:00:30,14,5,1293,17,1276,1.97%,1.31%
2020-01-01 00:00:30,14,6,4456,133,4323,6.80%,2.98%
2020-01-01 00:00:30,14,7,11451,934,10517,17.47%,8.16%
2020-01-01 00:00:30,14,8,13401,1264,12137,20.45%,9.43%
2020-01-01 00:00:30,14,9,1650,25,1625,2.52%,1.51%
2020-01-01 00:00:30,14,10,3818,107,3711,5.83%,2.80%
2020-01-01 00:00:30,14,11,25008,4220,20788,38.16%,16.87%
2020-01-01 00:00:30,14,12,7532,410,7122,11.49%,5.44%
2020-01-01 00:00:30,15,1,442,0,442,0.67%,0.00%
2020-01-01 00:00:30,15,2,132,0,132,0.20%,0.00%
2020-01-01 00:00:30,15,3,3915,110,3805,5.97%,2.81%
2020-01-01 00:00:30,15,4,5876,264,5612,8.97%,4.49%
2020-01-01 00:00:30,15,5,11584,997,10587,17.68%,8.61%
2020-01-01 00:00:30,15,6,6092,282,5810,9.30%,4.63%
2020-01-01 00:00:30,15,7,4412,180,4232,6.73%,4.08%
2020-01-01 00:00:30,15,8,6335,333,6002,9.67%,5.26%
2020-01-01 00:00:30,15,9,11803,1028,10775,18.01%,8.71%
2020-01-01 00:00:30,15,10,4419,143,4276,6.74%,3.24%
2020-01-01 00:00:30,15,11,10893,887,10006,16.62%,8.14%
2020-01-01 00:00:30,15,12,27586,5318,22268,42.09%,19.28%
2020-01-01 00:00:30,16,1,353,5,348,0.54%,1.41%
2020-01-01 00:00:30,16,2,285,0,285,0.43%,0.00%
2020-01-01 00:00:30,16,3,1221,8,1213,1.86%,0.65%
2020-01-01 00:00:30,16,4,4288,153,4135,6.54%,3.57%
2020-01-01 00:00:30,16,5,7681,556,7125,11.72%,7.24%
2020-01-01 00:00:30,16,6,5043,210,4833,7.70%,4.16%
2020-01-01 00:00:30,16,7,3639,96,3543,5.55%,2.64%
2020-01-01 00:00:30,16,8,7469,437,7032,11.40%,5.85%
2020-01-01 00:00:30,16,9,8127,591,7536,12.40%,7.27%
2020-01-01 00:00:30,16,10,1307,18,1289,1.99%,1.38%
2020-01-01 00:00:30,16,11,9127,625,8502,13.93%,6.85%
2020-01-01 00:00:30,16,12,25484,4516,20968,38.89%,17.72%
2020-01-01 00:00:40,1,1,16085,1905,14180,24.54%,11.84%
2020-01-01 00:00:40,1,2,6970,385,6585,10.64%,5.52%
2020-01-01 00:00:40,1,3,679,2,677,1.04%,0.29%
2020-01-01 00:00:40,1,4,8825,638,8187,13.47%,7.23%
2020-01-01 00:00:40,1,5,8495,607,7888,12.96%,7.14%
2020-01-01 00:00:40,1,6,8444,600,7844,12.88%,7.10%
2020-01-01 00:00:40,1,7,6276,316,5960,9.58%,5.03%
2020-01-01 00:00:40,1,8,5511,233,5278,8.41%,4.23%
2020-01-01 00:00:40,1,9,8403,596,7807,12.82%,7.09%
2020-01-01 00:00:40,1,10,4596,158,4438,7.01%,3.44%
2020-01-01 00:00:40,1,11,4775,178,4597,7.29%,3.73%
2020-01-01 00:00:40,1,12,8370,594,7776,12.77%,7.10%
2020-01-01 00:00:40,2,1,864,3,861,1.32%,0.35%
2020-01-01 00:00:40,2,2,29496,5832,23664,45.01%,19.77%
2020-01-01 00:00:40,2,3,24556,4119,20437,37.47%,16.77%
2020-01-01 00:00:40,2,4,826,3,823,1.26%,0.36%
2020-01-01 00:00:40,2,5,16417,1922,14495,25.05%,11.71%
2020-01-01 00:00:40,2,6,66,0,66,0.10%,0.00%
2020-01-01 00:00:40,2,7,4048,111,3937,6.18%,2.74%
2020-01-01 00:00:40,2,8,2545,46,2499,3.88%,1.81%
2020-01-01 00:00:40,2,9,16351,1909,14442,24.95%,11.67%
2020-01-01 00:00:40,2,10,1757,18,1739,2.68%,1.02%
2020-01-01 00:00:40,2,11,1780,20,1760,2.72%,1.12%
2020-01-01 00:00:40,2,12,16225,1884,14341,24.76%,11.61%
2020-01-01 00:00:40,3,1,1500,12,1488,2.29%,0.80%
2020-01-01 00:00:40,3,2,20832,2980,17852,31.79%,14.30%
2020-01-01 00:00:40,3,3,68882,26205,42677,105.11%,38.04%
2020-01-01 00:00:40,3,4,10469,763,9706,15.97%,7.29%
2020-01-01 00:00:40,3,5,47197,13645,33552,72.02%,28.91%
2020-01-01 00:00:40,3,6,11920,998,10922,18.19%,8.37%
2020-01-01 00:00:40,3,7,17491,2134,15357,26.69%,12.20%
2020-01-01 00:00:40,3,8,14663,1529,13134,22.37%,10.43%
2020-01-01 00:00:40,3,9,34973,7985,26988,53.36%,22.83%
2020-01-01 00:00:40,3,10,5003,201,4802,7.63%,4.02%
2020-01-01 00:00:40,3,11,2032,27,2005,3.10%,1.33%
2020-01-01 00:00:40,3,12,26200,4664,21536,39.98%,17.80%
2020-01-01 00:00:40,4,1,588,4,584,0.90%,0.68%
2020-01-01 00:00:40,4,2,374,2,372,0.57%,0.53%
2020-01-01 00:00:40,4,3,610,4,606,0.93%,0.65%
2020-01-01 00:00:40,4,4,29095,5593,23502,44.40%,19.22%
2020-01-01 00:00:40,4,5,17652,2153,15499,26.93%,12.20%
2020-01-01 00:00:40,4,6,24927,4182,20745,38.04%,16.78%
2020-01-01 00:00:40,4,7,5481,221,5260,8.36%,4.03%
2020-01-01 00:00:40,4,8,3154,91,3063,4.81%,2.88%
2020-01-01 00:00:40,4,9,15773,1730,14043,24.07%,10.97%
2020-01-01 00:00:40,4,10,1917,31,1886,2.93%,1.62%
2020-01-01 00:00:40,4,11,266,0,266,0.41%,0.00%
2020-01-01 00:00:40,4,12,13127,1222,11905,20.03%,9.31%
2020-01-01 00:00:40,5,1,2950,67,2883,4.50%,2.27%
2020-01-01 00:00:40,5,2,1417,18,1399,2.16%,1.27%
2020-01-01 00:00:40,5,3,755,4,751,1.15%,0.53%
2020-01-01 00:00:40,5,4,21708,3268,18440,33.12%,15.05%
2020-01-01 00:00:40,5,5,9980,731,9249,15.23%,7.32%
2020-01-01 00:00:40,5,6,14367,1485,12882,21.92%,10.34%
2020-01-01 00:00:40,5,7,4053,152,3901,6.18%,3.75%
2020-01-01 00:00:40,5,8,3084,93,2991,4.71%,3.01%
2020-01-01 00:00:40,5,9,9097,629,8468,13.88%,6.91%
2020-01-01 00:00:40,5,10,1556,20,1536,2.37%,1.28%
2020-01-01 00:00:40,5,11,648,8,640,0.99%,1.23%
2020-01-01 00:00:40,5,12,6992,394,6598,10.67%,5.63%
2020-01-01 00:00:40,6,1,1049,10,1039,1.60%,0.95%
2020-01-01 00:00:40,6,2,1210,13,1197,1.85%,1.07%
2020-01-01 00:00:40,6,3,1925,26,1899,2.94%,1.35%
2020-01-01 00:00:40,6,4,1299,9,1290,1.98%,0.69%
2020-01-01 00:00:40,6,5,14520,1504,13016,22.16%,10.36%
2020-01-01 00:00:40,6,6,5231,193,5038,7.98%,3.69%
2020-01-01 00:00:40,6,7,3553,92,3461,5.42%,2.59%
2020-01-01 00:00:40,6,8,3076,76,3000,4.69%,2.47%
2020-01-01 00:00:40,6,9,7120,391,6729,10.86%,5.49%
2020-01-01 00:00:40,6,10,1772,21,1751,2.70%,1.18%
2020-01-01 00:00:40,6,11,437,1,436,0.67%,0.23%
2020-01-01 00:00:40,6,12,5246,205,5041,8.00%,3.91%
2020-01-01 00:00:40,7,1,548,1,547,0.84%,0.18%
2020-01-01 00:00:40,7,2,223,0,223,0.34%,0.00%
2020-01-01 00:00:40,7,3,903,5,898,1.38%,0.55%
2020-01-01 00:00:40,7,4,1984,57,1927,3.03%,2.87%
2020-01-01 00:00:40,7,5,6770,380,6390,10.33%,5.61%
2020-01-01 00:00:40,7,6,12661,1241,11420,19.32%,9.80%
2020-01-01 00:00:40,7,7,3835,116,3719,5.85%,3.02%
2020-01-01 00:00:40,7,8,1815,33,1782,2.77%,1.82%
2020-01-01 00:00:40,7,9,5826,278,5548,8.89%,4.77%
2020-01-01 00:00:40,7,10,989,5,984,1.51%,0.51%
2020-01-01 00:00:40,7,11,45,0,45,0.07%,0.00%
2020-01-01 00:00:40,7,12,4808,183,4625,7.34%,3.81%
2020-01-01 00:00:40,8,1,384,0,384,0.59%,0.00%
2020-01-01 00:00:40,8,2,94,2,92,0.14%,2.11%
2020-01-01 00:00:40,8,3,1687,32,1655,2.57%,1.90%
2020-01-01 00:00:40,8,4,3056,67,2989,4.66%,2.19%
2020-01-01 00:00:40,8,5,8643,545,8098,13.19%,6.30%
2020-01-01 00:00:40,8,6,17224,2076,15148,26.28%,12.05%
2020-01-01 00:00:40,8,7,5458,263,5195,8.33%,4.82%
2020-01-01 00:00:40,8,8,2689,84,2605,4.10%,3.12%
2020-01-01 00:00:40,8,9,6723,333,6390,10.26%,4.95%
2020-01-01 00:00:40,8,10,1990,25,1965,3.04%,1.26%
2020-01-01 00:00:40,8,11,114,0,114,0.17%,0.00%
2020-01-01 00:00:40,8,12,4662,176,4486,7.11%,3.77%
2020-01-01 00:00:40,9,1,305,0,305,0.47%,0.00%
2020-01-01 00:00:40,9,2,1876,20,1856,2.86%,1.07%
2020-01-01 00:00:40,9,3,1074,6,1068,1.64%,0.56%
2020-01-01 00:00:40,9,4,7015,322,6693,10.70%,4.59%
2020-01-01 00:00:40,9,5,722,1,721,1.10%,0.14%
2020-01-01 00:00:40,9,6,8666,516,8150,13.22%,5.95%
2020-01-01 00:00:40,9,7,26032,4565,21467,39.72%,17.54%
2020-01-01 00:00:40,9,8,8906,567,8339,13.59%,6.37%
2020-01-01 00:00:40,9,9,265,0,265,0.40%,0.00%
2020-01-01 00:00:40,9,10,2358,33,2325,3.60%,1.40%
2020-01-01 00:00:40,9,11,7641,420,7221,11.66%,5.50%
2020-01-01 00:00:40,9,12,5025,195,4830,7.67%,3.88%
2020-01-01 00:00:40,10,1,1144,227,917,1.75%,19.83%
2020-01-01 00:00:40,10,2,3038,281,2757,4.64%,9.25%
2020-01-01 00:00:40,10,3,1774,30,1744,2.71%,1.69%
2020-01-01 00:00:40,10,4,4266,1078,3188,6.51%,25.26%
2020-01-01 00:00:40,10,5,859,55,804,1.31%,6.40%
2020-01-01 00:00:40,10,6,6296,1264,5032,9.61%,20.07%
2020-01-01 00:00:40,10,7,11112,2008,9104,16.96%,18.07%
2020-01-01 00:00:40,10,8,30729,8259,22470,46.89%,26.88%
2020-01-01 00:00:40,10,9,617,1,616,0.94%,0.16%
2020-01-01 00:00:40,10,10,2681,48,2633,4.09%,1.79%
2020-01-01 00:00:40,10,11,14669,1977,12692,22.38%,13.48%
2020-01-01 00:00:40,10,12,11196,1377,9819,17.08%,12.30%
2020-01-01 00:00:40,11,1,2077,34,2043,3.17%,1.64%
2020-01-01 00:00:40,11,2,3015,78,2937,4.60%,2.59%
2020-01-01 00:00:40,11,3,767,8,759,1.17%,1.04%
2020-01-01 00:00:40,11,4,4900,184,4716,7.48%,3.75%
2020-01-01 00:00:40,11,5,210,1,209,0.32%,0.47%
2020-01-01 00:00:40,11,6,5624,239,5385,8.58%,4.25%
2020-01-01 00:00:40,11,7,10404,840,9564,15.88%,8.07%
2020-01-01 00:00:40,11,8,24691,4106,20585,37.68%,16.63%
2020-01-01 00:00:40,11,9,407,1,406,0.62%,0.25%
2020-01-01 00:00:40,11,10,3340,91,3249,5.10%,2.72%
2020-01-01 00:00:40,11,11,10749,851,9898,16.40%,7.92%
2020-01-01 00:00:40,11,12,7094,376,6718,10.82%,5.30%
2020-01-01 00:00:40,12,1,35,0,35,0.05%,0.00%
2020-01-01 00:00:40,12,2,420,120,300,0.64%,28.50%
2020-01-01 00:00:40,12,3,2291,150,2141,3.50%,6.54%
2020-01-01 00:00:40,12,4,3347,81,3266,5.11%,2.42%
2020-01-01 00:00:40,12,5,8307,593,7714,12.68%,7.14%
2020-01-01 00:00:40,12,6,5405,221,5184,8.25%,4.09%
2020-01-01 00:00:40,12,7,1881,39,1842,2.87%,2.07%
2020-01-01 00:00:40,12,8,1553,225,1328,2.37%,14.48%
2020-01-01 00:00:40,12,9,24005,4662,19343,36.63%,19.42%
2020-01-01 00:00:40,12,10,4170,317,3853,6.36%,7.60%
2020-01-01 00:00:40,12,11,1744,230,1514,2.66%,13.18%
2020-01-01 00:00:40,12,12,8996,1257,7739,13.73%,13.97%
2020-01-01 00:00:40,13,1,1989,32,1957,3.03%,1.61%
2020-01-01 00:00:40,13,2,2374,43,2331,3.62%,1.81%
2020-01-01 00:00:40,13,3,623,2,621,0.95%,0.32%
2020-01-01 00:00:40,13,4,4711,585,4126,7.19%,12.42%
2020-01-01 00:00:40,13,5,6881,901,5980,10.50%,13.09%
2020-01-01 00:00:40,13,6,5205,615,4590,7.94%,11.81%
2020-01-01 00:00:40,13,7,4933,185,4748,7.53%,3.75%
2020-01-01 00:00:40,13,8,7138,397,6741,10.89%,5.56%
2020-01-01 00:00:40,13,9,7245,929,6316,11.05%,12.82%
2020-01-01 00:00:40,13,10,27089,5521,21568,41.33%,20.38%
2020-01-01 00:00:40,13,11,17281,2359,14922,26.37%,13.65%
2020-01-01 00:00:40,13,12,9759,1003,8756,14.89%,10.28%
2020-01-01 00:00:40,14,1,303,1,302,0.46%,0.33%
2020-01-01 00:00:40,14,2,1953,31,1922,2.98%,1.59%
2020-01-01 00:00:40,14,3,1437,11,1426,2.19%,0.76%
2020-01-01 00:00:40,14,4,3752,146,3606,5.73%,3.89%
2020-01-01 00:00:40,14,5,1754,24,1730,2.68%,1.37%
2020-01-01 00:00:40,14,6,4060,156,3904,6.20%,3.84%
2020-01-01 00:00:40,14,7,11524,954,10570,17.58%,8.28%
2020-01-01 00:00:40,14,8,13796,1364,12432,21.05%,9.89%
2020-01-01 00:00:40,14,9,2175,33,2142,3.32%,1.52%
2020-01-01 00:00:40,14,10,4743,172,4571,7.24%,3.63%
2020-01-01 00:00:40,14,11,28187,5289,22898,43.01%,18.76%
2020-01-01 00:00:40,14,12,9285,612,8673,14.17%,6.59%
2020-01-01 00:00:40,15,1,630,4,626,0.96%,0.63%
2020-01-01 00:00:40,15,2,140,0,140,0.21%,0.00%
2020-01-01 00:00:40,15,3,3156,72,3084,4.82%,2.28%
2020-01-01 00:00:40,15,4,5720,289,5431,8.73%,5.05%
2020-01-01 00:00:40,15,5,9794,788,9006,14.94%,8.04%
2020-01-01 00:00:40,15,6,5999,369,5630,9.15%,6.15%
2020-01-01 00:00:40,15,7,3437,97,3340,5.24%,2.82%
2020-01-01 00:00:40,15,8,6815,331,6484,10.40%,4.86%
2020-01-01 00:00:40,15,9,9967,809,9158,15.21%,8.12%
2020-01-01 00:00:40,15,10,9436,755,8681,14.40%,8.00%
2020-01-01 00:00:40,15,11,16401,1984,14417,25.03%,12.10%
2020-01-01 00:00:40,15,12,32609,7333,25276,49.76%,22.49%
2020-01-01 00:00:40,16,1,589,7,582,0.90%,1.19%
2020-01-01 00:00:40,16,2,250,2,248,0.38%,0.80%
2020-01-01 00:00:40,16,3,963,17,946,1.47%,1.76%
2020-01-01 00:00:40,16,4,4057,130,3927,6.19%,3.20%
2020-01-01 00:00:40,16,5,7665,485,7180,11.70%,6.33%
2020-01-01 00:00:40,16,6,4849,194,4655,7.40%,4.00%
2020-01-01 00:00:40,16,7,3268,79,3189,4.99%,2.42%
2020-01-01 00:00:40,16,8,7360,444,6916,11.23%,6.03%
2020-01-01 00:00:40,16,9,8152,541,7611,12.44%,6.64%
2020-01-01 00:00:40,16,10,1704,29,1675,2.60%,1.70%
2020-01-01 00:00:40,16,11,9383,678,8705,14.32%,7.23%
2020-01-01 00:00:40,16,12,26988,4922,22066,41.18%,18.24%
2020-01-01 00:00:50,1,1,21301,3159,18142,32.50%,14.83%
2020-01-01 00:00:50,1,2,7510,415,7095,11.46%,5.53%
2020-01-01 00:00:50,1,3,663,2,661,1.01%,0.30%
2020-01-01 00:00:50,1,4,13493,1336,12157,20.59%,9.90%
2020-01-01 00:00:50,1,5,12564,1170,11394,19.17%,9.31%
2020-01-01 00:00:50,1,6,12522,1161,11361,19.11%,9.27%
2020-01-01 00:00:50,1,7,6824,344,6480,10.41%,5.04%
2020-01-01 00:00:50,1,8,5729,231,5498,8.74%,4.03%
2020-01-01 00:00:50,1,9,12469,1150,11319,19.03%,9.22%
2020-01-01 00:00:50,1,10,5072,177,4895,7.74%,3.49%
2020-01-01 00:00:50,1,11,5157,187,4970,7.87%,3.63%
2020-01-01 00:00:50,1,12,12449,1146,11303,19.00%,9.20%
2020-01-01 00:00:50,2,1,1534,15,1519,2.34%,0.98%
2020-01-01 00:00:50,2,2,28353,5260,23093,43.26%,18.55%
2020-01-01 00:00:50,2,3,23997,3891,20106,36.62%,16.21%
2020-01-01 00:00:50,2,4,1465,9,1456,2.24%,0.61%
2020-01-01 00:00:50,2,5,15623,1769,13854,23.84%,11.32%
2020-01-01 00:00:50,2,6,27,0,27,0.04%,0.00%
2020-01-01 00:00:50,2,7,2795,48,2747,4.26%,1.72%
2020-01-01 00:00:50,2,8,1593,12,1581,2.43%,0.75%
2020-01-01 00:00:50,2,9,15522,1749,13773,23.68%,11.27%
2020-01-01 00:00:50,2,10,1133,6,1127,1.73%,0.53%
2020-01-01 00:00:50,2,11,1147,6,1141,1.75%,0.52%
2020-01-01 00:00:50,2,12,15402,1730,13672,23.50%,11.23%
2020-01-01 00:00:50,3,1,1808,26,1782,2.76%,1.44%
2020-01-01 00:00:50,3,2,23644,3875,19769,36.08%,16.39%
2020-01-01 00:00:50,3,3,72256,28336,43920,110.25%,39.22%
2020-01-01 00:00:50,3,4,10261,726,9535,15.66%,7.07%
2020-01-01 00:00:50,3,5,44922,12269,32653,68.55%,27.31%
2020-01-01 00:00:50,3,6,11486,911,10575,17.53%,7.93%
2020-01-01 00:00:50,3,7,20035,2842,17193,30.57%,14.18%
2020-01-01 00:00:50,3,8,16002,1860,14142,24.42%,11.62%
2020-01-01 00:00:50,3,9,32793,6925,25868,50.04%,21.12%
2020-01-01 00:00:50,3,10,3382,82,3300,5.16%,2.42%
2020-01-01 00:00:50,3,11,1977,32,1945,3.02%,1.62%
2020-01-01 00:00:50,3,12,27524,4986,22538,42.00%,18.11%
2020-01-01 00:00:50,4,1,584,4,580,0.89%,0.68%
2020-01-01 00:00:50,4,2,362,2,360,0.55%,0.55%
2020-01-01 00:00:50,4,3,651,0,651,0.99%,0.00%
2020-01-01 00:00:50,4,4,27076,4936,22140,41.31%,18.23%
2020-01-01 00:00:50,4,5,17426,2187,15239,26.59%,12.55%
2020-01-01 00:00:50,4,6,23422,3790,19632,35.74%,16.18%
2020-01-01 00:00:50,4,7,4559,168,4391,6.96%,3.68%
2020-01-01 00:00:50,4,8,2868,59,2809,4.38%,2.06%
2020-01-01 00:00:50,4,9,15649,1797,13852,23.88%,11.48%
2020-01-01 00:00:50,4,10,1770,18,1752,2.70%,1.02%
2020-01-01 00:00:50,4,11,209,1,208,0.32%,0.48%
2020-01-01 00:00:50,4,12,12934,1207,11727,19.74%,9.33%
2020-01-01 00:00:50,5,1,2639,52,2587,4.03%,1.97%
2020-01-01 00:00:50,5,2,791,3,788,1.21%,0.38%
2020-01-01 00:00:50,5,3,618,2,616,0.94%,0.32%
2020-01-01 00:00:50,5,4,25061,4290,20771,38.24%,17.12%
2020-01-01 00:00:50,5,5,9883,702,9181,15.08%,7.10%
2020-01-01 00:00:50,5,6,15385,1677,13708,23.48%,10.90%
2020-01-01 00:00:50,5,7,5000,192,4808,7.63%,3.84%
2020-01-01 00:00:50,5,8,3477,94,3383,5.31%,2.70%
2020-01-01 00:00:50,5,9,9072,589,8483,13.84%,6.49%
2020-01-01 00:00:50,5,10,1279,19,1260,1.95%,1.48%
2020-01-01 00:00:50,5,11,1055,14,1041,1.61%,1.33%
2020-01-01 00:00:50,5,12,7284,371,6913,11.11%,5.09%
2020-01-01 00:00:50,6,1,1105,5,1100,1.69%,0.45%
2020-01-01 00:00:50,6,2,1248,11,1237,1.90%,0.88%
2020-01-01 00:00:50,6,3,1733,31,1702,2.64%,1.79%
2020-01-01 00:00:50,6,4,1357,23,1334,2.07%,1.69%
2020-01-01 00:00:50,6,5,16019,1806,14213,24.44%,11.27%
2020-01-01 00:00:50,6,6,4006,122,3884,6.11%,3.04%
2020-01-01 00:00:50,6,7,2328,50,2278,3.55%,2.15%
2020-01-01 00:00:50,6,8,1783,30,1753,2.72%,1.68%
2020-01-01 00:00:50,6,9,10025,749,9276,15.30%,7.47%
2020-01-01 00:00:50,6,10,2457,48,2409,3.75%,1.95%
2020-01-01 00:00:50,6,11,388,2,386,0.59%,0.51%
2020-01-01 00:00:50,6,12,7507,410,7097,11.45%,5.46%
2020-01-01 00:00:50,7,1,497,1,496,0.76%,0.20%
2020-01-01 00:00:50,7,2,140,0,140,0.21%,0.00%
2020-01-01 00:00:50,7,3,1407,17,1390,2.15%,1.21%
2020-01-01 00:00:50,7,4,2182,23,2159,3.33%,1.05%
2020-01-01 00:00:50,7,5,6747,306,6441,10.30%,4.53%
2020-01-01 00:00:50,7,6,12958,1170,11788,19.77%,9.03%
2020-01-01 00:00:50,7,7,3923,122,3801,5.99%,3.11%
2020-01-01 00:00:50,7,8,1572,23,1549,2.40%,1.46%
2020-01-01 00:00:50,7,9,5206,182,5024,7.94%,3.50%
2020-01-01 00:00:50,7,10,1384,10,1374,2.11%,0.72%
2020-01-01 00:00:50,7,11,211,0,211,0.32%,0.00%
2020-01-01 00:00:50,7,12,3798,106,3692,5.80%,2.79%
2020-01-01 00:00:50,8,1,329,1,328,0.50%,0.30%
2020-01-01 00:00:50,8,2,132,0,132,0.20%,0.00%
2020-01-01 00:00:50,8,3,1507,20,1487,2.30%,1.33%
2020-01-01 00:00:50,8,4,2302,44,2258,3.51%,1.91%
2020-01-01 00:00:50,8,5,8168,490,7678,12.46%,6.00%
2020-01-01 00:00:50,8,6,15555,1757,13798,23.74%,11.29%
2020-01-01 00:00:50,8,7,5013,200,4813,7.65%,3.99%
2020-01-01 00:00:50,8,8,2061,30,2031,3.14%,1.45%
2020-01-01 00:00:50,8,9,6426,320,6106,9.81%,4.98%
2020-01-01 00:00:50,8,10,1865,22,1843,2.85%,1.18%
2020-01-01 00:00:50,8,11,254,0,254,0.39%,0.00%
2020-01-01 00:00:50,8,12,4437,155,4282,6.77%,3.49%
2020-01-01 00:00:50,9,1,848,0,848,1.29%,0.00%
2020-01-01 00:00:50,9,2,2726,48,2678,4.16%,1.76%
2020-01-01 00:00:50,9,3,1468,11,1457,2.24%,0.75%
2020-01-01 00:00:50,9,4,10777,839,9938,16.44%,7.78%
2020-01-01 00:00:50,9,5,417,1,416,0.64%,0.24%
2020-01-01 00:00:50,9,6,11625,970,10655,17.74%,8.34%
2020-01-01 00:00:50,9,7,30711,6226,24485,46.86%,20.27%
2020-01-01 00:00:50,9,8,10831,909,9922,16.53%,8.39%
2020-01-01 00:00:50,9,9,315,0,315,0.48%,0.00%
2020-01-01 00:00:50,9,10,3720,87,3633,5.68%,2.34%
2020-01-01 00:00:50,9,11,9822,751,9071,14.99%,7.65%
2020-01-01 00:00:50,9,12,5765,249,5516,8.80%,4.32%
2020-01-01 00:00:50,10,1,1296,353,943,1.98%,27.22%
2020-01-01 00:00:50,10,2,3102,400,2702,4.73%,12.89%
2020-01-01 00:00:50,10,3,1681,23,1658,2.57%,1.37%
2020-01-01 00:00:50,10,4,4520,1276,3244,6.90%,28.22%
2020-01-01 00:00:50,10,5,765,11,754,1.17%,1.44%
2020-01-01 00:00:50,10,6,6468,1399,5069,9.87%,21.63%
2020-01-01 00:00:50,10,7,11687,2307,9380,17.83%,19.74%
2020-01-01 00:00:50,10,8,27585,6758,20827,42.09%,24.50%
2020-01-01 00:00:50,10,9,815,5,810,1.24%,0.61%
2020-01-01 00:00:50,10,10,3456,105,3351,5.27%,3.04%
2020-01-01 00:00:50,10,11,12612,1410,11202,19.24%,11.18%
2020-01-01 00:00:50,10,12,8629,820,7809,13.17%,9.50%
2020-01-01 00:00:50,11,1,2974,59,2915,4.54%,1.98%
2020-01-01 00:00:50,11,2,5060,169,4891,7.72%,3.34%
2020-01-01 00:00:50,11,3,1902,20,1882,2.90%,1.05%
2020-01-01 00:00:50,11,4,5296,200,5096,8.08%,3.78%
2020-01-01 00:00:50,11,5,603,2,601,0.92%,0.33%
2020-01-01 00:00:50,11,6,6690,323,6367,10.21%,4.83%
2020-01-01 00:00:50,11,7,13575,1293,12282,20.71%,9.52%
2020-01-01 00:00:50,11,8,27421,4955,22466,41.84%,18.07%
2020-01-01 00:00:50,11,9,204,0,204,0.31%,0.00%
2020-01-01 00:00:50,11,10,2904,71,2833,4.43%,2.44%
2020-01-01 00:00:50,11,11,9883,728,9155,15.08%,7.37%
2020-01-01 00:00:50,11,12,6595,326,6269,10.06%,4.94%
2020-01-01 00:00:50,12,1,38,0,38,0.06%,0.00%
2020-01-01 00:00:50,12,2,608,238,370,0.93%,39.08%
2020-01-01 00:00:50,12,3,3304,309,2995,5.04%,9.35%
2020-01-01 00:00:50,12,4,3557,58,3499,5.43%,1.63%
2020-01-01 00:00:50,12,5,10195,936,9259,15.56%,9.18%
2020-01-01 00:00:50,12,6,6043,228,5815,9.22%,3.77%
2020-01-01 00:00:50,12,7,2385,53,2332,3.64%,2.22%
2020-01-01 00:00:50,12,8,1576,259,1317,2.40%,16.42%
2020-01-01 00:00:50,12,9,23661,4806,18855,36.10%,20.31%
2020-01-01 00:00:50,12,10,4064,366,3698,6.20%,9.00%
2020-01-01 00:00:50,12,11,1776,266,1510,2.71%,14.97%
2020-01-01 00:00:50,12,12,7912,1249,6663,12.07%,15.78%
2020-01-01 00:00:50,13,1,2245,41,2204,3.43%,1.83%
2020-01-01 00:00:50,13,2,2602,57,2545,3.97%,2.19%
2020-01-01 00:00:50,13,3,727,0,727,1.11%,0.00%
2020-01-01 00:00:50,13,4,4275,404,3871,6.52%,9.45%
2020-01-01 00:00:50,13,5,6634,693,5941,10.12%,10.44%
2020-01-01 00:00:50,13,6,5048,446,4602,7.70%,8.83%
2020-01-01 00:00:50,13,7,5257,212,5045,8.02%,4.03%
2020-01-01 00:00:50,13,8,7215,384,6831,11.01%,5.32%
2020-01-01 00:00:50,13,9,6893,720,6173,10.52%,10.44%
2020-01-01 00:00:50,13,10,25617,5026,20591,39.09%,19.62%
2020-01-01 00:00:50,13,11,16631,2360,14271,25.38%,14.19%
2020-01-01 00:00:50,13,12,8802,996,7806,13.43%,11.31%
2020-01-01 00:00:50,14,1,388,0,388,0.59%,0.00%
2020-01-01 00:00:50,14,2,2013,31,1982,3.07%,1.54%
2020-01-01 00:00:50,14,3,1317,12,1305,2.01%,0.91%
2020-01-01 00:00:50,14,4,3565,101,3464,5.44%,2.83%
2020-01-01 00:00:50,14,5,1418,15,1403,2.16%,1.06%
2020-01-01 00:00:50,14,6,3821,119,3702,5.83%,3.11%
2020-01-01 00:00:50,14,7,10771,874,9897,16.44%,8.11%
2020-01-01 00:00:50,14,8,12408,1154,11254,18.93%,9.30%
2020-01-01 00:00:50,14,9,1770,23,1747,2.70%,1.30%
2020-01-01 00:00:50,14,10,5372,189,5183,8.20%,3.52%
2020-01-01 00:00:50,14,11,24657,4159,20498,37.62%,16.87%
2020-01-01 00:00:50,14,12,6658,310,6348,10.16%,4.66%
2020-01-01 00:00:50,15,1,427,2,425,0.65%,0.47%
2020-01-01 00:00:50,15,2,126,0,126,0.19%,0.00%
2020-01-01 00:00:50,15,3,3711,89,3622,5.66%,2.40%
2020-01-01 00:00:50,15,4,5225,202,5023,7.97%,3.87%
2020-01-01 00:00:50,15,5,9699,646,9053,14.80%,6.66%
2020-01-01 00:00:50,15,6,5430,230,5200,8.29%,4.23%
2020-01-01 00:00:50,15,7,3571,102,3469,5.45%,2.86%
2020-01-01 00:00:50,15,8,5374,233,5141,8.20%,4.33%
2020-01-01 00:00:50,15,9,9856,667,9189,15.04%,6.77%
2020-01-01 00:00:50,15,10,4690,178,4512,7.16%,3.79%
2020-01-01 00:00:50,15,11,10216,740,9476,15.59%,7.24%
2020-01-01 00:00:50,15,12,24938,4335,20603,38.05%,17.38%
2020-01-01 00:00:50,16,1,536,9,527,0.82%,1.68%
2020-01-01 00:00:50,16,2,297,0,297,0.45%,0.00%
2020-01-01 00:00:50,16,3,2508,47,2461,3.83%,1.87%
2020-01-01 00:00:50,16,4,4361,167,4194,6.65%,3.83%
2020-01-01 00:00:50,16,5,9120,668,8452,13.92%,7.32%
2020-01-01 00:00:50,16,6,5109,221,4888,7.80%,4.32%
2020-01-01 00:00:50,16,7,3110,94,3016,4.75%,3.02%
2020-01-01 00:00:50,16,8,6679,378,6301,10.19%,5.66%
2020-01-01 00:00:50,16,9,9512,724,8788,14.51%,7.61%
2020-01-01 00:00:50,16,10,1560,15,1545,2.38%,0.96%
2020-01-01 00:00:50,16,11,8456,599,7857,12.90%,7.08%
2020-01-01 00:00:50,16,12,26832,4959,21873,40.94%,18.48%
2020-01-01 00:01:00,1,1,17786,2258,15528,27.14%,12.69%
2020-01-01 00:01:00,1,2,8312,561,7751,12.68%,6.75%
2020-01-01 00:01:00,1,3,1657,26,1631,2.53%,1.57%
2020-01-01 00:01:00,1,4,9112,650,8462,13.90%,7.13%
2020-01-01 00:01:00,1,5,8519,572,7947,13.00%,6.71%
2020-01-01 00:01:00,1,6,8487,560,7927,12.95%,6.60%
2020-01-01 00:01:00,1,7,6638,369,6269,10.13%,5.56%
2020-01-01 00:01:00,1,8,4995,213,4782,7.62%,4.26%
2020-01-01 00:01:00,1,9,8422,553,7869,12.85%,6.57%
2020-01-01 00:01:00,1,10,4192,144,4048,6.40%,3.43%
2020-01-01 00:01:00,1,11,4257,150,4107,6.50%,3.52%
2020-01-01 00:01:00,1,12,8055,496,7559,12.29%,6.16%
2020-01-01 00:01:00,2,1,690,3,687,1.05%,0.43%
2020-01-01 00:01:00,2,2,36445,8560,27885,55.61%,23.49%
2020-01-01 00:01:00,2,3,31340,6478,24862,47.82%,20.67%
2020-01-01 00:01:00,2,4,657,3,654,1.00%,0.46%
2020-01-01 00:01:00,2,5,13263,1314,11949,20.24%,9.91%
2020-01-01 00:01:00,2,6,84,0,84,0.13%,0.00%
2020-01-01 00:01:00,2,7,4393,158,4235,6.70%,3.60%
2020-01-01 00:01:00,2,8,3013,68,2945,4.60%,2.26%
2020-01-01 00:01:00,2,9,13120,1284,11836,20.02%,9.79%
2020-01-01 00:01:00,2,10,2307,40,2267,3.52%,1.73%
2020-01-01 00:01:00,2,11,2342,40,2302,3.57%,1.71%
2020-01-01 00:01:00,2,12,12956,1248,11708,19.77%,9.63%
2020-01-01 00:01:00,3,1,2037,30,2007,3.11%,1.47%
2020-01-01 00:01:00,3,2,23909,3867,20042,36.48%,16.17%
2020-01-01 00:01:00,3,3,65192,23981,41211,99.48%,36.78%
2020-01-01 00:01:00,3,4,8146,506,7640,12.43%,6.21%
2020-01-01 00:01:00,3,5,39791,10030,29761,60.72%,25.21%
2020-01-01 00:01:00,3,6,9571,692,8879,14.60%,7.23%
2020-01-01 00:01:00,3,7,19839,2690,17149,30.27%,13.56%
2020-01-01 00:01:00,3,8,15625,1722,13903,23.84%,11.02%
2020-01-01 00:01:00,3,9,29789,5888,23901,45.45%,19.77%
2020-01-01 00:01:00,3,10,3840,132,3708,5.86%,3.44%
2020-01-01 00:01:00,3,11,2155,37,2118,3.29%,1.72%
2020-01-01 00:01:00,3,12,23391,3717,19674,35.69%,15.89%
2020-01-01 00:01:00,4,1,387,1,386,0.59%,0.26%
2020-01-01 00:01:00,4,2,237,0,237,0.36%,0.00%
2020-01-01 00:01:00,4,3,864,5,859,1.32%,0.58%
2020-01-01 00:01:00,4,4,26368,4594,21774,40.23%,17.42%
2020-01-01 00:01:00,4,5,17264,2088,15176,26.34%,12.09%
2020-01-01 00:01:00,4,6,22987,3590,19397,35.08%,15.62%
2020-01-01 00:01:00,4,7,4449,139,4310,6.79%,3.12%
2020-01-01 00:01:00,4,8,2510,45,2465,3.83%,1.79%
2020-01-01 00:01:00,4,9,15254,1637,13617,23.28%,10.73%
2020-01-01 00:01:00,4,10,1769,30,1739,2.70%,1.69%
2020-01-01 00:01:00,4,11,94,0,94,0.14%,0.00%
2020-01-01 00:01:00,4,12,12692,1097,11595,19.37%,8.64%
2020-01-01 00:01:00,5,1,3054,76,2978,4.66%,2.49%
2020-01-01 00:01:00,5,2,690,6,684,1.05%,0.87%
2020-01-01 00:01:00,5,3,598,3,595,0.91%,0.50%
2020-01-01 00:01:00,5,4,26740,5028,21712,40.80%,18.80%
2020-01-01 00:01:00,5,5,10832,863,9969,16.53%,7.97%
2020-01-01 00:01:00,5,6,17823,2419,15404,27.20%,13.57%
2020-01-01 00:01:00,5,7,6448,482,5966,9.84%,7.47%
2020-01-01 00:01:00,5,8,3883,123,3760,5.92%,3.17%
2020-01-01 00:01:00,5,9,10112,768,9344,15.43%,7.59%
2020-01-01 00:01:00,5,10,832,8,824,1.27%,0.96%
2020-01-01 00:01:00,5,11,1073,12,1061,1.64%,1.12%
2020-01-01 00:01:00,5,12,8499,558,7941,12.97%,6.56%
2020-01-01 00:01:00,6,1,994,11,983,1.52%,1.11%
2020-01-01 00:01:00,6,2,1111,13,1098,1.70%,1.17%
2020-01-01 00:01:00,6,3,1544,27,1517,2.36%,1.75%
2020-01-01 00:01:00,6,4,1763,26,1737,2.69%,1.47%
2020-01-01 00:01:00,6,5,16715,1973,14742,25.51%,11.80%
2020-01-01 00:01:00,6,6,5016,210,4806,7.65%,4.19%
2020-01-01 00:01:00,6,7,2964,59,2905,4.52%,1.99%
2020-01-01 00:01:00,6,8,1554,19,1535,2.37%,1.22%
2020-01-01 00:01:00,6,9,9687,702,8985,14.78%,7.25%
2020-01-01 00:01:00,6,10,2167,31,2136,3.31%,1.43%
2020-01-01 00:01:00,6,11,436,1,435,0.67%,0.23%
2020-01-01 00:01:00,6,12,7424,439,6985,11.33%,5.91%
2020-01-01 00:01:00,7,1,487,2,485,0.74%,0.41%
2020-01-01 00:01:00,7,2,90,0,90,0.14%,0.00%
2020-01-01 00:01:00,7,3,1225,13,1212,1.87%,1.06%
2020-01-01 00:01:00,7,4,1605,17,1588,2.45%,1.06%
2020-01-01 00:01:00,7,5,7270,350,6920,11.09%,4.81%
2020-01-01 00:01:00,7,6,12132,1019,11113,18.51%,8.40%
2020-01-01 00:01:00,7,7,3106,87,3019,4.74%,2.80%
2020-01-01 00:01:00,7,8,1277,13,1264,1.95%,1.02%
2020-01-01 00:01:00,7,9,5963,239,5724,9.10%,4.01%
2020-01-01 00:01:00,7,10,1070,6,1064,1.63%,0.56%
2020-01-01 00:01:00,7,11,129,0,129,0.20%,0.00%
2020-01-01 00:01:00,7,12,4874,158,4716,7.44%,3.24%
2020-01-01 00:01:00,8,1,481,1,480,0.73%,0.21%
2020-01-01 00:01:00,8,2,112,0,112,0.17%,0.00%
2020-01-01 00:01:00,8,3,1768,20,1748,2.70%,1.13%
2020-01-01 00:01:00,8,4,2371,38,2333,3.62%,1.60%
2020-01-01 00:01:00,8,5,8213,480,7733,12.53%,5.84%
2020-01-01 00:01:00,8,6,16441,1956,14485,25.09%,11.90%
2020-01-01 00:01:00,8,7,5796,260,5536,8.84%,4.49%
2020-01-01 00:01:00,8,8,2169,50,2119,3.31%,2.30%
2020-01-01 00:01:00,8,9,6041,251,5790,9.22%,4.15%
2020-01-01 00:01:00,8,10,1745,31,1714,2.66%,1.78%
2020-01-01 00:01:00,8,11,328,2,326,0.50%,0.61%
2020-01-01 00:01:00,8,12,4212,123,4089,6.43%,2.92%
2020-01-01 00:01:00,9,1,457,0,457,0.70%,0.00%
2020-01-01 00:01:00,9,2,2061,24,2037,3.14%,1.16%
2020-01-01 00:01:00,9,3,1281,8,1273,1.95%,0.62%
2020-01-01 00:01:00,9,4,9669,621,9048,14.75%,6.42%
2020-01-01 00:01:00,9,5,431,0,431,0.66%,0.00%
2020-01-01 00:01:00,9,6,10478,740,9738,15.99%,7.06%
2020-01-01 00:01:00,9,7,32394,6831,25563,49.43%,21.09%
2020-01-01 00:01:00,9,8,11414,898,10516,17.42%,7.87%
2020-01-01 00:01:00,9,9,352,0,352,0.54%,0.00%
2020-01-01 00:01:00,9,10,3749,99,3650,5.72%,2.64%
2020-01-01 00:01:00,9,11,10074,715,9359,15.37%,7.10%
2020-01-01 00:01:00,9,12,6077,262,5815,9.27%,4.31%
2020-01-01 00:01:00,10,1,1395,298,1097,2.13%,21.35%
2020-01-01 00:01:00,10,2,3055,349,2706,4.66%,11.42%
2020-01-01 00:01:00,10,3,1522,18,1504,2.32%,1.18%
2020-01-01 00:01:00,10,4,4076,1084,2992,6.22%,26.59%
2020-01-01 00:01:00,10,5,653,7,646,1.00%,1.07%
2020-01-01 00:01:00,10,6,6074,1194,4880,9.27%,19.65%
2020-01-01 00:01:00,10,7,11169,2017,9152,17.04%,18.06%
2020-01-01 00:01:00,10,8,26646,6580,20066,40.66%,24.69%
2020-01-01 00:01:00,10,9,794,3,791,1.21%,0.38%
2020-01-01 00:01:00,10,10,2389,43,2346,3.65%,1.80%
2020-01-01 00:01:00,10,11,11688,1389,10299,17.83%,11.88%
2020-01-01 00:01:00,10,12,8782,981,7801,13.40%,11.17%
2020-01-01 00:01:00,11,1,2436,48,2388,3.72%,1.97%
2020-01-01 00:01:00,11,2,3869,100,3769,5.90%,2.58%
2020-01-01 00:01:00,11,3,1171,7,1164,1.79%,0.60%
2020-01-01 00:01:00,11,4,3750,112,3638,5.72%,2.99%
2020-01-01 00:01:00,11,5,664,7,657,1.01%,1.05%
2020-01-01 00:01:00,11,6,5159,208,4951,7.87%,4.03%
2020-01-01 00:01:00,11,7,10664,840,9824,16.27%,7.88%
2020-01-01 00:01:00,11,8,24195,3913,20282,36.92%,16.17%
2020-01-01 00:01:00,11,9,243,0,243,0.37%,0.00%
2020-01-01 00:01:00,11,10,3053,69,2984,4.66%,2.26%
2020-01-01 00:01:00,11,11,10183,747,9436,15.54%,7.34%
2020-01-01 00:01:00,11,12,6759,334,6425,10.31%,4.94%
2020-01-01 00:01:00,12,1,25,0,25,0.04%,0.00%
2020-01-01 00:01:00,12,2,648,227,421,0.99%,34.98%
2020-01-01 00:01:00,12,3,3168,289,2879,4.83%,9.12%
2020-01-01 00:01:00,12,4,3113,70,3043,4.75%,2.25%
2020-01-01 00:01:00,12,5,10493,1017,9476,16.01%,9.69%
2020-01-01 00:01:00,12,6,6532,363,6169,9.97%,5.56%
2020-01-01 00:01:00,12,7,3267,103,3164,4.99%,3.15%
2020-01-01 00:01:00,12,8,1388,189,1199,2.12%,13.61%
2020-01-01 00:01:00,12,9,23623,4836,18787,36.05%,20.47%
2020-01-01 00:01:00,12,10,4277,324,3953,6.53%,7.57%
2020-01-01 00:01:00,12,11,1563,193,1370,2.38%,12.34%
2020-01-01 00:01:00,12,12,7139,1041,6098,10.89%,14.58%
2020-01-01 00:01:00,13,1,2391,36,2355,3.65%,1.51%
2020-01-01 00:01:00,13,2,2701,48,2653,4.12%,1.78%
2020-01-01 00:01:00,13,3,648,3,645,0.99%,0.46%
2020-01-01 00:01:00,13,4,5031,450,4581,7.68%,8.94%
2020-01-01 00:01:00,13,5,7214,758,6456,11.01%,10.51%
2020-01-01 00:01:00,13,6,5907,520,5387,9.01%,8.80%
2020-01-01 00:01:00,13,7,5368,212,5156,8.19%,3.95%
2020-01-01 00:01:00,13,8,7244,381,6863,11.05%,5.26%
2020-01-01 00:01:00,13,9,7528,830,6698,11.49%,11.02%
2020-01-01 00:01:00,13,10,26140,5079,21061,39.89%,19.43%
2020-01-01 00:01:00,13,11,16594,2171,14423,25.32%,13.08%
2020-01-01 00:01:00,13,12,8875,843,8032,13.54%,9.50%
2020-01-01 00:01:00,14,1,310,0,310,0.47%,0.00%
2020-01-01 00:01:00,14,2,1443,13,1430,2.20%,0.90%
2020-01-01 00:01:00,14,3,965,3,962,1.47%,0.31%
2020-01-01 00:01:00,14,4,4834,170,4664,7.38%,3.52%
2020-01-01 00:01:00,14,5,1435,20,1415,2.19%,1.39%
2020-01-01 00:01:00,14,6,5000,182,4818,7.63%,3.64%
2020-01-01 00:01:00,14,7,11631,970,10661,17.75%,8.34%
2020-01-01 00:01:00,14,8,13430,1297,12133,20.49%,9.66%
2020-01-01 00:01:00,14,9,1768,28,1740,2.70%,1.58%
2020-01-01 00:01:00,14,10,4497,173,4324,6.86%,3.85%
2020-01-01 00:01:00,14,11,24864,4188,20676,37.94%,16.84%
2020-01-01 00:01:00,14,12,6761,339,6422,10.32%,5.01%
2020-01-01 00:01:00,15,1,503,2,501,0.77%,0.40%
2020-01-01 00:01:00,15,2,133,0,133,0.20%,0.00%
2020-01-01 00:01:00,15,3,4002,110,3892,6.11%,2.75%
2020-01-01 00:01:00,15,4,7284,688,6596,11.11%,9.44%
2020-01-01 00:01:00,15,5,12695,1422,11273,19.37%,11.20%
2020-01-01 00:01:00,15,6,7475,709,6766,11.41%,9.48%
2020-01-01 00:01:00,15,7,3846,133,3713,5.87%,3.46%
2020-01-01 00:01:00,15,8,5270,240,5030,8.04%,4.55%
2020-01-01 00:01:00,15,9,12899,1447,11452,19.68%,11.22%
2020-01-01 00:01:00,15,10,4790,214,4576,7.31%,4.47%
2020-01-01 00:01:00,15,11,10557,867,9690,16.11%,8.21%
2020-01-01 00:01:00,15,12,29192,6159,23033,44.54%,21.10%
2020-01-01 00:01:00,16,1,458,1,457,0.70%,0.22%
2020-01-01 00:01:00,16,2,266,3,263,0.41%,1.12%
2020-01-01 00:01:00,16,3,1074,15,1059,1.64%,1.40%
2020-01-01 00:01:00,16,4,4337,124,4213,6.62%,2.86%
2020-01-01 00:01:00,16,5,7500,479,7021,11.44%,6.39%
2020-01-01 00:01:00,16,6,5123,200,4923,7.82%,3.90%
2020-01-01 00:01:00,16,7,3744,146,3598,5.71%,3.90%
2020-01-01 00:01:00,16,8,7271,421,6850,11.09%,5.79%
2020-01-01 00:01:00,16,9,7848,508,7340,11.98%,6.47%
2020-01-01 00:01:00,16,10,1602,19,1583,2.44%,1.19%
2020-01-01 00:01:00,16,11,9050,628,8422,13.81%,6.94%
2020-01-01 00:01:00,16,12,25128,4381,20747,38.34%,17.43%
2020-01-01 00:01:10,1,1,18024,2304,15720,27.50%,12.78%
2020-01-01 00:01:10,1,2,8440,504,7936,12.88%,5.97%
2020-01-01 00:01:10,1,3,502,4,498,0.77%,0.80%
2020-01-01 00:01:10,1,4,9273,639,8634,14.15%,6.89%
2020-01-01 00:01:10,1,5,8949,603,8346,13.66%,6.74%
2020-01-01 00:01:10,1,6,8909,596,8313,13.59%,6.69%
2020-01-01 00:01:10,1,7,7916,457,7459,12.08%,5.77%
2020-01-01 00:01:10,1,8,7144,372,6772,10.90%,5.21%
2020-01-01 00:01:10,1,9,8871,591,8280,13.54%,6.66%
2020-01-01 00:01:10,1,10,6496,302,6194,9.91%,4.65%
2020-01-01 00:01:10,1,11,6589,306,6283,10.05%,4.64%
2020-01-01 00:01:10,1,12,8809,583,8226,13.44%,6.62%
2020-01-01 00:01:10,2,1,388,1,387,0.59%,0.26%
2020-01-01 00:01:10,2,2,25685,4374,21311,39.19%,17.03%
2020-01-01 00:01:10,2,3,19981,2735,17246,30.49%,13.69%
2020-01-01 00:01:10,2,4,344,1,343,0.52%,0.29%
2020-01-01 00:01:10,2,5,12437,1113,11324,18.98%,8.95%
2020-01-01 00:01:10,2,6,68,0,68,0.10%,0.00%
2020-01-01 00:01:10,2,7,5301,224,5077,8.09%,4.22%
2020-01-01 00:01:10,2,8,4012,134,3878,6.12%,3.34%
2020-01-01 00:01:10,2,9,12284,1083,11201,18.74%,8.82%
2020-01-01 00:01:10,2,10,3078,82,2996,4.70%,2.66%
2020-01-01 00:01:10,2,11,3100,84,3016,4.73%,2.71%
2020-01-01 00:01:10,2,12,12129,1059,11070,18.51%,8.73%
2020-01-01 00:01:10,3,1,2291,40,2251,3.50%,1.75%
2020-01-01 00:01:10,3,2,26705,4705,22000,40.75%,17.62%
2020-01-01 00:01:10,3,3,76816,31511,45305,117.21%,41.02%
2020-01-01 00:01:10,3,4,9253,586,8667,14.12%,6.33%
2020-01-01 00:01:10,3,5,48818,14382,34436,74.49%,29.46%
2020-01-01 00:01:10,3,6,10613,801,9812,16.19%,7.55%
2020-01-01 00:01:10,3,7,22608,3469,19139,34.50%,15.34%
2020-01-01 00:01:10,3,8,18107,2253,15854,27.63%,12.44%
2020-01-01 00:01:10,3,9,37728,9078,28650,57.57%,24.06%
2020-01-01 00:01:10,3,10,4607,157,4450,7.03%,3.41%
2020-01-01 00:01:10,3,11,1624,20,1604,2.48%,1.23%
2020-01-01 00:01:10,3,12,30870,6291,24579,47.10%,20.38%
2020-01-01 00:01:10,4,1,540,1,539,0.82%,0.18%
2020-01-01 00:01:10,4,2,324,1,323,0.49%,0.31%
2020-01-01 00:01:10,4,3,770,5,765,1.17%,0.65%
2020-01-01 00:01:10,4,4,27679,5105,22574,42.23%,18.44%
2020-01-01 00:01:10,4,5,17357,2126,15231,26.48%,12.25%
2020-01-01 00:01:10,4,6,23624,3772,19852,36.05%,15.97%
2020-01-01 00:01:10,4,7,4986,202,4784,7.61%,4.05%
2020-01-01 00:01:10,4,8,2765,59,2706,4.22%,2.13%
2020-01-01 00:01:10,4,9,15290,1671,13619,23.33%,10.93%
2020-01-01 00:01:10,4,10,1900,35,1865,2.90%,1.84%
2020-01-01 00:01:10,4,11,212,0,212,0.32%,0.00%
2020-01-01 00:01:10,4,12,12747,1162,11585,19.45%,9.12%
2020-01-01 00:01:10,5,1,3082,67,3015,4.70%,2.17%
2020-01-01 00:01:10,5,2,944,5,939,1.44%,0.53%
2020-01-01 00:01:10,5,3,1106,10,1096,1.69%,0.90%
2020-01-01 00:01:10,5,4,23994,3945,20049,36.61%,16.44%
2020-01-01 00:01:10,5,5,9973,726,9247,15.22%,7.28%
2020-01-01 00:01:10,5,6,16616,1916,14700,25.35%,11.53%
2020-01-01 00:01:10,5,7,6186,271,5915,9.44%,4.38%
2020-01-01 00:01:10,5,8,4575,147,4428,6.98%,3.21%
2020-01-01 00:01:10,5,9,8718,578,8140,13.30%,6.63%
2020-01-01 00:01:10,5,10,941,4,937,1.44%,0.42%
2020-01-01 00:01:10,5,11,669,5,664,1.02%,0.75%
2020-01-01 00:01:10,5,12,7270,408,6862,11.09%,5.61%
2020-01-01 00:01:10,6,1,1137,10,1127,1.73%,0.88%
2020-01-01 00:01:10,6,2,1254,12,1242,1.91%,0.96%
2020-01-01 00:01:10,6,3,1910,22,1888,2.91%,1.15%
2020-01-01 00:01:10,6,4,1160,7,1153,1.77%,0.60%
2020-01-01 00:01:10,6,5,14599,1482,13117,22.28%,10.15%
2020-01-01 00:01:10,6,6,3929,131,3798,6.00%,3.33%
2020-01-01 00:01:10,6,7,2271,58,2213,3.47%,2.55%
2020-01-01 00:01:10,6,8,1754,42,1712,2.68%,2.39%
2020-01-01 00:01:10,6,9,8080,461,7619,12.33%,5.70%
2020-01-01 00:01:10,6,10,2083,34,2049,3.18%,1.63%
2020-01-01 00:01:10,6,11,425,2,423,0.65%,0.47%
2020-01-01 00:01:10,6,12,5930,258,5672,9.05%,4.35%
2020-01-01 00:01:10,7,1,455,3,452,0.69%,0.66%
2020-01-01 00:01:10,7,2,192,0,192,0.29%,0.00%
2020-01-01 00:01:10,7,3,984,6,978,1.50%,0.61%
2020-01-01 00:01:10,7,4,1970,35,1935,3.01%,1.78%
2020-01-01 00:01:10,7,5,7871,420,7451,12.01%,5.34%
2020-01-01 00:01:10,7,6,13481,1266,12215,20.57%,9.39%
2020-01-01 00:01:10,7,7,3539,110,3429,5.40%,3.11%
2020-01-01 00:01:10,7,8,1647,20,1627,2.51%,1.21%
2020-01-01 00:01:10,7,9,6517,280,6237,9.94%,4.30%
2020-01-01 00:01:10,7,10,1236,12,1224,1.89%,0.97%
2020-01-01 00:01:10,7,11,73,0,73,0.11%,0.00%
2020-01-01 00:01:10,7,12,5257,187,5070,8.02%,3.56%
2020-01-01 00:01:10,8,1,449,2,447,0.69%,0.44%
2020-01-01 00:01:10,8,2,39,0,39,0.06%,0.00%
2020-01-01 00:01:10,8,3,1729,22,1707,2.64%,1.27%
2020-01-01 00:01:10,8,4,2850,72,2778,4.35%,2.53%
2020-01-01 00:01:10,8,5,8310,496,7814,12.68%,5.97%
2020-01-01 00:01:10,8,6,16874,1978,14896,25.75%,11.72%
2020-01-01 00:01:10,8,7,5632,241,5391,8.59%,4.28%
2020-01-01 00:01:10,8,8,2795,67,2728,4.26%,2.40%
2020-01-01 00:01:10,8,9,6325,274,6051,9.65%,4.33%
2020-01-01 00:01:10,8,10,1591,11,1580,2.43%,0.69%
2020-01-01 00:01:10,8,11,135,0,135,0.21%,0.00%
2020-01-01 00:01:10,8,12,4681,165,4516,7.14%,3.52%
2020-01-01 00:01:10,9,1,244,0,244,0.37%,0.00%
2020-01-01 00:01:10,9,2,1757,22,1735,2.68%,1.25%
2020-01-01 00:01:10,9,3,1192,8,1184,1.82%,0.67%
2020-01-01 00:01:10,9,4,5702,260,5442,8.70%,4.56%
2020-01-01 00:01:10,9,5,314,0,314,0.48%,0.00%
2020-01-01 00:01:10,9,6,6570,340,6230,10.03%,5.17%
2020-01-01 00:01:10,9,7,28963,5572,23391,44.19%,19.24%
2020-01-01 00:01:10,9,8,12102,1030,11072,18.47%,8.51%
2020-01-01 00:01:10,9,9,228,0,228,0.35%,0.00%
2020-01-01 00:01:10,9,10,2932,49,2883,4.47%,1.67%
2020-01-01 00:01:10,9,11,10999,854,10145,16.78%,7.76%
2020-01-01 00:01:10,9,12,7604,441,7163,11.60%,5.80%
2020-01-01 00:01:10,10,1,1478,282,1196,2.26%,19.07%
2020-01-01 00:01:10,10,2,3488,362,3126,5.32%,10.38%
2020-01-01 00:01:10,10,3,1840,31,1809,2.81%,1.68%
2020-01-01 00:01:10,10,4,4400,1111,3289,6.71%,25.24%
2020-01-01 00:01:10,10,5,1046,92,954,1.60%,8.79%
2020-01-01 00:01:10,10,6,6458,1317,5141,9.85%,20.39%
2020-01-01 00:01:10,10,7,11883,2143,9740,18.13%,18.03%
2020-01-01 00:01:10,10,8,28928,7263,21665,44.14%,25.11%
2020-01-01 00:01:10,10,9,633,3,630,0.97%,0.47%
2020-01-01 00:01:10,10,10,2362,47,2315,3.60%,1.99%
2020-01-01 00:01:10,10,11,12475,1562,10913,19.04%,12.52%
2020-01-01 00:01:10,10,12,9605,1122,8483,14.66%,11.68%
2020-01-01 00:01:10,11,1,2224,44,2180,3.39%,1.98%
2020-01-01 00:01:10,11,2,3682,130,3552,5.62%,3.53%
2020-01-01 00:01:10,11,3,1099,18,1081,1.68%,1.64%
2020-01-01 00:01:10,11,4,3619,130,3489,5.52%,3.59%
2020-01-01 00:01:10,11,5,185,0,185,0.28%,0.00%
2020-01-01 00:01:10,11,6,4324,175,4149,6.60%,4.05%
2020-01-01 00:01:10,11,7,9736,757,8979,14.86%,7.77%
2020-01-01 00:01:10,11,8,24688,4281,20407,37.67%,17.34%
2020-01-01 00:01:10,11,9,279,0,279,0.43%,0.00%
2020-01-01 00:01:10,11,10,3343,77,3266,5.10%,2.30%
2020-01-01 00:01:10,11,11,11066,892,10174,16.89%,8.06%
2020-01-01 00:01:10,11,12,7258,419,6839,11.07%,5.77%
2020-01-01 00:01:10,12,1,24,0,24,0.04%,0.00%
2020-01-01 00:01:10,12,2,444,136,308,0.68%,30.56%
2020-01-01 00:01:10,12,3,2520,182,2338,3.85%,7.22%
2020-01-01 00:01:10,12,4,3336,70,3266,5.09%,2.10%
2020-01-01 00:01:10,12,5,8569,602,7967,13.08%,7.02%
2020-01-01 00:01:10,12,6,5360,187,5173,8.18%,3.49%
2020-01-01 00:01:10,12,7,1905,20,1885,2.91%,1.05%
2020-01-01 00:01:10,12,8,1504,261,1243,2.29%,17.34%
2020-01-01 00:01:10,12,9,21637,3951,17686,33.02%,18.26%
2020-01-01 00:01:10,12,10,4143,358,3785,6.32%,8.64%
2020-01-01 00:01:10,12,11,1648,264,1384,2.51%,16.01%
2020-01-01 00:01:10,12,12,7632,1101,6531,11.65%,14.42%
2020-01-01 00:01:10,13,1,1819,19,1800,2.78%,1.04%
2020-01-01 00:01:10,13,2,2129,32,2097,3.25%,1.50%
2020-01-01 00:01:10,13,3,457,1,456,0.70%,0.22%
2020-01-01 00:01:10,13,4,4721,556,4165,7.20%,11.77%
2020-01-01 00:01:10,13,5,7042,918,6124,10.75%,13.03%
2020-01-01 00:01:10,13,6,5386,598,4788,8.22%,11.10%
2020-01-01 00:01:10,13,7,4348,138,4210,6.63%,3.17%
2020-01-01 00:01:10,13,8,6658,334,6324,10.16%,5.02%
2020-01-01 00:01:10,13,9,7456,966,6490,11.38%,12.95%
2020-01-01 00:01:10,13,10,26190,5215,20975,39.96%,19.91%
2020-01-01 00:01:10,13,11,16211,2066,14145,24.74%,12.74%
2020-01-01 00:01:10,13,12,9180,876,8304,14.01%,9.54%
2020-01-01 00:01:10,14,1,442,2,440,0.67%,0.45%
2020-01-01 00:01:10,14,2,1635,18,1617,2.49%,1.10%
2020-01-01 00:01:10,14,3,996,5,991,1.52%,0.50%
2020-01-01 00:01:10,14,4,4369,137,4232,6.67%,3.14%
2020-01-01 00:01:10,14,5,1745,25,1720,2.66%,1.43%
2020-01-01 00:01:10,14,6,4730,156,4574,7.22%,3.30%
2020-01-01 00:01:10,14,7,12114,998,11116,18.48%,8.24%
2020-01-01 00:01:10,14,8,13841,1301,12540,21.12%,9.40%
2020-01-01 00:01:10,14,9,2007,32,1975,3.06%,1.59%
2020-01-01 00:01:10,14,10,4453,158,4295,6.79%,3.55%
2020-01-01 00:01:10,14,11,26478,4592,21886,40.40%,17.34%
2020-01-01 00:01:10,14,12,7834,439,7395,11.95%,5.60%
2020-01-01 00:01:10,15,1,742,3,739,1.13%,0.40%
2020-01-01 00:01:10,15,2,139,0,139,0.21%,0.00%
2020-01-01 00:01:10,15,3,7040,377,6663,10.74%,5.35%
2020-01-01 00:01:10,15,4,5148,222,4926,7.86%,4.31%
2020-01-01 00:01:10,15,5,12966,1212,11754,19.78%,9.35%
2020-01-01 00:01:10,15,6,5392,254,5138,8.23%,4.71%
2020-01-01 00:01:10,15,7,3321,74,3247,5.07%,2.23%
2020-01-01 00:01:10,15,8,5410,216,5194,8.26%,3.99%
2020-01-01 00:01:10,15,9,13138,1241,11897,20.05%,9.45%
2020-01-01 00:01:10,15,10,5106,285,4821,7.79%,5.58%
2020-01-01 00:01:10,15,11,10872,943,9929,16.59%,8.67%
2020-01-01 00:01:10,15,12,29686,6156,23530,45.30%,20.74%
2020-01-01 00:01:10,16,1,485,2,483,0.74%,0.41%
2020-01-01 00:01:10,16,2,294,2,292,0.45%,0.68%
2020-01-01 00:01:10,16,3,1550,19,1531,2.37%,1.23%
2020-01-01 00:01:10,16,4,3906,108,3798,5.96%,2.76%
2020-01-01 00:01:10,16,5,7639,511,7128,11.66%,6.69%
2020-01-01 00:01:10,16,6,4744,175,4569,7.24%,3.69%
2020-01-01 00:01:10,16,7,3764,100,3664,5.74%,2.66%
2020-01-01 00:01:10,16,8,7531,494,7037,11.49%,6.56%
2020-01-01 00:01:10,16,9,8021,553,7468,12.24%,6.89%
2020-01-01 00:01:10,16,10,1386,18,1368,2.11%,1.30%
2020-01-01 00:01:10,16,11,9075,681,8394,13.85%,7.50%
2020-01-01 00:01:10,16,12,26279,4685,21594,40.10%,17.83%
2020-01-01 00:01:20,1,1,21428,3136,18292,32.70%,14.63%
2020-01-01 00:01:20,1,2,11414,938,10476,17.42%,8.22%
2020-01-01 00:01:20,1,3,559,2,557,0.85%,0.36%
2020-01-01 00:01:20,1,4,9768,710,9058,14.90%,7.27%
2020-01-01 00:01:20,1,5,8910,609,8301,13.60%,6.83%
2020-01-01 00:01:20,1,6,8843,604,8239,13.49%,6.83%
2020-01-01 00:01:20,1,7,10822,839,9983,16.51%,7.75%
2020-01-01 00:01:20,1,8,9513,646,8867,14.52%,6.79%
2020-01-01 00:01:20,1,9,8797,600,8197,13.42%,6.82%
2020-01-01 00:01:20,1,10,8775,561,8214,13.39%,6.39%
2020-01-01 00:01:20,1,11,8868,572,8296,13.53%,6.45%
2020-01-01 00:01:20,1,12,8754,595,8159,13.36%,6.80%
2020-01-01 00:01:20,2,1,857,6,851,1.31%,0.70%
2020-01-01 00:01:20,2,2,25462,4369,21093,38.85%,17.16%
2020-01-01 00:01:20,2,3,20656,2957,17699,31.52%,14.31%
2020-01-01 00:01:20,2,4,779,3,776,1.19%,0.38%
2020-01-01 00:01:20,2,5,13150,1272,11878,20.07%,9.67%
2020-01-01 00:01:20,2,6,41,0,41,0.06%,0.00%
2020-01-01 00:01:20,2,7,3916,118,3798,5.98%,3.01%
2020-01-01 00:01:20,2,8,3278,82,3196,5.00%,2.50%
2020-01-01 00:01:20,2,9,13071,1258,11813,19.94%,9.62%
2020-01-01 00:01:20,2,10,2560,46,2514,3.91%,1.80%
2020-01-01 00:01:20,2,11,2567,46,2521,3.92%,1.79%
2020-01-01 00:01:20,2,12,12929,1225,11704,19.73%,9.47%
2020-01-01 00:01:20,3,1,1443,16,1427,2.20%,1.11%
2020-01-01 00:01:20,3,2,24717,4195,20522,37.72%,16.97%
2020-01-01 00:01:20,3,3,68795,26315,42480,104.97%,38.25%
2020-01-01 00:01:20,3,4,12905,1239,11666,19.69%,9.60%
2020-01-01 00:01:20,3,5,43468,11745,31723,66.33%,27.02%
2020-01-01 00:01:20,3,6,13963,1427,12536,21.31%,10.22%
2020-01-01 00:01:20,3,7,21346,3191,18155,32.57%,14.95%
2020-01-01 00:01:20,3,8,17532,2201,15331,26.75%,12.55%
2020-01-01 00:01:20,3,9,28891,5533,23358,44.08%,19.15%
2020-01-01 00:01:20,3,10,5698,233,5465,8.69%,4.09%
2020-01-01 00:01:20,3,11,2065,38,2027,3.15%,1.84%
2020-01-01 00:01:20,3,12,21051,3104,17947,32.12%,14.74%
2020-01-01 00:01:20,4,1,480,1,479,0.73%,0.21%
2020-01-01 00:01:20,4,2,281,1,280,0.43%,0.35%
2020-01-01 00:01:20,4,3,986,10,976,1.50%,1.01%
2020-01-01 00:01:20,4,4,26886,4803,22083,41.02%,17.86%
2020-01-01 00:01:20,4,5,17596,2161,15435,26.85%,12.28%
2020-01-01 00:01:20,4,6,23492,3740,19752,35.85%,15.92%
2020-01-01 00:01:20,4,7,4394,163,4231,6.70%,3.71%
2020-01-01 00:01:20,4,8,2854,76,2778,4.35%,2.66%
2020-01-01 00:01:20,4,9,15538,1694,13844,23.71%,10.90%
2020-01-01 00:01:20,4,10,1907,34,1873,2.91%,1.78%
2020-01-01 00:01:20,4,11,177,0,177,0.27%,0.00%
2020-01-01 00:01:20,4,12,12784,1157,11627,19.51%,9.05%
2020-01-01 00:01:20,5,1,2507,43,2464,3.83%,1.71%
2020-01-01 00:01:20,5,2,682,6,676,1.04%,0.88%
2020-01-01 00:01:20,5,3,1126,10,1116,1.72%,0.89%
2020-01-01 00:01:20,5,4,22969,3633,19336,35.05%,15.82%
2020-01-01 00:01:20,5,5,10975,906,10069,16.75%,8.25%
2020-01-01 00:01:20,5,6,16631,1978,14653,25.38%,11.89%
2020-01-01 00:01:20,5,7,5019,223,4796,7.66%,4.44%
2020-01-01 00:01:20,5,8,3664,126,3538,5.59%,3.44%
2020-01-01 00:01:20,5,9,9662,728,8934,14.74%,7.53%
2020-01-01 00:01:20,5,10,852,8,844,1.30%,0.94%
2020-01-01 00:01:20,5,11,969,10,959,1.48%,1.03%
2020-01-01 00:01:20,5,12,8352,538,7814,12.74%,6.44%
2020-01-01 00:01:20,6,1,961,9,952,1.47%,0.94%
2020-01-01 00:01:20,6,2,1070,12,1058,1.63%,1.12%
2020-01-01 00:01:20,6,3,2253,30,2223,3.44%,1.33%
2020-01-01 00:01:20,6,4,1021,8,1013,1.56%,0.78%
2020-01-01 00:01:20,6,5,15553,1714,13839,23.73%,11.02%
2020-01-01 00:01:20,6,6,3324,94,3230,5.07%,2.83%
2020-01-01 00:01:20,6,7,1844,38,1806,2.81%,2.06%
2020-01-01 00:01:20,6,8,1310,24,1286,2.00%,1.83%
2020-01-01 00:01:20,6,9,9534,693,8841,14.55%,7.27%
2020-01-01 00:01:20,6,10,2108,32,2076,3.22%,1.52%
2020-01-01 00:01:20,6,11,445,1,444,0.68%,0.22%
2020-01-01 00:01:20,6,12,7313,423,6890,11.16%,5.78%
2020-01-01 00:01:20,7,1,572,1,571,0.87%,0.17%
2020-01-01 00:01:20,7,2,135,0,135,0.21%,0.00%
2020-01-01 00:01:20,7,3,680,7,673,1.04%,1.03%
2020-01-01 00:01:20,7,4,1673,12,1661,2.55%,0.72%
2020-01-01 00:01:20,7,5,6546,328,6218,9.99%,5.01%
2020-01-01 00:01:20,7,6,11886,978,10908,18.14%,8.23%
2020-01-01 00:01:20,7,7,3615,90,3525,5.52%,2.49%
2020-01-01 00:01:20,7,8,1392,19,1373,2.12%,1.36%
2020-01-01 00:01:20,7,9,5735,253,5482,8.75%,4.41%
2020-01-01 00:01:20,7,10,1163,12,1151,1.77%,1.03%
2020-01-01 00:01:20,7,11,36,0,36,0.05%,0.00%
2020-01-01 00:01:20,7,12,4555,158,4397,6.95%,3.47%
2020-01-01 00:01:20,8,1,447,1,446,0.68%,0.22%
2020-01-01 00:01:20,8,2,84,0,84,0.13%,0.00%
2020-01-01 00:01:20,8,3,1478,18,1460,2.26%,1.22%
2020-01-01 00:01:20,8,4,2621,53,2568,4.00%,2.02%
2020-01-01 00:01:20,8,5,8106,502,7604,12.37%,6.19%
2020-01-01 00:01:20,8,6,14894,1618,13276,22.73%,10.86%
2020-01-01 00:01:20,8,7,4082,140,3942,6.23%,3.43%
2020-01-01 00:01:20,8,8,1721,26,1695,2.63%,1.51%
2020-01-01 00:01:20,8,9,6435,320,6115,9.82%,4.97%
2020-01-01 00:01:20,8,10,1790,27,1763,2.73%,1.51%
2020-01-01 00:01:20,8,11,210,1,209,0.32%,0.47%
2020-01-01 00:01:20,8,12,4522,145,4377,6.90%,3.21%
2020-01-01 00:01:20,9,1,579,1,578,0.88%,0.17%
2020-01-01 00:01:20,9,2,2378,40,2338,3.63%,1.68%
2020-01-01 00:01:20,9,3,1286,13,1273,1.96%,1.01%
2020-01-01 00:01:20,9,4,8332,490,7842,12.71%,5.88%
2020-01-01 00:01:20,9,5,1052,8,1044,1.61%,0.76%
2020-01-01 00:01:20,9,6,9673,646,9027,14.76%,6.68%
2020-01-01 00:01:20,9,7,36818,8808,28010,56.18%,23.92%
2020-01-01 00:01:20,9,8,15230,1719,13511,23.24%,11.29%
2020-01-01 00:01:20,9,9,234,1,233,0.36%,0.43%
2020-01-01 00:01:20,9,10,4946,261,4685,7.55%,5.28%
2020-01-01 00:01:20,9,11,14107,1478,12629,21.53%,10.48%
2020-01-01 00:01:20,9,12,8818,549,8269,13.46%,6.23%
2020-01-01 00:01:20,10,1,1382,269,1113,2.11%,19.45%
2020-01-01 00:01:20,10,2,4710,416,4294,7.19%,8.83%
2020-01-01 00:01:20,10,3,3191,81,3110,4.87%,2.54%
2020-01-01 00:01:20,10,4,4485,1052,3433,6.84%,23.45%
2020-01-01 00:01:20,10,5,743,31,712,1.13%,4.17%
2020-01-01 00:01:20,10,6,6159,1193,4966,9.40%,19.37%
2020-01-01 00:01:20,10,7,12592,2181,10411,19.21%,17.32%
2020-01-01 00:01:20,10,8,29095,7196,21899,44.40%,24.73%
2020-01-01 00:01:20,10,9,575,0,575,0.88%,0.00%
2020-01-01 00:01:20,10,10,2164,24,2140,3.30%,1.11%
2020-01-01 00:01:20,10,11,11896,1323,10573,18.15%,11.12%
2020-01-01 00:01:20,10,12,9130,959,8171,13.93%,10.50%
2020-01-01 00:01:20,11,1,2176,36,2140,3.32%,1.65%
2020-01-01 00:01:20,11,2,3332,95,3237,5.08%,2.85%
2020-01-01 00:01:20,11,3,975,9,966,1.49%,0.92%
2020-01-01 00:01:20,11,4,4222,129,4093,6.44%,3.05%
2020-01-01 00:01:20,11,5,200,0,200,0.31%,0.00%
2020-01-01 00:01:20,11,6,5140,182,4958,7.84%,3.54%
2020-01-01 00:01:20,11,7,9924,761,9163,15.14%,7.67%
2020-01-01 00:01:20,11,8,27457,5077,22380,41.90%,18.49%
2020-01-01 00:01:20,11,9,367,0,367,0.56%,0.00%
2020-01-01 00:01:20,11,10,3265,86,3179,4.98%,2.63%
2020-01-01 00:01:20,11,11,13492,1326,12166,20.59%,9.83%
2020-01-01 00:01:20,11,12,9916,703,9213,15.13%,7.09%
2020-01-01 00:01:20,12,1,39,0,39,0.06%,0.00%
2020-01-01 00:01:20,12,2,606,221,385,0.92%,36.41%
2020-01-01 00:01:20,12,3,2270,245,2025,3.46%,10.79%
2020-01-01 00:01:20,12,4,3341,102,3239,5.10%,3.05%
2020-01-01 00:01:20,12,5,8645,691,7954,13.19%,7.99%
2020-01-01 00:01:20,12,6,5537,238,5299,8.45%,4.30%
2020-01-01 00:01:20,12,7,2104,38,2066,3.21%,1.81%
2020-01-01 00:01:20,12,8,1204,252,952,1.84%,20.91%
2020-01-01 00:01:20,12,9,20758,3844,16914,31.67%,18.52%
2020-01-01 00:01:20,12,10,3883,350,3533,5.92%,9.01%
2020-01-01 00:01:20,12,11,1472,254,1218,2.25%,17.24%
2020-01-01 00:01:20,12,12,7289,988,6301,11.12%,13.55%
2020-01-01 00:01:20,13,1,2036,28,2008,3.11%,1.37%
2020-01-01 00:01:20,13,2,2307,38,2269,3.52%,1.65%
2020-01-01 00:01:20,13,3,827,5,822,1.26%,0.60%
2020-01-01 00:01:20,13,4,4852,511,4341,7.40%,10.53%
2020-01-01 00:01:20,13,5,7199,819,6380,10.98%,11.38%
2020-01-01 00:01:20,13,6,5465,554,4911,8.34%,10.14%
2020-01-01 00:01:20,13,7,4665,159,4506,7.12%,3.41%
2020-01-01 00:01:20,13,8,7137,370,6767,10.89%,5.18%
2020-01-01 00:01:20,13,9,7526,848,6678,11.48%,11.27%
2020-01-01 00:01:20,13,10,26460,5232,21228,40.37%,19.77%
2020-01-01 00:01:20,13,11,16180,2048,14132,24.69%,12.66%
2020-01-01 00:01:20,13,12,8585,783,7802,13.10%,9.12%
2020-01-01 00:01:20,14,1,396,3,393,0.60%,0.76%
2020-01-01 00:01:20,14,2,1800,21,1779,2.75%,1.17%
2020-01-01 00:01:20,14,3,1210,7,1203,1.85%,0.58%
2020-01-01 00:01:20,14,4,3809,92,3717,5.81%,2.41%
2020-01-01 00:01:20,14,5,1628,24,1604,2.48%,1.47%
2020-01-01 00:01:20,14,6,4180,119,4061,6.38%,2.85%
2020-01-01 00:01:20,14,7,11315,923,10392,17.27%,8.16%
2020-01-01 00:01:20,14,8,12825,1145,11680,19.57%,8.93%
2020-01-01 00:01:20,14,9,1852,27,1825,2.83%,1.46%
2020-01-01 00:01:20,14,10,4666,152,4514,7.12%,3.26%
2020-01-01 00:01:20,14,11,24568,4078,20490,37.49%,16.60%
2020-01-01 00:01:20,14,12,6766,383,6383,10.32%,5.66%
2020-01-01 00:01:20,15,1,495,0,495,0.76%,0.00%
2020-01-01 00:01:20,15,2,111,0,111,0.17%,0.00%
2020-01-01 00:01:20,15,3,5313,213,5100,8.11%,4.01%
2020-01-01 00:01:20,15,4,5254,223,5031,8.02%,4.24%
2020-01-01 00:01:20,15,5,12596,1149,11447,19.22%,9.12%
2020-01-01 00:01:20,15,6,5589,247,5342,8.53%,4.42%
2020-01-01 00:01:20,15,7,3467,88,3379,5.29%,2.54%
2020-01-01 00:01:20,15,8,5380,217,5163,8.21%,4.03%
2020-01-01 00:01:20,15,9,12732,1177,11555,19.43%,9.24%
2020-01-01 00:01:20,15,10,5444,244,5200,8.31%,4.48%
2020-01-01 00:01:20,15,11,10979,900,10079,16.75%,8.20%
2020-01-01 00:01:20,15,12,28486,5708,22778,43.47%,20.04%
2020-01-01 00:01:20,16,1,442,1,441,0.67%,0.23%
2020-01-01 00:01:20,16,2,325,1,324,0.50%,0.31%
2020-01-01 00:01:20,16,3,1466,23,1443,2.24%,1.57%
2020-01-01 00:01:20,16,4,6460,297,6163,9.86%,4.60%
2020-01-01 00:01:20,16,5,10317,828,9489,15.74%,8.02%
2020-01-01 00:01:20,16,6,7373,377,6996,11.25%,5.11%
2020-01-01 00:01:20,16,7,3587,98,3489,5.47%,2.73%
2020-01-01 00:01:20,16,8,7298,382,6916,11.14%,5.23%
2020-01-01 00:01:20,16,9,10684,875,9809,16.30%,8.19%
2020-01-01 00:01:20,16,10,1663,39,1624,2.54%,2.34%
2020-01-01 00:01:20,16,11,9230,649,8581,14.08%,7.03%
2020-01-01 00:01:20,16,12,28486,5544,22942,43.47%,19.46%
2020-01-01 00:01:30,1,1,17463,2210,15253,26.65%,12.65%
2020-01-01 00:01:30,1,2,7434,433,7001,11.34%,5.82%
2020-01-01 00:01:30,1,3,673,2,671,1.03%,0.30%
2020-01-01 00:01:30,1,4,9711,743,8968,14.82%,7.65%
2020-01-01 00:01:30,1,5,9373,687,8686,14.30%,7.33%
2020-01-01 00:01:30,1,6,9312,677,8635,14.21%,7.27%
2020-01-01 00:01:30,1,7,6748,360,6388,10.30%,5.33%
2020-01-01 00:01:30,1,8,5363,235,5128,8.18%,4.38%
2020-01-01 00:01:30,1,9,9274,676,8598,14.15%,7.29%
2020-01-01 00:01:30,1,10,4502,158,4344,6.87%,3.51%
2020-01-01 00:01:30,1,11,4564,166,4398,6.96%,3.64%
2020-01-01 00:01:30,1,12,9249,670,8579,14.11%,7.24%
2020-01-01 00:01:30,2,1,1012,16,996,1.54%,1.58%
2020-01-01 00:01:30,2,2,29375,5612,23763,44.82%,19.10%
2020-01-01 00:01:30,2,3,23883,3786,20097,36.44%,15.85%
2020-01-01 00:01:30,2,4,639,11,628,0.98%,1.72%
2020-01-01 00:01:30,2,5,13720,1365,12355,20.94%,9.95%
2020-01-01 00:01:30,2,6,39,0,39,0.06%,0.00%
2020-01-01 00:01:30,2,7,4466,144,4322,6.81%,3.22%
2020-01-01 00:01:30,2,8,3393,78,3315,5.18%,2.30%
2020-01-01 00:01:30,2,9,13644,1341,12303,20.82%,9.83%
2020-01-01 00:01:30,2,10,2611,44,2567,3.98%,1.68%
2020-01-01 00:01:30,2,11,2616,44,2572,3.99%,1.68%
2020-01-01 00:01:30,2,12,13425,1295,12130,20.48%,9.65%
2020-01-01 00:01:30,3,1,1463,13,1450,2.23%,0.89%
2020-01-01 00:01:30,3,2,25578,4400,21178,39.03%,17.20%
2020-01-01 00:01:30,3,3,76363,31167,45196,116.52%,40.81%
2020-01-01 00:01:30,3,4,8718,546,8172,13.30%,6.26%
2020-01-01 00:01:30,3,5,47146,13517,33629,71.94%,28.67%
2020-01-01 00:01:30,3,6,9734,670,9064,14.85%,6.88%
2020-01-01 00:01:30,3,7,22218,3372,18846,33.90%,15.18%
2020-01-01 00:01:30,3,8,17628,2176,15452,26.90%,12.34%
2020-01-01 00:01:30,3,9,36520,8492,28028,55.73%,23.25%
2020-01-01 00:01:30,3,10,8762,553,8209,13.37%,6.31%
2020-01-01 00:01:30,3,11,1681,23,1658,2.57%,1.37%
2020-01-01 00:01:30,3,12,25006,4202,20804,38.16%,16.80%
2020-01-01 00:01:30,4,1,482,1,481,0.74%,0.21%
2020-01-01 00:01:30,4,2,300,0,300,0.46%,0.00%
2020-01-01 00:01:30,4,3,924,5,919,1.41%,0.54%
2020-01-01 00:01:30,4,4,28454,5482,22972,43.42%,19.27%
2020-01-01 00:01:30,4,5,18783,2454,16329,28.66%,13.06%
2020-01-01 00:01:30,4,6,24952,4249,20703,38.07%,17.03%
2020-01-01 00:01:30,4,7,5019,189,4830,7.66%,3.76%
2020-01-01 00:01:30,4,8,2859,60,2799,4.36%,2.10%
2020-01-01 00:01:30,4,9,16546,1905,14641,25.25%,11.51%
2020-01-01 00:01:30,4,10,2077,37,2040,3.17%,1.78%
2020-01-01 00:01:30,4,11,178,1,177,0.27%,0.56%
2020-01-01 00:01:30,4,12,12950,1190,11760,19.76%,9.19%
2020-01-01 00:01:30,5,1,2978,64,2914,4.54%,2.15%
2020-01-01 00:01:30,5,2,789,6,783,1.20%,0.76%
2020-01-01 00:01:30,5,3,623,3,620,0.95%,0.48%
2020-01-01 00:01:30,5,4,21891,3309,18582,33.40%,15.12%
2020-01-01 00:01:30,5,5,9605,711,8894,14.66%,7.40%
2020-01-01 00:01:30,5,6,15412,1688,13724,23.52%,10.95%
2020-01-01 00:01:30,5,7,5164,222,4942,7.88%,4.30%
2020-01-01 00:01:30,5,8,3456,109,3347,5.27%,3.15%
2020-01-01 00:01:30,5,9,8274,547,7727,12.63%,6.61%
2020-01-01 00:01:30,5,10,888,4,884,1.35%,0.45%
2020-01-01 00:01:30,5,11,677,6,671,1.03%,0.88%
2020-01-01 00:01:30,5,12,7122,418,6704,10.87%,5.87%
2020-01-01 00:01:30,6,1,1062,10,1052,1.62%,0.94%
2020-01-01 00:01:30,6,2,1118,13,1105,1.71%,1.16%
2020-01-01 00:01:30,6,3,2028,33,1995,3.09%,1.63%
2020-01-01 00:01:30,6,4,1209,13,1196,1.84%,1.07%
2020-01-01 00:01:30,6,5,12677,1236,11441,19.34%,9.75%
2020-01-01 00:01:30,6,6,3979,138,3841,6.07%,3.47%
2020-01-01 00:01:30,6,7,2280,54,2226,3.48%,2.37%
2020-01-01 00:01:30,6,8,1755,36,1719,2.68%,2.05%
2020-01-01 00:01:30,6,9,6324,341,5983,9.65%,5.39%
2020-01-01 00:01:30,6,10,1975,56,1919,3.01%,2.83%
2020-01-01 00:01:30,6,11,407,2,405,0.62%,0.49%
2020-01-01 00:01:30,6,12,4259,152,4107,6.50%,3.57%
2020-01-01 00:01:30,7,1,535,6,529,0.82%,1.12%
2020-01-01 00:01:30,7,2,151,0,151,0.23%,0.00%
2020-01-01 00:01:30,7,3,1244,12,1232,1.90%,0.96%
2020-01-01 00:01:30,7,4,1419,18,1401,2.17%,1.27%
2020-01-01 00:01:30,7,5,8375,525,7850,12.78%,6.27%
2020-01-01 00:01:30,7,6,12977,1229,11748,19.80%,9.47%
2020-01-01 00:01:30,7,7,3098,85,3013,4.73%,2.74%
2020-01-01 00:01:30,7,8,1052,5,1047,1.61%,0.47%
2020-01-01 00:01:30,7,9,7061,372,6689,10.77%,5.27%
2020-01-01 00:01:30,7,10,1527,11,1516,2.33%,0.72%
2020-01-01 00:01:30,7,11,101,0,101,0.15%,0.00%
2020-01-01 00:01:30,7,12,5483,233,5250,8.37%,4.25%
2020-01-01 00:01:30,8,1,401,1,400,0.61%,0.25%
2020-01-01 00:01:30,8,2,94,0,94,0.14%,0.00%
2020-01-01 00:01:30,8,3,1589,19,1570,2.42%,1.19%
2020-01-01 00:01:30,8,4,2553,58,2495,3.90%,2.27%
2020-01-01 00:01:30,8,5,8768,566,8202,13.38%,6.45%
2020-01-01 00:01:30,8,6,16650,1950,14700,25.41%,11.71%
2020-01-01 00:01:30,8,7,5234,222,5012,7.99%,4.24%
2020-01-01 00:01:30,8,8,2142,43,2099,3.27%,2.01%
2020-01-01 00:01:30,8,9,5995,271,5724,9.15%,4.52%
2020-01-01 00:01:30,8,10,1614,19,1595,2.46%,1.18%
2020-01-01 00:01:30,8,11,183,0,183,0.28%,0.00%
2020-01-01 00:01:30,8,12,4276,147,4129,6.52%,3.44%
2020-01-01 00:01:30,9,1,606,1,605,0.92%,0.16%
2020-01-01 00:01:30,9,2,2538,47,2491,3.87%,1.85%
2020-01-01 00:01:30,9,3,1363,15,1348,2.08%,1.10%
2020-01-01 00:01:30,9,4,9535,664,8871,14.55%,6.96%
2020-01-01 00:01:30,9,5,234,0,234,0.36%,0.00%
2020-01-01 00:01:30,9,6,10357,774,9583,15.80%,7.47%
2020-01-01 00:01:30,9,7,32419,6944,25475,49.47%,21.42%
2020-01-01 00:01:30,9,8,11967,1156,10811,18.26%,9.66%
2020-01-01 00:01:30,9,9,146,0,146,0.22%,0.00%
2020-01-01 00:01:30,9,10,4445,176,4269,6.78%,3.96%
2020-01-01 00:01:30,9,11,10677,931,9746,16.29%,8.72%
2020-01-01 00:01:30,9,12,5985,273,5712,9.13%,4.56%
2020-01-01 00:01:30,10,1,1236,206,1030,1.89%,16.65%
2020-01-01 00:01:30,10,2,2828,245,2583,4.32%,8.66%
2020-01-01 00:01:30,10,3,1445,23,1422,2.20%,1.59%
2020-01-01 00:01:30,10,4,4242,950,3292,6.47%,22.39%
2020-01-01 00:01:30,10,5,774,3,771,1.18%,0.39%
2020-01-01 00:01:30,10,6,6138,1051,5087,9.37%,17.12%
2020-01-01 00:01:30,10,7,11149,1784,9365,17.01%,16.00%
2020-01-01 00:01:30,10,8,27516,6520,20996,41.99%,23.69%
2020-01-01 00:01:30,10,9,785,6,779,1.20%,0.76%
2020-01-01 00:01:30,10,10,2304,43,2261,3.52%,1.87%
2020-01-01 00:01:30,10,11,12899,1566,11333,19.68%,12.14%
2020-01-01 00:01:30,10,12,9673,1072,8601,14.76%,11.08%
2020-01-01 00:01:30,11,1,2139,32,2107,3.26%,1.50%
2020-01-01 00:01:30,11,2,3676,104,3572,5.61%,2.83%
2020-01-01 00:01:30,11,3,1431,18,1413,2.18%,1.26%
2020-01-01 00:01:30,11,4,4495,146,4349,6.86%,3.25%
2020-01-01 00:01:30,11,5,154,0,154,0.23%,0.00%
2020-01-01 00:01:30,11,6,5218,199,5019,7.96%,3.81%
2020-01-01 00:01:30,11,7,10610,822,9788,16.19%,7.75%
2020-01-01 00:01:30,11,8,26513,4774,21739,40.46%,18.01%
2020-01-01 00:01:30,11,9,195,0,195,0.30%,0.00%
2020-01-01 00:01:30,11,10,2983,77,2906,4.55%,2.58%
2020-01-01 00:01:30,11,11,12261,1116,11145,18.71%,9.10%
2020-01-01 00:01:30,11,12,8911,591,8320,13.60%,6.63%
2020-01-01 00:01:30,12,1,44,0,44,0.07%,0.00%
2020-01-01 00:01:30,12,2,563,194,369,0.86%,34.40%
2020-01-01 00:01:30,12,3,2761,261,2500,4.21%,9.45%
2020-01-01 00:01:30,12,4,3132,60,3072,4.78%,1.92%
2020-01-01 00:01:30,12,5,9225,801,8424,14.08%,8.68%
2020-01-01 00:01:30,12,6,5527,198,5329,8.43%,3.58%
2020-01-01 00:01:30,12,7,2230,41,2189,3.40%,1.84%
2020-01-01 00:01:30,12,8,1356,279,1077,2.07%,20.56%
2020-01-01 00:01:30,12,9,21593,4200,17393,32.95%,19.45%
2020-01-01 00:01:30,12,10,3991,378,3613,6.09%,9.47%
2020-01-01 00:01:30,12,11,1524,282,1242,2.33%,18.49%
2020-01-01 00:01:30,12,12,7858,1002,6856,11.99%,12.75%
2020-01-01 00:01:30,13,1,2808,69,2739,4.28%,2.46%
2020-01-01 00:01:30,13,2,3134,80,3054,4.78%,2.55%
2020-01-01 00:01:30,13,3,849,7,842,1.30%,0.82%
2020-01-01 00:01:30,13,4,4824,541,4283,7.36%,11.21%
2020-01-01 00:01:30,13,5,7637,817,6820,11.65%,10.70%
2020-01-01 00:01:30,13,6,5678,597,5081,8.66%,10.51%
2020-01-01 00:01:30,13,7,5459,213,5246,8.33%,3.90%
2020-01-01 00:01:30,13,8,7753,420,7333,11.83%,5.42%
2020-01-01 00:01:30,13,9,8040,864,7176,12.27%,10.74%
2020-01-01 00:01:30,13,10,27665,5691,21974,42.21%,20.57%
2020-01-01 00:01:30,13,11,16579,2270,14309,25.30%,13.69%
2020-01-01 00:01:30,13,12,8298,921,7377,12.66%,11.10%
2020-01-01 00:01:30,14,1,417,3,414,0.64%,0.72%
2020-01-01 00:01:30,14,2,1570,24,1546,2.40%,1.53%
2020-01-01 00:01:30,14,3,965,10,955,1.47%,1.04%
2020-01-01 00:01:30,14,4,3973,118,3855,6.06%,2.97%
2020-01-01 00:01:30,14,5,1335,16,1319,2.04%,1.20%
2020-01-01 00:01:30,14,6,4434,151,4283,6.77%,3.40%
2020-01-01 00:01:30,14,7,12526,1143,11383,19.11%,9.12%
2020-01-01 00:01:30,14,8,14144,1415,12729,21.58%,10.00%
2020-01-01 00:01:30,14,9,1511,22,1489,2.31%,1.46%
2020-01-01 00:01:30,14,10,3815,103,3712,5.82%,2.70%
2020-01-01 00:01:30,14,11,25632,4383,21249,39.11%,17.10%
2020-01-01 00:01:30,14,12,7496,414,7082,11.44%,5.52%
2020-01-01 00:01:30,15,1,502,5,497,0.77%,0.99%
2020-01-01 00:01:30,15,2,155,0,155,0.24%,0.00%
2020-01-01 00:01:30,15,3,3859,98,3761,5.89%,2.54%
2020-01-01 00:01:30,15,4,5354,206,5148,8.17%,3.85%
2020-01-01 00:01:30,15,5,10386,757,9629,15.85%,7.29%
2020-01-01 00:01:30,15,6,5591,224,5367,8.53%,4.01%
2020-01-01 00:01:30,15,7,4167,134,4033,6.36%,3.21%
2020-01-01 00:01:30,15,8,6378,334,6044,9.73%,5.24%
2020-01-01 00:01:30,15,9,10587,788,9799,16.15%,7.44%
2020-01-01 00:01:30,15,10,4762,237,4525,7.27%,4.98%
2020-01-01 00:01:30,15,11,11263,1033,10230,17.19%,9.17%
2020-01-01 00:01:30,15,12,27919,5609,22310,42.60%,20.09%
2020-01-01 00:01:30,16,1,429,2,427,0.65%,0.47%
2020-01-01 00:01:30,16,2,208,1,207,0.32%,0.48%
2020-01-01 00:01:30,16,3,1075,11,1064,1.64%,1.02%
2020-01-01 00:01:30,16,4,4135,137,3998,6.31%,3.31%
2020-01-01 00:01:30,16,5,7774,486,7288,11.86%,6.25%
2020-01-01 00:01:30,16,6,4966,211,4755,7.58%,4.25%
2020-01-01 00:01:30,16,7,3121,63,3058,4.76%,2.02%
2020-01-01 00:01:30,16,8,6765,377,6388,10.32%,5.57%
2020-01-01 00:01:30,16,9,8110,530,7580,12.37%,6.53%
2020-01-01 00:01:30,16,10,1552,19,1533,2.37%,1.22%
2020-01-01 00:01:30,16,11,8546,587,7959,13.04%,6.87%
2020-01-01 00:01:30,16,12,24894,4276,20618,37.99%,17.18%
2020-01-01 00:01:40,1,1,18019,2304,15715,27.49%,12.79%
2020-01-01 00:01:40,1,2,5833,269,5564,8.90%,4.61%
2020-01-01 00:01:40,1,3,828,4,824,1.26%,0.48%
2020-01-01 00:01:40,1,4,11761,992,10769,17.95%,8.43%
2020-01-01 00:01:40,1,5,10824,870,9954,16.52%,8.04%
2020-01-01 00:01:40,1,6,10763,866,9897,16.42%,8.05%
2020-01-01 00:01:40,1,7,4969,197,4772,7.58%,3.96%
2020-01-01 00:01:40,1,8,3280,83,3197,5.00%,2.53%
2020-01-01 00:01:40,1,9,10725,861,9864,16.37%,8.03%
2020-01-01 00:01:40,1,10,2458,47,2411,3.75%,1.91%
2020-01-01 00:01:40,1,11,2548,50,2498,3.89%,1.96%
2020-01-01 00:01:40,1,12,10691,855,9836,16.31%,8.00%
2020-01-01 00:01:40,2,1,778,8,770,1.19%,1.03%
2020-01-01 00:01:40,2,2,28274,5319,22955,43.14%,18.81%
2020-01-01 00:01:40,2,3,22375,3381,18994,34.14%,15.11%
2020-01-01 00:01:40,2,4,530,7,523,0.81%,1.32%
2020-01-01 00:01:40,2,5,10651,840,9811,16.25%,7.89%
2020-01-01 00:01:40,2,6,24,0,24,0.04%,0.00%
2020-01-01 00:01:40,2,7,5104,181,4923,7.79%,3.55%
2020-01-01 00:01:40,2,8,3811,102,3709,5.82%,2.68%
2020-01-01 00:01:40,2,9,10571,832,9739,16.13%,7.87%
2020-01-01 00:01:40,2,10,2614,52,2562,3.99%,1.99%
2020-01-01 00:01:40,2,11,2624,52,2572,4.00%,1.98%
2020-01-01 00:01:40,2,12,10399,805,9594,15.87%,7.74%
2020-01-01 00:01:40,3,1,1664,22,1642,2.54%,1.32%
2020-01-01 00:01:40,3,2,28154,5212,22942,42.96%,18.51%
2020-01-01 00:01:40,3,3,69651,26716,42935,106.28%,38.36%
2020-01-01 00:01:40,3,4,5446,223,5223,8.31%,4.09%
2020-01-01 00:01:40,3,5,40514,10270,30244,61.82%,25.35%
2020-01-01 00:01:40,3,6,6447,302,6145,9.84%,4.68%
2020-01-01 00:01:40,3,7,24170,3931,20239,36.88%,16.26%
2020-01-01 00:01:40,3,8,18859,2444,16415,28.78%,12.96%
2020-01-01 00:01:40,3,9,33379,7191,26188,50.93%,21.54%
2020-01-01 00:01:40,3,10,4114,123,3991,6.28%,2.99%
2020-01-01 00:01:40,3,11,1937,31,1906,2.96%,1.60%
2020-01-01 00:01:40,3,12,25394,4328,21066,38.75%,17.04%
2020-01-01 00:01:40,4,1,550,0,550,0.84%,0.00%
2020-01-01 00:01:40,4,2,300,0,300,0.46%,0.00%
2020-01-01 00:01:40,4,3,860,6,854,1.31%,0.70%
2020-01-01 00:01:40,4,4,30415,6223,24192,46.41%,20.46%
2020-01-01 00:01:40,4,5,19353,2695,16658,29.53%,13.92%
2020-01-01 00:01:40,4,6,26469,4790,21679,40.39%,18.10%
2020-01-01 00:01:40,4,7,5789,255,5534,8.83%,4.40%
2020-01-01 00:01:40,4,8,3439,90,3349,5.25%,2.62%
2020-01-01 00:01:40,4,9,17119,2143,14976,26.12%,12.52%
2020-01-01 00:01:40,4,10,2099,29,2070,3.20%,1.38%
2020-01-01 00:01:40,4,11,163,0,163,0.25%,0.00%
2020-01-01 00:01:40,4,12,12876,1245,11631,19.65%,9.67%
2020-01-01 00:01:40,5,1,3298,95,3203,5.03%,2.88%
2020-01-01 00:01:40,5,2,867,7,860,1.32%,0.81%
2020-01-01 00:01:40,5,3,537,7,530,0.82%,1.30%
2020-01-01 00:01:40,5,4,23620,3815,19805,36.04%,16.15%
2020-01-01 00:01:40,5,5,10562,841,9721,16.12%,7.96%
2020-01-01 00:01:40,5,6,16221,1879,14342,24.75%,11.58%
2020-01-01 00:01:40,5,7,5033,207,4826,7.68%,4.11%
2020-01-01 00:01:40,5,8,3632,100,3532,5.54%,2.75%
2020-01-01 00:01:40,5,9,9926,729,9197,15.15%,7.34%
2020-01-01 00:01:40,5,10,1240,14,1226,1.89%,1.13%
2020-01-01 00:01:40,5,11,756,5,751,1.15%,0.66%
2020-01-01 00:01:40,5,12,8428,528,7900,12.86%,6.26%
2020-01-01 00:01:40,6,1,1150,9,1141,1.75%,0.78%
2020-01-01 00:01:40,6,2,1189,12,1177,1.81%,1.01%
2020-01-01 00:01:40,6,3,1690,24,1666,2.58%,1.42%
2020-01-01 00:01:40,6,4,1076,5,1071,1.64%,0.46%
2020-01-01 00:01:40,6,5,12285,1113,11172,18.75%,9.06%
2020-01-01 00:01:40,6,6,4893,182,4711,7.47%,3.72%
2020-01-01 00:01:40,6,7,3179,80,3099,4.85%,2.52%
2020-01-01 00:01:40,6,8,2625,48,2577,4.01%,1.83%
2020-01-01 00:01:40,6,9,5422,221,5201,8.27%,4.08%
2020-01-01 00:01:40,6,10,1565,19,1546,2.39%,1.21%
2020-01-01 00:01:40,6,11,395,1,394,0.60%,0.25%
2020-01-01 00:01:40,6,12,3787,107,3680,5.78%,2.82%
2020-01-01 00:01:40,7,1,522,8,514,0.80%,1.53%
2020-01-01 00:01:40,7,2,222,1,221,0.34%,0.45%
2020-01-01 00:01:40,7,3,713,6,707,1.09%,0.84%
2020-01-01 00:01:40,7,4,2166,50,2116,3.31%,2.31%
2020-01-01 00:01:40,7,5,9524,638,8886,14.53%,6.70%
2020-01-01 00:01:40,7,6,14959,1563,13396,22.83%,10.45%
2020-01-01 00:01:40,7,7,3180,91,3089,4.85%,2.86%
2020-01-01 00:01:40,7,8,1103,8,1095,1.68%,0.72%
2020-01-01 00:01:40,7,9,8708,529,8179,13.29%,6.07%
2020-01-01 00:01:40,7,10,2146,21,2125,3.27%,0.98%
2020-01-01 00:01:40,7,11,104,0,104,0.16%,0.00%
2020-01-01 00:01:40,7,12,6498,313,6185,9.92%,4.82%
2020-01-01 00:01:40,8,1,512,2,510,0.78%,0.39%
2020-01-01 00:01:40,8,2,172,0,172,0.26%,0.00%
2020-01-01 00:01:40,8,3,1582,21,1561,2.41%,1.33%
2020-01-01 00:01:40,8,4,2813,52,2761,4.29%,1.85%
2020-01-01 00:01:40,8,5,8306,514,7792,12.67%,6.19%
2020-01-01 00:01:40,8,6,20587,2951,17636,31.41%,14.33%
2020-01-01 00:01:40,8,7,9332,654,8678,14.24%,7.01%
2020-01-01 00:01:40,8,8,6113,280,5833,9.33%,4.58%
2020-01-01 00:01:40,8,9,5997,282,5715,9.15%,4.70%
2020-01-01 00:01:40,8,10,1674,20,1654,2.55%,1.19%
2020-01-01 00:01:40,8,11,102,0,102,0.16%,0.00%
2020-01-01 00:01:40,8,12,4262,143,4119,6.50%,3.35%
2020-01-01 00:01:40,9,1,431,1,430,0.66%,0.23%
2020-01-01 00:01:40,9,2,2154,33,2121,3.29%,1.53%
2020-01-01 00:01:40,9,3,1183,9,1174,1.81%,0.76%
2020-01-01 00:01:40,9,4,6174,270,5904,9.42%,4.37%
2020-01-01 00:01:40,9,5,247,0,247,0.38%,0.00%
2020-01-01 00:01:40,9,6,6990,351,6639,10.67%,5.02%
2020-01-01 00:01:40,9,7,26070,4617,21453,39.78%,17.71%
2020-01-01 00:01:40,9,8,10161,771,9390,15.50%,7.59%
2020-01-01 00:01:40,9,9,160,0,160,0.24%,0.00%
2020-01-01 00:01:40,9,10,2609,62,2547,3.98%,2.38%
2020-01-01 00:01:40,9,11,7946,491,7455,12.12%,6.18%
2020-01-01 00:01:40,9,12,5032,202,4830,7.68%,4.01%
2020-01-01 00:01:40,10,1,1264,255,1009,1.93%,20.16%
2020-01-01 00:01:40,10,2,2989,312,2677,4.56%,10.43%
2020-01-01 00:01:40,10,3,1523,28,1495,2.32%,1.84%
2020-01-01 00:01:40,10,4,4109,1213,2896,6.27%,29.51%
2020-01-01 00:01:40,10,5,699,41,658,1.07%,5.86%
2020-01-01 00:01:40,10,6,6091,1376,4715,9.29%,22.59%
2020-01-01 00:01:40,10,7,11736,2233,9503,17.91%,19.03%
2020-01-01 00:01:40,10,8,29321,7620,21701,44.74%,25.99%
2020-01-01 00:01:40,10,9,809,5,804,1.23%,0.62%
2020-01-01 00:01:40,10,10,2248,33,2215,3.43%,1.47%
2020-01-01 00:01:40,10,11,13909,1795,12114,21.22%,12.90%
2020-01-01 00:01:40,10,12,10882,1308,9574,16.60%,12.02%
2020-01-01 00:01:40,11,1,2058,38,2020,3.14%,1.85%
2020-01-01 00:01:40,11,2,2936,74,2862,4.48%,2.52%
2020-01-01 00:01:40,11,3,748,0,748,1.14%,0.00%
2020-01-01 00:01:40,11,4,3832,103,3729,5.85%,2.69%
2020-01-01 00:01:40,11,5,179,2,177,0.27%,1.11%
2020-01-01 00:01:40,11,6,4839,183,4656,7.38%,3.78%
2020-01-01 00:01:40,11,7,9484,699,8785,14.47%,7.37%
2020-01-01 00:01:40,11,8,24925,4262,20663,38.03%,17.10%
2020-01-01 00:01:40,11,9,328,0,328,0.50%,0.00%
2020-01-01 00:01:40,11,10,3788,113,3675,5.78%,2.98%
2020-01-01 00:01:40,11,11,11449,969,10480,17.47%,8.46%
2020-01-01 00:01:40,11,12,7106,385,6721,10.84%,5.42%
2020-01-01 00:01:40,12,1,28,0,28,0.04%,0.00%
2020-01-01 00:01:40,12,2,606,166,440,0.92%,27.35%
2020-01-01 00:01:40,12,3,3109,221,2888,4.74%,7.11%
2020-01-01 00:01:40,12,4,2854,79,2775,4.35%,2.77%
2020-01-01 00:01:40,12,5,9452,782,8670,14.42%,8.27%
2020-01-01 00:01:40,12,6,5636,245,5391,8.60%,4.35%
2020-01-01 00:01:40,12,7,2580,37,2543,3.94%,1.43%
2020-01-01 00:01:40,12,8,1747,312,1435,2.67%,17.85%
2020-01-01 00:01:40,12,9,23620,4629,18991,36.04%,19.60%
2020-01-01 00:01:40,12,10,4365,427,3938,6.66%,9.78%
2020-01-01 00:01:40,12,11,1900,318,1582,2.90%,16.73%
2020-01-01 00:01:40,12,12,8666,1132,7534,13.22%,13.06%
2020-01-01 00:01:40,13,1,2455,45,2410,3.75%,1.83%
2020-01-01 00:01:40,13,2,2797,68,2729,4.27%,2.43%
2020-01-01 00:01:40,13,3,1003,7,996,1.53%,0.70%
2020-01-01 00:01:40,13,4,5353,517,4836,8.17%,9.66%
2020-01-01 00:01:40,13,5,8357,933,7424,12.75%,11.16%
2020-01-01 00:01:40,13,6,6179,577,5602,9.43%,9.34%
2020-01-01 00:01:40,13,7,5163,234,4929,7.88%,4.53%
2020-01-01 00:01:40,13,8,7961,498,7463,12.15%,6.25%
2020-01-01 00:01:40,13,9,8686,971,7715,13.25%,11.18%
2020-01-01 00:01:40,13,10,29657,6485,23172,45.25%,21.87%
2020-01-01 00:01:40,13,11,17720,2641,15079,27.04%,14.90%
2020-01-01 00:01:40,13,12,9314,1088,8226,14.21%,11.68%
2020-01-01 00:01:40,14,1,221,0,221,0.34%,0.00%
2020-01-01 00:01:40,14,2,1200,22,1178,1.83%,1.83%
2020-01-01 00:01:40,14,3,750,14,736,1.14%,1.86%
2020-01-01 00:01:40,14,4,5295,201,5094,8.08%,3.80%
2020-01-01 00:01:40,14,5,1258,9,1249,1.92%,0.71%
2020-01-01 00:01:40,14,6,5693,229,5464,8.69%,4.02%
2020-01-01 00:01:40,14,7,13637,1301,12336,20.81%,9.54%
2020-01-01 00:01:40,14,8,15148,1621,13527,23.11%,10.70%
2020-01-01 00:01:40,14,9,1449,13,1436,2.21%,0.90%
2020-01-01 00:01:40,14,10,3816,107,3709,5.82%,2.80%
2020-01-01 00:01:40,14,11,27401,5077,22324,41.81%,18.53%
2020-01-01 00:01:40,14,12,8186,497,7689,12.49%,6.07%
2020-01-01 00:01:40,15,1,470,2,468,0.72%,0.42%
2020-01-01 00:01:40,15,2,166,1,165,0.25%,0.60%
2020-01-01 00:01:40,15,3,3701,94,3607,5.65%,2.54%
2020-01-01 00:01:40,15,4,5298,213,5085,8.08%,4.02%
2020-01-01 00:01:40,15,5,9847,725,9122,15.03%,7.36%
2020-01-01 00:01:40,15,6,5685,240,5445,8.67%,4.22%
2020-01-01 00:01:40,15,7,3866,113,3753,5.90%,2.92%
2020-01-01 00:01:40,15,8,5832,264,5568,8.90%,4.53%
2020-01-01 00:01:40,15,9,10090,754,9336,15.40%,7.47%
2020-01-01 00:01:40,15,10,4051,229,3822,6.18%,5.65%
2020-01-01 00:01:40,15,11,9977,807,9170,15.22%,8.09%
2020-01-01 00:01:40,15,12,25634,4884,20750,39.11%,19.05%
2020-01-01 00:01:40,16,1,396,0,396,0.60%,0.00%
2020-01-01 00:01:40,16,2,247,3,244,0.38%,1.21%
2020-01-01 00:01:40,16,3,1317,15,1302,2.01%,1.14%
2020-01-01 00:01:40,16,4,4731,181,4550,7.22%,3.83%
2020-01-01 00:01:40,16,5,8319,584,7735,12.69%,7.02%
2020-01-01 00:01:40,16,6,5731,259,5472,8.74%,4.52%
2020-01-01 00:01:40,16,7,3035,70,2965,4.63%,2.31%
2020-01-01 00:01:40,16,8,6934,419,6515,10.58%,6.04%
2020-01-01 00:01:40,16,9,8742,629,8113,13.34%,7.19%
2020-01-01 00:01:40,16,10,1463,15,1448,2.23%,1.02%
2020-01-01 00:01:40,16,11,8669,596,8073,13.23%,6.87%
2020-01-01 00:01:40,16,12,25563,4521,21042,39.01%,17.69%
2020-01-01 00:01:50,1,1,27224,4979,22245,41.54%,18.29%
2020-01-01 00:01:50,1,2,13371,1242,12129,20.40%,9.29%
2020-01-01 00:01:50,1,3,1472,13,1459,2.25%,0.88%
2020-01-01 00:01:50,1,4,13406,1349,12057,20.46%,10.06%
2020-01-01 00:01:50,1,5,12025,1126,10899,18.35%,9.36%
2020-01-01 00:01:50,1,6,12006,1119,10887,18.32%,9.32%
2020-01-01 00:01:50,1,7,11865,985,10880,18.10%,8.30%
2020-01-01 00:01:50,1,8,9565,641,8924,14.60%,6.70%
2020-01-01 00:01:50,1,9,11966,1113,10853,18.26%,9.30%
2020-01-01 00:01:50,1,10,8916,555,8361,13.60%,6.22%
2020-01-01 00:01:50,1,11,8984,568,8416,13.71%,6.32%
2020-01-01 00:01:50,1,12,11937,1108,10829,18.21%,9.28%
2020-01-01 00:01:50,2,1,501,2,499,0.76%,0.40%
2020-01-01 00:01:50,2,2,25051,4262,20789,38.22%,17.01%
2020-01-01 00:01:50,2,3,19306,2518,16788,29.46%,13.04%
2020-01-01 00:01:50,2,4,462,2,460,0.70%,0.43%
2020-01-01 00:01:50,2,5,11886,1030,10856,18.14%,8.66%
2020-01-01 00:01:50,2,6,32,0,32,0.05%,0.00%
2020-01-01 00:01:50,2,7,5220,218,5002,7.97%,4.18%
2020-01-01 00:01:50,2,8,4246,128,4118,6.48%,3.01%
2020-01-01 00:01:50,2,9,11748,1006,10742,17.93%,8.56%
2020-01-01 00:01:50,2,10,3231,69,3162,4.93%,2.13%
2020-01-01 00:01:50,2,11,3261,69,3192,4.98%,2.12%
2020-01-01 00:01:50,2,12,11556,977,10579,17.63%,8.45%
2020-01-01 00:01:50,3,1,1480,22,1458,2.26%,1.49%
2020-01-01 00:01:50,3,2,23468,3689,19779,35.81%,15.72%
2020-01-01 00:01:50,3,3,64412,23297,41115,98.28%,36.17%
2020-01-01 00:01:50,3,4,7465,414,7051,11.39%,5.55%
2020-01-01 00:01:50,3,5,40073,9994,30079,61.15%,24.94%
2020-01-01 00:01:50,3,6,8390,530,7860,12.80%,6.32%
2020-01-01 00:01:50,3,7,20255,2770,17485,30.91%,13.67%
2020-01-01 00:01:50,3,8,17053,2019,15034,26.02%,11.84%
2020-01-01 00:01:50,3,9,31225,6302,24923,47.65%,20.18%
2020-01-01 00:01:50,3,10,4386,142,4244,6.69%,3.24%
2020-01-01 00:01:50,3,11,2319,49,2270,3.54%,2.11%
2020-01-01 00:01:50,3,12,24494,4001,20493,37.37%,16.33%
2020-01-01 00:01:50,4,1,546,2,544,0.83%,0.37%
2020-01-01 00:01:50,4,2,299,0,299,0.46%,0.00%
2020-01-01 00:01:50,4,3,1053,11,1042,1.61%,1.04%
2020-01-01 00:01:50,4,4,27892,5177,22715,42.56%,18.56%
2020-01-01 00:01:50,4,5,17265,2125,15140,26.34%,12.31%
2020-01-01 00:01:50,4,6,24122,3929,20193,36.81%,16.29%
2020-01-01 00:01:50,4,7,5485,221,5264,8.37%,4.03%
2020-01-01 00:01:50,4,8,3157,75,3082,4.82%,2.37%
2020-01-01 00:01:50,4,9,15142,1636,13506,23.10%,10.80%
2020-01-01 00:01:50,4,10,1930,28,1902,2.94%,1.45%
2020-01-01 00:01:50,4,11,171,0,171,0.26%,0.00%
2020-01-01 00:01:50,4,12,12034,1036,10998,18.36%,8.61%
2020-01-01 00:01:50,5,1,2756,48,2708,4.21%,1.74%
2020-01-01 00:01:50,5,2,753,5,748,1.15%,0.66%
2020-01-01 00:01:50,5,3,563,1,562,0.86%,0.18%
2020-01-01 00:01:50,5,4,30523,6192,24331,46.57%,20.29%
2020-01-01 00:01:50,5,5,11555,1011,10544,17.63%,8.75%
2020-01-01 00:01:50,5,6,17396,2180,15216,26.54%,12.53%
2020-01-01 00:01:50,5,7,5203,221,4982,7.94%,4.25%
2020-01-01 00:01:50,5,8,4119,145,3974,6.29%,3.52%
2020-01-01 00:01:50,5,9,10781,883,9898,16.45%,8.19%
2020-01-01 00:01:50,5,10,1000,7,993,1.53%,0.70%
2020-01-01 00:01:50,5,11,781,6,775,1.19%,0.77%
2020-01-01 00:01:50,5,12,8919,621,8298,13.61%,6.96%
2020-01-01 00:01:50,6,1,1075,11,1064,1.64%,1.02%
2020-01-01 00:01:50,6,2,1143,14,1129,1.74%,1.22%
2020-01-01 00:01:50,6,3,1699,23,1676,2.59%,1.35%
2020-01-01 00:01:50,6,4,1494,10,1484,2.28%,0.67%
2020-01-01 00:01:50,6,5,14127,1377,12750,21.56%,9.75%
2020-01-01 00:01:50,6,6,4234,139,4095,6.46%,3.28%
2020-01-01 00:01:50,6,7,2245,52,2193,3.43%,2.32%
2020-01-01 00:01:50,6,8,1574,31,1543,2.40%,1.97%
2020-01-01 00:01:50,6,9,8004,444,7560,12.21%,5.55%
2020-01-01 00:01:50,6,10,2219,46,2173,3.39%,2.07%
2020-01-01 00:01:50,6,11,349,1,348,0.53%,0.29%
2020-01-01 00:01:50,6,12,5738,228,5510,8.76%,3.97%
2020-01-01 00:01:50,7,1,394,5,389,0.60%,1.27%
2020-01-01 00:01:50,7,2,180,0,180,0.27%,0.00%
2020-01-01 00:01:50,7,3,2106,20,2086,3.21%,0.95%
2020-01-01 00:01:50,7,4,1734,24,1710,2.65%,1.38%
2020-01-01 00:01:50,7,5,9033,653,8380,13.78%,7.23%
2020-01-01 00:01:50,7,6,14019,1481,12538,21.39%,10.56%
2020-01-01 00:01:50,7,7,3190,78,3112,4.87%,2.44%
2020-01-01 00:01:50,7,8,1128,6,1122,1.72%,0.53%
2020-01-01 00:01:50,7,9,6648,382,6266,10.14%,5.75%
2020-01-01 00:01:50,7,10,1399,18,1381,2.13%,1.29%
2020-01-01 00:01:50,7,11,129,0,129,0.20%,0.00%
2020-01-01 00:01:50,7,12,5223,235,4988,7.97%,4.50%
2020-01-01 00:01:50,8,1,430,0,430,0.66%,0.00%
2020-01-01 00:01:50,8,2,155,0,155,0.24%,0.00%
2020-01-01 00:01:50,8,3,1861,19,1842,2.84%,1.02%
2020-01-01 00:01:50,8,4,2892,59,2833,4.41%,2.04%
2020-01-01 00:01:50,8,5,8539,494,8045,13.03%,5.78%
2020-01-01 00:01:50,8,6,17052,1982,15070,26.02%,11.62%
2020-01-01 00:01:50,8,7,5526,222,5304,8.43%,4.02%
2020-01-01 00:01:50,8,8,2609,42,2567,3.98%,1.61%
2020-01-01 00:01:50,8,9,6514,286,6228,9.94%,4.39%
2020-01-01 00:01:50,8,10,1623,14,1609,2.48%,0.86%
2020-01-01 00:01:50,8,11,126,0,126,0.19%,0.00%
2020-01-01 00:01:50,8,12,4779,171,4608,7.29%,3.58%
2020-01-01 00:01:50,9,1,395,0,395,0.60%,0.00%
2020-01-01 00:01:50,9,2,2322,43,2279,3.54%,1.85%
2020-01-01 00:01:50,9,3,1233,16,1217,1.88%,1.30%
2020-01-01 00:01:50,9,4,8489,514,7975,12.95%,6.05%
2020-01-01 00:01:50,9,5,368,0,368,0.56%,0.00%
2020-01-01 00:01:50,9,6,9724,673,9051,14.84%,6.92%
2020-01-01 00:01:50,9,7,29848,5905,23943,45.54%,19.78%
2020-01-01 00:01:50,9,8,10079,754,9325,15.38%,7.48%
2020-01-01 00:01:50,9,9,277,0,277,0.42%,0.00%
2020-01-01 00:01:50,9,10,3795,128,3667,5.79%,3.37%
2020-01-01 00:01:50,9,11,8976,618,8358,13.70%,6.88%
2020-01-01 00:01:50,9,12,4871,196,4675,7.43%,4.02%
2020-01-01 00:01:50,10,1,1368,268,1100,2.09%,19.58%
2020-01-01 00:01:50,10,2,3170,324,2846,4.84%,10.22%
2020-01-01 00:01:50,10,3,1544,16,1528,2.36%,1.04%
2020-01-01 00:01:50,10,4,3933,1035,2898,6.00%,26.31%
2020-01-01 00:01:50,10,5,605,27,578,0.92%,4.46%
2020-01-01 00:01:50,10,6,6005,1183,4822,9.16%,19.70%
2020-01-01 00:01:50,10,7,11364,2001,9363,17.34%,17.61%
2020-01-01 00:01:50,10,8,27820,6986,20834,42.45%,25.11%
2020-01-01 00:01:50,10,9,933,7,926,1.42%,0.75%
2020-01-01 00:01:50,10,10,2399,48,2351,3.66%,2.00%
2020-01-01 00:01:50,10,11,12914,1552,11362,19.71%,12.02%
2020-01-01 00:01:50,10,12,9899,1091,8808,15.10%,11.02%
2020-01-01 00:01:50,11,1,1919,30,1889,2.93%,1.56%
2020-01-01 00:01:50,11,2,2811,58,2753,4.29%,2.06%
2020-01-01 00:01:50,11,3,713,4,709,1.09%,0.56%
2020-01-01 00:01:50,11,4,3221,77,3144,4.91%,2.39%
2020-01-01 00:01:50,11,5,531,2,529,0.81%,0.38%
2020-01-01 00:01:50,11,6,4421,160,4261,6.75%,3.62%
2020-01-01 00:01:50,11,7,8865,580,8285,13.53%,6.54%
2020-01-01 00:01:50,11,8,22750,3505,19245,34.71%,15.41%
2020-01-01 00:01:50,11,9,306,0,306,0.47%,0.00%
2020-01-01 00:01:50,11,10,3760,102,3658,5.74%,2.71%
2020-01-01 00:01:50,11,11,10635,792,9843,16.23%,7.45%
2020-01-01 00:01:50,11,12,6507,282,6225,9.93%,4.33%
2020-01-01 00:01:50,12,1,55,0,55,0.08%,0.00%
2020-01-01 00:01:50,12,2,679,193,486,1.04%,28.38%
2020-01-01 00:01:50,12,3,2618,226,2392,3.99%,8.63%
2020-01-01 00:01:50,12,4,2651,51,2600,4.05%,1.92%
2020-01-01 00:01:50,12,5,9904,878,9026,15.11%,8.86%
2020-01-01 00:01:50,12,6,5660,265,5395,8.64%,4.68%
2020-01-01 00:01:50,12,7,2867,61,2806,4.37%,2.13%
2020-01-01 00:01:50,12,8,1246,188,1058,1.90%,15.08%
2020-01-01 00:01:50,12,9,22694,4449,18245,34.63%,19.60%
2020-01-01 00:01:50,12,10,3529,271,3258,5.38%,7.68%
2020-01-01 00:01:50,12,11,1381,190,1191,2.11%,13.75%
2020-01-01 00:01:50,12,12,7577,1081,6496,11.56%,14.26%
2020-01-01 00:01:50,13,1,2145,41,2104,3.27%,1.91%
2020-01-01 00:01:50,13,2,2439,47,2392,3.72%,1.93%
2020-01-01 00:01:50,13,3,822,4,818,1.25%,0.49%
2020-01-01 00:01:50,13,4,4881,606,4275,7.45%,12.41%
2020-01-01 00:01:50,13,5,7396,904,6492,11.29%,12.22%
2020-01-01 00:01:50,13,6,5837,669,5168,8.91%,11.46%
2020-01-01 00:01:50,13,7,5007,185,4822,7.64%,3.69%
2020-01-01 00:01:50,13,8,7322,390,6932,11.17%,5.33%
2020-01-01 00:01:50,13,9,7781,944,6837,11.87%,12.13%
2020-01-01 00:01:50,13,10,26477,5428,21049,40.40%,20.50%
2020-01-01 00:01:50,13,11,16225,2217,14008,24.76%,13.66%
2020-01-01 00:01:50,13,12,8354,924,7430,12.75%,11.06%
2020-01-01 00:01:50,14,1,301,0,301,0.46%,0.00%
2020-01-01 00:01:50,14,2,1216,18,1198,1.86%,1.48%
2020-01-01 00:01:50,14,3,773,12,761,1.18%,1.55%
2020-01-01 00:01:50,14,4,7153,444,6709,10.91%,6.21%
2020-01-01 00:01:50,14,5,1219,12,1207,1.86%,0.98%
2020-01-01 00:01:50,14,6,7388,470,6918,11.27%,6.36%
2020-01-01 00:01:50,14,7,13766,1413,12353,21.01%,10.26%
2020-01-01 00:01:50,14,8,15138,1674,13464,23.10%,11.06%
2020-01-01 00:01:50,14,9,1445,12,1433,2.20%,0.83%
2020-01-01 00:01:50,14,10,3992,107,3885,6.09%,2.68%
2020-01-01 00:01:50,14,11,27353,5038,22315,41.74%,18.42%
2020-01-01 00:01:50,14,12,7947,459,7488,12.13%,5.78%
2020-01-01 00:01:50,15,1,692,2,690,1.06%,0.29%
2020-01-01 00:01:50,15,2,116,0,116,0.18%,0.00%
2020-01-01 00:01:50,15,3,3907,110,3797,5.96%,2.81%
2020-01-01 00:01:50,15,4,4530,226,4304,6.91%,4.99%
2020-01-01 00:01:50,15,5,9704,766,8938,14.81%,7.89%
2020-01-01 00:01:50,15,6,4806,246,4560,7.33%,5.12%
2020-01-01 00:01:50,15,7,3593,87,3506,5.48%,2.42%
2020-01-01 00:01:50,15,8,5390,191,5199,8.22%,3.54%
2020-01-01 00:01:50,15,9,10003,813,9190,15.26%,8.13%
2020-01-01 00:01:50,15,10,3887,161,3726,5.93%,4.14%
2020-01-01 00:01:50,15,11,9393,629,8764,14.33%,6.70%
2020-01-01 00:01:50,15,12,24752,4484,20268,37.77%,18.11%
2020-01-01 00:01:50,16,1,328,0,328,0.50%,0.00%
2020-01-01 00:01:50,16,2,213,1,212,0.33%,0.47%
2020-01-01 00:01:50,16,3,2198,45,2153,3.35%,2.05%
2020-01-01 00:01:50,16,4,4673,162,4511,7.13%,3.47%
2020-01-01 00:01:50,16,5,8766,627,8139,13.38%,7.15%
2020-01-01 00:01:50,16,6,5498,214,5284,8.39%,3.89%
2020-01-01 00:01:50,16,7,3236,84,3152,4.94%,2.59%
2020-01-01 00:01:50,16,8,6587,328,6259,10.05%,4.98%
2020-01-01 00:01:50,16,9,9250,697,8553,14.11%,7.53%
2020-01-01 00:01:50,16,10,3874,104,3770,5.91%,2.68%
2020-01-01 00:01:50,16,11,10726,827,9899,16.37%,7.71%
2020-01-01 00:01:50,16,12,28007,5265,22742,42.74%,18.80%
2020-01-01 00:02:00,1,1,22210,3366,18844,33.89%,15.15%
2020-01-01 00:02:00,1,2,6525,359,6166,9.96%,5.50%
2020-01-01 00:02:00,1,3,414,2,412,0.63%,0.48%
2020-01-01 00:02:00,1,4,15323,1658,13665,23.38%,10.82%
2020-01-01 00:02:00,1,5,14970,1567,13403,22.84%,10.47%
2020-01-01 00:02:00,1,6,14904,1547,13357,22.74%,10.38%
2020-01-01 00:02:00,1,7,6088,328,5760,9.29%,5.39%
2020-01-01 00:02:00,1,8,4231,149,4082,6.46%,3.52%
2020-01-01 00:02:00,1,9,14860,1540,13320,22.67%,10.36%
2020-01-01 00:02:00,1,10,3704,115,3589,5.65%,3.10%
2020-01-01 00:02:00,1,11,3759,120,3639,5.74%,3.19%
2020-01-01 00:02:00,1,12,14826,1532,13294,22.62%,10.33%
2020-01-01 00:02:00,2,1,700,9,691,1.07%,1.28%
2020-01-01 00:02:00,2,2,29037,5633,23404,44.31%,19.40%
2020-01-01 00:02:00,2,3,22401,3431,18970,34.18%,15.32%
2020-01-01 00:02:00,2,4,606,8,598,0.92%,1.32%
2020-01-01 00:02:00,2,5,14585,1534,13051,22.25%,10.52%
2020-01-01 00:02:00,2,6,26,0,26,0.04%,0.00%
2020-01-01 00:02:00,2,7,5929,249,5680,9.05%,4.20%
2020-01-01 00:02:00,2,8,5004,179,4825,7.64%,3.58%
2020-01-01 00:02:00,2,9,14427,1508,12919,22.01%,10.45%
2020-01-01 00:02:00,2,10,4313,131,4182,6.58%,3.04%
2020-01-01 00:02:00,2,11,4330,134,4196,6.61%,3.09%
2020-01-01 00:02:00,2,12,14269,1483,12786,21.77%,10.39%
2020-01-01 00:02:00,3,1,1834,35,1799,2.80%,1.91%
2020-01-01 00:02:00,3,2,24080,4005,20075,36.74%,16.63%
2020-01-01 00:02:00,3,3,71041,27696,43345,108.40%,38.99%
2020-01-01 00:02:00,3,4,8478,541,7937,12.94%,6.38%
2020-01-01 00:02:00,3,5,45483,12646,32837,69.40%,27.80%
2020-01-01 00:02:00,3,6,9606,690,8916,14.66%,7.18%
2020-01-01 00:02:00,3,7,20782,3029,17753,31.71%,14.57%
2020-01-01 00:02:00,3,8,15713,1775,13938,23.98%,11.30%
2020-01-01 00:02:00,3,9,35405,7960,27445,54.02%,22.48%
2020-01-01 00:02:00,3,10,4319,145,4174,6.59%,3.36%
2020-01-01 00:02:00,3,11,1998,26,1972,3.05%,1.30%
2020-01-01 00:02:00,3,12,28918,5460,23458,44.13%,18.88%
2020-01-01 00:02:00,4,1,473,1,472,0.72%,0.21%
2020-01-01 00:02:00,4,2,281,0,281,0.43%,0.00%
2020-01-01 00:02:00,4,3,1241,5,1236,1.89%,0.40%
2020-01-01 00:02:00,4,4,27519,5019,22500,41.99%,18.24%
2020-01-01 00:02:00,4,5,17752,2176,15576,27.09%,12.26%
2020-01-01 00:02:00,4,6,23862,3850,20012,36.41%,16.13%
2020-01-01 00:02:00,4,7,4875,177,4698,7.44%,3.63%
2020-01-01 00:02:00,4,8,2650,82,2568,4.04%,3.09%
2020-01-01 00:02:00,4,9,15390,1643,13747,23.48%,10.68%
2020-01-01 00:02:00,4,10,2146,31,2115,3.27%,1.44%
2020-01-01 00:02:00,4,11,127,0,127,0.19%,0.00%
2020-01-01 00:02:00,4,12,12590,1143,11447,19.21%,9.08%
2020-01-01 00:02:00,5,1,3104,51,3053,4.74%,1.64%
2020-01-01 00:02:00,5,2,752,6,746,1.15%,0.80%
2020-01-01 00:02:00,5,3,436,1,435,0.67%,0.23%
2020-01-01 00:02:00,5,4,25534,4370,21164,38.96%,17.11%
2020-01-01 00:02:00,5,5,11881,1016,10865,18.13%,8.55%
2020-01-01 00:02:00,5,6,17309,2142,15167,26.41%,12.37%
2020-01-01 00:02:00,5,7,4852,177,4675,7.40%,3.65%
2020-01-01 00:02:00,5,8,3783,104,3679,5.77%,2.75%
2020-01-01 00:02:00,5,9,11300,918,10382,17.24%,8.12%
2020-01-01 00:02:00,5,10,1486,24,1462,2.27%,1.61%
2020-01-01 00:02:00,5,11,925,6,919,1.41%,0.65%
2020-01-01 00:02:00,5,12,8868,545,8323,13.53%,6.14%
2020-01-01 00:02:00,6,1,1135,9,1126,1.73%,0.79%
2020-01-01 00:02:00,6,2,1241,13,1228,1.89%,1.05%
2020-01-01 00:02:00,6,3,1780,21,1759,2.72%,1.18%
2020-01-01 00:02:00,6,4,1410,8,1402,2.15%,0.57%
2020-01-01 00:02:00,6,5,16460,1923,14537,25.12%,11.68%
2020-01-01 00:02:00,6,6,3804,115,3689,5.80%,3.02%
2020-01-01 00:02:00,6,7,2036,37,1999,3.11%,1.82%
2020-01-01 00:02:00,6,8,1454,14,1440,2.22%,0.96%
2020-01-01 00:02:00,6,9,10477,797,9680,15.99%,7.61%
2020-01-01 00:02:00,6,10,2404,36,2368,3.67%,1.50%
2020-01-01 00:02:00,6,11,498,1,497,0.76%,0.20%
2020-01-01 00:02:00,6,12,7991,466,7525,12.19%,5.83%
2020-01-01 00:02:00,7,1,338,4,334,0.52%,1.18%
2020-01-01 00:02:00,7,2,219,1,218,0.33%,0.45%
2020-01-01 00:02:00,7,3,716,1,715,1.09%,0.14%
2020-01-01 00:02:00,7,4,1231,15,1216,1.88%,1.22%
2020-01-01 00:02:00,7,5,6882,356,6526,10.50%,5.17%
2020-01-01 00:02:00,7,6,11413,961,10452,17.41%,8.42%
2020-01-01 00:02:00,7,7,3232,90,3142,4.93%,2.78%
2020-01-01 00:02:00,7,8,1102,14,1088,1.68%,1.27%
2020-01-01 00:02:00,7,9,5994,277,5717,9.15%,4.62%
2020-01-01 00:02:00,7,10,1247,18,1229,1.90%,1.44%
2020-01-01 00:02:00,7,11,178,0,178,0.27%,0.00%
2020-01-01 00:02:00,7,12,4731,173,4558,7.22%,3.66%
2020-01-01 00:02:00,8,1,430,1,429,0.66%,0.23%
2020-01-01 00:02:00,8,2,106,1,105,0.16%,0.93%
2020-01-01 00:02:00,8,3,1859,20,1839,2.84%,1.08%
2020-01-01 00:02:00,8,4,2631,45,2586,4.01%,1.71%
2020-01-01 00:02:00,8,5,8267,476,7791,12.61%,5.76%
2020-01-01 00:02:00,8,6,15765,1739,14026,24.06%,11.03%
2020-01-01 00:02:00,8,7,4788,159,4629,7.31%,3.32%
2020-01-01 00:02:00,8,8,1586,20,1566,2.42%,1.26%
2020-01-01 00:02:00,8,9,6209,271,5938,9.47%,4.36%
2020-01-01 00:02:00,8,10,1637,16,1621,2.50%,0.98%
2020-01-01 00:02:00,8,11,178,0,178,0.27%,0.00%
2020-01-01 00:02:00,8,12,4391,150,4241,6.70%,3.42%
2020-01-01 00:02:00,9,1,1054,2,1052,1.61%,0.19%
2020-01-01 00:02:00,9,2,4776,174,4602,7.29%,3.64%
2020-01-01 00:02:00,9,3,3242,94,3148,4.95%,2.90%
2020-01-01 00:02:00,9,4,4487,138,4349,6.85%,3.07%
2020-01-01 00:02:00,9,5,369,2,367,0.56%,0.54%
2020-01-01 00:02:00,9,6,5328,203,5125,8.13%,3.81%
2020-01-01 00:02:00,9,7,27267,5080,22187,41.61%,18.63%
2020-01-01 00:02:00,9,8,10538,832,9706,16.08%,7.89%
2020-01-01 00:02:00,9,9,327,2,325,0.50%,0.61%
2020-01-01 00:02:00,9,10,2451,48,2403,3.74%,1.96%
2020-01-01 00:02:00,9,11,8128,459,7669,12.40%,5.65%
2020-01-01 00:02:00,9,12,5269,222,5047,8.04%,4.21%
2020-01-01 00:02:00,10,1,1438,318,1120,2.19%,22.10%
2020-01-01 00:02:00,10,2,4500,416,4084,6.87%,9.24%
2020-01-01 00:02:00,10,3,2799,48,2751,4.27%,1.71%
2020-01-01 00:02:00,10,4,4475,927,3548,6.83%,20.71%
2020-01-01 00:02:00,10,5,444,3,441,0.68%,0.67%
2020-01-01 00:02:00,10,6,6089,1047,5042,9.29%,17.19%
2020-01-01 00:02:00,10,7,12724,2097,10627,19.42%,16.48%
2020-01-01 00:02:00,10,8,29529,7517,22012,45.06%,25.46%
2020-01-01 00:02:00,10,9,853,5,848,1.30%,0.59%
2020-01-01 00:02:00,10,10,2963,78,2885,4.52%,2.63%
2020-01-01 00:02:00,10,11,12646,1492,11154,19.30%,11.80%
2020-01-01 00:02:00,10,12,9054,928,8126,13.82%,10.25%
2020-01-01 00:02:00,11,1,1860,27,1833,2.84%,1.45%
2020-01-01 00:02:00,11,2,4802,151,4651,7.33%,3.14%
2020-01-01 00:02:00,11,3,2714,50,2664,4.14%,1.84%
2020-01-01 00:02:00,11,4,3655,97,3558,5.58%,2.65%
2020-01-01 00:02:00,11,5,123,0,123,0.19%,0.00%
2020-01-01 00:02:00,11,6,4448,134,4314,6.79%,3.01%
2020-01-01 00:02:00,11,7,10904,833,10071,16.64%,7.64%
2020-01-01 00:02:00,11,8,24561,4070,20491,37.48%,16.57%
2020-01-01 00:02:00,11,9,247,0,247,0.38%,0.00%
2020-01-01 00:02:00,11,10,3487,96,3391,5.32%,2.75%
2020-01-01 00:02:00,11,11,10669,819,9850,16.28%,7.68%
2020-01-01 00:02:00,11,12,6906,361,6545,10.54%,5.23%
2020-01-01 00:02:00,12,1,40,0,40,0.06%,0.00%
2020-01-01 00:02:00,12,2,736,225,511,1.12%,30.53%
2020-01-01 00:02:00,12,3,2769,289,2480,4.23%,10.43%
2020-01-01 00:02:00,12,4,3154,74,3080,4.81%,2.35%
2020-01-01 00:02:00,12,5,10856,1088,9768,16.56%,10.02%
2020-01-01 00:02:00,12,6,6572,337,6235,10.03%,5.13%
2020-01-01 00:02:00,12,7,3288,104,3184,5.02%,3.16%
2020-01-01 00:02:00,12,8,980,192,788,1.50%,19.57%
2020-01-01 00:02:00,12,9,23621,4856,18765,36.04%,20.56%
2020-01-01 00:02:00,12,10,3445,268,3177,5.26%,7.78%
2020-01-01 00:02:00,12,11,1075,192,883,1.64%,17.84%
2020-01-01 00:02:00,12,12,7779,1158,6621,11.87%,14.88%
2020-01-01 00:02:00,13,1,1943,29,1914,2.96%,1.49%
2020-01-01 00:02:00,13,2,2308,40,2268,3.52%,1.73%
2020-01-01 00:02:00,13,3,659,4,655,1.01%,0.61%
2020-01-01 00:02:00,13,4,5100,461,4639,7.78%,9.04%
2020-01-01 00:02:00,13,5,7506,788,6718,11.45%,10.50%
2020-01-01 00:02:00,13,6,6126,548,5578,9.35%,8.94%
2020-01-01 00:02:00,13,7,5014,172,4842,7.65%,3.43%
2020-01-01 00:02:00,13,8,6958,341,6617,10.62%,4.90%
2020-01-01 00:02:00,13,9,7832,825,7007,11.95%,10.53%
2020-01-01 00:02:00,13,10,27784,5616,22168,42.40%,20.21%
2020-01-01 00:02:00,13,11,17679,2468,15211,26.98%,13.96%
2020-01-01 00:02:00,13,12,10111,1083,9028,15.43%,10.71%
2020-01-01 00:02:00,14,1,508,2,506,0.78%,0.39%
2020-01-01 00:02:00,14,2,1653,25,1628,2.52%,1.51%
2020-01-01 00:02:00,14,3,978,8,970,1.49%,0.82%
2020-01-01 00:02:00,14,4,4665,198,4467,7.12%,4.24%
2020-01-01 00:02:00,14,5,1378,13,1365,2.10%,0.94%
2020-01-01 00:02:00,14,6,4915,220,4695,7.50%,4.48%
2020-01-01 00:02:00,14,7,11252,1008,10244,17.17%,8.96%
2020-01-01 00:02:00,14,8,12712,1249,11463,19.40%,9.82%
2020-01-01 00:02:00,14,9,1729,22,1707,2.64%,1.27%
2020-01-01 00:02:00,14,10,4120,128,3992,6.29%,3.11%
2020-01-01 00:02:00,14,11,24272,4137,20135,37.04%,17.04%
2020-01-01 00:02:00,14,12,7168,388,6780,10.94%,5.41%
2020-01-01 00:02:00,15,1,533,3,530,0.81%,0.56%
2020-01-01 00:02:00,15,2,147,0,147,0.22%,0.00%
2020-01-01 00:02:00,15,3,3430,97,3333,5.23%,2.83%
2020-01-01 00:02:00,15,4,5249,226,5023,8.01%,4.30%
2020-01-01 00:02:00,15,5,10330,814,9516,15.76%,7.88%
2020-01-01 00:02:00,15,6,5481,248,5233,8.36%,4.52%
2020-01-01 00:02:00,15,7,4191,156,4035,6.39%,3.72%
2020-01-01 00:02:00,15,8,6126,315,5811,9.35%,5.14%
2020-01-01 00:02:00,15,9,10609,855,9754,16.19%,8.06%
2020-01-01 00:02:00,15,10,4672,151,4521,7.13%,3.23%
2020-01-01 00:02:00,15,11,10972,895,10077,16.74%,8.16%
2020-01-01 00:02:00,15,12,27712,5521,22191,42.29%,19.92%
2020-01-01 00:02:00,16,1,412,2,410,0.63%,0.48%
2020-01-01 00:02:00,16,2,246,3,243,0.38%,1.21%
2020-01-01 00:02:00,16,3,2318,33,2285,3.54%,1.42%
2020-01-01 00:02:00,16,4,3636,120,3516,5.55%,3.30%
2020-01-01 00:02:00,16,5,7760,516,7244,11.84%,6.65%
2020-01-01 00:02:00,16,6,4390,157,4233,6.70%,3.58%
2020-01-01 00:02:00,16,7,4060,120,3940,6.20%,2.95%
2020-01-01 00:02:00,16,8,8239,497,7742,12.57%,6.03%
2020-01-01 00:02:00,16,9,8196,560,7636,12.51%,6.83%
2020-01-01 00:02:00,16,10,1709,27,1682,2.61%,1.58%
2020-01-01 00:02:00,16,11,10135,746,9389,15.46%,7.36%
2020-01-01 00:02:00,16,12,26276,4709,21567,40.09%,17.92%
2020-01-01 00:02:10,1,1,15526,1788,13738,23.69%,11.52%
2020-01-01 00:02:10,1,2,6353,323,6030,9.69%,5.08%
2020-01-01 00:02:10,1,3,550,1,549,0.84%,0.18%
2020-01-01 00:02:10,1,4,8674,592,8082,13.24%,6.82%
2020-01-01 00:02:10,1,5,8403,558,7845,12.82%,6.64%
2020-01-01 00:02:10,1,6,8330,542,7788,12.71%,6.51%
2020-01-01 00:02:10,1,7,5786,263,5523,8.83%,4.54%
2020-01-01 00:02:10,1,8,4799,183,4616,7.32%,3.81%
2020-01-01 00:02:10,1,9,8290,539,7751,12.65%,6.50%
2020-01-01 00:02:10,1,10,4235,148,4087,6.46%,3.49%
2020-01-01 00:02:10,1,11,4324,154,4170,6.60%,3.56%
2020-01-01 00:02:10,1,12,8273,538,7735,12.62%,6.50%
2020-01-01 00:02:10,2,1,584,0,584,0.89%,0.00%
2020-01-01 00:02:10,2,2,26451,4741,21710,40.36%,17.92%
2020-01-01 00:02:10,2,3,21424,3229,18195,32.69%,15.07%
2020-01-01 00:02:10,2,4,513,0,513,0.78%,0.00%
2020-01-01 00:02:10,2,5,11964,1034,10930,18.26%,8.64%
2020-01-01 00:02:10,2,6,31,0,31,0.05%,0.00%
2020-01-01 00:02:10,2,7,4434,146,4288,6.77%,3.29%
2020-01-01 00:02:10,2,8,3221,90,3131,4.91%,2.79%
2020-01-01 00:02:10,2,9,11874,1015,10859,18.12%,8.55%
2020-01-01 00:02:10,2,10,2488,54,2434,3.80%,2.17%
2020-01-01 00:02:10,2,11,2506,54,2452,3.82%,2.15%
2020-01-01 00:02:10,2,12,11632,970,10662,17.75%,8.34%
2020-01-01 00:02:10,3,1,1249,5,1244,1.91%,0.40%
2020-01-01 00:02:10,3,2,22721,3514,19207,34.67%,15.47%
2020-01-01 00:02:10,3,3,67321,25238,42083,102.72%,37.49%
2020-01-01 00:02:10,3,4,7053,369,6684,10.76%,5.23%
2020-01-01 00:02:10,3,5,41470,10720,30750,63.28%,25.85%
2020-01-01 00:02:10,3,6,8122,485,7637,12.39%,5.97%
2020-01-01 00:02:10,3,7,19866,2708,17158,30.31%,13.63%
2020-01-01 00:02:10,3,8,16520,1838,14682,25.21%,11.13%
2020-01-01 00:02:10,3,9,32937,7103,25834,50.26%,21.56%
2020-01-01 00:02:10,3,10,6750,340,6410,10.30%,5.04%
2020-01-01 00:02:10,3,11,1723,15,1708,2.63%,0.87%
2020-01-01 00:02:10,3,12,23651,3799,19852,36.09%,16.06%
2020-01-01 00:02:10,4,1,506,2,504,0.77%,0.39%
2020-01-01 00:02:10,4,2,321,2,319,0.49%,0.62%
2020-01-01 00:02:10,4,3,1113,15,1098,1.70%,1.35%
2020-01-01 00:02:10,4,4,29223,5651,23572,44.59%,19.34%
2020-01-01 00:02:10,4,5,17992,2245,15747,27.45%,12.48%
2020-01-01 00:02:10,4,6,24787,4135,20652,37.82%,16.68%
2020-01-01 00:02:10,4,7,5497,273,5224,8.39%,4.97%
2020-01-01 00:02:10,4,8,2951,92,2859,4.50%,3.12%
2020-01-01 00:02:10,4,9,15592,1715,13877,23.79%,11.00%
2020-01-01 00:02:10,4,10,2066,29,2037,3.15%,1.40%
2020-01-01 00:02:10,4,11,144,0,144,0.22%,0.00%
2020-01-01 00:02:10,4,12,12692,1157,11535,19.37%,9.12%
2020-01-01 00:02:10,5,1,3056,62,2994,4.66%,2.03%
2020-01-01 00:02:10,5,2,812,1,811,1.24%,0.12%
2020-01-01 00:02:10,5,3,1995,29,1966,3.04%,1.45%
2020-01-01 00:02:10,5,4,24052,3953,20099,36.70%,16.43%
2020-01-01 00:02:10,5,5,11645,976,10669,17.77%,8.38%
2020-01-01 00:02:10,5,6,17081,2044,15037,26.06%,11.97%
2020-01-01 00:02:10,5,7,5006,196,4810,7.64%,3.91%
2020-01-01 00:02:10,5,8,3612,105,3507,5.51%,2.91%
2020-01-01 00:02:10,5,9,9482,672,8810,14.47%,7.09%
2020-01-01 00:02:10,5,10,1472,11,1461,2.25%,0.75%
2020-01-01 00:02:10,5,11,751,4,747,1.15%,0.53%
2020-01-01 00:02:10,5,12,7479,440,7039,11.41%,5.88%
2020-01-01 00:02:10,6,1,1107,11,1096,1.69%,0.99%
2020-01-01 00:02:10,6,2,1196,11,1185,1.82%,0.92%
2020-01-01 00:02:10,6,3,1589,21,1568,2.42%,1.32%
2020-01-01 00:02:10,6,4,1307,10,1297,1.99%,0.76%
2020-01-01 00:02:10,6,5,16798,1982,14816,25.63%,11.80%
2020-01-01 00:02:10,6,6,5158,183,4975,7.87%,3.55%
2020-01-01 00:02:10,6,7,3413,82,3331,5.21%,2.40%
2020-01-01 00:02:10,6,8,2654,53,2601,4.05%,2.00%
2020-01-01 00:02:10,6,9,9648,658,8990,14.72%,6.82%
2020-01-01 00:02:10,6,10,2345,50,2295,3.58%,2.13%
2020-01-01 00:02:10,6,11,560,4,556,0.85%,0.71%
2020-01-01 00:02:10,6,12,7265,399,6866,11.09%,5.49%
2020-01-01 00:02:10,7,1,585,3,582,0.89%,0.51%
2020-01-01 00:02:10,7,2,148,0,148,0.23%,0.00%
2020-01-01 00:02:10,7,3,759,4,755,1.16%,0.53%
2020-01-01 00:02:10,7,4,1872,29,1843,2.86%,1.55%
2020-01-01 00:02:10,7,5,8386,518,7868,12.80%,6.18%
2020-01-01 00:02:10,7,6,13354,1268,12086,20.38%,9.49%
2020-01-01 00:02:10,7,7,3029,58,2971,4.62%,1.91%
2020-01-01 00:02:10,7,8,1263,9,1254,1.93%,0.71%
2020-01-01 00:02:10,7,9,7408,406,7002,11.30%,5.48%
2020-01-01 00:02:10,7,10,2022,15,2007,3.09%,0.74%
2020-01-01 00:02:10,7,11,82,0,82,0.13%,0.00%
2020-01-01 00:02:10,7,12,5356,217,5139,8.17%,4.05%
2020-01-01 00:02:10,8,1,394,1,393,0.60%,0.25%
2020-01-01 00:02:10,8,2,96,1,95,0.15%,1.03%
2020-01-01 00:02:10,8,3,2139,30,2109,3.26%,1.40%
2020-01-01 00:02:10,8,4,2854,58,2796,4.35%,2.03%
2020-01-01 00:02:10,8,5,8752,544,8208,13.35%,6.22%
2020-01-01 00:02:10,8,6,16917,1999,14918,25.81%,11.82%
2020-01-01 00:02:10,8,7,5193,210,4983,7.92%,4.04%
2020-01-01 00:02:10,8,8,1960,33,1927,2.99%,1.68%
2020-01-01 00:02:10,8,9,6376,295,6081,9.73%,4.63%
2020-01-01 00:02:10,8,10,1937,28,1909,2.96%,1.44%
2020-01-01 00:02:10,8,11,193,2,191,0.29%,1.03%
2020-01-01 00:02:10,8,12,4347,154,4193,6.63%,3.54%
2020-01-01 00:02:10,9,1,413,0,413,0.63%,0.00%
2020-01-01 00:02:10,9,2,3557,97,3460,5.43%,2.73%
2020-01-01 00:02:10,9,3,2746,47,2699,4.19%,1.71%
2020-01-01 00:02:10,9,4,7701,415,7286,11.75%,5.39%
2020-01-01 00:02:10,9,5,278,1,277,0.42%,0.36%
2020-01-01 00:02:10,9,6,8581,516,8065,13.09%,6.01%
2020-01-01 00:02:10,9,7,31853,6670,25183,48.60%,20.94%
2020-01-01 00:02:10,9,8,13521,1330,12191,20.63%,9.84%
2020-01-01 00:02:10,9,9,242,1,241,0.37%,0.41%
2020-01-01 00:02:10,9,10,4850,215,4635,7.40%,4.43%
2020-01-01 00:02:10,9,11,11720,1037,10683,17.88%,8.85%
2020-01-01 00:02:10,9,12,6476,326,6150,9.88%,5.03%
2020-01-01 00:02:10,10,1,1294,316,978,1.97%,24.40%
2020-01-01 00:02:10,10,2,3267,381,2886,4.99%,11.66%
2020-01-01 00:02:10,10,3,1771,26,1745,2.70%,1.47%
2020-01-01 00:02:10,10,4,4398,1110,3288,6.71%,25.23%
2020-01-01 00:02:10,10,5,677,31,646,1.03%,4.57%
2020-01-01 00:02:10,10,6,6690,1289,5401,10.21%,19.26%
2020-01-01 00:02:10,10,7,12374,2259,10115,18.88%,18.25%
2020-01-01 00:02:10,10,8,30884,8245,22639,47.13%,26.70%
2020-01-01 00:02:10,10,9,686,5,681,1.05%,0.73%
2020-01-01 00:02:10,10,10,3095,58,3037,4.72%,1.87%
2020-01-01 00:02:10,10,11,14452,1936,12516,22.05%,13.40%
2020-01-01 00:02:10,10,12,10484,1284,9200,16.00%,12.25%
2020-01-01 00:02:10,11,1,2783,66,2717,4.25%,2.37%
2020-01-01 00:02:10,11,2,5132,209,4923,7.83%,4.07%
2020-01-01 00:02:10,11,3,2196,30,2166,3.35%,1.37%
2020-01-01 00:02:10,11,4,3272,85,3187,4.99%,2.60%
2020-01-01 00:02:10,11,5,194,0,194,0.30%,0.00%
2020-01-01 00:02:10,11,6,4226,144,4082,6.45%,3.41%
2020-01-01 00:02:10,11,7,11218,967,10251,17.12%,8.62%
2020-01-01 00:02:10,11,8,25569,4495,21074,39.02%,17.58%
2020-01-01 00:02:10,11,9,274,1,273,0.42%,0.36%
2020-01-01 00:02:10,11,10,3336,82,3254,5.09%,2.46%
2020-01-01 00:02:10,11,11,10553,810,9743,16.10%,7.67%
2020-01-01 00:02:10,11,12,6857,344,6513,10.46%,5.02%
2020-01-01 00:02:10,12,1,55,0,55,0.08%,0.00%
2020-01-01 00:02:10,12,2,686,200,486,1.05%,29.11%
2020-01-01 00:02:10,12,3,3469,268,3201,5.29%,7.72%
2020-01-01 00:02:10,12,4,3466,78,3388,5.29%,2.25%
2020-01-01 00:02:10,12,5,11217,1075,10142,17.12%,9.58%
2020-01-01 00:02:10,12,6,6597,299,6298,10.07%,4.53%
2020-01-01 00:02:10,12,7,2949,67,2882,4.50%,2.27%
2020-01-01 00:02:10,12,8,1379,308,1071,2.10%,22.32%
2020-01-01 00:02:10,12,9,23861,4858,19003,36.41%,20.36%
2020-01-01 00:02:10,12,10,4169,403,3766,6.36%,9.66%
2020-01-01 00:02:10,12,11,1720,317,1403,2.62%,18.42%
2020-01-01 00:02:10,12,12,7645,1207,6438,11.67%,15.79%
2020-01-01 00:02:10,13,1,2085,36,2049,3.18%,1.73%
2020-01-01 00:02:10,13,2,2393,46,2347,3.65%,1.92%
2020-01-01 00:02:10,13,3,871,5,866,1.33%,0.57%
2020-01-01 00:02:10,13,4,4899,454,4445,7.48%,9.27%
2020-01-01 00:02:10,13,5,7371,774,6597,11.25%,10.50%
2020-01-01 00:02:10,13,6,5766,517,5249,8.80%,8.96%
2020-01-01 00:02:10,13,7,4476,161,4315,6.83%,3.60%
2020-01-01 00:02:10,13,8,6387,321,6066,9.75%,5.03%
2020-01-01 00:02:10,13,9,7684,806,6878,11.72%,10.49%
2020-01-01 00:02:10,13,10,26285,5195,21090,40.11%,19.76%
2020-01-01 00:02:10,13,11,15898,2129,13769,24.26%,13.39%
2020-01-01 00:02:10,13,12,9052,912,8140,13.81%,10.07%
2020-01-01 00:02:10,14,1,196,0,196,0.30%,0.00%
2020-01-01 00:02:10,14,2,1405,11,1394,2.14%,0.78%
2020-01-01 00:02:10,14,3,1029,3,1026,1.57%,0.29%
2020-01-01 00:02:10,14,4,4232,128,4104,6.46%,3.02%
2020-01-01 00:02:10,14,5,1491,16,1475,2.28%,1.07%
2020-01-01 00:02:10,14,6,4549,142,4407,6.94%,3.12%
2020-01-01 00:02:10,14,7,11941,1024,10917,18.22%,8.57%
2020-01-01 00:02:10,14,8,13586,1311,12275,20.73%,9.65%
2020-01-01 00:02:10,14,9,1751,20,1731,2.67%,1.14%
2020-01-01 00:02:10,14,10,4461,156,4305,6.81%,3.50%
2020-01-01 00:02:10,14,11,27330,5051,22279,41.70%,18.48%
2020-01-01 00:02:10,14,12,9060,606,8454,13.82%,6.69%
2020-01-01 00:02:10,15,1,434,1,433,0.66%,0.23%
2020-01-01 00:02:10,15,2,101,0,101,0.15%,0.00%
2020-01-01 00:02:10,15,3,3807,103,3704,5.81%,2.70%
2020-01-01 00:02:10,15,4,5408,226,5182,8.25%,4.18%
2020-01-01 00:02:10,15,5,10373,764,9609,15.83%,7.36%
2020-01-01 00:02:10,15,6,5653,246,5407,8.63%,4.35%
2020-01-01 00:02:10,15,7,3751,104,3647,5.72%,2.77%
2020-01-01 00:02:10,15,8,6089,278,5811,9.29%,4.56%
2020-01-01 00:02:10,15,9,10643,808,9835,16.24%,7.59%
2020-01-01 00:02:10,15,10,4567,354,4213,6.97%,7.75%
2020-01-01 00:02:10,15,11,10800,1068,9732,16.48%,9.89%
2020-01-01 00:02:10,15,12,27055,5294,21761,41.28%,19.57%
2020-01-01 00:02:10,16,1,491,3,488,0.75%,0.61%
2020-01-01 00:02:10,16,2,273,3,270,0.42%,1.09%
2020-01-01 00:02:10,16,3,1815,35,1780,2.77%,1.93%
2020-01-01 00:02:10,16,4,4906,171,4735,7.49%,3.48%
2020-01-01 00:02:10,16,5,8729,625,8104,13.32%,7.16%
2020-01-01 00:02:10,16,6,5807,241,5566,8.86%,4.15%
2020-01-01 00:02:10,16,7,3496,109,3387,5.33%,3.12%
2020-01-01 00:02:10,16,8,8217,535,7682,12.54%,6.51%
2020-01-01 00:02:10,16,9,9226,686,8540,14.08%,7.43%
2020-01-01 00:02:10,16,10,1897,26,1871,2.89%,1.37%
2020-01-01 00:02:10,16,11,10331,817,9514,15.76%,7.91%
2020-01-01 00:02:10,16,12,27522,5146,22376,42.00%,18.70%
2020-01-01 00:02:20,1,1,22151,3377,18774,33.80%,15.24%
2020-01-01 00:02:20,1,2,7955,470,7485,12.14%,5.91%
2020-01-01 00:02:20,1,3,572,0,572,0.87%,0.00%
2020-01-01 00:02:20,1,4,13743,1346,12397,20.97%,9.79%
2020-01-01 00:02:20,1,5,13423,1270,12153,20.48%,9.46%
2020-01-01 00:02:20,1,6,13323,1255,12068,20.33%,9.42%
2020-01-01 00:02:20,1,7,7356,406,6950,11.22%,5.52%
2020-01-01 00:02:20,1,8,6826,347,6479,10.42%,5.08%
2020-01-01 00:02:20,1,9,13229,1235,11994,20.19%,9.33%
2020-01-01 00:02:20,1,10,6214,282,5932,9.48%,4.54%
2020-01-01 00:02:20,1,11,6303,288,6015,9.62%,4.57%
2020-01-01 00:02:20,1,12,13208,1227,11981,20.15%,9.29%
2020-01-01 00:02:20,2,1,943,3,940,1.44%,0.32%
2020-01-01 00:02:20,2,2,25864,4460,21404,39.47%,17.24%
2020-01-01 00:02:20,2,3,20144,2819,17325,30.74%,13.99%
2020-01-01 00:02:20,2,4,842,2,840,1.28%,0.24%
2020-01-01 00:02:20,2,5,11478,989,10489,17.51%,8.62%
2020-01-01 00:02:20,2,6,25,0,25,0.04%,0.00%
2020-01-01 00:02:20,2,7,4757,142,4615,7.26%,2.98%
2020-01-01 00:02:20,2,8,3770,89,3681,5.75%,2.36%
2020-01-01 00:02:20,2,9,11377,977,10400,17.36%,8.59%
2020-01-01 00:02:20,2,10,2921,53,2868,4.46%,1.81%
2020-01-01 00:02:20,2,11,2961,53,2908,4.52%,1.79%
2020-01-01 00:02:20,2,12,11196,949,10247,17.08%,8.48%
2020-01-01 00:02:20,3,1,1504,25,1479,2.29%,1.66%
2020-01-01 00:02:20,3,2,22922,3625,19297,34.98%,15.81%
2020-01-01 00:02:20,3,3,63804,22950,40854,97.36%,35.97%
2020-01-01 00:02:20,3,4,6242,302,5940,9.52%,4.84%
2020-01-01 00:02:20,3,5,37800,9081,28719,57.68%,24.02%
2020-01-01 00:02:20,3,6,7500,430,7070,11.44%,5.73%
2020-01-01 00:02:20,3,7,18388,2416,15972,28.06%,13.14%
2020-01-01 00:02:20,3,8,14433,1521,12912,22.02%,10.54%
2020-01-01 00:02:20,3,9,29963,5918,24045,45.72%,19.75%
2020-01-01 00:02:20,3,10,5247,195,5052,8.01%,3.72%
2020-01-01 00:02:20,3,11,1293,17,1276,1.97%,1.31%
2020-01-01 00:02:20,3,12,22893,3633,19260,34.93%,15.87%
2020-01-01 00:02:20,4,1,623,6,617,0.95%,0.96%
2020-01-01 00:02:20,4,2,387,1,386,0.59%,0.26%
2020-01-01 00:02:20,4,3,1093,9,1084,1.67%,0.82%
2020-01-01 00:02:20,4,4,29556,5892,23664,45.10%,19.93%
2020-01-01 00:02:20,4,5,18157,2352,15805,27.71%,12.95%
2020-01-01 00:02:20,4,6,25159,4288,20871,38.39%,17.04%
2020-01-01 00:02:20,4,7,5740,237,5503,8.76%,4.13%
2020-01-01 00:02:20,4,8,3096,69,3027,4.72%,2.23%
2020-01-01 00:02:20,4,9,15801,1784,14017,24.11%,11.29%
2020-01-01 00:02:20,4,10,1993,25,1968,3.04%,1.25%
2020-01-01 00:02:20,4,11,203,0,203,0.31%,0.00%
2020-01-01 00:02:20,4,12,13058,1237,11821,19.92%,9.47%
2020-01-01 00:02:20,5,1,2742,71,2671,4.18%,2.59%
2020-01-01 00:02:20,5,2,719,4,715,1.10%,0.56%
2020-01-01 00:02:20,5,3,408,0,408,0.62%,0.00%
2020-01-01 00:02:20,5,4,22334,3450,18884,34.08%,15.45%
2020-01-01 00:02:20,5,5,10216,746,9470,15.59%,7.30%
2020-01-01 00:02:20,5,6,15622,1735,13887,23.84%,11.11%
2020-01-01 00:02:20,5,7,5000,210,4790,7.63%,4.20%
2020-01-01 00:02:20,5,8,3842,118,3724,5.86%,3.07%
2020-01-01 00:02:20,5,9,9652,680,8972,14.73%,7.04%
2020-01-01 00:02:20,5,10,1474,18,1456,2.25%,1.22%
2020-01-01 00:02:20,5,11,815,4,811,1.24%,0.49%
2020-01-01 00:02:20,5,12,7860,439,7421,11.99%,5.58%
2020-01-01 00:02:20,6,1,1302,17,1285,1.99%,1.30%
2020-01-01 00:02:20,6,2,1399,24,1375,2.13%,1.71%
2020-01-01 00:02:20,6,3,2085,45,2040,3.18%,2.16%
2020-01-01 00:02:20,6,4,1507,46,1461,2.30%,3.05%
2020-01-01 00:02:20,6,5,17556,2187,15369,26.79%,12.46%
2020-01-01 00:02:20,6,6,4831,202,4629,7.37%,4.18%
2020-01-01 00:02:20,6,7,2758,57,2701,4.21%,2.07%
2020-01-01 00:02:20,6,8,2015,27,1988,3.07%,1.34%
2020-01-01 00:02:20,6,9,10342,753,9589,15.78%,7.28%
2020-01-01 00:02:20,6,10,2534,37,2497,3.87%,1.46%
2020-01-01 00:02:20,6,11,433,1,432,0.66%,0.23%
2020-01-01 00:02:20,6,12,7771,446,7325,11.86%,5.74%
2020-01-01 00:02:20,7,1,535,5,530,0.82%,0.93%
2020-01-01 00:02:20,7,2,178,1,177,0.27%,0.56%
2020-01-01 00:02:20,7,3,1158,8,1150,1.77%,0.69%
2020-01-01 00:02:20,7,4,1975,31,1944,3.01%,1.57%
2020-01-01 00:02:20,7,5,8251,517,7734,12.59%,6.27%
2020-01-01 00:02:20,7,6,13470,1328,12142,20.55%,9.86%
2020-01-01 00:02:20,7,7,3163,82,3081,4.83%,2.59%
2020-01-01 00:02:20,7,8,1162,9,1153,1.77%,0.77%
2020-01-01 00:02:20,7,9,6879,380,6499,10.50%,5.52%
2020-01-01 00:02:20,7,10,1330,8,1322,2.03%,0.60%
2020-01-01 00:02:20,7,11,77,0,77,0.12%,0.00%
2020-01-01 00:02:20,7,12,5509,249,5260,8.41%,4.52%
2020-01-01 00:02:20,8,1,444,1,443,0.68%,0.22%
2020-01-01 00:02:20,8,2,108,0,108,0.16%,0.00%
2020-01-01 00:02:20,8,3,2035,24,2011,3.11%,1.18%
2020-01-01 00:02:20,8,4,2796,60,2736,4.27%,2.15%
2020-01-01 00:02:20,8,5,8663,556,8107,13.22%,6.42%
2020-01-01 00:02:20,8,6,17404,2174,15230,26.56%,12.49%
2020-01-01 00:02:20,8,7,5852,280,5572,8.93%,4.78%
2020-01-01 00:02:20,8,8,2569,44,2525,3.92%,1.71%
2020-01-01 00:02:20,8,9,6439,308,6131,9.83%,4.78%
2020-01-01 00:02:20,8,10,1730,26,1704,2.64%,1.50%
2020-01-01 00:02:20,8,11,150,0,150,0.23%,0.00%
2020-01-01 00:02:20,8,12,4527,156,4371,6.91%,3.45%
2020-01-01 00:02:20,9,1,775,3,772,1.18%,0.39%
2020-01-01 00:02:20,9,2,5433,236,5197,8.29%,4.34%
2020-01-01 00:02:20,9,3,4079,137,3942,6.22%,3.36%
2020-01-01 00:02:20,9,4,6348,272,6076,9.69%,4.28%
2020-01-01 00:02:20,9,5,177,0,177,0.27%,0.00%
2020-01-01 00:02:20,9,6,7205,346,6859,10.99%,4.80%
2020-01-01 00:02:20,9,7,28474,5350,23124,43.45%,18.79%
2020-01-01 00:02:20,9,8,10218,819,9399,15.59%,8.01%
2020-01-01 00:02:20,9,9,146,0,146,0.22%,0.00%
2020-01-01 00:02:20,9,10,2595,43,2552,3.96%,1.66%
2020-01-01 00:02:20,9,11,9250,678,8572,14.11%,7.33%
2020-01-01 00:02:20,9,12,6258,269,5989,9.55%,4.30%
2020-01-01 00:02:20,10,1,1429,294,1135,2.18%,20.56%
2020-01-01 00:02:20,10,2,3279,363,2916,5.00%,11.07%
2020-01-01 00:02:20,10,3,1675,37,1638,2.56%,2.21%
2020-01-01 00:02:20,10,4,4276,1160,3116,6.52%,27.12%
2020-01-01 00:02:20,10,5,719,30,689,1.10%,4.17%
2020-01-01 00:02:20,10,6,6650,1350,5300,10.15%,20.30%
2020-01-01 00:02:20,10,7,11536,2142,9394,17.60%,18.57%
2020-01-01 00:02:20,10,8,30889,8293,22596,47.13%,26.85%
2020-01-01 00:02:20,10,9,619,3,616,0.94%,0.48%
2020-01-01 00:02:20,10,10,2369,44,2325,3.61%,1.86%
2020-01-01 00:02:20,10,11,14685,1989,12696,22.41%,13.54%
2020-01-01 00:02:20,10,12,11498,1420,10078,17.54%,12.35%
2020-01-01 00:02:20,11,1,2802,58,2744,4.28%,2.07%
2020-01-01 00:02:20,11,2,3839,119,3720,5.86%,3.10%
2020-01-01 00:02:20,11,3,829,3,826,1.26%,0.36%
2020-01-01 00:02:20,11,4,3103,73,3030,4.73%,2.35%
2020-01-01 00:02:20,11,5,292,1,291,0.45%,0.34%
2020-01-01 00:02:20,11,6,3980,124,3856,6.07%,3.11%
2020-01-01 00:02:20,11,7,9477,682,8795,14.46%,7.20%
2020-01-01 00:02:20,11,8,24216,4052,20164,36.95%,16.73%
2020-01-01 00:02:20,11,9,250,0,250,0.38%,0.00%
2020-01-01 00:02:20,11,10,3263,83,3180,4.98%,2.54%
2020-01-01 00:02:20,11,11,10692,856,9836,16.31%,8.01%
2020-01-01 00:02:20,11,12,7043,366,6677,10.75%,5.20%
2020-01-01 00:02:20,12,1,96,0,96,0.15%,0.00%
2020-01-01 00:02:20,12,2,733,196,537,1.12%,26.70%
2020-01-01 00:02:20,12,3,3513,272,3241,5.36%,7.74%
2020-01-01 00:02:20,12,4,3566,108,3458,5.44%,3.03%
2020-01-01 00:02:20,12,5,10621,997,9624,16.21%,9.39%
2020-01-01 00:02:20,12,6,6292,302,5990,9.60%,4.80%
2020-01-01 00:02:20,12,7,2557,51,2506,3.90%,1.99%
2020-01-01 00:02:20,12,8,1516,288,1228,2.31%,18.98%
2020-01-01 00:02:20,12,9,23421,4783,18638,35.74%,20.42%
2020-01-01 00:02:20,12,10,4600,423,4177,7.02%,9.19%
2020-01-01 00:02:20,12,11,1772,292,1480,2.70%,16.47%
2020-01-01 00:02:20,12,12,7675,1217,6458,11.71%,15.85%
2020-01-01 00:02:20,13,1,2295,45,2250,3.50%,1.96%
2020-01-01 00:02:20,13,2,2683,56,2627,4.09%,2.09%
2020-01-01 00:02:20,13,3,842,3,839,1.28%,0.36%
2020-01-01 00:02:20,13,4,4400,474,3926,6.71%,10.77%
2020-01-01 00:02:20,13,5,7142,799,6343,10.90%,11.19%
2020-01-01 00:02:20,13,6,5442,535,4907,8.30%,9.83%
2020-01-01 00:02:20,13,7,4904,196,4708,7.48%,4.00%
2020-01-01 00:02:20,13,8,7155,393,6762,10.92%,5.49%
2020-01-01 00:02:20,13,9,7536,842,6694,11.50%,11.17%
2020-01-01 00:02:20,13,10,27991,5796,22195,42.71%,20.71%
2020-01-01 00:02:20,13,11,17322,2445,14877,26.43%,14.11%
2020-01-01 00:02:20,13,12,9729,1050,8679,14.85%,10.79%
2020-01-01 00:02:20,14,1,226,1,225,0.34%,0.44%
2020-01-01 00:02:20,14,2,1528,17,1511,2.33%,1.11%
2020-01-01 00:02:20,14,3,1172,8,1164,1.79%,0.68%
2020-01-01 00:02:20,14,4,4094,119,3975,6.25%,2.91%
2020-01-01 00:02:20,14,5,1767,22,1745,2.70%,1.24%
2020-01-01 00:02:20,14,6,4388,134,4254,6.70%,3.05%
2020-01-01 00:02:20,14,7,12033,1020,11013,18.36%,8.48%
2020-01-01 00:02:20,14,8,13722,1358,12364,20.94%,9.90%
2020-01-01 00:02:20,14,9,2068,27,2041,3.16%,1.30%
2020-01-01 00:02:20,14,10,4965,159,4806,7.58%,3.20%
2020-01-01 00:02:20,14,11,28420,5383,23037,43.37%,18.94%
2020-01-01 00:02:20,14,12,9409,640,8769,14.36%,6.80%
2020-01-01 00:02:20,15,1,476,5,471,0.73%,1.05%
2020-01-01 00:02:20,15,2,134,0,134,0.20%,0.00%
2020-01-01 00:02:20,15,3,3953,125,3828,6.03%,3.16%
2020-01-01 00:02:20,15,4,5740,288,5452,8.76%,5.02%
2020-01-01 00:02:20,15,5,11234,945,10289,17.14%,8.41%
2020-01-01 00:02:20,15,6,6064,318,5746,9.25%,5.24%
2020-01-01 00:02:20,15,7,4008,152,3856,6.12%,3.79%
2020-01-01 00:02:20,15,8,6058,299,5759,9.24%,4.93%
2020-01-01 00:02:20,15,9,11503,983,10520,17.55%,8.54%
2020-01-01 00:02:20,15,10,4652,377,4275,7.10%,8.10%
2020-01-01 00:02:20,15,11,10849,1032,9817,16.55%,9.51%
2020-01-01 00:02:20,15,12,28006,5687,22319,42.73%,20.31%
2020-01-01 00:02:20,16,1,478,1,477,0.73%,0.21%
2020-01-01 00:02:20,16,2,266,1,265,0.41%,0.37%
2020-01-01 00:02:20,16,3,1906,37,1869,2.91%,1.94%
2020-01-01 00:02:20,16,4,4064,126,3938,6.20%,3.10%
2020-01-01 00:02:20,16,5,8098,572,7526,12.36%,7.06%
2020-01-01 00:02:20,16,6,5049,206,4843,7.70%,4.08%
2020-01-01 00:02:20,16,7,3286,101,3185,5.01%,3.07%
2020-01-01 00:02:20,16,8,7094,455,6639,10.82%,6.41%
2020-01-01 00:02:20,16,9,8608,628,7980,13.13%,7.29%
2020-01-01 00:02:20,16,10,1837,16,1821,2.80%,0.87%
2020-01-01 00:02:20,16,11,9186,686,8500,14.02%,7.47%
2020-01-01 00:02:20,16,12,26445,4737,21708,40.35%,17.91%
2020-01-01 00:02:30,1,1,25691,4439,21252,39.20%,17.28%
2020-01-01 00:02:30,1,2,14828,1589,13239,22.63%,10.72%
2020-01-01 00:02:30,1,3,1120,3,1117,1.71%,0.27%
2020-01-01 00:02:30,1,4,10433,797,9636,15.92%,7.64%
2020-01-01 00:02:30,1,5,10154,755,9399,15.49%,7.43%
2020-01-01 00:02:30,1,6,10105,754,9351,15.42%,7.46%
2020-01-01 00:02:30,1,7,13697,1374,12323,20.90%,10.03%
2020-01-01 00:02:30,1,8,12853,1221,11632,19.61%,9.50%
2020-01-01 00:02:30,1,9,10036,742,9294,15.31%,7.39%
2020-01-01 00:02:30,1,10,12428,1154,11274,18.96%,9.28%
2020-01-01 00:02:30,1,11,12550,1177,11373,19.15%,9.38%
2020-01-01 00:02:30,1,12,9997,735,9262,15.25%,7.35%
2020-01-01 00:02:30,2,1,1208,4,1204,1.84%,0.33%
2020-01-01 00:02:30,2,2,25857,4448,21409,39.45%,17.20%
2020-01-01 00:02:30,2,3,18622,2374,16248,28.41%,12.75%
2020-01-01 00:02:30,2,4,1162,3,1159,1.77%,0.26%
2020-01-01 00:02:30,2,5,13193,1235,11958,20.13%,9.36%
2020-01-01 00:02:30,2,6,28,0,28,0.04%,0.00%
2020-01-01 00:02:30,2,7,6007,283,5724,9.17%,4.71%
2020-01-01 00:02:30,2,8,4903,194,4709,7.48%,3.96%
2020-01-01 00:02:30,2,9,13083,1216,11867,19.96%,9.29%
2020-01-01 00:02:30,2,10,4193,147,4046,6.40%,3.51%
2020-01-01 00:02:30,2,11,4228,148,4080,6.45%,3.50%
2020-01-01 00:02:30,2,12,12900,1181,11719,19.68%,9.15%
2020-01-01 00:02:30,3,1,2003,46,1957,3.06%,2.30%
2020-01-01 00:02:30,3,2,25547,4376,21171,38.98%,17.13%
2020-01-01 00:02:30,3,3,68794,26278,42516,104.97%,38.20%
2020-01-01 00:02:30,3,4,5306,203,5103,8.10%,3.83%
2020-01-01 00:02:30,3,5,41103,10645,30458,62.72%,25.90%
2020-01-01 00:02:30,3,6,6894,354,6540,10.52%,5.13%
2020-01-01 00:02:30,3,7,20660,2915,17745,31.52%,14.11%
2020-01-01 00:02:30,3,8,16301,1857,14444,24.87%,11.39%
2020-01-01 00:02:30,3,9,33801,7482,26319,51.58%,22.13%
2020-01-01 00:02:30,3,10,6156,292,5864,9.39%,4.74%
2020-01-01 00:02:30,3,11,1990,44,1946,3.04%,2.21%
2020-01-01 00:02:30,3,12,25472,4324,21148,38.87%,16.97%
2020-01-01 00:02:30,4,1,507,5,502,0.77%,0.98%
2020-01-01 00:02:30,4,2,297,3,294,0.45%,1.01%
2020-01-01 00:02:30,4,3,1161,8,1153,1.77%,0.69%
2020-01-01 00:02:30,4,4,28370,5226,23144,43.29%,18.42%
2020-01-01 00:02:30,4,5,17533,2125,15408,26.75%,12.12%
2020-01-01 00:02:30,4,6,23607,3752,19855,36.02%,15.89%
2020-01-01 00:02:30,4,7,4842,167,4675,7.39%,3.45%
2020-01-01 00:02:30,4,8,2834,54,2780,4.32%,1.90%
2020-01-01 00:02:30,4,9,15103,1602,13501,23.05%,10.61%
2020-01-01 00:02:30,4,10,1956,26,1930,2.98%,1.33%
2020-01-01 00:02:30,4,11,217,0,217,0.33%,0.00%
2020-01-01 00:02:30,4,12,12509,1106,11403,19.09%,8.84%
2020-01-01 00:02:30,5,1,2758,58,2700,4.21%,2.10%
2020-01-01 00:02:30,5,2,866,8,858,1.32%,0.92%
2020-01-01 00:02:30,5,3,611,4,607,0.93%,0.65%
2020-01-01 00:02:30,5,4,20685,2971,17714,31.56%,14.36%
2020-01-01 00:02:30,5,5,9423,671,8752,14.38%,7.12%
2020-01-01 00:02:30,5,6,14537,1586,12951,22.18%,10.91%
2020-01-01 00:02:30,5,7,4634,193,4441,7.07%,4.16%
2020-01-01 00:02:30,5,8,3704,122,3582,5.65%,3.29%
2020-01-01 00:02:30,5,9,8608,563,8045,13.13%,6.54%
2020-01-01 00:02:30,5,10,967,11,956,1.48%,1.14%
2020-01-01 00:02:30,5,11,691,8,683,1.05%,1.16%
2020-01-01 00:02:30,5,12,7167,390,6777,10.94%,5.44%
2020-01-01 00:02:30,6,1,1157,4,1153,1.77%,0.35%
2020-01-01 00:02:30,6,2,1259,4,1255,1.92%,0.32%
2020-01-01 00:02:30,6,3,1743,17,1726,2.66%,0.97%
2020-01-01 00:02:30,6,4,1324,16,1308,2.02%,1.21%
2020-01-01 00:02:30,6,5,16547,1873,14674,25.25%,11.32%
2020-01-01 00:02:30,6,6,5077,203,4874,7.75%,4.00%
2020-01-01 00:02:30,6,7,3233,95,3138,4.93%,2.94%
2020-01-01 00:02:30,6,8,2676,68,2608,4.08%,2.54%
2020-01-01 00:02:30,6,9,9394,624,8770,14.33%,6.64%
2020-01-01 00:02:30,6,10,2853,55,2798,4.35%,1.93%
2020-01-01 00:02:30,6,11,390,1,389,0.60%,0.26%
2020-01-01 00:02:30,6,12,6468,310,6158,9.87%,4.79%
2020-01-01 00:02:30,7,1,449,0,449,0.69%,0.00%
2020-01-01 00:02:30,7,2,191,0,191,0.29%,0.00%
2020-01-01 00:02:30,7,3,1484,8,1476,2.26%,0.54%
2020-01-01 00:02:30,7,4,1768,32,1736,2.70%,1.81%
2020-01-01 00:02:30,7,5,7893,441,7452,12.04%,5.59%
2020-01-01 00:02:30,7,6,13235,1254,11981,20.20%,9.47%
2020-01-01 00:02:30,7,7,3445,88,3357,5.26%,2.55%
2020-01-01 00:02:30,7,8,1540,28,1512,2.35%,1.82%
2020-01-01 00:02:30,7,9,6260,283,5977,9.55%,4.52%
2020-01-01 00:02:30,7,10,1134,9,1125,1.73%,0.79%
2020-01-01 00:02:30,7,11,73,0,73,0.11%,0.00%
2020-01-01 00:02:30,7,12,5072,186,4886,7.74%,3.67%
2020-01-01 00:02:30,8,1,334,0,334,0.51%,0.00%
2020-01-01 00:02:30,8,2,125,0,125,0.19%,0.00%
2020-01-01 00:02:30,8,3,1575,19,1556,2.40%,1.21%
2020-01-01 00:02:30,8,4,2650,52,2598,4.04%,1.96%
2020-01-01 00:02:30,8,5,8029,456,7573,12.25%,5.68%
2020-01-01 00:02:30,8,6,15373,1653,13720,23.46%,10.75%
2020-01-01 00:02:30,8,7,4633,181,4452,7.07%,3.91%
2020-01-01 00:02:30,8,8,1654,27,1627,2.52%,1.63%
2020-01-01 00:02:30,8,9,6176,261,5915,9.42%,4.23%
2020-01-01 00:02:30,8,10,1663,32,1631,2.54%,1.92%
2020-01-01 00:02:30,8,11,201,0,201,0.31%,0.00%
2020-01-01 00:02:30,8,12,4363,115,4248,6.66%,2.64%
2020-01-01 00:02:30,9,1,1263,12,1251,1.93%,0.95%
2020-01-01 00:02:30,9,2,6021,283,5738,9.19%,4.70%
2020-01-01 00:02:30,9,3,4029,126,3903,6.15%,3.13%
2020-01-01 00:02:30,9,4,7585,424,7161,11.57%,5.59%
2020-01-01 00:02:30,9,5,571,3,568,0.87%,0.52%
2020-01-01 00:02:30,9,6,8636,542,8094,13.18%,6.28%
2020-01-01 00:02:30,9,7,35616,8154,27462,54.35%,22.89%
2020-01-01 00:02:30,9,8,11183,909,10274,17.06%,8.13%
2020-01-01 00:02:30,9,9,326,2,324,0.50%,0.61%
2020-01-01 00:02:30,9,10,4486,133,4353,6.85%,2.96%
2020-01-01 00:02:30,9,11,9853,713,9140,15.03%,7.24%
2020-01-01 00:02:30,9,12,5008,172,4836,7.64%,3.43%
2020-01-01 00:02:30,10,1,1225,277,948,1.87%,22.59%
2020-01-01 00:02:30,10,2,3064,326,2738,4.68%,10.64%
2020-01-01 00:02:30,10,3,1633,18,1615,2.49%,1.10%
2020-01-01 00:02:30,10,4,4306,994,3312,6.57%,23.08%
2020-01-01 00:02:30,10,5,692,25,667,1.06%,3.61%
2020-01-01 00:02:30,10,6,6295,1139,5156,9.61%,18.09%
2020-01-01 00:02:30,10,7,11183,1960,9223,17.06%,17.53%
2020-01-01 00:02:30,10,8,26760,6537,20223,40.83%,24.43%
2020-01-01 00:02:30,10,9,598,3,595,0.91%,0.50%
2020-01-01 00:02:30,10,10,2275,35,2240,3.47%,1.54%
2020-01-01 00:02:30,10,11,11604,1301,10303,17.71%,11.21%
2020-01-01 00:02:30,10,12,8748,910,7838,13.35%,10.40%
2020-01-01 00:02:30,11,1,2185,42,2143,3.33%,1.92%
2020-01-01 00:02:30,11,2,3259,77,3182,4.97%,2.36%
2020-01-01 00:02:30,11,3,907,4,903,1.38%,0.44%
2020-01-01 00:02:30,11,4,3495,198,3297,5.33%,5.66%
2020-01-01 00:02:30,11,5,321,0,321,0.49%,0.00%
2020-01-01 00:02:30,11,6,4355,240,4115,6.65%,5.51%
2020-01-01 00:02:30,11,7,9281,719,8562,14.16%,7.75%
2020-01-01 00:02:30,11,8,23008,3674,19334,35.11%,15.97%
2020-01-01 00:02:30,11,9,323,0,323,0.49%,0.00%
2020-01-01 00:02:30,11,10,3045,61,2984,4.65%,2.00%
2020-01-01 00:02:30,11,11,10482,800,9682,15.99%,7.63%
2020-01-01 00:02:30,11,12,7154,402,6752,10.92%,5.62%
2020-01-01 00:02:30,12,1,117,0,117,0.18%,0.00%
2020-01-01 00:02:30,12,2,573,172,401,0.87%,29.97%
2020-01-01 00:02:30,12,3,2600,207,2393,3.97%,7.96%
2020-01-01 00:02:30,12,4,2776,49,2727,4.24%,1.76%
2020-01-01 00:02:30,12,5,8854,754,8100,13.51%,8.51%
2020-01-01 00:02:30,12,6,5543,249,5294,8.46%,4.49%
2020-01-01 00:02:30,12,7,2531,57,2474,3.86%,2.25%
2020-01-01 00:02:30,12,8,1332,276,1056,2.03%,20.71%
2020-01-01 00:02:30,12,9,21361,4166,17195,32.59%,19.50%
2020-01-01 00:02:30,12,10,3856,354,3502,5.88%,9.18%
2020-01-01 00:02:30,12,11,1528,277,1251,2.33%,18.12%
2020-01-01 00:02:30,12,12,7379,1113,6266,11.26%,15.08%
2020-01-01 00:02:30,13,1,2050,35,2015,3.13%,1.71%
2020-01-01 00:02:30,13,2,2473,47,2426,3.77%,1.90%
2020-01-01 00:02:30,13,3,537,2,535,0.82%,0.37%
2020-01-01 00:02:30,13,4,4132,468,3664,6.30%,11.32%
2020-01-01 00:02:30,13,5,7064,811,6253,10.78%,11.48%
2020-01-01 00:02:30,13,6,5109,531,4578,7.80%,10.39%
2020-01-01 00:02:30,13,7,5077,185,4892,7.75%,3.64%
2020-01-01 00:02:30,13,8,7209,396,6813,11.00%,5.49%
2020-01-01 00:02:30,13,9,7313,835,6478,11.16%,11.42%
2020-01-01 00:02:30,13,10,26946,5357,21589,41.12%,19.88%
2020-01-01 00:02:30,13,11,16878,2198,14680,25.75%,13.02%
2020-01-01 00:02:30,13,12,9161,869,8292,13.98%,9.48%
2020-01-01 00:02:30,14,1,380,3,377,0.58%,0.79%
2020-01-01 00:02:30,14,2,1617,18,1599,2.47%,1.11%
2020-01-01 00:02:30,14,3,1092,5,1087,1.67%,0.46%
2020-01-01 00:02:30,14,4,4360,134,4226,6.65%,3.07%
2020-01-01 00:02:30,14,5,1431,16,1415,2.18%,1.12%
2020-01-01 00:02:30,14,6,4838,170,4668,7.38%,3.51%
2020-01-01 00:02:30,14,7,12133,1050,11083,18.51%,8.65%
2020-01-01 00:02:30,14,8,14254,1437,12817,21.75%,10.08%
2020-01-01 00:02:30,14,9,1673,22,1651,2.55%,1.31%
2020-01-01 00:02:30,14,10,4007,126,3881,6.11%,3.14%
2020-01-01 00:02:30,14,11,27053,4791,22262,41.28%,17.71%
2020-01-01 00:02:30,14,12,8499,499,8000,12.97%,5.87%
2020-01-01 00:02:30,15,1,523,2,521,0.80%,0.38%
2020-01-01 00:02:30,15,2,190,1,189,0.29%,0.52%
2020-01-01 00:02:30,15,3,6011,279,5732,9.17%,4.64%
2020-01-01 00:02:30,15,4,4961,224,4737,7.57%,4.51%
2020-01-01 00:02:30,15,5,12524,1266,11258,19.11%,10.11%
2020-01-01 00:02:30,15,6,5326,269,5057,8.13%,5.05%
2020-01-01 00:02:30,15,7,3879,151,3728,5.92%,3.89%
2020-01-01 00:02:30,15,8,5962,295,5667,9.10%,4.95%
2020-01-01 00:02:30,15,9,12750,1299,11451,19.45%,10.19%
2020-01-01 00:02:30,15,10,4609,223,4386,7.03%,4.84%
2020-01-01 00:02:30,15,11,10716,952,9764,16.35%,8.88%
2020-01-01 00:02:30,15,12,29225,6138,23087,44.59%,21.00%
2020-01-01 00:02:30,16,1,391,1,390,0.60%,0.26%
2020-01-01 00:02:30,16,2,286,0,286,0.44%,0.00%
2020-01-01 00:02:30,16,3,1128,14,1114,1.72%,1.24%
2020-01-01 00:02:30,16,4,3456,90,3366,5.27%,2.60%
2020-01-01 00:02:30,16,5,6810,385,6425,10.39%,5.65%
2020-01-01 00:02:30,16,6,4361,141,4220,6.65%,3.23%
2020-01-01 00:02:30,16,7,3747,123,3624,5.72%,3.28%
2020-01-01 00:02:30,16,8,7300,475,6825,11.14%,6.51%
2020-01-01 00:02:30,16,9,7188,428,6760,10.97%,5.95%
2020-01-01 00:02:30,16,10,2398,39,2359,3.66%,1.63%
2020-01-01 00:02:30,16,11,9947,770,9177,15.18%,7.74%
2020-01-01 00:02:30,16,12,25480,4457,21023,38.88%,17.49%
2020-01-01 00:02:40,1,1,23713,3806,19907,36.18%,16.05%
2020-01-01 00:02:40,1,2,10941,862,10079,16.69%,7.88%
2020-01-01 00:02:40,1,3,993,10,983,1.52%,1.01%
2020-01-01 00:02:40,1,4,12432,1142,11290,18.97%,9.19%
2020-01-01 00:02:40,1,5,11986,1072,10914,18.29%,8.94%
2020-01-01 00:02:40,1,6,11947,1066,10881,18.23%,8.92%
2020-01-01 00:02:40,1,7,9937,704,9233,15.16%,7.08%
2020-01-01 00:02:40,1,8,8922,568,8354,13.61%,6.37%
2020-01-01 00:02:40,1,9,11911,1059,10852,18.17%,8.89%
2020-01-01 00:02:40,1,10,8157,483,7674,12.45%,5.92%
2020-01-01 00:02:40,1,11,8379,512,7867,12.79%,6.11%
2020-01-01 00:02:40,1,12,11884,1052,10832,18.13%,8.85%
2020-01-01 00:02:40,2,1,640,3,637,0.98%,0.47%
2020-01-01 00:02:40,2,2,29324,5761,23563,44.74%,19.65%
2020-01-01 00:02:40,2,3,23524,3830,19694,35.89%,16.28%
2020-01-01 00:02:40,2,4,590,3,587,0.90%,0.51%
2020-01-01 00:02:40,2,5,13262,1306,11956,20.24%,9.85%
2020-01-01 00:02:40,2,6,45,0,45,0.07%,0.00%
2020-01-01 00:02:40,2,7,5139,191,4948,7.84%,3.72%
2020-01-01 00:02:40,2,8,4238,130,4108,6.47%,3.07%
2020-01-01 00:02:40,2,9,13212,1294,11918,20.16%,9.79%
2020-01-01 00:02:40,2,10,3580,87,3493,5.46%,2.43%
2020-01-01 00:02:40,2,11,3600,89,3511,5.49%,2.47%
2020-01-01 00:02:40,2,12,13052,1257,11795,19.92%,9.63%
2020-01-01 00:02:40,3,1,1460,15,1445,2.23%,1.03%
2020-01-01 00:02:40,3,2,21347,3192,18155,32.57%,14.95%
2020-01-01 00:02:40,3,3,66817,25176,41641,101.95%,37.68%
2020-01-01 00:02:40,3,4,8969,573,8396,13.69%,6.39%
2020-01-01 00:02:40,3,5,44113,12284,31829,67.31%,27.85%
2020-01-01 00:02:40,3,6,9996,711,9285,15.25%,7.11%
2020-01-01 00:02:40,3,7,18072,2312,15760,27.58%,12.79%
2020-01-01 00:02:40,3,8,14834,1601,13233,22.63%,10.79%
2020-01-01 00:02:40,3,9,33734,7691,26043,51.47%,22.80%
2020-01-01 00:02:40,3,10,4143,146,3997,6.32%,3.52%
2020-01-01 00:02:40,3,11,2169,45,2124,3.31%,2.07%
2020-01-01 00:02:40,3,12,25748,4790,20958,39.29%,18.60%
2020-01-01 00:02:40,4,1,590,3,587,0.90%,0.51%
2020-01-01 00:02:40,4,2,388,1,387,0.59%,0.26%
2020-01-01 00:02:40,4,3,722,1,721,1.10%,0.14%
2020-01-01 00:02:40,4,4,27728,5113,22615,42.31%,18.44%
2020-01-01 00:02:40,4,5,16763,1942,14821,25.58%,11.58%
2020-01-01 00:02:40,4,6,23489,3764,19725,35.84%,16.02%
2020-01-01 00:02:40,4,7,5205,174,5031,7.94%,3.34%
2020-01-01 00:02:40,4,8,2891,57,2834,4.41%,1.97%
2020-01-01 00:02:40,4,9,14841,1542,13299,22.65%,10.39%
2020-01-01 00:02:40,4,10,1925,19,1906,2.94%,0.99%
2020-01-01 00:02:40,4,11,209,0,209,0.32%,0.00%
2020-01-01 00:02:40,4,12,12304,1072,11232,18.77%,8.71%
2020-01-01 00:02:40,5,1,2683,52,2631,4.09%,1.94%
2020-01-01 00:02:40,5,2,1021,6,1015,1.56%,0.59%
2020-01-01 00:02:40,5,3,1672,24,1648,2.55%,1.43%
2020-01-01 00:02:40,5,4,20836,3127,17709,31.79%,15.01%
2020-01-01 00:02:40,5,5,10024,786,9238,15.30%,7.84%
2020-01-01 00:02:40,5,6,14139,1498,12641,21.57%,10.59%
2020-01-01 00:02:40,5,7,3630,111,3519,5.54%,3.06%
2020-01-01 00:02:40,5,8,2726,55,2671,4.16%,2.02%
2020-01-01 00:02:40,5,9,8200,538,7662,12.51%,6.56%
2020-01-01 00:02:40,5,10,1047,14,1033,1.60%,1.34%
2020-01-01 00:02:40,5,11,601,4,597,0.92%,0.66%
2020-01-01 00:02:40,5,12,6691,351,6340,10.21%,5.25%
2020-01-01 00:02:40,6,1,1183,14,1169,1.81%,1.18%
2020-01-01 00:02:40,6,2,1307,20,1287,1.99%,1.53%
2020-01-01 00:02:40,6,3,1955,41,1914,2.98%,2.10%
2020-01-01 00:02:40,6,4,1391,12,1379,2.12%,0.86%
2020-01-01 00:02:40,6,5,12831,1203,11628,19.58%,9.38%
2020-01-01 00:02:40,6,6,4188,131,4057,6.39%,3.13%
2020-01-01 00:02:40,6,7,2268,48,2220,3.46%,2.12%
2020-01-01 00:02:40,6,8,1803,33,1770,2.75%,1.83%
2020-01-01 00:02:40,6,9,6475,324,6151,9.88%,5.00%
2020-01-01 00:02:40,6,10,1930,33,1897,2.94%,1.71%
2020-01-01 00:02:40,6,11,452,1,451,0.69%,0.22%
2020-01-01 00:02:40,6,12,4470,168,4302,6.82%,3.76%
2020-01-01 00:02:40,7,1,497,0,497,0.76%,0.00%
2020-01-01 00:02:40,7,2,197,1,196,0.30%,0.51%
2020-01-01 00:02:40,7,3,1185,15,1170,1.81%,1.26%
2020-01-01 00:02:40,7,4,2344,40,2304,3.58%,1.71%
2020-01-01 00:02:40,7,5,7538,428,7110,11.50%,5.68%
2020-01-01 00:02:40,7,6,13742,1322,12420,20.97%,9.62%
2020-01-01 00:02:40,7,7,3781,117,3664,5.77%,3.09%
2020-01-01 00:02:40,7,8,1580,21,1559,2.41%,1.33%
2020-01-01 00:02:40,7,9,6149,265,5884,9.38%,4.31%
2020-01-01 00:02:40,7,10,1084,8,1076,1.65%,0.74%
2020-01-01 00:02:40,7,11,86,0,86,0.13%,0.00%
2020-01-01 00:02:40,7,12,5032,188,4844,7.68%,3.74%
2020-01-01 00:02:40,8,1,453,1,452,0.69%,0.22%
2020-01-01 00:02:40,8,2,102,0,102,0.16%,0.00%
2020-01-01 00:02:40,8,3,1688,16,1672,2.58%,0.95%
2020-01-01 00:02:40,8,4,2978,73,2905,4.54%,2.45%
2020-01-01 00:02:40,8,5,7790,448,7342,11.89%,5.75%
2020-01-01 00:02:40,8,6,15015,1666,13349,22.91%,11.09%
2020-01-01 00:02:40,8,7,4147,144,4003,6.33%,3.47%
2020-01-01 00:02:40,8,8,1505,12,1493,2.30%,0.80%
2020-01-01 00:02:40,8,9,5882,255,5627,8.98%,4.33%
2020-01-01 00:02:40,8,10,1663,18,1645,2.54%,1.08%
2020-01-01 00:02:40,8,11,146,0,146,0.22%,0.00%
2020-01-01 00:02:40,8,12,4145,142,4003,6.32%,3.42%
2020-01-01 00:02:40,9,1,644,2,642,0.98%,0.31%
2020-01-01 00:02:40,9,2,2529,46,2483,3.86%,1.82%
2020-01-01 00:02:40,9,3,1426,10,1416,2.18%,0.70%
2020-01-01 00:02:40,9,4,6009,269,5740,9.17%,4.48%
2020-01-01 00:02:40,9,5,947,8,939,1.45%,0.84%
2020-01-01 00:02:40,9,6,7734,471,7263,11.80%,6.09%
2020-01-01 00:02:40,9,7,30654,6282,24372,46.77%,20.49%
2020-01-01 00:02:40,9,8,11116,877,10239,16.96%,7.89%
2020-01-01 00:02:40,9,9,429,2,427,0.65%,0.47%
2020-01-01 00:02:40,9,10,4929,166,4763,7.52%,3.37%
2020-01-01 00:02:40,9,11,10038,729,9309,15.32%,7.26%
2020-01-01 00:02:40,9,12,4742,161,4581,7.24%,3.39%
2020-01-01 00:02:40,10,1,1441,254,1187,2.20%,17.61%
2020-01-01 00:02:40,10,2,3586,331,3255,5.47%,9.23%
2020-01-01 00:02:40,10,3,1980,33,1947,3.02%,1.67%
2020-01-01 00:02:40,10,4,4352,1004,3348,6.64%,23.06%
2020-01-01 00:02:40,10,5,861,56,805,1.31%,6.50%
2020-01-01 00:02:40,10,6,6584,1189,5395,10.05%,18.06%
2020-01-01 00:02:40,10,7,12237,2047,10190,18.67%,16.73%
2020-01-01 00:02:40,10,8,29591,7380,22211,45.15%,24.94%
2020-01-01 00:02:40,10,9,575,5,570,0.88%,0.87%
2020-01-01 00:02:40,10,10,2214,57,2157,3.38%,2.57%
2020-01-01 00:02:40,10,11,13381,1734,11647,20.42%,12.96%
2020-01-01 00:02:40,10,12,10591,1292,9299,16.16%,12.20%
2020-01-01 00:02:40,11,1,2333,40,2293,3.56%,1.71%
2020-01-01 00:02:40,11,2,3302,72,3230,5.04%,2.18%
2020-01-01 00:02:40,11,3,807,5,802,1.23%,0.62%
2020-01-01 00:02:40,11,4,8631,512,8119,13.17%,5.93%
2020-01-01 00:02:40,11,5,203,0,203,0.31%,0.00%
2020-01-01 00:02:40,11,6,9428,621,8807,14.39%,6.59%
2020-01-01 00:02:40,11,7,14434,1471,12963,22.02%,10.19%
2020-01-01 00:02:40,11,8,28352,5399,22953,43.26%,19.04%
2020-01-01 00:02:40,11,9,261,0,261,0.40%,0.00%
2020-01-01 00:02:40,11,10,3076,67,3009,4.69%,2.18%
2020-01-01 00:02:40,11,11,10404,784,9620,15.88%,7.53%
2020-01-01 00:02:40,11,12,6918,372,6546,10.56%,5.38%
2020-01-01 00:02:40,12,1,110,0,110,0.17%,0.00%
2020-01-01 00:02:40,12,2,462,128,334,0.70%,27.65%
2020-01-01 00:02:40,12,3,2667,171,2496,4.07%,6.41%
2020-01-01 00:02:40,12,4,3259,83,3176,4.97%,2.55%
2020-01-01 00:02:40,12,5,8411,758,7653,12.83%,9.01%
2020-01-01 00:02:40,12,6,5159,333,4826,7.87%,6.45%
2020-01-01 00:02:40,12,7,1603,30,1573,2.45%,1.87%
2020-01-01 00:02:40,12,8,1289,252,1037,1.97%,19.53%
2020-01-01 00:02:40,12,9,20973,4027,16946,32.00%,19.20%
2020-01-01 00:02:40,12,10,4296,353,3943,6.56%,8.22%
2020-01-01 00:02:40,12,11,1445,256,1189,2.20%,17.70%
2020-01-01 00:02:40,12,12,6627,1032,5595,10.11%,15.57%
2020-01-01 00:02:40,13,1,1952,37,1915,2.98%,1.89%
2020-01-01 00:02:40,13,2,2385,52,2333,3.64%,2.18%
2020-01-01 00:02:40,13,3,825,11,814,1.26%,1.33%
2020-01-01 00:02:40,13,4,4462,498,3964,6.81%,11.16%
2020-01-01 00:02:40,13,5,7985,971,7014,12.18%,12.16%
2020-01-01 00:02:40,13,6,5101,537,4564,7.78%,10.53%
2020-01-01 00:02:40,13,7,4828,163,4665,7.37%,3.38%
2020-01-01 00:02:40,13,8,6978,340,6638,10.65%,4.87%
2020-01-01 00:02:40,13,9,8269,1010,7259,12.62%,12.21%
2020-01-01 00:02:40,13,10,29157,6140,23017,44.49%,21.06%
2020-01-01 00:02:40,13,11,18629,2600,16029,28.43%,13.96%
2020-01-01 00:02:40,13,12,11223,1178,10045,17.12%,10.50%
2020-01-01 00:02:40,14,1,347,1,346,0.53%,0.29%
2020-01-01 00:02:40,14,2,1205,12,1193,1.84%,1.00%
2020-01-01 00:02:40,14,3,639,5,634,0.98%,0.78%
2020-01-01 00:02:40,14,4,3876,118,3758,5.91%,3.04%
2020-01-01 00:02:40,14,5,1526,20,1506,2.33%,1.31%
2020-01-01 00:02:40,14,6,4293,146,4147,6.55%,3.40%
2020-01-01 00:02:40,14,7,11199,938,10261,17.09%,8.38%
2020-01-01 00:02:40,14,8,12714,1233,11481,19.40%,9.70%
2020-01-01 00:02:40,14,9,1680,28,1652,2.56%,1.67%
2020-01-01 00:02:40,14,10,4266,147,4119,6.51%,3.45%
2020-01-01 00:02:40,14,11,27866,5317,22549,42.52%,19.08%
2020-01-01 00:02:40,14,12,10484,813,9671,16.00%,7.75%
2020-01-01 00:02:40,15,1,493,0,493,0.75%,0.00%
2020-01-01 00:02:40,15,2,108,0,108,0.16%,0.00%
2020-01-01 00:02:40,15,3,6520,323,6197,9.95%,4.95%
2020-01-01 00:02:40,15,4,4625,204,4421,7.06%,4.41%
2020-01-01 00:02:40,15,5,12039,1105,10934,18.37%,9.18%
2020-01-01 00:02:40,15,6,4909,252,4657,7.49%,5.13%
2020-01-01 00:02:40,15,7,3236,110,3126,4.94%,3.40%
2020-01-01 00:02:40,15,8,5316,257,5059,8.11%,4.83%
2020-01-01 00:02:40,15,9,12199,1135,11064,18.61%,9.30%
2020-01-01 00:02:40,15,10,5246,378,4868,8.00%,7.20%
2020-01-01 00:02:40,15,11,10677,1032,9645,16.29%,9.66%
2020-01-01 00:02:40,15,12,28488,5909,22579,43.47%,20.74%
2020-01-01 00:02:40,16,1,396,3,393,0.60%,0.76%
2020-01-01 00:02:40,16,2,237,4,233,0.36%,1.68%
2020-01-01 00:02:40,16,3,1236,12,1224,1.89%,0.97%
2020-01-01 00:02:40,16,4,3588,85,3503,5.47%,2.37%
2020-01-01 00:02:40,16,5,7215,419,6796,11.01%,5.81%
2020-01-01 00:02:40,16,6,4505,133,4372,6.87%,2.95%
2020-01-01 00:02:40,16,7,3469,96,3373,5.29%,2.77%
2020-01-01 00:02:40,16,8,6986,451,6535,10.66%,6.45%
2020-01-01 00:02:40,16,9,7688,479,7209,11.73%,6.23%
2020-01-01 00:02:40,16,10,2189,53,2136,3.34%,2.42%
2020-01-01 00:02:40,16,11,9394,760,8634,14.33%,8.09%
2020-01-01 00:02:40,16,12,24914,4236,20678,38.02%,17.00%
2020-01-01 00:02:50,1,1,19215,2523,16692,29.32%,13.13%
2020-01-01 00:02:50,1,2,8661,537,8124,13.22%,6.20%
2020-01-01 00:02:50,1,3,370,2,368,0.56%,0.54%
2020-01-01 00:02:50,1,4,9944,745,9199,15.17%,7.49%
2020-01-01 00:02:50,1,5,9511,683,8828,14.51%,7.18%
2020-01-01 00:02:50,1,6,9446,675,8771,14.41%,7.15%
2020-01-01 00:02:50,1,7,8267,498,7769,12.61%,6.02%
2020-01-01 00:02:50,1,8,7188,377,6811,10.97%,5.24%
2020-01-01 00:02:50,1,9,9402,670,8732,14.35%,7.13%
2020-01-01 00:02:50,1,10,6117,257,5860,9.33%,4.20%
2020-01-01 00:02:50,1,11,6209,266,5943,9.47%,4.28%
2020-01-01 00:02:50,1,12,9375,669,8706,14.31%,7.14%
2020-01-01 00:02:50,2,1,1070,10,1060,1.63%,0.93%
2020-01-01 00:02:50,2,2,29325,5663,23662,44.75%,19.31%
2020-01-01 00:02:50,2,3,23702,3818,19884,36.17%,16.11%
2020-01-01 00:02:50,2,4,998,8,990,1.52%,0.80%
2020-01-01 00:02:50,2,5,12037,1053,10984,18.37%,8.75%
2020-01-01 00:02:50,2,6,26,0,26,0.04%,0.00%
2020-01-01 00:02:50,2,7,4542,155,4387,6.93%,3.41%
2020-01-01 00:02:50,2,8,3227,73,3154,4.92%,2.26%
2020-01-01 00:02:50,2,9,11963,1044,10919,18.25%,8.73%
2020-01-01 00:02:50,2,10,2328,44,2284,3.55%,1.89%
2020-01-01 00:02:50,2,11,2348,45,2303,3.58%,1.92%
2020-01-01 00:02:50,2,12,11826,1020,10806,18.05%,8.62%
2020-01-01 00:02:50,3,1,1487,23,1464,2.27%,1.55%
2020-01-01 00:02:50,3,2,21179,3058,18121,32.32%,14.44%
2020-01-01 00:02:50,3,3,73983,29657,44326,112.89%,40.09%
2020-01-01 00:02:50,3,4,11068,926,10142,16.89%,8.37%
2020-01-01 00:02:50,3,5,49681,14937,34744,75.81%,30.07%
2020-01-01 00:02:50,3,6,12268,1125,11143,18.72%,9.17%
2020-01-01 00:02:50,3,7,17917,2267,15650,27.34%,12.65%
2020-01-01 00:02:50,3,8,14988,1644,13344,22.87%,10.97%
2020-01-01 00:02:50,3,9,37104,8727,28377,56.62%,23.52%
2020-01-01 00:02:50,3,10,5670,220,5450,8.65%,3.88%
2020-01-01 00:02:50,3,11,2155,23,2132,3.29%,1.07%
2020-01-01 00:02:50,3,12,27983,5149,22834,42.70%,18.40%
2020-01-01 00:02:50,4,1,569,3,566,0.87%,0.53%
2020-01-01 00:02:50,4,2,388,2,386,0.59%,0.51%
2020-01-01 00:02:50,4,3,728,8,720,1.11%,1.10%
2020-01-01 00:02:50,4,4,28689,5487,23202,43.78%,19.13%
2020-01-01 00:02:50,4,5,17536,2127,15409,26.76%,12.13%
2020-01-01 00:02:50,4,6,24226,4018,20208,36.97%,16.58%
2020-01-01 00:02:50,4,7,5177,206,4971,7.90%,3.98%
2020-01-01 00:02:50,4,8,2913,57,2856,4.44%,1.96%
2020-01-01 00:02:50,4,9,15744,1751,13993,24.02%,11.12%
2020-01-01 00:02:50,4,10,2200,42,2158,3.36%,1.91%
2020-01-01 00:02:50,4,11,223,0,223,0.34%,0.00%
2020-01-01 00:02:50,4,12,12653,1135,11518,19.31%,8.97%
2020-01-01 00:02:50,5,1,2726,53,2673,4.16%,1.94%
2020-01-01 00:02:50,5,2,626,5,621,0.96%,0.80%
2020-01-01 00:02:50,5,3,1648,18,1630,2.51%,1.09%
2020-01-01 00:02:50,5,4,21900,3323,18577,33.42%,15.17%
2020-01-01 00:02:50,5,5,10085,735,9350,15.39%,7.29%
2020-01-01 00:02:50,5,6,14660,1550,13110,22.37%,10.57%
2020-01-01 00:02:50,5,7,4166,137,4029,6.36%,3.29%
2020-01-01 00:02:50,5,8,3240,83,3157,4.94%,2.56%
2020-01-01 00:02:50,5,9,8269,497,7772,12.62%,6.01%
2020-01-01 00:02:50,5,10,899,8,891,1.37%,0.89%
2020-01-01 00:02:50,5,11,769,3,766,1.17%,0.39%
2020-01-01 00:02:50,5,12,7091,371,6720,10.82%,5.23%
2020-01-01 00:02:50,6,1,1342,12,1330,2.05%,0.89%
2020-01-01 00:02:50,6,2,1407,16,1391,2.15%,1.14%
2020-01-01 00:02:50,6,3,2053,28,2025,3.13%,1.36%
2020-01-01 00:02:50,6,4,1323,7,1316,2.02%,0.53%
2020-01-01 00:02:50,6,5,12106,1033,11073,18.47%,8.53%
2020-01-01 00:02:50,6,6,3818,103,3715,5.83%,2.70%
2020-01-01 00:02:50,6,7,2014,38,1976,3.07%,1.89%
2020-01-01 00:02:50,6,8,1529,24,1505,2.33%,1.57%
2020-01-01 00:02:50,6,9,6045,284,5761,9.22%,4.70%
2020-01-01 00:02:50,6,10,1746,35,1711,2.66%,2.00%
2020-01-01 00:02:50,6,11,495,5,490,0.76%,1.01%
2020-01-01 00:02:50,6,12,4227,139,4088,6.45%,3.29%
2020-01-01 00:02:50,7,1,607,3,604,0.93%,0.49%
2020-01-01 00:02:50,7,2,155,0,155,0.24%,0.00%
2020-01-01 00:02:50,7,3,783,5,778,1.19%,0.64%
2020-01-01 00:02:50,7,4,2443,48,2395,3.73%,1.96%
2020-01-01 00:02:50,7,5,7800,470,7330,11.90%,6.02%
2020-01-01 00:02:50,7,6,14215,1487,12728,21.69%,10.46%
2020-01-01 00:02:50,7,7,3860,115,3745,5.89%,2.98%
2020-01-01 00:02:50,7,8,1381,19,1362,2.11%,1.37%
2020-01-01 00:02:50,7,9,6851,361,6490,10.45%,5.27%
2020-01-01 00:02:50,7,10,1297,10,1287,1.98%,0.77%
2020-01-01 00:02:50,7,11,97,0,97,0.15%,0.00%
2020-01-01 00:02:50,7,12,5538,238,5300,8.45%,4.30%
2020-01-01 00:02:50,8,1,577,10,567,0.88%,1.73%
2020-01-01 00:02:50,8,2,80,0,80,0.12%,0.00%
2020-01-01 00:02:50,8,3,2268,36,2232,3.46%,1.59%
2020-01-01 00:02:50,8,4,2953,79,2874,4.51%,2.67%
2020-01-01 00:02:50,8,5,8912,561,8351,13.60%,6.29%
2020-01-01 00:02:50,8,6,16760,1975,14785,25.57%,11.78%
2020-01-01 00:02:50,8,7,4693,169,4524,7.16%,3.60%
2020-01-01 00:02:50,8,8,2134,31,2103,3.26%,1.45%
2020-01-01 00:02:50,8,9,6261,304,5957,9.55%,4.85%
2020-01-01 00:02:50,8,10,1604,16,1588,2.45%,1.00%
2020-01-01 00:02:50,8,11,186,0,186,0.28%,0.00%
2020-01-01 00:02:50,8,12,4612,158,4454,7.04%,3.43%
2020-01-01 00:02:50,9,1,1228,6,1222,1.87%,0.49%
2020-01-01 00:02:50,9,2,2793,45,2748,4.26%,1.61%
2020-01-01 00:02:50,9,3,1093,10,1083,1.67%,0.91%
2020-01-01 00:02:50,9,4,5169,203,4966,7.89%,3.93%
2020-01-01 00:02:50,9,5,593,2,591,0.90%,0.34%
2020-01-01 00:02:50,9,6,6431,302,6129,9.81%,4.70%
2020-01-01 00:02:50,9,7,27168,4886,22282,41.46%,17.98%
2020-01-01 00:02:50,9,8,11569,972,10597,17.65%,8.40%
2020-01-01 00:02:50,9,9,256,0,256,0.39%,0.00%
2020-01-01 00:02:50,9,10,4329,154,4175,6.61%,3.56%
2020-01-01 00:02:50,9,11,10384,805,9579,15.84%,7.75%
2020-01-01 00:02:50,9,12,5715,221,5494,8.72%,3.87%
2020-01-01 00:02:50,10,1,1327,261,1066,2.02%,19.65%
2020-01-01 00:02:50,10,2,4499,401,4098,6.86%,8.91%
2020-01-01 00:02:50,10,3,3028,83,2945,4.62%,2.74%
2020-01-01 00:02:50,10,4,4106,1123,2983,6.27%,27.34%
2020-01-01 00:02:50,10,5,836,77,759,1.28%,9.20%
2020-01-01 00:02:50,10,6,6395,1327,5068,9.76%,20.75%
2020-01-01 00:02:50,10,7,12369,2328,10041,18.87%,18.82%
2020-01-01 00:02:50,10,8,31429,8438,22991,47.96%,26.85%
2020-01-01 00:02:50,10,9,548,0,548,0.84%,0.00%
2020-01-01 00:02:50,10,10,2879,61,2818,4.39%,2.12%
2020-01-01 00:02:50,10,11,14676,1983,12693,22.39%,13.51%
2020-01-01 00:02:50,10,12,11002,1352,9650,16.79%,12.29%
2020-01-01 00:02:50,11,1,2756,82,2674,4.21%,2.97%
2020-01-01 00:02:50,11,2,4019,171,3848,6.13%,4.25%
2020-01-01 00:02:50,11,3,1075,36,1039,1.64%,3.35%
2020-01-01 00:02:50,11,4,3838,126,3712,5.86%,3.28%
2020-01-01 00:02:50,11,5,182,1,181,0.28%,0.55%
2020-01-01 00:02:50,11,6,4580,174,4406,6.99%,3.80%
2020-01-01 00:02:50,11,7,10481,866,9615,15.99%,8.26%
2020-01-01 00:02:50,11,8,24903,4289,20614,38.00%,17.22%
2020-01-01 00:02:50,11,9,259,0,259,0.40%,0.00%
2020-01-01 00:02:50,11,10,3668,101,3567,5.60%,2.75%
2020-01-01 00:02:50,11,11,10873,849,10024,16.59%,7.81%
2020-01-01 00:02:50,11,12,6609,334,6275,10.08%,5.05%
2020-01-01 00:02:50,12,1,42,0,42,0.06%,0.00%
2020-01-01 00:02:50,12,2,566,149,417,0.86%,26.28%
2020-01-01 00:02:50,12,3,3548,236,3312,5.41%,6.65%
2020-01-01 00:02:50,12,4,3638,114,3524,5.55%,3.13%
2020-01-01 00:02:50,12,5,10190,886,9304,15.55%,8.69%
2020-01-01 00:02:50,12,6,5475,252,5223,8.35%,4.60%
2020-01-01 00:02:50,12,7,1669,30,1639,2.55%,1.80%
2020-01-01 00:02:50,12,8,1536,295,1241,2.34%,19.19%
2020-01-01 00:02:50,12,9,23334,4601,18733,35.60%,19.72%
2020-01-01 00:02:50,12,10,5033,436,4597,7.68%,8.66%
2020-01-01 00:02:50,12,11,1878,300,1578,2.87%,15.97%
2020-01-01 00:02:50,12,12,7110,1075,6035,10.85%,15.12%
2020-01-01 00:02:50,13,1,2512,39,2473,3.83%,1.55%
2020-01-01 00:02:50,13,2,2966,62,2904,4.53%,2.09%
2020-01-01 00:02:50,13,3,1069,3,1066,1.63%,0.28%
2020-01-01 00:02:50,13,4,4656,524,4132,7.10%,11.25%
2020-01-01 00:02:50,13,5,7504,954,6550,11.45%,12.71%
2020-01-01 00:02:50,13,6,5411,568,4843,8.26%,10.50%
2020-01-01 00:02:50,13,7,5261,243,5018,8.03%,4.62%
2020-01-01 00:02:50,13,8,8064,525,7539,12.30%,6.51%
2020-01-01 00:02:50,13,9,7814,986,6828,11.92%,12.62%
2020-01-01 00:02:50,13,10,28068,5945,22123,42.83%,21.18%
2020-01-01 00:02:50,13,11,17372,2487,14885,26.51%,14.32%
2020-01-01 00:02:50,13,12,8878,901,7977,13.55%,10.15%
2020-01-01 00:02:50,14,1,423,4,419,0.65%,0.94%
2020-01-01 00:02:50,14,2,1571,21,1550,2.40%,1.34%
2020-01-01 00:02:50,14,3,875,9,866,1.34%,1.03%
2020-01-01 00:02:50,14,4,3786,109,3677,5.78%,2.88%
2020-01-01 00:02:50,14,5,1279,12,1267,1.95%,0.94%
2020-01-01 00:02:50,14,6,4309,143,4166,6.58%,3.32%
2020-01-01 00:02:50,14,7,12464,1090,11374,19.02%,8.74%
2020-01-01 00:02:50,14,8,13837,1321,12516,21.11%,9.55%
2020-01-01 00:02:50,14,9,1474,14,1460,2.25%,0.95%
2020-01-01 00:02:50,14,10,4328,137,4191,6.60%,3.16%
2020-01-01 00:02:50,14,11,29089,5753,23336,44.39%,19.78%
2020-01-01 00:02:50,14,12,10595,878,9717,16.17%,8.29%
2020-01-01 00:02:50,15,1,563,0,563,0.86%,0.00%
2020-01-01 00:02:50,15,2,129,0,129,0.20%,0.00%
2020-01-01 00:02:50,15,3,3968,117,3851,6.05%,2.95%
2020-01-01 00:02:50,15,4,4580,214,4366,6.99%,4.67%
2020-01-01 00:02:50,15,5,9369,704,8665,14.30%,7.51%
2020-01-01 00:02:50,15,6,4848,239,4609,7.40%,4.93%
2020-01-01 00:02:50,15,7,3627,96,3531,5.53%,2.65%
2020-01-01 00:02:50,15,8,6161,293,5868,9.40%,4.75%
2020-01-01 00:02:50,15,9,9581,738,8843,14.62%,7.70%
2020-01-01 00:02:50,15,10,4283,418,3865,6.54%,9.76%
2020-01-01 00:02:50,15,11,10577,1074,9503,16.14%,10.15%
2020-01-01 00:02:50,15,12,25579,5038,20541,39.03%,19.70%
2020-01-01 00:02:50,16,1,484,0,484,0.74%,0.00%
2020-01-01 00:02:50,16,2,281,4,277,0.43%,1.42%
2020-01-01 00:02:50,16,3,1367,25,1342,2.09%,1.83%
2020-01-01 00:02:50,16,4,4043,136,3907,6.17%,3.36%
2020-01-01 00:02:50,16,5,7314,481,6833,11.16%,6.58%
2020-01-01 00:02:50,16,6,5050,201,4849,7.71%,3.98%
2020-01-01 00:02:50,16,7,2899,68,2831,4.42%,2.34%
2020-01-01 00:02:50,16,8,6611,377,6234,10.09%,5.70%
2020-01-01 00:02:50,16,9,7902,544,7358,12.06%,6.88%
2020-01-01 00:02:50,16,10,1610,16,1594,2.46%,0.99%
2020-01-01 00:02:50,16,11,8494,578,7916,12.96%,6.80%
2020-01-01 00:02:50,16,12,24238,4005,20233,36.98%,16.52%
2020-01-01 00:03:00,1,1,18800,2394,16406,28.69%,12.73%
2020-01-01 00:03:00,1,2,9217,624,8593,14.06%,6.77%
2020-01-01 00:03:00,1,3,346,1,345,0.53%,0.29%
2020-01-01 00:03:00,1,4,9133,592,8541,13.94%,6.48%
2020-01-01 00:03:00,1,5,8756,559,8197,13.36%,6.38%
2020-01-01 00:03:00,1,6,8701,546,8155,13.28%,6.27%
2020-01-01 00:03:00,1,7,8855,577,8278,13.51%,6.52%
2020-01-01 00:03:00,1,8,6530,295,6235,9.96%,4.52%
2020-01-01 00:03:00,1,9,8666,544,8122,13.22%,6.28%
2020-01-01 00:03:00,1,10,5665,214,5451,8.64%,3.78%
2020-01-01 00:03:00,1,11,5731,222,5509,8.74%,3.87%
2020-01-01 00:03:00,1,12,8405,519,7886,12.83%,6.17%
2020-01-01 00:03:00,2,1,792,2,790,1.21%,0.25%
2020-01-01 00:03:00,2,2,23477,3782,19695,35.82%,16.11%
2020-01-01 00:03:00,2,3,18847,2488,16359,28.76%,13.20%
2020-01-01 00:03:00,2,4,706,1,705,1.08%,0.14%
2020-01-01 00:03:00,2,5,11756,1015,10741,17.94%,8.63%
2020-01-01 00:03:00,2,6,40,0,40,0.06%,0.00%
2020-01-01 00:03:00,2,7,3814,108,3706,5.82%,2.83%
2020-01-01 00:03:00,2,8,2465,47,2418,3.76%,1.91%
2020-01-01 00:03:00,2,9,11718,1005,10713,17.88%,8.58%
2020-01-01 00:03:00,2,10,1792,18,1774,2.73%,1.00%
2020-01-01 00:03:00,2,11,1801,19,1782,2.75%,1.05%
2020-01-01 00:03:00,2,12,11518,979,10539,17.58%,8.50%
2020-01-01 00:03:00,3,1,1601,19,1582,2.44%,1.19%
2020-01-01 00:03:00,3,2,22898,3666,19232,34.94%,16.01%
2020-01-01 00:03:00,3,3,69171,26492,42679,105.55%,38.30%
2020-01-01 00:03:00,3,4,7382,393,6989,11.26%,5.32%
2020-01-01 00:03:00,3,5,45152,12459,32693,68.90%,27.59%
2020-01-01 00:03:00,3,6,8828,560,8268,13.47%,6.34%
2020-01-01 00:03:00,3,7,19358,2657,16701,29.54%,13.72%
2020-01-01 00:03:00,3,8,15318,1694,13624,23.37%,11.06%
2020-01-01 00:03:00,3,9,35977,8321,27656,54.90%,23.13%
2020-01-01 00:03:00,3,10,7462,434,7028,11.39%,5.82%
2020-01-01 00:03:00,3,11,2132,42,2090,3.25%,1.97%
2020-01-01 00:03:00,3,12,24784,4159,20625,37.82%,16.78%
2020-01-01 00:03:00,4,1,526,2,524,0.80%,0.38%
2020-01-01 00:03:00,4,2,337,0,337,0.51%,0.00%
2020-01-01 00:03:00,4,3,619,3,616,0.94%,0.48%
2020-01-01 00:03:00,4,4,28224,5223,23001,43.07%,18.50%
2020-01-01 00:03:00,4,5,16966,1991,14975,25.89%,11.73%
2020-01-01 00:03:00,4,6,23892,3783,20109,36.46%,15.83%
2020-01-01 00:03:00,4,7,5394,199,5195,8.23%,3.69%
2020-01-01 00:03:00,4,8,2936,60,2876,4.48%,2.04%
2020-01-01 00:03:00,4,9,14963,1549,13414,22.83%,10.35%
2020-01-01 00:03:00,4,10,2036,25,2011,3.11%,1.23%
2020-01-01 00:03:00,4,11,204,0,204,0.31%,0.00%
2020-01-01 00:03:00,4,12,12335,1068,11267,18.82%,8.66%
2020-01-01 00:03:00,5,1,2650,62,2588,4.04%,2.34%
2020-01-01 00:03:00,5,2,759,3,756,1.16%,0.39%
2020-01-01 00:03:00,5,3,890,6,884,1.36%,0.67%
2020-01-01 00:03:00,5,4,25877,4430,21447,39.49%,17.12%
2020-01-01 00:03:00,5,5,9583,634,8949,14.62%,6.62%
2020-01-01 00:03:00,5,6,15118,1544,13574,23.07%,10.21%
2020-01-01 00:03:00,5,7,5102,175,4927,7.79%,3.43%
2020-01-01 00:03:00,5,8,3273,70,3203,4.99%,2.14%
2020-01-01 00:03:00,5,9,8576,500,8076,13.09%,5.83%
2020-01-01 00:03:00,5,10,1011,10,1001,1.54%,0.99%
2020-01-01 00:03:00,5,11,560,1,559,0.85%,0.18%
2020-01-01 00:03:00,5,12,7258,363,6895,11.07%,5.00%
2020-01-01 00:03:00,6,1,1047,10,1037,1.60%,0.95%
2020-01-01 00:03:00,6,2,1106,11,1095,1.69%,0.99%
2020-01-01 00:03:00,6,3,1730,25,1705,2.64%,1.44%
2020-01-01 00:03:00,6,4,1089,9,1080,1.66%,0.83%
2020-01-01 00:03:00,6,5,14044,1439,12605,21.43%,10.25%
2020-01-01 00:03:00,6,6,5412,229,5183,8.26%,4.23%
2020-01-01 00:03:00,6,7,3870,111,3759,5.91%,2.87%
2020-01-01 00:03:00,6,8,3457,87,3370,5.27%,2.52%
2020-01-01 00:03:00,6,9,6609,303,6306,10.08%,4.58%
2020-01-01 00:03:00,6,10,2081,27,2054,3.18%,1.30%
2020-01-01 00:03:00,6,11,412,2,410,0.63%,0.48%
2020-01-01 00:03:00,6,12,4464,147,4317,6.81%,3.29%
2020-01-01 00:03:00,7,1,575,1,574,0.88%,0.17%
2020-01-01 00:03:00,7,2,152,0,152,0.23%,0.00%
2020-01-01 00:03:00,7,3,795,3,792,1.21%,0.38%
2020-01-01 00:03:00,7,4,2089,33,2056,3.19%,1.58%
2020-01-01 00:03:00,7,5,7743,422,7321,11.81%,5.45%
2020-01-01 00:03:00,7,6,13186,1258,11928,20.12%,9.54%
2020-01-01 00:03:00,7,7,3247,64,3183,4.95%,1.97%
2020-01-01 00:03:00,7,8,1438,16,1422,2.19%,1.11%
2020-01-01 00:03:00,7,9,6702,324,6378,10.23%,4.83%
2020-01-01 00:03:00,7,10,992,7,985,1.51%,0.70%
2020-01-01 00:03:00,7,11,97,0,97,0.15%,0.00%
2020-01-01 00:03:00,7,12,5688,243,5445,8.68%,4.27%
2020-01-01 00:03:00,8,1,704,1,703,1.07%,0.14%
2020-01-01 00:03:00,8,2,92,0,92,0.14%,0.00%
2020-01-01 00:03:00,8,3,1916,13,1903,2.92%,0.68%
2020-01-01 00:03:00,8,4,3076,59,3017,4.69%,1.92%
2020-01-01 00:03:00,8,5,9118,580,8538,13.91%,6.36%
2020-01-01 00:03:00,8,6,17903,2195,15708,27.32%,12.26%
2020-01-01 00:03:00,8,7,5577,237,5340,8.51%,4.25%
2020-01-01 00:03:00,8,8,2754,73,2681,4.20%,2.65%
2020-01-01 00:03:00,8,9,6713,335,6378,10.24%,4.99%
2020-01-01 00:03:00,8,10,1719,13,1706,2.62%,0.76%
2020-01-01 00:03:00,8,11,213,0,213,0.33%,0.00%
2020-01-01 00:03:00,8,12,4948,190,4758,7.55%,3.84%
2020-01-01 00:03:00,9,1,375,0,375,0.57%,0.00%
2020-01-01 00:03:00,9,2,1827,23,1804,2.79%,1.26%
2020-01-01 00:03:00,9,3,1066,11,1055,1.63%,1.03%
2020-01-01 00:03:00,9,4,8105,489,7616,12.37%,6.03%
2020-01-01 00:03:00,9,5,524,1,523,0.80%,0.19%
2020-01-01 00:03:00,9,6,9279,631,8648,14.16%,6.80%
2020-01-01 00:03:00,9,7,30485,6172,24313,46.52%,20.25%
2020-01-01 00:03:00,9,8,14247,1519,12728,21.74%,10.66%
2020-01-01 00:03:00,9,9,161,0,161,0.25%,0.00%
2020-01-01 00:03:00,9,10,4043,113,3930,6.17%,2.79%
2020-01-01 00:03:00,9,11,12070,1065,11005,18.42%,8.82%
2020-01-01 00:03:00,9,12,7752,457,7295,11.83%,5.89%
2020-01-01 00:03:00,10,1,1515,246,1269,2.31%,16.23%
2020-01-01 00:03:00,10,2,3665,315,3350,5.59%,8.59%
2020-01-01 00:03:00,10,3,1998,30,1968,3.05%,1.50%
2020-01-01 00:03:00,10,4,4003,854,3149,6.11%,21.33%
2020-01-01 00:03:00,10,5,903,80,823,1.38%,8.85%
2020-01-01 00:03:00,10,6,6116,1038,5078,9.33%,16.97%
2020-01-01 00:03:00,10,7,11283,1822,9461,17.22%,16.15%
2020-01-01 00:03:00,10,8,31091,8093,22998,47.44%,26.03%
2020-01-01 00:03:00,10,9,749,7,742,1.14%,0.93%
2020-01-01 00:03:00,10,10,2963,80,2883,4.52%,2.70%
2020-01-01 00:03:00,10,11,14692,1862,12830,22.42%,12.67%
2020-01-01 00:03:00,10,12,10687,1171,9516,16.31%,10.96%
2020-01-01 00:03:00,11,1,2791,61,2730,4.26%,2.18%
2020-01-01 00:03:00,11,2,3905,112,3793,5.96%,2.87%
2020-01-01 00:03:00,11,3,929,8,921,1.42%,0.86%
2020-01-01 00:03:00,11,4,3168,87,3081,4.83%,2.75%
2020-01-01 00:03:00,11,5,198,0,198,0.30%,0.00%
2020-01-01 00:03:00,11,6,4091,140,3951,6.24%,3.42%
2020-01-01 00:03:00,11,7,9819,707,9112,14.98%,7.20%
2020-01-01 00:03:00,11,8,24328,3999,20329,37.12%,16.44%
2020-01-01 00:03:00,11,9,167,1,166,0.25%,0.60%
2020-01-01 00:03:00,11,10,3841,112,3729,5.86%,2.92%
2020-01-01 00:03:00,11,11,10658,818,9840,16.26%,7.67%
2020-01-01 00:03:00,11,12,6239,297,5942,9.52%,4.76%
2020-01-01 00:03:00,12,1,41,0,41,0.06%,0.00%
2020-01-01 00:03:00,12,2,519,145,374,0.79%,27.88%
2020-01-01 00:03:00,12,3,2969,201,2768,4.53%,6.77%
2020-01-01 00:03:00,12,4,3122,63,3059,4.76%,2.02%
2020-01-01 00:03:00,12,5,9560,793,8767,14.59%,8.29%
2020-01-01 00:03:00,12,6,5025,174,4851,7.67%,3.46%
2020-01-01 00:03:00,12,7,1754,27,1727,2.68%,1.54%
2020-01-01 00:03:00,12,8,1517,314,1203,2.31%,20.69%
2020-01-01 00:03:00,12,9,23317,4536,18781,35.58%,19.45%
2020-01-01 00:03:00,12,10,5047,483,4564,7.70%,9.57%
2020-01-01 00:03:00,12,11,2133,334,1799,3.25%,15.65%
2020-01-01 00:03:00,12,12,7793,1135,6658,11.89%,14.56%
2020-01-01 00:03:00,13,1,2470,45,2425,3.77%,1.82%
2020-01-01 00:03:00,13,2,2765,58,2707,4.22%,2.10%
2020-01-01 00:03:00,13,3,926,8,918,1.41%,0.86%
2020-01-01 00:03:00,13,4,4986,634,4352,7.61%,12.71%
2020-01-01 00:03:00,13,5,7440,959,6481,11.35%,12.89%
2020-01-01 00:03:00,13,6,5513,662,4851,8.41%,12.01%
2020-01-01 00:03:00,13,7,4727,178,4549,7.21%,3.76%
2020-01-01 00:03:00,13,8,8014,459,7555,12.23%,5.73%
2020-01-01 00:03:00,13,9,7687,981,6706,11.73%,12.76%
2020-01-01 00:03:00,13,10,28708,6132,22576,43.80%,21.36%
2020-01-01 00:03:00,13,11,18429,2689,15740,28.12%,14.59%
2020-01-01 00:03:00,13,12,10033,1135,8898,15.31%,11.31%
2020-01-01 00:03:00,14,1,214,0,214,0.33%,0.00%
2020-01-01 00:03:00,14,2,1691,26,1665,2.58%,1.54%
2020-01-01 00:03:00,14,3,1209,12,1197,1.84%,0.99%
2020-01-01 00:03:00,14,4,4006,121,3885,6.11%,3.02%
2020-01-01 00:03:00,14,5,1133,6,1127,1.73%,0.53%
2020-01-01 00:03:00,14,6,4369,146,4223,6.67%,3.34%
2020-01-01 00:03:00,14,7,12279,1089,11190,18.74%,8.87%
2020-01-01 00:03:00,14,8,14020,1412,12608,21.39%,10.07%
2020-01-01 00:03:00,14,9,1400,14,1386,2.14%,1.00%
2020-01-01 00:03:00,14,10,4007,106,3901,6.11%,2.64%
2020-01-01 00:03:00,14,11,26730,4763,21967,40.79%,17.82%
2020-01-01 00:03:00,14,12,8329,522,7807,12.71%,6.27%
2020-01-01 00:03:00,15,1,484,2,482,0.74%,0.41%
2020-01-01 00:03:00,15,2,177,0,177,0.27%,0.00%
2020-01-01 00:03:00,15,3,4435,142,4293,6.77%,3.20%
2020-01-01 00:03:00,15,4,5797,377,5420,8.85%,6.50%
2020-01-01 00:03:00,15,5,11232,978,10254,17.14%,8.71%
2020-01-01 00:03:00,15,6,6063,406,5657,9.25%,6.70%
2020-01-01 00:03:00,15,7,3910,100,3810,5.97%,2.56%
2020-01-01 00:03:00,15,8,7165,332,6833,10.93%,4.63%
2020-01-01 00:03:00,15,9,11456,1008,10448,17.48%,8.80%
2020-01-01 00:03:00,15,10,4933,325,4608,7.53%,6.59%
2020-01-01 00:03:00,15,11,12201,1164,11037,18.62%,9.54%
2020-01-01 00:03:00,15,12,29370,6133,23237,44.82%,20.88%
2020-01-01 00:03:00,16,1,523,3,520,0.80%,0.57%
2020-01-01 00:03:00,16,2,310,0,310,0.47%,0.00%
2020-01-01 00:03:00,16,3,1291,13,1278,1.97%,1.01%
2020-01-01 00:03:00,16,4,4041,115,3926,6.17%,2.85%
2020-01-01 00:03:00,16,5,7354,459,6895,11.22%,6.24%
2020-01-01 00:03:00,16,6,4975,184,4791,7.59%,3.70%
2020-01-01 00:03:00,16,7,3317,95,3222,5.06%,2.86%
2020-01-01 00:03:00,16,8,7952,546,7406,12.13%,6.87%
2020-01-01 00:03:00,16,9,7943,506,7437,12.12%,6.37%
2020-01-01 00:03:00,16,10,1565,17,1548,2.39%,1.09%
2020-01-01 00:03:00,16,11,9724,762,8962,14.84%,7.84%
2020-01-01 00:03:00,16,12,25290,4322,20968,38.59%,17.09%
2020-01-01 00:03:10,1,1,13886,1392,12494,21.19%,10.02%
2020-01-01 00:03:10,1,2,5135,207,4928,7.84%,4.03%
2020-01-01 00:03:10,1,3,333,0,333,0.51%,0.00%
2020-01-01 00:03:10,1,4,8330,494,7836,12.71%,5.93%
2020-01-01 00:03:10,1,5,8134,478,7656,12.41%,5.88%
2020-01-01 00:03:10,1,6,8071,472,7599,12.32%,5.85%
2020-01-01 00:03:10,1,7,4792,188,4604,7.31%,3.92%
2020-01-01 00:03:10,1,8,3736,104,3632,5.70%,2.78%
2020-01-01 00:03:10,1,9,8038,466,7572,12.27%,5.80%
2020-01-01 00:03:10,1,10,3112,62,3050,4.75%,1.99%
2020-01-01 00:03:10,1,11,3170,67,3103,4.84%,2.11%
2020-01-01 00:03:10,1,12,7888,450,7438,12.04%,5.70%
2020-01-01 00:03:10,2,1,283,1,282,0.43%,0.35%
2020-01-01 00:03:10,2,2,25401,4401,21000,38.76%,17.33%
2020-01-01 00:03:10,2,3,20851,2997,17854,31.82%,14.37%
2020-01-01 00:03:10,2,4,218,1,217,0.33%,0.46%
2020-01-01 00:03:10,2,5,11507,972,10535,17.56%,8.45%
2020-01-01 00:03:10,2,6,25,0,25,0.04%,0.00%
2020-01-01 00:03:10,2,7,4255,153,4102,6.49%,3.59%
2020-01-01 00:03:10,2,8,3437,95,3342,5.24%,2.76%
2020-01-01 00:03:10,2,9,11431,959,10472,17.44%,8.39%
2020-01-01 00:03:10,2,10,2715,45,2670,4.14%,1.66%
2020-01-01 00:03:10,2,11,2726,45,2681,4.16%,1.65%
2020-01-01 00:03:10,2,12,11260,927,10333,17.18%,8.23%
2020-01-01 00:03:10,3,1,1558,21,1537,2.38%,1.35%
2020-01-01 00:03:10,3,2,26866,4835,22031,40.99%,18.00%
2020-01-01 00:03:10,3,3,74876,30332,44544,114.25%,40.51%
2020-01-01 00:03:10,3,4,8645,519,8126,13.19%,6.00%
2020-01-01 00:03:10,3,5,45830,12870,32960,69.93%,28.08%
2020-01-01 00:03:10,3,6,10364,784,9580,15.81%,7.56%
2020-01-01 00:03:10,3,7,23371,3730,19641,35.66%,15.96%
2020-01-01 00:03:10,3,8,18268,2351,15917,27.87%,12.87%
2020-01-01 00:03:10,3,9,35189,7999,27190,53.69%,22.73%
2020-01-01 00:03:10,3,10,5184,205,4979,7.91%,3.95%
2020-01-01 00:03:10,3,11,1948,32,1916,2.97%,1.64%
2020-01-01 00:03:10,3,12,25998,4614,21384,39.67%,17.75%
2020-01-01 00:03:10,4,1,452,0,452,0.69%,0.00%
2020-01-01 00:03:10,4,2,269,0,269,0.41%,0.00%
2020-01-01 00:03:10,4,3,856,5,851,1.31%,0.58%
2020-01-01 00:03:10,4,4,29716,5998,23718,45.34%,20.18%
2020-01-01 00:03:10,4,5,17774,2305,15469,27.12%,12.97%
2020-01-01 00:03:10,4,6,25524,4449,21075,38.95%,17.43%
2020-01-01 00:03:10,4,7,6224,311,5913,9.50%,5.00%
2020-01-01 00:03:10,4,8,2916,60,2856,4.45%,2.06%
2020-01-01 00:03:10,4,9,15596,1821,13775,23.80%,11.68%
2020-01-01 00:03:10,4,10,2239,54,2185,3.42%,2.41%
2020-01-01 00:03:10,4,11,141,0,141,0.22%,0.00%
2020-01-01 00:03:10,4,12,12666,1222,11444,19.33%,9.65%
2020-01-01 00:03:10,5,1,3247,92,3155,4.95%,2.83%
2020-01-01 00:03:10,5,2,1066,10,1056,1.63%,0.94%
2020-01-01 00:03:10,5,3,675,6,669,1.03%,0.89%
2020-01-01 00:03:10,5,4,22762,3440,19322,34.73%,15.11%
2020-01-01 00:03:10,5,5,9553,666,8887,14.58%,6.97%
2020-01-01 00:03:10,5,6,14951,1545,13406,22.81%,10.33%
2020-01-01 00:03:10,5,7,4914,169,4745,7.50%,3.44%
2020-01-01 00:03:10,5,8,3565,86,3479,5.44%,2.41%
2020-01-01 00:03:10,5,9,8745,570,8175,13.34%,6.52%
2020-01-01 00:03:10,5,10,974,8,966,1.49%,0.82%
2020-01-01 00:03:10,5,11,721,5,716,1.10%,0.69%
2020-01-01 00:03:10,5,12,7247,396,6851,11.06%,5.46%
2020-01-01 00:03:10,6,1,1163,9,1154,1.77%,0.77%
2020-01-01 00:03:10,6,2,1214,11,1203,1.85%,0.91%
2020-01-01 00:03:10,6,3,1882,29,1853,2.87%,1.54%
2020-01-01 00:03:10,6,4,1241,9,1232,1.89%,0.72%
2020-01-01 00:03:10,6,5,15136,1593,13543,23.10%,10.52%
2020-01-01 00:03:10,6,6,4023,109,3914,6.14%,2.71%
2020-01-01 00:03:10,6,7,2208,41,2167,3.37%,1.86%
2020-01-01 00:03:10,6,8,1729,27,1702,2.64%,1.56%
2020-01-01 00:03:10,6,9,8917,593,8324,13.61%,6.65%
2020-01-01 00:03:10,6,10,2745,49,2696,4.19%,1.78%
2020-01-01 00:03:10,6,11,539,4,535,0.82%,0.74%
2020-01-01 00:03:10,6,12,6085,289,5796,9.28%,4.75%
2020-01-01 00:03:10,7,1,436,2,434,0.67%,0.46%
2020-01-01 00:03:10,7,2,169,0,169,0.26%,0.00%
2020-01-01 00:03:10,7,3,1340,9,1331,2.04%,0.67%
2020-01-01 00:03:10,7,4,1507,15,1492,2.30%,0.99%
2020-01-01 00:03:10,7,5,9048,610,8438,13.81%,6.74%
2020-01-01 00:03:10,7,6,14524,1522,13002,22.16%,10.48%
2020-01-01 00:03:10,7,7,3860,146,3714,5.89%,3.78%
2020-01-01 00:03:10,7,8,1587,23,1564,2.42%,1.45%
2020-01-01 00:03:10,7,9,7623,431,7192,11.63%,5.65%
2020-01-01 00:03:10,7,10,1419,13,1406,2.17%,0.92%
2020-01-01 00:03:10,7,11,92,1,91,0.14%,1.08%
2020-01-01 00:03:10,7,12,6170,279,5891,9.41%,4.52%
2020-01-01 00:03:10,8,1,446,0,446,0.68%,0.00%
2020-01-01 00:03:10,8,2,103,0,103,0.16%,0.00%
2020-01-01 00:03:10,8,3,1460,22,1438,2.23%,1.51%
2020-01-01 00:03:10,8,4,2737,53,2684,4.18%,1.94%
2020-01-01 00:03:10,8,5,8132,479,7653,12.41%,5.89%
2020-01-01 00:03:10,8,6,16463,1884,14579,25.12%,11.44%
2020-01-01 00:03:10,8,7,5506,217,5289,8.40%,3.94%
2020-01-01 00:03:10,8,8,2096,33,2063,3.20%,1.57%
2020-01-01 00:03:10,8,9,6429,298,6131,9.81%,4.63%
2020-01-01 00:03:10,8,10,1764,20,1744,2.69%,1.13%
2020-01-01 00:03:10,8,11,273,0,273,0.42%,0.00%
2020-01-01 00:03:10,8,12,4609,156,4453,7.03%,3.38%
2020-01-01 00:03:10,9,1,854,0,854,1.30%,0.00%
2020-01-01 00:03:10,9,2,3030,62,2968,4.62%,2.05%
2020-01-01 00:03:10,9,3,1859,28,1831,2.84%,1.51%
2020-01-01 00:03:10,9,4,6177,365,5812,9.43%,5.91%
2020-01-01 00:03:10,9,5,313,1,312,0.48%,0.32%
2020-01-01 00:03:10,9,6,7168,485,6683,10.94%,6.77%
2020-01-01 00:03:10,9,7,30270,6187,24083,46.19%,20.44%
2020-01-01 00:03:10,9,8,12361,1146,11215,18.86%,9.27%
2020-01-01 00:03:10,9,9,242,0,242,0.37%,0.00%
2020-01-01 00:03:10,9,10,4082,150,3932,6.23%,3.67%
2020-01-01 00:03:10,9,11,11012,929,10083,16.80%,8.44%
2020-01-01 00:03:10,9,12,6678,348,6330,10.19%,5.21%
2020-01-01 00:03:10,10,1,1332,194,1138,2.03%,14.55%
2020-01-01 00:03:10,10,2,3128,229,2899,4.77%,7.32%
2020-01-01 00:03:10,10,3,1638,9,1629,2.50%,0.55%
2020-01-01 00:03:10,10,4,4068,799,3269,6.21%,19.64%
2020-01-01 00:03:10,10,5,540,0,540,0.82%,0.00%
2020-01-01 00:03:10,10,6,6182,954,5228,9.43%,15.43%
2020-01-01 00:03:10,10,7,11355,1736,9619,17.33%,15.29%
2020-01-01 00:03:10,10,8,30826,7719,23107,47.04%,25.04%
2020-01-01 00:03:10,10,9,1012,10,1002,1.54%,0.99%
2020-01-01 00:03:10,10,10,3421,79,3342,5.22%,2.31%
2020-01-01 00:03:10,10,11,15403,2121,13282,23.50%,13.77%
2020-01-01 00:03:10,10,12,11072,1345,9727,16.89%,12.15%
2020-01-01 00:03:10,11,1,2794,62,2732,4.26%,2.22%
2020-01-01 00:03:10,11,2,3869,118,3751,5.90%,3.05%
2020-01-01 00:03:10,11,3,871,7,864,1.33%,0.80%
2020-01-01 00:03:10,11,4,4911,213,4698,7.49%,4.34%
2020-01-01 00:03:10,11,5,170,0,170,0.26%,0.00%
2020-01-01 00:03:10,11,6,5716,270,5446,8.72%,4.72%
2020-01-01 00:03:10,11,7,11524,919,10605,17.58%,7.97%
2020-01-01 00:03:10,11,8,24633,4028,20605,37.59%,16.35%
2020-01-01 00:03:10,11,9,192,0,192,0.29%,0.00%
2020-01-01 00:03:10,11,10,2845,51,2794,4.34%,1.79%
2020-01-01 00:03:10,11,11,9563,718,8845,14.59%,7.51%
2020-01-01 00:03:10,11,12,6352,329,6023,9.69%,5.18%
2020-01-01 00:03:10,12,1,50,0,50,0.08%,0.00%
2020-01-01 00:03:10,12,2,574,221,353,0.88%,38.43%
2020-01-01 00:03:10,12,3,2591,286,2305,3.95%,11.03%
2020-01-01 00:03:10,12,4,2805,63,2742,4.28%,2.25%
2020-01-01 00:03:10,12,5,8861,796,8065,13.52%,8.98%
2020-01-01 00:03:10,12,6,5362,197,5165,8.18%,3.67%
2020-01-01 00:03:10,12,7,2412,23,2389,3.68%,0.95%
2020-01-01 00:03:10,12,8,1287,218,1069,1.96%,16.93%
2020-01-01 00:03:10,12,9,21455,4173,17282,32.74%,19.45%
2020-01-01 00:03:10,12,10,3722,314,3408,5.68%,8.43%
2020-01-01 00:03:10,12,11,1526,225,1301,2.33%,14.73%
2020-01-01 00:03:10,12,12,7769,1112,6657,11.85%,14.31%
2020-01-01 00:03:10,13,1,2237,38,2199,3.41%,1.70%
2020-01-01 00:03:10,13,2,2554,54,2500,3.90%,2.11%
2020-01-01 00:03:10,13,3,837,6,831,1.28%,0.72%
2020-01-01 00:03:10,13,4,4775,421,4354,7.29%,8.81%
2020-01-01 00:03:10,13,5,7048,680,6368,10.75%,9.65%
2020-01-01 00:03:10,13,6,5392,463,4929,8.23%,8.59%
2020-01-01 00:03:10,13,7,5093,209,4884,7.77%,4.10%
2020-01-01 00:03:10,13,8,7412,428,6984,11.31%,5.77%
2020-01-01 00:03:10,13,9,7394,708,6686,11.28%,9.57%
2020-01-01 00:03:10,13,10,26456,5236,21220,40.37%,19.79%
2020-01-01 00:03:10,13,11,16698,2325,14373,25.48%,13.92%
2020-01-01 00:03:10,13,12,8747,907,7840,13.35%,10.37%
2020-01-01 00:03:10,14,1,321,0,321,0.49%,0.00%
2020-01-01 00:03:10,14,2,1484,16,1468,2.26%,1.08%
2020-01-01 00:03:10,14,3,954,8,946,1.46%,0.84%
2020-01-01 00:03:10,14,4,5056,185,4871,7.71%,3.66%
2020-01-01 00:03:10,14,5,1654,22,1632,2.52%,1.33%
2020-01-01 00:03:10,14,6,5443,212,5231,8.31%,3.89%
2020-01-01 00:03:10,14,7,13314,1312,12002,20.32%,9.85%
2020-01-01 00:03:10,14,8,15169,1688,13481,23.15%,11.13%
2020-01-01 00:03:10,14,9,1861,29,1832,2.84%,1.56%
2020-01-01 00:03:10,14,10,4422,175,4247,6.75%,3.96%
2020-01-01 00:03:10,14,11,27898,5162,22736,42.57%,18.50%
2020-01-01 00:03:10,14,12,8108,467,7641,12.37%,5.76%
2020-01-01 00:03:10,15,1,542,2,540,0.83%,0.37%
2020-01-01 00:03:10,15,2,225,0,225,0.34%,0.00%
2020-01-01 00:03:10,15,3,3881,113,3768,5.92%,2.91%
2020-01-01 00:03:10,15,4,6935,359,6576,10.58%,5.18%
2020-01-01 00:03:10,15,5,12004,1033,10971,18.32%,8.60%
2020-01-01 00:03:10,15,6,7168,380,6788,10.94%,5.30%
2020-01-01 00:03:10,15,7,3829,109,3720,5.84%,2.85%
2020-01-01 00:03:10,15,8,5743,265,5478,8.76%,4.61%
2020-01-01 00:03:10,15,9,12260,1071,11189,18.71%,8.74%
2020-01-01 00:03:10,15,10,4765,170,4595,7.27%,3.57%
2020-01-01 00:03:10,15,11,10654,823,9831,16.26%,7.72%
2020-01-01 00:03:10,15,12,28992,5792,23200,44.24%,19.98%
2020-01-01 00:03:10,16,1,499,3,496,0.76%,0.60%
2020-01-01 00:03:10,16,2,263,0,263,0.40%,0.00%
2020-01-01 00:03:10,16,3,1145,10,1135,1.75%,0.87%
2020-01-01 00:03:10,16,4,5227,176,5051,7.98%,3.37%
2020-01-01 00:03:10,16,5,8451,529,7922,12.90%,6.26%
2020-01-01 00:03:10,16,6,6061,239,5822,9.25%,3.94%
2020-01-01 00:03:10,16,7,3447,102,3345,5.26%,2.96%
2020-01-01 00:03:10,16,8,8575,557,8018,13.08%,6.49%
2020-01-01 00:03:10,16,9,8825,566,8259,13.47%,6.41%
2020-01-01 00:03:10,16,10,1663,19,1644,2.54%,1.14%
2020-01-01 00:03:10,16,11,10399,814,9585,15.87%,7.83%
2020-01-01 00:03:10,16,12,26707,4803,21904,40.75%,17.98%
2020-01-01 00:03:20,1,1,20815,2981,17834,31.76%,14.32%
2020-01-01 00:03:20,1,2,7418,386,7032,11.32%,5.20%
2020-01-01 00:03:20,1,3,745,2,743,1.14%,0.27%
2020-01-01 00:03:20,1,4,13094,1272,11822,19.98%,9.71%
2020-01-01 00:03:20,1,5,12792,1222,11570,19.52%,9.55%
2020-01-01 00:03:20,1,6,12743,1218,11525,19.44%,9.56%
2020-01-01 00:03:20,1,7,6650,324,6326,10.15%,4.87%
2020-01-01 00:03:20,1,8,4770,181,4589,7.28%,3.79%
2020-01-01 00:03:20,1,9,12684,1207,11477,19.35%,9.52%
2020-01-01 00:03:20,1,10,3917,125,3792,5.98%,3.19%
2020-01-01 00:03:20,1,11,4001,134,3867,6.11%,3.35%
2020-01-01 00:03:20,1,12,12649,1199,11450,19.30%,9.48%
2020-01-01 00:03:20,2,1,884,2,882,1.35%,0.23%
2020-01-01 00:03:20,2,2,26230,4630,21600,40.02%,17.65%
2020-01-01 00:03:20,2,3,21051,3086,17965,32.12%,14.66%
2020-01-01 00:03:20,2,4,752,1,751,1.15%,0.13%
2020-01-01 00:03:20,2,5,11973,1010,10963,18.27%,8.43%
2020-01-01 00:03:20,2,6,27,0,27,0.04%,0.00%
2020-01-01 00:03:20,2,7,4278,127,4151,6.53%,2.97%
2020-01-01 00:03:20,2,8,3251,80,3171,4.96%,2.46%
2020-01-01 00:03:20,2,9,11914,1003,10911,18.18%,8.42%
2020-01-01 00:03:20,2,10,2494,45,2449,3.81%,1.80%
2020-01-01 00:03:20,2,11,2503,45,2458,3.82%,1.80%
2020-01-01 00:03:20,2,12,11729,984,10745,17.90%,8.39%
2020-01-01 00:03:20,3,1,1525,16,1509,2.33%,1.05%
2020-01-01 00:03:20,3,2,23895,3882,20013,36.46%,16.25%
2020-01-01 00:03:20,3,3,68937,26195,42742,105.19%,38.00%
2020-01-01 00:03:20,3,4,6057,248,5809,9.24%,4.09%
2020-01-01 00:03:20,3,5,43680,11609,32071,66.65%,26.58%
2020-01-01 00:03:20,3,6,7472,399,7073,11.40%,5.34%
2020-01-01 00:03:20,3,7,20309,2851,17458,30.99%,14.04%
2020-01-01 00:03:20,3,8,15311,1605,13706,23.36%,10.48%
2020-01-01 00:03:20,3,9,35876,8046,27830,54.74%,22.43%
2020-01-01 00:03:20,3,10,9649,679,8970,14.72%,7.04%
2020-01-01 00:03:20,3,11,1639,17,1622,2.50%,1.04%
2020-01-01 00:03:20,3,12,22791,3472,19319,34.78%,15.23%
2020-01-01 00:03:20,4,1,530,3,527,0.81%,0.56%
2020-01-01 00:03:20,4,2,330,2,328,0.50%,0.60%
2020-01-01 00:03:20,4,3,950,4,946,1.45%,0.42%
2020-01-01 00:03:20,4,4,29903,5941,23962,45.63%,19.87%
2020-01-01 00:03:20,4,5,18424,2370,16054,28.11%,12.86%
2020-01-01 00:03:20,4,6,25858,4519,21339,39.46%,17.48%
2020-01-01 00:03:20,4,7,5791,242,5549,8.84%,4.18%
2020-01-01 00:03:20,4,8,2972,56,2916,4.53%,1.88%
2020-01-01 00:03:20,4,9,16127,1842,14285,24.61%,11.42%
2020-01-01 00:03:20,4,10,2192,31,2161,3.34%,1.41%
2020-01-01 00:03:20,4,11,192,1,191,0.29%,0.52%
2020-01-01 00:03:20,4,12,13173,1283,11890,20.10%,9.74%
2020-01-01 00:03:20,5,1,2858,51,2807,4.36%,1.78%
2020-01-01 00:03:20,5,2,864,4,860,1.32%,0.46%
2020-01-01 00:03:20,5,3,711,1,710,1.08%,0.14%
2020-01-01 00:03:20,5,4,24454,4026,20428,37.31%,16.46%
2020-01-01 00:03:20,5,5,9254,615,8639,14.12%,6.65%
2020-01-01 00:03:20,5,6,15287,1639,13648,23.33%,10.72%
2020-01-01 00:03:20,5,7,5467,238,5229,8.34%,4.35%
2020-01-01 00:03:20,5,8,4179,153,4026,6.38%,3.66%
2020-01-01 00:03:20,5,9,8377,508,7869,12.78%,6.06%
2020-01-01 00:03:20,5,10,817,7,810,1.25%,0.86%
2020-01-01 00:03:20,5,11,794,8,786,1.21%,1.01%
2020-01-01 00:03:20,5,12,6970,350,6620,10.64%,5.02%
2020-01-01 00:03:20,6,1,1026,6,1020,1.57%,0.58%
2020-01-01 00:03:20,6,2,1169,6,1163,1.78%,0.51%
2020-01-01 00:03:20,6,3,1917,30,1887,2.93%,1.56%
2020-01-01 00:03:20,6,4,1440,30,1410,2.20%,2.08%
2020-01-01 00:03:20,6,5,15471,1747,13724,23.61%,11.29%
2020-01-01 00:03:20,6,6,4336,156,4180,6.62%,3.60%
2020-01-01 00:03:20,6,7,2350,41,2309,3.59%,1.74%
2020-01-01 00:03:20,6,8,1750,27,1723,2.67%,1.54%
2020-01-01 00:03:20,6,9,8804,585,8219,13.43%,6.64%
2020-01-01 00:03:20,6,10,1929,30,1899,2.94%,1.55%
2020-01-01 00:03:20,6,11,435,1,434,0.66%,0.23%
2020-01-01 00:03:20,6,12,6812,344,6468,10.39%,5.05%
2020-01-01 00:03:20,7,1,400,1,399,0.61%,0.25%
2020-01-01 00:03:20,7,2,186,0,186,0.28%,0.00%
2020-01-01 00:03:20,7,3,766,7,759,1.17%,0.91%
2020-01-01 00:03:20,7,4,1405,17,1388,2.14%,1.21%
2020-01-01 00:03:20,7,5,7031,364,6667,10.73%,5.18%
2020-01-01 00:03:20,7,6,12533,1134,11399,19.12%,9.05%
2020-01-01 00:03:20,7,7,3964,133,3831,6.05%,3.35%
2020-01-01 00:03:20,7,8,1660,23,1637,2.53%,1.38%
2020-01-01 00:03:20,7,9,6125,272,5853,9.35%,4.44%
2020-01-01 00:03:20,7,10,1126,10,1116,1.72%,0.89%
2020-01-01 00:03:20,7,11,114,0,114,0.17%,0.00%
2020-01-01 00:03:20,7,12,4961,192,4769,7.57%,3.87%
2020-01-01 00:03:20,8,1,410,2,408,0.63%,0.49%
2020-01-01 00:03:20,8,2,98,0,98,0.15%,0.00%
2020-01-01 00:03:20,8,3,1455,10,1445,2.22%,0.69%
2020-01-01 00:03:20,8,4,2536,56,2480,3.87%,2.21%
2020-01-01 00:03:20,8,5,8314,499,7815,12.69%,6.00%
2020-01-01 00:03:20,8,6,16727,1980,14747,25.52%,11.84%
2020-01-01 00:03:20,8,7,5783,275,5508,8.82%,4.75%
2020-01-01 00:03:20,8,8,2028,42,1986,3.09%,2.07%
2020-01-01 00:03:20,8,9,6568,332,6236,10.02%,5.05%
2020-01-01 00:03:20,8,10,1747,29,1718,2.67%,1.66%
2020-01-01 00:03:20,8,11,202,0,202,0.31%,0.00%
2020-01-01 00:03:20,8,12,4735,180,4555,7.23%,3.80%
2020-01-01 00:03:20,9,1,1923,74,1849,2.93%,3.85%
2020-01-01 00:03:20,9,2,3631,131,3500,5.54%,3.61%
2020-01-01 00:03:20,9,3,1304,7,1297,1.99%,0.54%
2020-01-01 00:03:20,9,4,4168,119,4049,6.36%,2.85%
2020-01-01 00:03:20,9,5,455,0,455,0.69%,0.00%
2020-01-01 00:03:20,9,6,5237,191,5046,7.99%,3.65%
2020-01-01 00:03:20,9,7,25899,4402,21497,39.52%,17.00%
2020-01-01 00:03:20,9,8,9809,656,9153,14.97%,6.69%
2020-01-01 00:03:20,9,9,332,0,332,0.51%,0.00%
2020-01-01 00:03:20,9,10,2313,40,2273,3.53%,1.73%
2020-01-01 00:03:20,9,11,8501,484,8017,12.97%,5.69%
2020-01-01 00:03:20,9,12,5806,237,5569,8.86%,4.08%
2020-01-01 00:03:20,10,1,1431,282,1149,2.18%,19.69%
2020-01-01 00:03:20,10,2,3058,341,2717,4.67%,11.15%
2020-01-01 00:03:20,10,3,1430,12,1418,2.18%,0.84%
2020-01-01 00:03:20,10,4,4781,935,3846,7.30%,19.55%
2020-01-01 00:03:20,10,5,727,20,707,1.11%,2.75%
2020-01-01 00:03:20,10,6,6819,1085,5734,10.40%,15.91%
2020-01-01 00:03:20,10,7,12258,2037,10221,18.70%,16.62%
2020-01-01 00:03:20,10,8,30204,7683,22521,46.09%,25.44%
2020-01-01 00:03:20,10,9,856,12,844,1.31%,1.40%
2020-01-01 00:03:20,10,10,2440,50,2390,3.72%,2.05%
2020-01-01 00:03:20,10,11,13573,1833,11740,20.71%,13.50%
2020-01-01 00:03:20,10,12,10511,1367,9144,16.04%,13.00%
2020-01-01 00:03:20,11,1,2361,35,2326,3.60%,1.48%
2020-01-01 00:03:20,11,2,3612,98,3514,5.51%,2.71%
2020-01-01 00:03:20,11,3,1066,12,1054,1.63%,1.12%
2020-01-01 00:03:20,11,4,8413,515,7898,12.84%,6.12%
2020-01-01 00:03:20,11,5,191,2,189,0.29%,1.04%
2020-01-01 00:03:20,11,6,9274,618,8656,14.15%,6.66%
2020-01-01 00:03:20,11,7,14760,1555,13205,22.52%,10.53%
2020-01-01 00:03:20,11,8,29863,5888,23975,45.57%,19.72%
2020-01-01 00:03:20,11,9,148,0,148,0.23%,0.00%
2020-01-01 00:03:20,11,10,4289,129,4160,6.54%,3.01%
2020-01-01 00:03:20,11,11,11439,935,10504,17.45%,8.17%
2020-01-01 00:03:20,11,12,6867,374,6493,10.48%,5.45%
2020-01-01 00:03:20,12,1,45,0,45,0.07%,0.00%
2020-01-01 00:03:20,12,2,615,205,410,0.94%,33.28%
2020-01-01 00:03:20,12,3,2803,270,2533,4.28%,9.63%
2020-01-01 00:03:20,12,4,2988,58,2930,4.56%,1.94%
2020-01-01 00:03:20,12,5,8739,705,8034,13.33%,8.07%
2020-01-01 00:03:20,12,6,5106,170,4936,7.79%,3.33%
2020-01-01 00:03:20,12,7,1973,26,1947,3.01%,1.32%
2020-01-01 00:03:20,12,8,1291,261,1030,1.97%,20.20%
2020-01-01 00:03:20,12,9,21187,4006,17181,32.33%,18.91%
2020-01-01 00:03:20,12,10,3975,356,3619,6.07%,8.95%
2020-01-01 00:03:20,12,11,1717,265,1452,2.62%,15.42%
2020-01-01 00:03:20,12,12,7261,1059,6202,11.08%,14.58%
2020-01-01 00:03:20,13,1,2780,49,2731,4.24%,1.76%
2020-01-01 00:03:20,13,2,3136,62,3074,4.79%,1.98%
2020-01-01 00:03:20,13,3,580,0,580,0.89%,0.00%
2020-01-01 00:03:20,13,4,5108,501,4607,7.79%,9.81%
2020-01-01 00:03:20,13,5,7565,798,6767,11.54%,10.55%
2020-01-01 00:03:20,13,6,5807,548,5259,8.86%,9.44%
2020-01-01 00:03:20,13,7,5737,237,5500,8.75%,4.13%
2020-01-01 00:03:20,13,8,7881,456,7425,12.03%,5.79%
2020-01-01 00:03:20,13,9,7862,828,7034,12.00%,10.53%
2020-01-01 00:03:20,13,10,27011,5408,21603,41.22%,20.02%
2020-01-01 00:03:20,13,11,16785,2331,14454,25.61%,13.89%
2020-01-01 00:03:20,13,12,8387,856,7531,12.80%,10.21%
2020-01-01 00:03:20,14,1,420,1,419,0.64%,0.24%
2020-01-01 00:03:20,14,2,1681,20,1661,2.57%,1.19%
2020-01-01 00:03:20,14,3,1070,7,1063,1.63%,0.65%
2020-01-01 00:03:20,14,4,4770,195,4575,7.28%,4.09%
2020-01-01 00:03:20,14,5,1542,17,1525,2.35%,1.10%
2020-01-01 00:03:20,14,6,5233,233,5000,7.98%,4.45%
2020-01-01 00:03:20,14,7,13084,1220,11864,19.96%,9.32%
2020-01-01 00:03:20,14,8,14702,1525,13177,22.43%,10.37%
2020-01-01 00:03:20,14,9,1779,27,1752,2.71%,1.52%
2020-01-01 00:03:20,14,10,4753,162,4591,7.25%,3.41%
2020-01-01 00:03:20,14,11,27793,5016,22777,42.41%,18.05%
2020-01-01 00:03:20,14,12,8063,438,7625,12.30%,5.43%
2020-01-01 00:03:20,15,1,552,1,551,0.84%,0.18%
2020-01-01 00:03:20,15,2,201,1,200,0.31%,0.50%
2020-01-01 00:03:20,15,3,3871,101,3770,5.91%,2.61%
2020-01-01 00:03:20,15,4,5275,239,5036,8.05%,4.53%
2020-01-01 00:03:20,15,5,10180,775,9405,15.53%,7.61%
2020-01-01 00:03:20,15,6,5600,283,5317,8.54%,5.05%
2020-01-01 00:03:20,15,7,3524,94,3430,5.38%,2.67%
2020-01-01 00:03:20,15,8,6224,297,5927,9.50%,4.77%
2020-01-01 00:03:20,15,9,10506,813,9693,16.03%,7.74%
2020-01-01 00:03:20,15,10,4153,156,3997,6.34%,3.76%
2020-01-01 00:03:20,15,11,10517,849,9668,16.05%,8.07%
2020-01-01 00:03:20,15,12,26859,5174,21685,40.98%,19.26%
2020-01-01 00:03:20,16,1,599,6,593,0.91%,1.00%
2020-01-01 00:03:20,16,2,222,0,222,0.34%,0.00%
2020-01-01 00:03:20,16,3,934,8,926,1.43%,0.86%
2020-01-01 00:03:20,16,4,4412,167,4245,6.73%,3.78%
2020-01-01 00:03:20,16,5,7499,511,6988,11.44%,6.81%
2020-01-01 00:03:20,16,6,5287,238,5049,8.07%,4.50%
2020-01-01 00:03:20,16,7,3603,89,3514,5.50%,2.47%
2020-01-01 00:03:20,16,8,8000,540,7460,12.21%,6.75%
2020-01-01 00:03:20,16,9,7939,559,7380,12.11%,7.04%
2020-01-01 00:03:20,16,10,1813,21,1792,2.77%,1.16%
2020-01-01 00:03:20,16,11,9996,782,9214,15.25%,7.82%
2020-01-01 00:03:20,16,12,26115,4872,21243,39.85%,18.66%
2020-01-01 00:03:30,1,1,18734,2533,16201,28.59%,13.52%
2020-01-01 00:03:30,1,2,6376,305,6071,9.73%,4.78%
2020-01-01 00:03:30,1,3,431,1,430,0.66%,0.23%
2020-01-01 00:03:30,1,4,11988,1066,10922,18.29%,8.89%
2020-01-01 00:03:30,1,5,11718,1027,10691,17.88%,8.76%
2020-01-01 00:03:30,1,6,11631,1012,10619,17.75%,8.70%
2020-01-01 00:03:30,1,7,5934,269,5665,9.05%,4.53%
2020-01-01 00:03:30,1,8,4809,179,4630,7.34%,3.72%
2020-01-01 00:03:30,1,9,11611,1010,10601,17.72%,8.70%
2020-01-01 00:03:30,1,10,4110,133,3977,6.27%,3.24%
2020-01-01 00:03:30,1,11,4206,139,4067,6.42%,3.30%
2020-01-01 00:03:30,1,12,11582,1006,10576,17.67%,8.69%
2020-01-01 00:03:30,2,1,1213,16,1197,1.85%,1.32%
2020-01-01 00:03:30,2,2,26612,4809,21803,40.61%,18.07%
2020-01-01 00:03:30,2,3,20684,3022,17662,31.56%,14.61%
2020-01-01 00:03:30,2,4,1103,14,1089,1.68%,1.27%
2020-01-01 00:03:30,2,5,12160,1110,11050,18.55%,9.13%
2020-01-01 00:03:30,2,6,42,0,42,0.06%,0.00%
2020-01-01 00:03:30,2,7,4692,160,4532,7.16%,3.41%
2020-01-01 00:03:30,2,8,3407,85,3322,5.20%,2.49%
2020-01-01 00:03:30,2,9,12112,1098,11014,18.48%,9.06%
2020-01-01 00:03:30,2,10,2784,48,2736,4.25%,1.72%
2020-01-01 00:03:30,2,11,2797,48,2749,4.27%,1.72%
2020-01-01 00:03:30,2,12,11964,1075,10889,18.26%,8.98%
2020-01-01 00:03:30,3,1,1690,24,1666,2.58%,1.42%
2020-01-01 00:03:30,3,2,22176,3376,18800,33.84%,15.22%
2020-01-01 00:03:30,3,3,81173,34530,46643,123.86%,42.54%
2020-01-01 00:03:30,3,4,11326,846,10480,17.28%,7.47%
2020-01-01 00:03:30,3,5,57112,18974,38138,87.15%,33.22%
2020-01-01 00:03:30,3,6,12211,984,11227,18.63%,8.06%
2020-01-01 00:03:30,3,7,18648,2437,16211,28.45%,13.07%
2020-01-01 00:03:30,3,8,15388,1692,13696,23.48%,10.99%
2020-01-01 00:03:30,3,9,44585,12224,32361,68.03%,27.42%
2020-01-01 00:03:30,3,10,13895,1457,12438,21.20%,10.49%
2020-01-01 00:03:30,3,11,1695,19,1676,2.59%,1.12%
2020-01-01 00:03:30,3,12,26224,4528,21696,40.01%,17.27%
2020-01-01 00:03:30,4,1,568,1,567,0.87%,0.18%
2020-01-01 00:03:30,4,2,389,0,389,0.59%,0.00%
2020-01-01 00:03:30,4,3,923,6,917,1.41%,0.65%
2020-01-01 00:03:30,4,4,27886,5153,22733,42.55%,18.48%
2020-01-01 00:03:30,4,5,17031,2065,14966,25.99%,12.12%
2020-01-01 00:03:30,4,6,23481,3732,19749,35.83%,15.89%
2020-01-01 00:03:30,4,7,5063,191,4872,7.73%,3.77%
2020-01-01 00:03:30,4,8,2792,61,2731,4.26%,2.18%
2020-01-01 00:03:30,4,9,14874,1573,13301,22.70%,10.57%
2020-01-01 00:03:30,4,10,1939,37,1902,2.96%,1.91%
2020-01-01 00:03:30,4,11,231,0,231,0.35%,0.00%
2020-01-01 00:03:30,4,12,12153,1083,11070,18.54%,8.91%
2020-01-01 00:03:30,5,1,2765,65,2700,4.22%,2.35%
2020-01-01 00:03:30,5,2,1143,6,1137,1.74%,0.52%
2020-01-01 00:03:30,5,3,1072,9,1063,1.64%,0.84%
2020-01-01 00:03:30,5,4,24011,3931,20080,36.64%,16.37%
2020-01-01 00:03:30,5,5,10153,729,9424,15.49%,7.18%
2020-01-01 00:03:30,5,6,16930,1963,14967,25.83%,11.59%
2020-01-01 00:03:30,5,7,6419,315,6104,9.79%,4.91%
2020-01-01 00:03:30,5,8,3271,92,3179,4.99%,2.81%
2020-01-01 00:03:30,5,9,8934,550,8384,13.63%,6.16%
2020-01-01 00:03:30,5,10,1108,6,1102,1.69%,0.54%
2020-01-01 00:03:30,5,11,381,0,381,0.58%,0.00%
2020-01-01 00:03:30,5,12,7719,413,7306,11.78%,5.35%
2020-01-01 00:03:30,6,1,1033,9,1024,1.58%,0.87%
2020-01-01 00:03:30,6,2,1170,13,1157,1.79%,1.11%
2020-01-01 00:03:30,6,3,1706,21,1685,2.60%,1.23%
2020-01-01 00:03:30,6,4,902,6,896,1.38%,0.66%
2020-01-01 00:03:30,6,5,11999,1100,10899,18.31%,9.17%
2020-01-01 00:03:30,6,6,4133,146,3987,6.31%,3.53%
2020-01-01 00:03:30,6,7,2811,75,2736,4.29%,2.67%
2020-01-01 00:03:30,6,8,2013,56,1957,3.07%,2.78%
2020-01-01 00:03:30,6,9,5920,284,5636,9.03%,4.80%
2020-01-01 00:03:30,6,10,1677,23,1654,2.56%,1.37%
2020-01-01 00:03:30,6,11,329,1,328,0.50%,0.30%
2020-01-01 00:03:30,6,12,4201,155,4046,6.41%,3.69%
2020-01-01 00:03:30,7,1,480,10,470,0.73%,2.08%
2020-01-01 00:03:30,7,2,180,0,180,0.27%,0.00%
2020-01-01 00:03:30,7,3,916,2,914,1.40%,0.22%
2020-01-01 00:03:30,7,4,2271,47,2224,3.47%,2.07%
2020-01-01 00:03:30,7,5,7712,403,7309,11.77%,5.22%
2020-01-01 00:03:30,7,6,13431,1317,12114,20.49%,9.80%
2020-01-01 00:03:30,7,7,3302,112,3190,5.04%,3.39%
2020-01-01 00:03:30,7,8,1610,18,1592,2.46%,1.12%
2020-01-01 00:03:30,7,9,6516,306,6210,9.94%,4.70%
2020-01-01 00:03:30,7,10,1407,21,1386,2.15%,1.49%
2020-01-01 00:03:30,7,11,82,0,82,0.13%,0.00%
2020-01-01 00:03:30,7,12,5052,194,4858,7.71%,3.84%
2020-01-01 00:03:30,8,1,406,0,406,0.62%,0.00%
2020-01-01 00:03:30,8,2,95,0,95,0.14%,0.00%
2020-01-01 00:03:30,8,3,1728,21,1707,2.64%,1.21%
2020-01-01 00:03:30,8,4,2917,53,2864,4.45%,1.82%
2020-01-01 00:03:30,8,5,8634,533,8101,13.17%,6.17%
2020-01-01 00:03:30,8,6,16690,1996,14694,25.47%,11.96%
2020-01-01 00:03:30,8,7,4935,189,4746,7.53%,3.83%
2020-01-01 00:03:30,8,8,2097,35,2062,3.20%,1.67%
2020-01-01 00:03:30,8,9,6676,300,6376,10.19%,4.49%
2020-01-01 00:03:30,8,10,1676,14,1662,2.56%,0.83%
2020-01-01 00:03:30,8,11,161,0,161,0.25%,0.00%
2020-01-01 00:03:30,8,12,4914,158,4756,7.50%,3.21%
2020-01-01 00:03:30,9,1,323,0,323,0.49%,0.00%
2020-01-01 00:03:30,9,2,2390,42,2348,3.65%,1.76%
2020-01-01 00:03:30,9,3,1680,23,1657,2.56%,1.37%
2020-01-01 00:03:30,9,4,7077,360,6717,10.80%,5.09%
2020-01-01 00:03:30,9,5,502,1,501,0.77%,0.20%
2020-01-01 00:03:30,9,6,8275,497,7778,12.63%,6.01%
2020-01-01 00:03:30,9,7,25335,4352,20983,38.66%,17.18%
2020-01-01 00:03:30,9,8,8216,494,7722,12.54%,6.01%
2020-01-01 00:03:30,9,9,332,0,332,0.51%,0.00%
2020-01-01 00:03:30,9,10,2187,25,2162,3.34%,1.14%
2020-01-01 00:03:30,9,11,7028,377,6651,10.72%,5.36%
2020-01-01 00:03:30,9,12,4642,172,4470,7.08%,3.70%
2020-01-01 00:03:30,10,1,1203,328,875,1.84%,27.24%
2020-01-01 00:03:30,10,2,3606,400,3206,5.50%,11.09%
2020-01-01 00:03:30,10,3,2269,36,2233,3.46%,1.59%
2020-01-01 00:03:30,10,4,4620,1063,3557,7.05%,23.00%
2020-01-01 00:03:30,10,5,978,70,908,1.49%,7.15%
2020-01-01 00:03:30,10,6,6474,1245,5229,9.88%,19.23%
2020-01-01 00:03:30,10,7,12213,2226,9987,18.64%,18.22%
2020-01-01 00:03:30,10,8,29977,7846,22131,45.74%,26.17%
2020-01-01 00:03:30,10,9,828,6,822,1.26%,0.72%
2020-01-01 00:03:30,10,10,2470,60,2410,3.77%,2.43%
2020-01-01 00:03:30,10,11,13696,1871,11825,20.90%,13.66%
2020-01-01 00:03:30,10,12,10562,1403,9159,16.12%,13.28%
2020-01-01 00:03:30,11,1,2230,44,2186,3.40%,1.97%
2020-01-01 00:03:30,11,2,3030,73,2957,4.62%,2.41%
2020-01-01 00:03:30,11,3,599,5,594,0.91%,0.83%
2020-01-01 00:03:30,11,4,3441,77,3364,5.25%,2.24%
2020-01-01 00:03:30,11,5,199,1,198,0.30%,0.50%
2020-01-01 00:03:30,11,6,4318,138,4180,6.59%,3.20%
2020-01-01 00:03:30,11,7,9178,607,8571,14.00%,6.61%
2020-01-01 00:03:30,11,8,23196,3630,19566,35.39%,15.65%
2020-01-01 00:03:30,11,9,210,1,209,0.32%,0.47%
2020-01-01 00:03:30,11,10,2878,48,2830,4.39%,1.67%
2020-01-01 00:03:30,11,11,9902,711,9191,15.11%,7.18%
2020-01-01 00:03:30,11,12,6661,349,6312,10.16%,5.24%
2020-01-01 00:03:30,12,1,48,0,48,0.07%,0.00%
2020-01-01 00:03:30,12,2,529,161,368,0.81%,30.38%
2020-01-01 00:03:30,12,3,3056,211,2845,4.66%,6.90%
2020-01-01 00:03:30,12,4,2998,76,2922,4.57%,2.53%
2020-01-01 00:03:30,12,5,8691,664,8027,13.26%,7.64%
2020-01-01 00:03:30,12,6,4881,175,4706,7.45%,3.58%
2020-01-01 00:03:30,12,7,1676,13,1663,2.56%,0.78%
2020-01-01 00:03:30,12,8,1282,263,1019,1.96%,20.50%
2020-01-01 00:03:30,12,9,21822,4011,17811,33.30%,18.38%
2020-01-01 00:03:30,12,10,4447,395,4052,6.79%,8.88%
2020-01-01 00:03:30,12,11,1511,270,1241,2.31%,17.86%
2020-01-01 00:03:30,12,12,7309,951,6358,11.15%,13.01%
2020-01-01 00:03:30,13,1,1790,32,1758,2.73%,1.79%
2020-01-01 00:03:30,13,2,2102,43,2059,3.21%,2.04%
2020-01-01 00:03:30,13,3,468,2,466,0.71%,0.43%
2020-01-01 00:03:30,13,4,4124,605,3519,6.29%,14.67%
2020-01-01 00:03:30,13,5,6101,797,5304,9.31%,13.06%
2020-01-01 00:03:30,13,6,4784,642,4142,7.30%,13.42%
2020-01-01 00:03:30,13,7,4465,151,4314,6.81%,3.38%
2020-01-01 00:03:30,13,8,7273,376,6897,11.10%,5.17%
2020-01-01 00:03:30,13,9,6420,818,5602,9.80%,12.74%
2020-01-01 00:03:30,13,10,26264,5308,20956,40.08%,20.21%
2020-01-01 00:03:30,13,11,17427,2487,14940,26.59%,14.27%
2020-01-01 00:03:30,13,12,9681,1060,8621,14.77%,10.95%
2020-01-01 00:03:30,14,1,282,0,282,0.43%,0.00%
2020-01-01 00:03:30,14,2,1126,15,1111,1.72%,1.33%
2020-01-01 00:03:30,14,3,628,10,618,0.96%,1.59%
2020-01-01 00:03:30,14,4,3686,102,3584,5.62%,2.77%
2020-01-01 00:03:30,14,5,1474,15,1459,2.25%,1.02%
2020-01-01 00:03:30,14,6,3946,118,3828,6.02%,2.99%
2020-01-01 00:03:30,14,7,11091,893,10198,16.92%,8.05%
2020-01-01 00:03:30,14,8,12574,1152,11422,19.19%,9.16%
2020-01-01 00:03:30,14,9,1875,30,1845,2.86%,1.60%
2020-01-01 00:03:30,14,10,4255,128,4127,6.49%,3.01%
2020-01-01 00:03:30,14,11,25191,4313,20878,38.44%,17.12%
2020-01-01 00:03:30,14,12,8030,448,7582,12.25%,5.58%
2020-01-01 00:03:30,15,1,557,3,554,0.85%,0.54%
2020-01-01 00:03:30,15,2,168,0,168,0.26%,0.00%
2020-01-01 00:03:30,15,3,6869,355,6514,10.48%,5.17%
2020-01-01 00:03:30,15,4,5601,268,5333,8.55%,4.78%
2020-01-01 00:03:30,15,5,13877,1389,12488,21.17%,10.01%
2020-01-01 00:03:30,15,6,5892,321,5571,8.99%,5.45%
2020-01-01 00:03:30,15,7,3404,86,3318,5.19%,2.53%
2020-01-01 00:03:30,15,8,5571,230,5341,8.50%,4.13%
2020-01-01 00:03:30,15,9,14038,1422,12616,21.42%,10.13%
2020-01-01 00:03:30,15,10,4649,254,4395,7.09%,5.46%
2020-01-01 00:03:30,15,11,10384,848,9536,15.84%,8.17%
2020-01-01 00:03:30,15,12,32246,7121,25125,49.20%,22.08%
2020-01-01 00:03:30,16,1,435,1,434,0.66%,0.23%
2020-01-01 00:03:30,16,2,283,0,283,0.43%,0.00%
2020-01-01 00:03:30,16,3,1353,13,1340,2.06%,0.96%
2020-01-01 00:03:30,16,4,4645,198,4447,7.09%,4.26%
2020-01-01 00:03:30,16,5,8186,557,7629,12.49%,6.80%
2020-01-01 00:03:30,16,6,5406,249,5157,8.25%,4.61%
2020-01-01 00:03:30,16,7,3541,78,3463,5.40%,2.20%
2020-01-01 00:03:30,16,8,7498,445,7053,11.44%,5.93%
2020-01-01 00:03:30,16,9,8555,590,7965,13.05%,6.90%
2020-01-01 00:03:30,16,10,1814,32,1782,2.77%,1.76%
2020-01-01 00:03:30,16,11,9502,702,8800,14.50%,7.39%
2020-01-01 00:03:30,16,12,25434,4426,21008,38.81%,17.40%
2020-01-01 00:03:40,1,1,18681,2435,16246,28.50%,13.03%
2020-01-01 00:03:40,1,2,6597,331,6266,10.07%,5.02%
2020-01-01 00:03:40,1,3,732,3,729,1.12%,0.41%
2020-01-01 00:03:40,1,4,11596,1011,10585,17.69%,8.72%
2020-01-01 00:03:40,1,5,11336,968,10368,17.30%,8.54%
2020-01-01 00:03:40,1,6,11281,955,10326,17.21%,8.46%
2020-01-01 00:03:40,1,7,5849,256,5593,8.92%,4.38%
2020-01-01 00:03:40,1,8,4337,140,4197,6.62%,3.23%
2020-01-01 00:03:40,1,9,11224,944,10280,17.13%,8.41%
2020-01-01 00:03:40,1,10,3774,107,3667,5.76%,2.83%
2020-01-01 00:03:40,1,11,3913,114,3799,5.97%,2.91%
2020-01-01 00:03:40,1,12,11209,943,10266,17.10%,8.41%
2020-01-01 00:03:40,2,1,2914,67,2847,4.45%,2.30%
2020-01-01 00:03:40,2,2,28564,5554,23010,43.59%,19.44%
2020-01-01 00:03:40,2,3,18734,2506,16228,28.59%,13.38%
2020-01-01 00:03:40,2,4,2840,64,2776,4.33%,2.25%
2020-01-01 00:03:40,2,5,11031,955,10076,16.83%,8.66%
2020-01-01 00:03:40,2,6,61,0,61,0.09%,0.00%
2020-01-01 00:03:40,2,7,6878,369,6509,10.49%,5.36%
2020-01-01 00:03:40,2,8,5539,238,5301,8.45%,4.30%
2020-01-01 00:03:40,2,9,10979,949,10030,16.75%,8.64%
2020-01-01 00:03:40,2,10,4481,161,4320,6.84%,3.59%
2020-01-01 00:03:40,2,11,4503,163,4340,6.87%,3.62%
2020-01-01 00:03:40,2,12,10801,921,9880,16.48%,8.53%
2020-01-01 00:03:40,3,1,1966,27,1939,3.00%,1.37%
2020-01-01 00:03:40,3,2,28003,5198,22805,42.73%,18.56%
2020-01-01 00:03:40,3,3,74046,29776,44270,112.99%,40.21%
2020-01-01 00:03:40,3,4,6637,323,6314,10.13%,4.87%
2020-01-01 00:03:40,3,5,44189,12158,32031,67.43%,27.51%
2020-01-01 00:03:40,3,6,7459,406,7053,11.38%,5.44%
2020-01-01 00:03:40,3,7,24282,3946,20336,37.05%,16.25%
2020-01-01 00:03:40,3,8,16988,2007,14981,25.92%,11.81%
2020-01-01 00:03:40,3,9,36178,8524,27654,55.20%,23.56%
2020-01-01 00:03:40,3,10,5571,226,5345,8.50%,4.06%
2020-01-01 00:03:40,3,11,1731,18,1713,2.64%,1.04%
2020-01-01 00:03:40,3,12,26134,4652,21482,39.88%,17.80%
2020-01-01 00:03:40,4,1,536,4,532,0.82%,0.74%
2020-01-01 00:03:40,4,2,319,1,318,0.49%,0.31%
2020-01-01 00:03:40,4,3,636,29,607,0.97%,4.55%
2020-01-01 00:03:40,4,4,27881,5201,22680,42.54%,18.65%
2020-01-01 00:03:40,4,5,17690,2256,15434,26.99%,12.75%
2020-01-01 00:03:40,4,6,24147,4039,20108,36.85%,16.73%
2020-01-01 00:03:40,4,7,5047,189,4858,7.70%,3.74%
2020-01-01 00:03:40,4,8,2805,48,2757,4.28%,1.71%
2020-01-01 00:03:40,4,9,15776,1784,13992,24.07%,11.31%
2020-01-01 00:03:40,4,10,1983,23,1960,3.03%,1.16%
2020-01-01 00:03:40,4,11,217,0,217,0.33%,0.00%
2020-01-01 00:03:40,4,12,12385,1130,11255,18.90%,9.12%
2020-01-01 00:03:40,5,1,2751,63,2688,4.20%,2.29%
2020-01-01 00:03:40,5,2,713,5,708,1.09%,0.70%
2020-01-01 00:03:40,5,3,1095,13,1082,1.67%,1.19%
2020-01-01 00:03:40,5,4,25682,4469,21213,39.19%,17.40%
2020-01-01 00:03:40,5,5,11198,979,10219,17.09%,8.74%
2020-01-01 00:03:40,5,6,16143,1907,14236,24.63%,11.81%
2020-01-01 00:03:40,5,7,4567,186,4381,6.97%,4.07%
2020-01-01 00:03:40,5,8,3354,96,3258,5.12%,2.86%
2020-01-01 00:03:40,5,9,9939,787,9152,15.17%,7.92%
2020-01-01 00:03:40,5,10,1338,15,1323,2.04%,1.12%
2020-01-01 00:03:40,5,11,443,2,441,0.68%,0.45%
2020-01-01 00:03:40,5,12,8383,557,7826,12.79%,6.64%
2020-01-01 00:03:40,6,1,1207,11,1196,1.84%,0.91%
2020-01-01 00:03:40,6,2,1260,11,1249,1.92%,0.87%
2020-01-01 00:03:40,6,3,1778,24,1754,2.71%,1.35%
2020-01-01 00:03:40,6,4,1200,24,1176,1.83%,2.00%
2020-01-01 00:03:40,6,5,13269,1247,12022,20.25%,9.40%
2020-01-01 00:03:40,6,6,4939,203,4736,7.54%,4.11%
2020-01-01 00:03:40,6,7,3167,94,3073,4.83%,2.97%
2020-01-01 00:03:40,6,8,2331,54,2277,3.56%,2.32%
2020-01-01 00:03:40,6,9,6315,287,6028,9.64%,4.54%
2020-01-01 00:03:40,6,10,1780,22,1758,2.72%,1.24%
2020-01-01 00:03:40,6,11,347,1,346,0.53%,0.29%
2020-01-01 00:03:40,6,12,4463,140,4323,6.81%,3.14%
2020-01-01 00:03:40,7,1,622,0,622,0.95%,0.00%
2020-01-01 00:03:40,7,2,284,0,284,0.43%,0.00%
2020-01-01 00:03:40,7,3,1003,7,996,1.53%,0.70%
2020-01-01 00:03:40,7,4,1869,26,1843,2.85%,1.39%
2020-01-01 00:03:40,7,5,7792,442,7350,11.89%,5.67%
2020-01-01 00:03:40,7,6,13099,1242,11857,19.99%,9.48%
2020-01-01 00:03:40,7,7,3367,109,3258,5.14%,3.24%
2020-01-01 00:03:40,7,8,1313,16,1297,2.00%,1.22%
2020-01-01 00:03:40,7,9,6642,313,6329,10.13%,4.71%
2020-01-01 00:03:40,7,10,1659,17,1642,2.53%,1.02%
2020-01-01 00:03:40,7,11,97,0,97,0.15%,0.00%
2020-01-01 00:03:40,7,12,4898,190,4708,7.47%,3.88%
2020-01-01 00:03:40,8,1,481,1,480,0.73%,0.21%
2020-01-01 00:03:40,8,2,163,0,163,0.25%,0.00%
2020-01-01 00:03:40,8,3,1664,13,1651,2.54%,0.78%
2020-01-01 00:03:40,8,4,3412,89,3323,5.21%,2.61%
2020-01-01 00:03:40,8,5,8092,484,7608,12.35%,5.98%
2020-01-01 00:03:40,8,6,16571,1928,14643,25.29%,11.63%
2020-01-01 00:03:40,8,7,4758,171,4587,7.26%,3.59%
2020-01-01 00:03:40,8,8,2144,29,2115,3.27%,1.35%
2020-01-01 00:03:40,8,9,6195,285,5910,9.45%,4.60%
2020-01-01 00:03:40,8,10,1620,18,1602,2.47%,1.11%
2020-01-01 00:03:40,8,11,159,0,159,0.24%,0.00%
2020-01-01 00:03:40,8,12,4531,174,4357,6.91%,3.84%
2020-01-01 00:03:40,9,1,560,2,558,0.85%,0.36%
2020-01-01 00:03:40,9,2,2312,29,2283,3.53%,1.25%
2020-01-01 00:03:40,9,3,1294,7,1287,1.97%,0.54%
2020-01-01 00:03:40,9,4,5035,234,4801,7.68%,4.65%
2020-01-01 00:03:40,9,5,333,0,333,0.51%,0.00%
2020-01-01 00:03:40,9,6,6090,322,5768,9.29%,5.29%
2020-01-01 00:03:40,9,7,28182,5152,23030,43.00%,18.28%
2020-01-01 00:03:40,9,8,10818,820,9998,16.51%,7.58%
2020-01-01 00:03:40,9,9,185,0,185,0.28%,0.00%
2020-01-01 00:03:40,9,10,3408,63,3345,5.20%,1.85%
2020-01-01 00:03:40,9,11,9643,654,8989,14.71%,6.78%
2020-01-01 00:03:40,9,12,5995,274,5721,9.15%,4.57%
2020-01-01 00:03:40,10,1,1154,192,962,1.76%,16.62%
2020-01-01 00:03:40,10,2,3687,278,3409,5.63%,7.54%
2020-01-01 00:03:40,10,3,2334,46,2288,3.56%,1.97%
2020-01-01 00:03:40,10,4,4241,1100,3141,6.47%,25.93%
2020-01-01 00:03:40,10,5,767,54,713,1.17%,7.03%
2020-01-01 00:03:40,10,6,6246,1270,4976,9.53%,20.33%
2020-01-01 00:03:40,10,7,11629,2033,9596,17.74%,17.48%
2020-01-01 00:03:40,10,8,29562,7591,21971,45.11%,25.68%
2020-01-01 00:03:40,10,9,830,8,822,1.27%,0.96%
2020-01-01 00:03:40,10,10,2661,47,2614,4.06%,1.77%
2020-01-01 00:03:40,10,11,13563,1814,11749,20.70%,13.37%
2020-01-01 00:03:40,10,12,10394,1302,9092,15.86%,12.53%
2020-01-01 00:03:40,11,1,2563,43,2520,3.91%,1.68%
2020-01-01 00:03:40,11,2,3648,96,3552,5.57%,2.63%
2020-01-01 00:03:40,11,3,953,11,942,1.45%,1.15%
2020-01-01 00:03:40,11,4,7000,343,6657,10.68%,4.90%
2020-01-01 00:03:40,11,5,219,1,218,0.33%,0.45%
2020-01-01 00:03:40,11,6,8026,446,7580,12.25%,5.56%
2020-01-01 00:03:40,11,7,13894,1334,12560,21.20%,9.60%
2020-01-01 00:03:40,11,8,28119,5191,22928,42.91%,18.46%
2020-01-01 00:03:40,11,9,179,0,179,0.27%,0.00%
2020-01-01 00:03:40,11,10,3354,91,3263,5.12%,2.71%
2020-01-01 00:03:40,11,11,10308,774,9534,15.73%,7.51%
2020-01-01 00:03:40,11,12,6532,312,6220,9.97%,4.78%
2020-01-01 00:03:40,12,1,54,0,54,0.08%,0.00%
2020-01-01 00:03:40,12,2,559,149,410,0.85%,26.61%
2020-01-01 00:03:40,12,3,3117,228,2889,4.76%,7.31%
2020-01-01 00:03:40,12,4,3395,72,3323,5.18%,2.12%
2020-01-01 00:03:40,12,5,9705,765,8940,14.81%,7.88%
2020-01-01 00:03:40,12,6,5836,219,5617,8.91%,3.75%
2020-01-01 00:03:40,12,7,2238,43,2195,3.41%,1.92%
2020-01-01 00:03:40,12,8,1639,282,1357,2.50%,17.20%
2020-01-01 00:03:40,12,9,22663,4218,18445,34.58%,18.61%
2020-01-01 00:03:40,12,10,4369,402,3967,6.67%,9.20%
2020-01-01 00:03:40,12,11,1784,283,1501,2.72%,15.85%
2020-01-01 00:03:40,12,12,8012,1061,6951,12.23%,13.24%
2020-01-01 00:03:40,13,1,2049,46,2003,3.13%,2.24%
2020-01-01 00:03:40,13,2,2393,62,2331,3.65%,2.59%
2020-01-01 00:03:40,13,3,698,7,691,1.07%,1.00%
2020-01-01 00:03:40,13,4,4286,481,3805,6.54%,11.22%
2020-01-01 00:03:40,13,5,6326,742,5584,9.65%,11.73%
2020-01-01 00:03:40,13,6,4941,526,4415,7.54%,10.64%
2020-01-01 00:03:40,13,7,4417,157,4260,6.74%,3.55%
2020-01-01 00:03:40,13,8,6450,309,6141,9.84%,4.79%
2020-01-01 00:03:40,13,9,6702,775,5927,10.23%,11.56%
2020-01-01 00:03:40,13,10,26051,5127,20924,39.75%,19.68%
2020-01-01 00:03:40,13,11,16789,2274,14515,25.62%,13.54%
2020-01-01 00:03:40,13,12,9855,1037,8818,15.04%,10.52%
2020-01-01 00:03:40,14,1,218,0,218,0.33%,0.00%
2020-01-01 00:03:40,14,2,1128,9,1119,1.72%,0.80%
2020-01-01 00:03:40,14,3,670,3,667,1.02%,0.45%
2020-01-01 00:03:40,14,4,4377,143,4234,6.68%,3.27%
2020-01-01 00:03:40,14,5,1506,14,1492,2.30%,0.93%
2020-01-01 00:03:40,14,6,4638,163,4475,7.08%,3.51%
2020-01-01 00:03:40,14,7,12136,1060,11076,18.52%,8.73%
2020-01-01 00:03:40,14,8,13662,1338,12324,20.85%,9.79%
2020-01-01 00:03:40,14,9,1820,17,1803,2.78%,0.93%
2020-01-01 00:03:40,14,10,4113,100,4013,6.28%,2.43%
2020-01-01 00:03:40,14,11,25754,4498,21256,39.30%,17.46%
2020-01-01 00:03:40,14,12,7750,455,7295,11.83%,5.87%
2020-01-01 00:03:40,15,1,567,4,563,0.87%,0.70%
2020-01-01 00:03:40,15,2,232,2,230,0.35%,0.86%
2020-01-01 00:03:40,15,3,4220,137,4083,6.44%,3.25%
2020-01-01 00:03:40,15,4,5924,248,5676,9.04%,4.19%
2020-01-01 00:03:40,15,5,10835,818,10017,16.53%,7.55%
2020-01-01 00:03:40,15,6,6214,271,5943,9.48%,4.36%
2020-01-01 00:03:40,15,7,3621,99,3522,5.53%,2.73%
2020-01-01 00:03:40,15,8,5319,216,5103,8.12%,4.06%
2020-01-01 00:03:40,15,9,11000,847,10153,16.78%,7.70%
2020-01-01 00:03:40,15,10,4513,174,4339,6.89%,3.85%
2020-01-01 00:03:40,15,11,9984,746,9238,15.23%,7.47%
2020-01-01 00:03:40,15,12,26517,4993,21524,40.46%,18.83%
2020-01-01 00:03:40,16,1,539,4,535,0.82%,0.74%
2020-01-01 00:03:40,16,2,269,0,269,0.41%,0.00%
2020-01-01 00:03:40,16,3,1388,7,1381,2.12%,0.50%
2020-01-01 00:03:40,16,4,3961,179,3782,6.04%,4.52%
2020-01-01 00:03:40,16,5,7206,470,6736,11.00%,6.52%
2020-01-01 00:03:40,16,6,4647,218,4429,7.09%,4.69%
2020-01-01 00:03:40,16,7,3911,110,3801,5.97%,2.81%
2020-01-01 00:03:40,16,8,8072,609,7463,12.32%,7.54%
2020-01-01 00:03:40,16,9,7671,513,7158,11.71%,6.69%
2020-01-01 00:03:40,16,10,1757,30,1727,2.68%,1.71%
2020-01-01 00:03:40,16,11,10085,846,9239,15.39%,8.39%
2020-01-01 00:03:40,16,12,25360,4430,20930,38.70%,17.47%
2020-01-01 00:03:50,1,1,18209,2317,15892,27.78%,12.72%
2020-01-01 00:03:50,1,2,5518,238,5280,8.42%,4.31%
2020-01-01 00:03:50,1,3,524,3,521,0.80%,0.57%
2020-01-01 00:03:50,1,4,12272,1099,11173,18.73%,8.95%
2020-01-01 00:03:50,1,5,12010,1054,10956,18.33%,8.78%
2020-01-01 00:03:50,1,6,11917,1045,10872,18.18%,8.77%
2020-01-01 00:03:50,1,7,4971,180,4791,7.59%,3.62%
2020-01-01 00:03:50,1,8,4304,121,4183,6.57%,2.81%
2020-01-01 00:03:50,1,9,11877,1039,10838,18.12%,8.75%
2020-01-01 00:03:50,1,10,3721,92,3629,5.68%,2.47%
2020-01-01 00:03:50,1,11,3962,106,3856,6.05%,2.67%
2020-01-01 00:03:50,1,12,11857,1033,10824,18.09%,8.71%
2020-01-01 00:03:50,2,1,719,1,718,1.10%,0.14%
2020-01-01 00:03:50,2,2,23544,3668,19876,35.93%,15.58%
2020-01-01 00:03:50,2,3,17985,2159,15826,27.44%,12.00%
2020-01-01 00:03:50,2,4,668,1,667,1.02%,0.15%
2020-01-01 00:03:50,2,5,10207,707,9500,15.57%,6.93%
2020-01-01 00:03:50,2,6,29,0,29,0.04%,0.00%
2020-01-01 00:03:50,2,7,4810,164,4646,7.34%,3.41%
2020-01-01 00:03:50,2,8,3285,78,3207,5.01%,2.37%
2020-01-01 00:03:50,2,9,10122,697,9425,15.44%,6.89%
2020-01-01 00:03:50,2,10,2520,45,2475,3.85%,1.79%
2020-01-01 00:03:50,2,11,2537,45,2492,3.87%,1.77%
2020-01-01 00:03:50,2,12,10005,682,9323,15.27%,6.82%
2020-01-01 00:03:50,3,1,1569,13,1556,2.39%,0.83%
2020-01-01 00:03:50,3,2,26042,4371,21671,39.74%,16.78%
2020-01-01 00:03:50,3,3,70302,27139,43163,107.27%,38.60%
2020-01-01 00:03:50,3,4,9703,623,9080,14.81%,6.42%
2020-01-01 00:03:50,3,5,43461,11659,31802,66.32%,26.83%
2020-01-01 00:03:50,3,6,11166,804,10362,17.04%,7.20%
2020-01-01 00:03:50,3,7,22407,3311,19096,34.19%,14.78%
2020-01-01 00:03:50,3,8,18205,2222,15983,27.78%,12.20%
2020-01-01 00:03:50,3,9,31869,6644,25225,48.63%,20.85%
2020-01-01 00:03:50,3,10,5860,274,5586,8.94%,4.67%
2020-01-01 00:03:50,3,11,2273,31,2242,3.47%,1.36%
2020-01-01 00:03:50,3,12,22804,3546,19258,34.80%,15.55%
2020-01-01 00:03:50,4,1,552,2,550,0.84%,0.36%
2020-01-01 00:03:50,4,2,345,1,344,0.53%,0.29%
2020-01-01 00:03:50,4,3,946,9,937,1.44%,0.95%
2020-01-01 00:03:50,4,4,28613,5368,23245,43.66%,18.76%
2020-01-01 00:03:50,4,5,17598,2158,15440,26.85%,12.26%
2020-01-01 00:03:50,4,6,24594,4089,20505,37.53%,16.63%
2020-01-01 00:03:50,4,7,5426,200,5226,8.28%,3.69%
2020-01-01 00:03:50,4,8,3016,74,2942,4.60%,2.45%
2020-01-01 00:03:50,4,9,15319,1669,13650,23.37%,10.89%
2020-01-01 00:03:50,4,10,1887,26,1861,2.88%,1.38%
2020-01-01 00:03:50,4,11,275,0,275,0.42%,0.00%
2020-01-01 00:03:50,4,12,12716,1145,11571,19.40%,9.00%
2020-01-01 00:03:50,5,1,2923,55,2868,4.46%,1.88%
2020-01-01 00:03:50,5,2,997,8,989,1.52%,0.80%
2020-01-01 00:03:50,5,3,1934,27,1907,2.95%,1.40%
2020-01-01 00:03:50,5,4,24656,4103,20553,37.62%,16.64%
2020-01-01 00:03:50,5,5,10449,799,9650,15.94%,7.65%
2020-01-01 00:03:50,5,6,16429,1914,14515,25.07%,11.65%
2020-01-01 00:03:50,5,7,5366,216,5150,8.19%,4.02%
2020-01-01 00:03:50,5,8,4535,143,4392,6.92%,3.15%
2020-01-01 00:03:50,5,9,8313,510,7803,12.68%,6.13%
2020-01-01 00:03:50,5,10,1158,13,1145,1.77%,1.12%
2020-01-01 00:03:50,5,11,654,5,649,1.00%,0.76%
2020-01-01 00:03:50,5,12,6941,363,6578,10.59%,5.23%
2020-01-01 00:03:50,6,1,1075,10,1065,1.64%,0.93%
2020-01-01 00:03:50,6,2,1174,13,1161,1.79%,1.11%
2020-01-01 00:03:50,6,3,1663,25,1638,2.54%,1.50%
2020-01-01 00:03:50,6,4,1390,11,1379,2.12%,0.79%
2020-01-01 00:03:50,6,5,12717,1181,11536,19.40%,9.29%
2020-01-01 00:03:50,6,6,4184,127,4057,6.38%,3.03%
2020-01-01 00:03:50,6,7,2271,54,2217,3.47%,2.38%
2020-01-01 00:03:50,6,8,1833,39,1794,2.80%,2.13%
2020-01-01 00:03:50,6,9,6569,331,6238,10.02%,5.04%
2020-01-01 00:03:50,6,10,2227,41,2186,3.40%,1.84%
2020-01-01 00:03:50,6,11,467,0,467,0.71%,0.00%
2020-01-01 00:03:50,6,12,4255,135,4120,6.49%,3.17%
2020-01-01 00:03:50,7,1,436,1,435,0.67%,0.23%
2020-01-01 00:03:50,7,2,202,0,202,0.31%,0.00%
2020-01-01 00:03:50,7,3,687,3,684,1.05%,0.44%
2020-01-01 00:03:50,7,4,2124,37,2087,3.24%,1.74%
2020-01-01 00:03:50,7,5,7021,371,6650,10.71%,5.28%
2020-01-01 00:03:50,7,6,13157,1263,11894,20.08%,9.60%
2020-01-01 00:03:50,7,7,3940,118,3822,6.01%,2.99%
2020-01-01 00:03:50,7,8,2084,45,2039,3.18%,2.16%
2020-01-01 00:03:50,7,9,6068,284,5784,9.26%,4.68%
2020-01-01 00:03:50,7,10,1141,11,1130,1.74%,0.96%
2020-01-01 00:03:50,7,11,54,0,54,0.08%,0.00%
2020-01-01 00:03:50,7,12,4896,209,4687,7.47%,4.27%
2020-01-01 00:03:50,8,1,512,2,510,0.78%,0.39%
2020-01-01 00:03:50,8,2,110,0,110,0.17%,0.00%
2020-01-01 00:03:50,8,3,1689,15,1674,2.58%,0.89%
2020-01-01 00:03:50,8,4,3005,63,2942,4.59%,2.10%
2020-01-01 00:03:50,8,5,8568,563,8005,13.07%,6.57%
2020-01-01 00:03:50,8,6,15215,1641,13574,23.22%,10.78%
2020-01-01 00:03:50,8,7,3507,91,3416,5.35%,2.59%
2020-01-01 00:03:50,8,8,1381,12,1369,2.11%,0.87%
2020-01-01 00:03:50,8,9,6624,347,6277,10.11%,5.24%
2020-01-01 00:03:50,8,10,1940,38,1902,2.96%,1.96%
2020-01-01 00:03:50,8,11,99,0,99,0.15%,0.00%
2020-01-01 00:03:50,8,12,4593,140,4453,7.01%,3.05%
2020-01-01 00:03:50,9,1,778,6,772,1.19%,0.77%
2020-01-01 00:03:50,9,2,2780,52,2728,4.24%,1.87%
2020-01-01 00:03:50,9,3,1501,10,1491,2.29%,0.67%
2020-01-01 00:03:50,9,4,7624,427,7197,11.63%,5.60%
2020-01-01 00:03:50,9,5,787,2,785,1.20%,0.25%
2020-01-01 00:03:50,9,6,9480,649,8831,14.47%,6.85%
2020-01-01 00:03:50,9,7,33407,7247,26160,50.98%,21.69%
2020-01-01 00:03:50,9,8,12382,1097,11285,18.89%,8.86%
2020-01-01 00:03:50,9,9,357,0,357,0.54%,0.00%
2020-01-01 00:03:50,9,10,2963,65,2898,4.52%,2.19%
2020-01-01 00:03:50,9,11,11392,918,10474,17.38%,8.06%
2020-01-01 00:03:50,9,12,8094,454,7640,12.35%,5.61%
2020-01-01 00:03:50,10,1,1225,267,958,1.87%,21.78%
2020-01-01 00:03:50,10,2,3422,322,3100,5.22%,9.41%
2020-01-01 00:03:50,10,3,2003,27,1976,3.06%,1.35%
2020-01-01 00:03:50,10,4,4026,1116,2910,6.14%,27.71%
2020-01-01 00:03:50,10,5,933,56,877,1.42%,6.00%
2020-01-01 00:03:50,10,6,5708,1245,4463,8.71%,21.81%
2020-01-01 00:03:50,10,7,10748,1988,8760,16.40%,18.49%
2020-01-01 00:03:50,10,8,28366,6934,21432,43.28%,24.44%
2020-01-01 00:03:50,10,9,552,2,550,0.84%,0.36%
2020-01-01 00:03:50,10,10,3221,85,3136,4.91%,2.64%
2020-01-01 00:03:50,10,11,13436,1607,11829,20.50%,11.96%
2020-01-01 00:03:50,10,12,9533,1009,8524,14.55%,10.58%
2020-01-01 00:03:50,11,1,2325,40,2285,3.55%,1.72%
2020-01-01 00:03:50,11,2,3300,79,3221,5.04%,2.39%
2020-01-01 00:03:50,11,3,827,3,824,1.26%,0.36%
2020-01-01 00:03:50,11,4,9025,587,8438,13.77%,6.50%
2020-01-01 00:03:50,11,5,230,0,230,0.35%,0.00%
2020-01-01 00:03:50,11,6,9866,697,9169,15.05%,7.06%
2020-01-01 00:03:50,11,7,14689,1510,13179,22.41%,10.28%
2020-01-01 00:03:50,11,8,29649,5843,23806,45.24%,19.71%
2020-01-01 00:03:50,11,9,323,1,322,0.49%,0.31%
2020-01-01 00:03:50,11,10,3186,75,3111,4.86%,2.35%
2020-01-01 00:03:50,11,11,10823,852,9971,16.51%,7.87%
2020-01-01 00:03:50,11,12,7105,375,6730,10.84%,5.28%
2020-01-01 00:03:50,12,1,59,0,59,0.09%,0.00%
2020-01-01 00:03:50,12,2,479,122,357,0.73%,25.42%
2020-01-01 00:03:50,12,3,2601,168,2433,3.97%,6.46%
2020-01-01 00:03:50,12,4,2993,68,2925,4.57%,2.27%
2020-01-01 00:03:50,12,5,8448,615,7833,12.89%,7.28%
2020-01-01 00:03:50,12,6,5079,201,4878,7.75%,3.96%
2020-01-01 00:03:50,12,7,1942,32,1910,2.96%,1.65%
2020-01-01 00:03:50,12,8,1394,194,1200,2.13%,13.91%
2020-01-01 00:03:50,12,9,21017,3830,17187,32.07%,18.22%
2020-01-01 00:03:50,12,10,4381,298,4083,6.68%,6.80%
2020-01-01 00:03:50,12,11,1625,197,1428,2.48%,12.12%
2020-01-01 00:03:50,12,12,7300,1060,6240,11.14%,14.52%
2020-01-01 00:03:50,13,1,1774,21,1753,2.71%,1.18%
2020-01-01 00:03:50,13,2,2151,32,2119,3.28%,1.49%
2020-01-01 00:03:50,13,3,597,6,591,0.91%,1.00%
2020-01-01 00:03:50,13,4,5081,519,4562,7.75%,10.21%
2020-01-01 00:03:50,13,5,7138,875,6263,10.89%,12.26%
2020-01-01 00:03:50,13,6,5738,592,5146,8.76%,10.32%
2020-01-01 00:03:50,13,7,4269,154,4115,6.51%,3.61%
2020-01-01 00:03:50,13,8,6788,371,6417,10.36%,5.46%
2020-01-01 00:03:50,13,9,7468,906,6562,11.40%,12.13%
2020-01-01 00:03:50,13,10,26371,5244,21127,40.24%,19.88%
2020-01-01 00:03:50,13,11,16581,2167,14414,25.30%,13.07%
2020-01-01 00:03:50,13,12,9437,883,8554,14.40%,9.36%
2020-01-01 00:03:50,14,1,270,2,268,0.41%,0.74%
2020-01-01 00:03:50,14,2,1470,21,1449,2.24%,1.43%
2020-01-01 00:03:50,14,3,992,5,987,1.51%,0.50%
2020-01-01 00:03:50,14,4,3987,109,3878,6.08%,2.73%
2020-01-01 00:03:50,14,5,1352,10,1342,2.06%,0.74%
2020-01-01 00:03:50,14,6,4311,128,4183,6.58%,2.97%
2020-01-01 00:03:50,14,7,11703,974,10729,17.86%,8.32%
2020-01-01 00:03:50,14,8,13254,1260,11994,20.22%,9.51%
2020-01-01 00:03:50,14,9,1647,15,1632,2.51%,0.91%
2020-01-01 00:03:50,14,10,4579,129,4450,6.99%,2.82%
2020-01-01 00:03:50,14,11,27257,4938,22319,41.59%,18.12%
2020-01-01 00:03:50,14,12,9034,554,8480,13.78%,6.13%
2020-01-01 00:03:50,15,1,536,2,534,0.82%,0.37%
2020-01-01 00:03:50,15,2,142,0,142,0.22%,0.00%
2020-01-01 00:03:50,15,3,6745,351,6394,10.29%,5.20%
2020-01-01 00:03:50,15,4,5082,222,4860,7.75%,4.37%
2020-01-01 00:03:50,15,5,12608,1166,11442,19.24%,9.25%
2020-01-01 00:03:50,15,6,5387,241,5146,8.22%,4.47%
2020-01-01 00:03:50,15,7,3397,79,3318,5.18%,2.32%
2020-01-01 00:03:50,15,8,5149,207,4942,7.86%,4.02%
2020-01-01 00:03:50,15,9,12781,1192,11589,19.50%,9.33%
2020-01-01 00:03:50,15,10,7170,498,6672,10.94%,6.94%
2020-01-01 00:03:50,15,11,12549,1213,11336,19.15%,9.67%
2020-01-01 00:03:50,15,12,31159,6805,24354,47.54%,21.84%
2020-01-01 00:03:50,16,1,440,2,438,0.67%,0.45%
2020-01-01 00:03:50,16,2,221,0,221,0.34%,0.00%
2020-01-01 00:03:50,16,3,1395,18,1377,2.13%,1.29%
2020-01-01 00:03:50,16,4,4684,166,4518,7.15%,3.54%
2020-01-01 00:03:50,16,5,8511,560,7951,12.99%,6.58%
2020-01-01 00:03:50,16,6,5474,217,5257,8.35%,3.96%
2020-01-01 00:03:50,16,7,3402,83,3319,5.19%,2.44%
2020-01-01 00:03:50,16,8,7273,462,6811,11.10%,6.35%
2020-01-01 00:03:50,16,9,9008,614,8394,13.75%,6.82%
2020-01-01 00:03:50,16,10,1551,20,1531,2.37%,1.29%
2020-01-01 00:03:50,16,11,9026,641,8385,13.77%,7.10%
2020-01-01 00:03:50,16,12,26362,4702,21660,40.23%,17.84%
2020-01-01 00:04:00,1,1,22100,3261,18839,33.72%,14.75%
2020-01-01 00:04:00,1,2,10502,765,9737,16.02%,7.28%
2020-01-01 00:04:00,1,3,2345,37,2308,3.58%,1.58%
2020-01-01 00:04:00,1,4,11033,916,10117,16.84%,8.30%
2020-01-01 00:04:00,1,5,10758,861,9897,16.42%,8.00%
2020-01-01 00:04:00,1,6,10661,848,9813,16.27%,7.95%
2020-01-01 00:04:00,1,7,8143,469,7674,12.43%,5.76%
2020-01-01 00:04:00,1,8,5458,201,5257,8.33%,3.68%
2020-01-01 00:04:00,1,9,10615,838,9777,16.20%,7.89%
2020-01-01 00:04:00,1,10,4531,147,4384,6.91%,3.24%
2020-01-01 00:04:00,1,11,4629,151,4478,7.06%,3.26%
2020-01-01 00:04:00,1,12,10580,832,9748,16.14%,7.86%
2020-01-01 00:04:00,2,1,705,1,704,1.08%,0.14%
2020-01-01 00:04:00,2,2,23295,3763,19532,35.55%,16.15%
2020-01-01 00:04:00,2,3,19003,2514,16489,29.00%,13.23%
2020-01-01 00:04:00,2,4,650,1,649,0.99%,0.15%
2020-01-01 00:04:00,2,5,10800,828,9972,16.48%,7.67%
2020-01-01 00:04:00,2,6,71,0,71,0.11%,0.00%
2020-01-01 00:04:00,2,7,3571,101,3470,5.45%,2.83%
2020-01-01 00:04:00,2,8,2490,49,2441,3.80%,1.97%
2020-01-01 00:04:00,2,9,10714,822,9892,16.35%,7.67%
2020-01-01 00:04:00,2,10,1661,21,1640,2.53%,1.26%
2020-01-01 00:04:00,2,11,1696,23,1673,2.59%,1.36%
2020-01-01 00:04:00,2,12,10469,785,9684,15.97%,7.50%
2020-01-01 00:04:00,3,1,1490,14,1476,2.27%,0.94%
2020-01-01 00:04:00,3,2,24788,4175,20613,37.82%,16.84%
2020-01-01 00:04:00,3,3,80517,34182,46335,122.86%,42.45%
2020-01-01 00:04:00,3,4,7308,380,6928,11.15%,5.20%
2020-01-01 00:04:00,3,5,53190,16821,36369,81.16%,31.62%
2020-01-01 00:04:00,3,6,9362,612,8750,14.29%,6.54%
2020-01-01 00:04:00,3,7,21443,3151,18292,32.72%,14.69%
2020-01-01 00:04:00,3,8,17131,2076,15055,26.14%,12.12%
2020-01-01 00:04:00,3,9,43251,11742,31509,66.00%,27.15%
2020-01-01 00:04:00,3,10,11565,931,10634,17.65%,8.05%
2020-01-01 00:04:00,3,11,1939,30,1909,2.96%,1.55%
2020-01-01 00:04:00,3,12,27572,5153,22419,42.07%,18.69%
2020-01-01 00:04:00,4,1,564,4,560,0.86%,0.71%
2020-01-01 00:04:00,4,2,363,0,363,0.55%,0.00%
2020-01-01 00:04:00,4,3,699,6,693,1.07%,0.86%
2020-01-01 00:04:00,4,4,27859,5197,22662,42.51%,18.65%
2020-01-01 00:04:00,4,5,17159,2111,15048,26.18%,12.30%
2020-01-01 00:04:00,4,6,23630,3834,19796,36.06%,16.22%
2020-01-01 00:04:00,4,7,5048,208,4840,7.70%,4.12%
2020-01-01 00:04:00,4,8,3099,71,3028,4.73%,2.29%
2020-01-01 00:04:00,4,9,14909,1598,13311,22.75%,10.72%
2020-01-01 00:04:00,4,10,1898,19,1879,2.90%,1.00%
2020-01-01 00:04:00,4,11,251,0,251,0.38%,0.00%
2020-01-01 00:04:00,4,12,12249,1116,11133,18.69%,9.11%
2020-01-01 00:04:00,5,1,2513,34,2479,3.83%,1.35%
2020-01-01 00:04:00,5,2,611,2,609,0.93%,0.33%
2020-01-01 00:04:00,5,3,453,2,451,0.69%,0.44%
2020-01-01 00:04:00,5,4,22529,3425,19104,34.38%,15.20%
2020-01-01 00:04:00,5,5,9418,645,8773,14.37%,6.85%
2020-01-01 00:04:00,5,6,14232,1447,12785,21.72%,10.17%
2020-01-01 00:04:00,5,7,4337,144,4193,6.62%,3.32%
2020-01-01 00:04:00,5,8,3156,78,3078,4.82%,2.47%
2020-01-01 00:04:00,5,9,8800,567,8233,13.43%,6.44%
2020-01-01 00:04:00,5,10,1030,10,1020,1.57%,0.97%
2020-01-01 00:04:00,5,11,482,3,479,0.74%,0.62%
2020-01-01 00:04:00,5,12,7525,427,7098,11.48%,5.67%
2020-01-01 00:04:00,6,1,1137,8,1129,1.73%,0.70%
2020-01-01 00:04:00,6,2,1202,8,1194,1.83%,0.67%
2020-01-01 00:04:00,6,3,1928,22,1906,2.94%,1.14%
2020-01-01 00:04:00,6,4,1321,12,1309,2.02%,0.91%
2020-01-01 00:04:00,6,5,12936,1285,11651,19.74%,9.93%
2020-01-01 00:04:00,6,6,4653,181,4472,7.10%,3.89%
2020-01-01 00:04:00,6,7,2915,87,2828,4.45%,2.98%
2020-01-01 00:04:00,6,8,1996,50,1946,3.05%,2.50%
2020-01-01 00:04:00,6,9,6030,261,5769,9.20%,4.33%
2020-01-01 00:04:00,6,10,1799,26,1773,2.75%,1.44%
2020-01-01 00:04:00,6,11,406,1,405,0.62%,0.25%
2020-01-01 00:04:00,6,12,4179,132,4047,6.38%,3.16%
2020-01-01 00:04:00,7,1,501,20,481,0.76%,3.98%
2020-01-01 00:04:00,7,2,144,0,144,0.22%,0.00%
2020-01-01 00:04:00,7,3,665,2,663,1.01%,0.30%
2020-01-01 00:04:00,7,4,2430,64,2366,3.71%,2.63%
2020-01-01 00:04:00,7,5,7377,359,7018,11.26%,4.87%
2020-01-01 00:04:00,7,6,13067,1235,11832,19.94%,9.45%
2020-01-01 00:04:00,7,7,3185,80,3105,4.86%,2.51%
2020-01-01 00:04:00,7,8,1483,19,1464,2.26%,1.28%
2020-01-01 00:04:00,7,9,6649,299,6350,10.15%,4.50%
2020-01-01 00:04:00,7,10,1099,8,1091,1.68%,0.73%
2020-01-01 00:04:00,7,11,103,1,102,0.16%,0.96%
2020-01-01 00:04:00,7,12,5517,222,5295,8.42%,4.02%
2020-01-01 00:04:00,8,1,521,0,521,0.79%,0.00%
2020-01-01 00:04:00,8,2,122,0,122,0.19%,0.00%
2020-01-01 00:04:00,8,3,2272,31,2241,3.47%,1.36%
2020-01-01 00:04:00,8,4,2658,58,2600,4.06%,2.18%
2020-01-01 00:04:00,8,5,8939,588,8351,13.64%,6.58%
2020-01-01 00:04:00,8,6,16388,1931,14457,25.01%,11.78%
2020-01-01 00:04:00,8,7,4682,181,4501,7.14%,3.87%
2020-01-01 00:04:00,8,8,1804,22,1782,2.75%,1.22%
2020-01-01 00:04:00,8,9,6137,289,5848,9.36%,4.71%
2020-01-01 00:04:00,8,10,1599,23,1576,2.44%,1.44%
2020-01-01 00:04:00,8,11,148,0,148,0.23%,0.00%
2020-01-01 00:04:00,8,12,4496,163,4333,6.86%,3.62%
2020-01-01 00:04:00,9,1,785,2,783,1.20%,0.25%
2020-01-01 00:04:00,9,2,2115,31,2084,3.23%,1.47%
2020-01-01 00:04:00,9,3,986,10,976,1.50%,1.01%
2020-01-01 00:04:00,9,4,8833,536,8297,13.48%,6.07%
2020-01-01 00:04:00,9,5,599,1,598,0.91%,0.17%
2020-01-01 00:04:00,9,6,10085,696,9389,15.39%,6.90%
2020-01-01 00:04:00,9,7,31117,6232,24885,47.48%,20.03%
2020-01-01 00:04:00,9,8,12897,1207,11690,19.68%,9.36%
2020-01-01 00:04:00,9,9,141,0,141,0.22%,0.00%
2020-01-01 00:04:00,9,10,5274,286,4988,8.05%,5.42%
2020-01-01 00:04:00,9,11,11934,1051,10883,18.21%,8.81%
2020-01-01 00:04:00,9,12,6318,265,6053,9.64%,4.19%
2020-01-01 00:04:00,10,1,1465,266,1199,2.24%,18.14%
2020-01-01 00:04:00,10,2,4621,380,4241,7.05%,8.22%
2020-01-01 00:04:00,10,3,3060,73,2987,4.67%,2.38%
2020-01-01 00:04:00,10,4,3969,994,2975,6.06%,25.04%
2020-01-01 00:04:00,10,5,1164,115,1049,1.78%,9.87%
2020-01-01 00:04:00,10,6,6442,1257,5185,9.83%,19.51%
2020-01-01 00:04:00,10,7,12329,2167,10162,18.81%,17.58%
2020-01-01 00:04:00,10,8,30327,7961,22366,46.28%,26.25%
2020-01-01 00:04:00,10,9,439,0,439,0.67%,0.00%
2020-01-01 00:04:00,10,10,2352,40,2312,3.59%,1.70%
2020-01-01 00:04:00,10,11,13656,1615,12041,20.84%,11.83%
2020-01-01 00:04:00,10,12,10584,1096,9488,16.15%,10.35%
2020-01-01 00:04:00,11,1,2177,38,2139,3.32%,1.74%
2020-01-01 00:04:00,11,2,2912,65,2847,4.44%,2.23%
2020-01-01 00:04:00,11,3,578,1,577,0.88%,0.17%
2020-01-01 00:04:00,11,4,3019,68,2951,4.61%,2.25%
2020-01-01 00:04:00,11,5,277,0,277,0.42%,0.00%
2020-01-01 00:04:00,11,6,4079,124,3955,6.22%,3.04%
2020-01-01 00:04:00,11,7,8917,606,8311,13.61%,6.80%
2020-01-01 00:04:00,11,8,24462,4143,20319,37.33%,16.94%
2020-01-01 00:04:00,11,9,369,2,367,0.56%,0.54%
2020-01-01 00:04:00,11,10,3073,73,3000,4.69%,2.37%
2020-01-01 00:04:00,11,11,11364,933,10431,17.34%,8.21%
2020-01-01 00:04:00,11,12,7825,445,7380,11.94%,5.69%
2020-01-01 00:04:00,12,1,119,0,119,0.18%,0.00%
2020-01-01 00:04:00,12,2,583,113,470,0.89%,19.35%
2020-01-01 00:04:00,12,3,3032,185,2847,4.63%,6.10%
2020-01-01 00:04:00,12,4,3014,75,2939,4.60%,2.49%
2020-01-01 00:04:00,12,5,9723,818,8905,14.84%,8.41%
2020-01-01 00:04:00,12,6,4711,152,4559,7.19%,3.23%
2020-01-01 00:04:00,12,7,1565,18,1547,2.39%,1.15%
2020-01-01 00:04:00,12,8,1344,315,1029,2.05%,23.42%
2020-01-01 00:04:00,12,9,21694,4077,17617,33.10%,18.79%
2020-01-01 00:04:00,12,10,4534,455,4079,6.92%,10.03%
2020-01-01 00:04:00,12,11,1562,318,1244,2.38%,20.35%
2020-01-01 00:04:00,12,12,6980,986,5994,10.65%,14.12%
2020-01-01 00:04:00,13,1,2297,41,2256,3.50%,1.78%
2020-01-01 00:04:00,13,2,2574,54,2520,3.93%,2.10%
2020-01-01 00:04:00,13,3,1024,10,1014,1.56%,0.98%
2020-01-01 00:04:00,13,4,4955,657,4298,7.56%,13.26%
2020-01-01 00:04:00,13,5,7435,975,6460,11.34%,13.11%
2020-01-01 00:04:00,13,6,5458,701,4757,8.33%,12.84%
2020-01-01 00:04:00,13,7,4590,161,4429,7.00%,3.51%
2020-01-01 00:04:00,13,8,8268,526,7742,12.62%,6.36%
2020-01-01 00:04:00,13,9,7757,1005,6752,11.84%,12.95%
2020-01-01 00:04:00,13,10,28752,6155,22597,43.87%,21.41%
2020-01-01 00:04:00,13,11,18351,2675,15676,28.00%,14.58%
2020-01-01 00:04:00,13,12,9781,1022,8759,14.92%,10.45%
2020-01-01 00:04:00,14,1,246,0,246,0.38%,0.00%
2020-01-01 00:04:00,14,2,1646,19,1627,2.51%,1.15%
2020-01-01 00:04:00,14,3,1057,6,1051,1.61%,0.57%
2020-01-01 00:04:00,14,4,3455,87,3368,5.27%,2.52%
2020-01-01 00:04:00,14,5,1137,21,1116,1.73%,1.85%
2020-01-01 00:04:00,14,6,3698,100,3598,5.64%,2.70%
2020-01-01 00:04:00,14,7,11154,921,10233,17.02%,8.26%
2020-01-01 00:04:00,14,8,12862,1172,11690,19.63%,9.11%
2020-01-01 00:04:00,14,9,1303,23,1280,1.99%,1.76%
2020-01-01 00:04:00,14,10,3902,114,3788,5.95%,2.92%
2020-01-01 00:04:00,14,11,26265,4561,21704,40.08%,17.36%
2020-01-01 00:04:00,14,12,9147,578,8569,13.96%,6.32%
2020-01-01 00:04:00,15,1,559,3,556,0.85%,0.54%
2020-01-01 00:04:00,15,2,135,0,135,0.21%,0.00%
2020-01-01 00:04:00,15,3,4026,138,3888,6.14%,3.43%
2020-01-01 00:04:00,15,4,4724,217,4507,7.21%,4.59%
2020-01-01 00:04:00,15,5,9575,731,8844,14.61%,7.63%
2020-01-01 00:04:00,15,6,4924,231,4693,7.51%,4.69%
2020-01-01 00:04:00,15,7,3551,95,3456,5.42%,2.67%
2020-01-01 00:04:00,15,8,5473,250,5223,8.35%,4.57%
2020-01-01 00:04:00,15,9,9791,766,9025,14.94%,7.82%
2020-01-01 00:04:00,15,10,4295,336,3959,6.55%,7.82%
2020-01-01 00:04:00,15,11,9865,919,8946,15.05%,9.31%
2020-01-01 00:04:00,15,12,24586,4715,19871,37.52%,19.18%
2020-01-01 00:04:00,16,1,415,3,412,0.63%,0.72%
2020-01-01 00:04:00,16,2,314,0,314,0.48%,0.00%
2020-01-01 00:04:00,16,3,1455,16,1439,2.22%,1.10%
2020-01-01 00:04:00,16,4,3892,128,3764,5.94%,3.29%
2020-01-01 00:04:00,16,5,7039,412,6627,10.74%,5.85%
2020-01-01 00:04:00,16,6,4618,167,4451,7.05%,3.62%
2020-01-01 00:04:00,16,7,3343,93,3250,5.10%,2.78%
2020-01-01 00:04:00,16,8,7133,443,6690,10.88%,6.21%
2020-01-01 00:04:00,16,9,7649,490,7159,11.67%,6.41%
2020-01-01 00:04:00,16,10,1493,10,1483,2.28%,0.67%
2020-01-01 00:04:00,16,11,8795,622,8173,13.42%,7.07%
2020-01-01 00:04:00,16,12,24107,4040,20067,36.78%,16.76%
2020-01-01 00:04:10,1,1,20397,2785,17612,31.12%,13.65%
2020-01-01 00:04:10,1,2,5682,248,5434,8.67%,4.36%
2020-01-01 00:04:10,1,3,437,2,435,0.67%,0.46%
2020-01-01 00:04:10,1,4,14396,1427,12969,21.97%,9.91%
2020-01-01 00:04:10,1,5,14079,1370,12709,21.48%,9.73%
2020-01-01 00:04:10,1,6,14016,1355,12661,21.39%,9.67%
2020-01-01 00:04:10,1,7,5226,214,5012,7.97%,4.09%
2020-01-01 00:04:10,1,8,4623,157,4466,7.05%,3.40%
2020-01-01 00:04:10,1,9,13995,1349,12646,21.35%,9.64%
2020-01-01 00:04:10,1,10,3802,103,3699,5.80%,2.71%
2020-01-01 00:04:10,1,11,3845,105,3740,5.87%,2.73%
2020-01-01 00:04:10,1,12,13954,1343,12611,21.29%,9.62%
2020-01-01 00:04:10,2,1,448,13,435,0.68%,2.90%
2020-01-01 00:04:10,2,2,25548,4356,21192,38.98%,17.05%
2020-01-01 00:04:10,2,3,20262,2839,17423,30.92%,14.01%
2020-01-01 00:04:10,2,4,381,13,368,0.58%,3.40%
2020-01-01 00:04:10,2,5,11579,971,10608,17.67%,8.39%
2020-01-01 00:04:10,2,6,66,0,66,0.10%,0.00%
2020-01-01 00:04:10,2,7,4830,177,4653,7.37%,3.66%
2020-01-01 00:04:10,2,8,3965,116,3849,6.05%,2.92%
2020-01-01 00:04:10,2,9,11471,949,10522,17.50%,8.27%
2020-01-01 00:04:10,2,10,3113,71,3042,4.75%,2.28%
2020-01-01 00:04:10,2,11,3138,71,3067,4.79%,2.26%
2020-01-01 00:04:10,2,12,11315,918,10397,17.27%,8.11%
2020-01-01 00:04:10,3,1,2665,48,2617,4.07%,1.80%
2020-01-01 00:04:10,3,2,26651,4827,21824,40.67%,18.11%
2020-01-01 00:04:10,3,3,71695,28261,43434,109.40%,39.42%
2020-01-01 00:04:10,3,4,7246,391,6855,11.06%,5.40%
2020-01-01 00:04:10,3,5,42788,11346,31442,65.29%,26.52%
2020-01-01 00:04:10,3,6,8115,495,7620,12.38%,6.10%
2020-01-01 00:04:10,3,7,22102,3418,18684,33.72%,15.46%
2020-01-01 00:04:10,3,8,16446,1946,14500,25.09%,11.83%
2020-01-01 00:04:10,3,9,34244,7545,26699,52.25%,22.03%
2020-01-01 00:04:10,3,10,8103,469,7634,12.36%,5.79%
2020-01-01 00:04:10,3,11,1810,26,1784,2.76%,1.44%
2020-01-01 00:04:10,3,12,23537,3755,19782,35.91%,15.95%
2020-01-01 00:04:10,4,1,540,4,536,0.82%,0.74%
2020-01-01 00:04:10,4,2,331,2,329,0.51%,0.60%
2020-01-01 00:04:10,4,3,922,8,914,1.41%,0.87%
2020-01-01 00:04:10,4,4,28497,5342,23155,43.48%,18.75%
2020-01-01 00:04:10,4,5,17866,2189,15677,27.26%,12.25%
2020-01-01 00:04:10,4,6,24959,4180,20779,38.08%,16.75%
2020-01-01 00:04:10,4,7,5658,221,5437,8.63%,3.91%
2020-01-01 00:04:10,4,8,2719,43,2676,4.15%,1.58%
2020-01-01 00:04:10,4,9,15623,1675,13948,23.84%,10.72%
2020-01-01 00:04:10,4,10,1856,41,1815,2.83%,2.21%
2020-01-01 00:04:10,4,11,74,0,74,0.11%,0.00%
2020-01-01 00:04:10,4,12,12706,1097,11609,19.39%,8.63%
2020-01-01 00:04:10,5,1,2675,66,2609,4.08%,2.47%
2020-01-01 00:04:10,5,2,557,2,555,0.85%,0.36%
2020-01-01 00:04:10,5,3,2142,33,2109,3.27%,1.54%
2020-01-01 00:04:10,5,4,30530,6291,24239,46.59%,20.61%
2020-01-01 00:04:10,5,5,12078,1050,11028,18.43%,8.69%
2020-01-01 00:04:10,5,6,18545,2471,16074,28.30%,13.32%
2020-01-01 00:04:10,5,7,5854,295,5559,8.93%,5.04%
2020-01-01 00:04:10,5,8,4002,134,3868,6.11%,3.35%
2020-01-01 00:04:10,5,9,9185,618,8567,14.02%,6.73%
2020-01-01 00:04:10,5,10,919,9,910,1.40%,0.98%
2020-01-01 00:04:10,5,11,892,5,887,1.36%,0.56%
2020-01-01 00:04:10,5,12,7824,453,7371,11.94%,5.79%
2020-01-01 00:04:10,6,1,1064,21,1043,1.62%,1.97%
2020-01-01 00:04:10,6,2,1184,24,1160,1.81%,2.03%
2020-01-01 00:04:10,6,3,1595,28,1567,2.43%,1.75%
2020-01-01 00:04:10,6,4,1669,16,1653,2.55%,0.96%
2020-01-01 00:04:10,6,5,16230,1884,14346,24.77%,11.61%
2020-01-01 00:04:10,6,6,4130,163,3967,6.30%,3.95%
2020-01-01 00:04:10,6,7,2082,65,2017,3.18%,3.12%
2020-01-01 00:04:10,6,8,1557,53,1504,2.38%,3.40%
2020-01-01 00:04:10,6,9,10098,709,9389,15.41%,7.02%
2020-01-01 00:04:10,6,10,2150,29,2121,3.28%,1.35%
2020-01-01 00:04:10,6,11,394,0,394,0.60%,0.00%
2020-01-01 00:04:10,6,12,7814,438,7376,11.92%,5.60%
2020-01-01 00:04:10,7,1,530,4,526,0.81%,0.75%
2020-01-01 00:04:10,7,2,221,0,221,0.34%,0.00%
2020-01-01 00:04:10,7,3,1299,7,1292,1.98%,0.54%
2020-01-01 00:04:10,7,4,1681,18,1663,2.57%,1.07%
2020-01-01 00:04:10,7,5,7551,443,7108,11.52%,5.87%
2020-01-01 00:04:10,7,6,12974,1242,11732,19.80%,9.57%
2020-01-01 00:04:10,7,7,3602,82,3520,5.50%,2.28%
2020-01-01 00:04:10,7,8,1279,15,1264,1.95%,1.17%
2020-01-01 00:04:10,7,9,6183,301,5882,9.43%,4.87%
2020-01-01 00:04:10,7,10,1563,22,1541,2.38%,1.41%
2020-01-01 00:04:10,7,11,90,0,90,0.14%,0.00%
2020-01-01 00:04:10,7,12,4600,197,4403,7.02%,4.28%
2020-01-01 00:04:10,8,1,368,1,367,0.56%,0.27%
2020-01-01 00:04:10,8,2,28,0,28,0.04%,0.00%
2020-01-01 00:04:10,8,3,1139,6,1133,1.74%,0.53%
2020-01-01 00:04:10,8,4,2290,38,2252,3.49%,1.66%
2020-01-01 00:04:10,8,5,7816,528,7288,11.93%,6.75%
2020-01-01 00:04:10,8,6,15272,1707,13565,23.30%,11.18%
2020-01-01 00:04:10,8,7,5076,199,4877,7.75%,3.92%
2020-01-01 00:04:10,8,8,2215,40,2175,3.38%,1.81%
2020-01-01 00:04:10,8,9,6150,357,5793,9.38%,5.80%
2020-01-01 00:04:10,8,10,1788,31,1757,2.73%,1.73%
2020-01-01 00:04:10,8,11,328,1,327,0.50%,0.30%
2020-01-01 00:04:10,8,12,4220,135,4085,6.44%,3.20%
2020-01-01 00:04:10,9,1,217,1,216,0.33%,0.46%
2020-01-01 00:04:10,9,2,1946,32,1914,2.97%,1.64%
2020-01-01 00:04:10,9,3,1481,22,1459,2.26%,1.48%
2020-01-01 00:04:10,9,4,5696,237,5459,8.69%,4.16%
2020-01-01 00:04:10,9,5,301,0,301,0.46%,0.00%
2020-01-01 00:04:10,9,6,6681,329,6352,10.19%,4.92%
2020-01-01 00:04:10,9,7,29864,5799,24065,45.57%,19.42%
2020-01-01 00:04:10,9,8,14735,1530,13205,22.48%,10.38%
2020-01-01 00:04:10,9,9,282,0,282,0.43%,0.00%
2020-01-01 00:04:10,9,10,5962,251,5711,9.10%,4.21%
2020-01-01 00:04:10,9,11,13254,1254,12000,20.22%,9.46%
2020-01-01 00:04:10,9,12,6792,327,6465,10.36%,4.81%
2020-01-01 00:04:10,10,1,1064,221,843,1.62%,20.75%
2020-01-01 00:04:10,10,2,2502,261,2241,3.82%,10.43%
2020-01-01 00:04:10,10,3,1217,16,1201,1.86%,1.31%
2020-01-01 00:04:10,10,4,4142,785,3357,6.32%,18.95%
2020-01-01 00:04:10,10,5,518,2,516,0.79%,0.39%
2020-01-01 00:04:10,10,6,6228,923,5305,9.50%,14.82%
2020-01-01 00:04:10,10,7,10814,1628,9186,16.50%,15.05%
2020-01-01 00:04:10,10,8,27906,6880,21026,42.58%,24.65%
2020-01-01 00:04:10,10,9,540,1,539,0.82%,0.18%
2020-01-01 00:04:10,10,10,2340,51,2289,3.57%,2.18%
2020-01-01 00:04:10,10,11,12974,1689,11285,19.80%,13.02%
2020-01-01 00:04:10,10,12,10099,1213,8886,15.41%,12.01%
2020-01-01 00:04:10,11,1,2144,38,2106,3.27%,1.77%
2020-01-01 00:04:10,11,2,3277,82,3195,5.00%,2.50%
2020-01-01 00:04:10,11,3,944,7,937,1.44%,0.74%
2020-01-01 00:04:10,11,4,4931,199,4732,7.52%,4.03%
2020-01-01 00:04:10,11,5,306,1,305,0.47%,0.33%
2020-01-01 00:04:10,11,6,5886,271,5615,8.98%,4.60%
2020-01-01 00:04:10,11,7,11074,919,10155,16.90%,8.30%
2020-01-01 00:04:10,11,8,25222,4351,20871,38.49%,17.25%
2020-01-01 00:04:10,11,9,223,0,223,0.34%,0.00%
2020-01-01 00:04:10,11,10,3575,107,3468,5.46%,2.99%
2020-01-01 00:04:10,11,11,10830,842,9988,16.53%,7.77%
2020-01-01 00:04:10,11,12,6662,312,6350,10.17%,4.68%
2020-01-01 00:04:10,12,1,47,0,47,0.07%,0.00%
2020-01-01 00:04:10,12,2,667,217,450,1.02%,32.49%
2020-01-01 00:04:10,12,3,2670,265,2405,4.07%,9.92%
2020-01-01 00:04:10,12,4,2986,84,2902,4.56%,2.81%
2020-01-01 00:04:10,12,5,8609,773,7836,13.14%,8.98%
2020-01-01 00:04:10,12,6,5097,222,4875,7.78%,4.35%
2020-01-01 00:04:10,12,7,2013,40,1973,3.07%,1.99%
2020-01-01 00:04:10,12,8,1298,331,967,1.98%,25.48%
2020-01-01 00:04:10,12,9,23639,4839,18800,36.07%,20.47%
2020-01-01 00:04:10,12,10,4287,414,3873,6.54%,9.65%
2020-01-01 00:04:10,12,11,1775,338,1437,2.71%,19.03%
2020-01-01 00:04:10,12,12,10086,1416,8670,15.39%,14.04%
2020-01-01 00:04:10,13,1,2627,59,2568,4.01%,2.25%
2020-01-01 00:04:10,13,2,2981,72,2909,4.55%,2.41%
2020-01-01 00:04:10,13,3,495,2,493,0.76%,0.40%
2020-01-01 00:04:10,13,4,6021,490,5531,9.19%,8.14%
2020-01-01 00:04:10,13,5,8865,924,7941,13.53%,10.42%
2020-01-01 00:04:10,13,6,7074,583,6491,10.79%,8.24%
2020-01-01 00:04:10,13,7,5505,243,5262,8.40%,4.41%
2020-01-01 00:04:10,13,8,7699,439,7260,11.75%,5.70%
2020-01-01 00:04:10,13,9,9166,964,8202,13.99%,10.52%
2020-01-01 00:04:10,13,10,27744,5742,22002,42.33%,20.70%
2020-01-01 00:04:10,13,11,16302,2145,14157,24.87%,13.16%
2020-01-01 00:04:10,13,12,8050,771,7279,12.28%,9.58%
2020-01-01 00:04:10,14,1,475,0,475,0.72%,0.00%
2020-01-01 00:04:10,14,2,1520,16,1504,2.32%,1.05%
2020-01-01 00:04:10,14,3,840,3,837,1.28%,0.36%
2020-01-01 00:04:10,14,4,4135,135,4000,6.31%,3.26%
2020-01-01 00:04:10,14,5,1700,23,1677,2.59%,1.35%
2020-01-01 00:04:10,14,6,4367,147,4220,6.66%,3.37%
2020-01-01 00:04:10,14,7,11740,981,10759,17.91%,8.36%
2020-01-01 00:04:10,14,8,12835,1169,11666,19.58%,9.11%
2020-01-01 00:04:10,14,9,1905,27,1878,2.91%,1.42%
2020-01-01 00:04:10,14,10,4130,118,4012,6.30%,2.86%
2020-01-01 00:04:10,14,11,24656,4046,20610,37.62%,16.41%
2020-01-01 00:04:10,14,12,7518,438,7080,11.47%,5.83%
2020-01-01 00:04:10,15,1,404,0,404,0.62%,0.00%
2020-01-01 00:04:10,15,2,295,2,293,0.45%,0.68%
2020-01-01 00:04:10,15,3,4017,122,3895,6.13%,3.04%
2020-01-01 00:04:10,15,4,5746,233,5513,8.77%,4.05%
2020-01-01 00:04:10,15,5,10348,749,9599,15.79%,7.24%
2020-01-01 00:04:10,15,6,5991,262,5729,9.14%,4.37%
2020-01-01 00:04:10,15,7,3556,119,3437,5.43%,3.35%
2020-01-01 00:04:10,15,8,5032,212,4820,7.68%,4.21%
2020-01-01 00:04:10,15,9,10616,792,9824,16.20%,7.46%
2020-01-01 00:04:10,15,10,3867,125,3742,5.90%,3.23%
2020-01-01 00:04:10,15,11,9181,674,8507,14.01%,7.34%
2020-01-01 00:04:10,15,12,24824,4516,20308,37.88%,18.19%
2020-01-01 00:04:10,16,1,486,4,482,0.74%,0.82%
2020-01-01 00:04:10,16,2,212,0,212,0.32%,0.00%
2020-01-01 00:04:10,16,3,1148,11,1137,1.75%,0.96%
2020-01-01 00:04:10,16,4,4174,150,4024,6.37%,3.59%
2020-01-01 00:04:10,16,5,7357,502,6855,11.23%,6.82%
2020-01-01 00:04:10,16,6,4967,201,4766,7.58%,4.05%
2020-01-01 00:04:10,16,7,3535,111,3424,5.39%,3.14%
2020-01-01 00:04:10,16,8,7668,468,7200,11.70%,6.10%
2020-01-01 00:04:10,16,9,7799,549,7250,11.90%,7.04%
2020-01-01 00:04:10,16,10,1710,18,1692,2.61%,1.05%
2020-01-01 00:04:10,16,11,9584,697,8887,14.62%,7.27%
2020-01-01 00:04:10,16,12,25003,4363,20640,38.15%,17.45%
2020-01-01 00:04:20,1,1,16521,1907,14614,25.21%,11.54%
2020-01-01 00:04:20,1,2,5600,217,5383,8.54%,3.87%
2020-01-01 00:04:20,1,3,589,4,585,0.90%,0.68%
2020-01-01 00:04:20,1,4,10525,805,9720,16.06%,7.65%
2020-01-01 00:04:20,1,5,10360,781,9579,15.81%,7.54%
2020-01-01 00:04:20,1,6,10277,765,9512,15.68%,7.44%
2020-01-01 00:04:20,1,7,4993,177,4816,7.62%,3.54%
2020-01-01 00:04:20,1,8,4214,113,4101,6.43%,2.68%
2020-01-01 00:04:20,1,9,10249,762,9487,15.64%,7.43%
2020-01-01 00:04:20,1,10,3719,78,3641,5.67%,2.10%
2020-01-01 00:04:20,1,11,3776,80,3696,5.76%,2.12%
2020-01-01 00:04:20,1,12,10206,761,9445,15.57%,7.46%
2020-01-01 00:04:20,2,1,354,0,354,0.54%,0.00%
2020-01-01 00:04:20,2,2,31086,6272,24814,47.43%,20.18%
2020-01-01 00:04:20,2,3,26173,4528,21645,39.94%,17.30%
2020-01-01 00:04:20,2,4,219,0,219,0.33%,0.00%
2020-01-01 00:04:20,2,5,15409,1680,13729,23.51%,10.90%
2020-01-01 00:04:20,2,6,64,0,64,0.10%,0.00%
2020-01-01 00:04:20,2,7,4550,180,4370,6.94%,3.96%
2020-01-01 00:04:20,2,8,3777,117,3660,5.76%,3.10%
2020-01-01 00:04:20,2,9,15312,1664,13648,23.36%,10.87%
2020-01-01 00:04:20,2,10,2986,79,2907,4.56%,2.64%
2020-01-01 00:04:20,2,11,3004,80,2924,4.58%,2.66%
2020-01-01 00:04:20,2,12,15157,1636,13521,23.13%,10.79%
2020-01-01 00:04:20,3,1,1459,10,1449,2.23%,0.68%
2020-01-01 00:04:20,3,2,26312,4668,21644,40.15%,17.74%
2020-01-01 00:04:20,3,3,75349,30618,44731,114.97%,40.63%
2020-01-01 00:04:20,3,4,7851,464,7387,11.98%,5.91%
2020-01-01 00:04:20,3,5,47744,13875,33869,72.85%,29.06%
2020-01-01 00:04:20,3,6,9267,659,8608,14.14%,7.11%
2020-01-01 00:04:20,3,7,23023,3620,19403,35.13%,15.72%
2020-01-01 00:04:20,3,8,17055,2054,15001,26.02%,12.04%
2020-01-01 00:04:20,3,9,38048,9184,28864,58.06%,24.14%
2020-01-01 00:04:20,3,10,6534,318,6216,9.97%,4.87%
2020-01-01 00:04:20,3,11,1278,11,1267,1.95%,0.86%
2020-01-01 00:04:20,3,12,28513,5362,23151,43.51%,18.80%
2020-01-01 00:04:20,4,1,471,3,468,0.72%,0.64%
2020-01-01 00:04:20,4,2,263,0,263,0.40%,0.00%
2020-01-01 00:04:20,4,3,781,3,778,1.19%,0.38%
2020-01-01 00:04:20,4,4,26923,4883,22040,41.08%,18.14%
2020-01-01 00:04:20,4,5,16467,1913,14554,25.13%,11.62%
2020-01-01 00:04:20,4,6,23520,3817,19703,35.89%,16.23%
2020-01-01 00:04:20,4,7,5391,210,5181,8.23%,3.89%
2020-01-01 00:04:20,4,8,3014,64,2950,4.60%,2.12%
2020-01-01 00:04:20,4,9,14482,1488,12994,22.10%,10.27%
2020-01-01 00:04:20,4,10,1946,27,1919,2.97%,1.39%
2020-01-01 00:04:20,4,11,168,0,168,0.26%,0.00%
2020-01-01 00:04:20,4,12,11812,1001,10811,18.02%,8.47%
2020-01-01 00:04:20,5,1,3085,66,3019,4.71%,2.14%
2020-01-01 00:04:20,5,2,1102,9,1093,1.68%,0.82%
2020-01-01 00:04:20,5,3,1348,6,1342,2.06%,0.44%
2020-01-01 00:04:20,5,4,24673,4171,20502,37.65%,16.90%
2020-01-01 00:04:20,5,5,10242,774,9468,15.63%,7.56%
2020-01-01 00:04:20,5,6,15280,1678,13602,23.32%,10.98%
2020-01-01 00:04:20,5,7,4575,171,4404,6.98%,3.74%
2020-01-01 00:04:20,5,8,3226,84,3142,4.92%,2.60%
2020-01-01 00:04:20,5,9,8725,571,8154,13.31%,6.54%
2020-01-01 00:04:20,5,10,1005,6,999,1.53%,0.60%
2020-01-01 00:04:20,5,11,669,4,665,1.02%,0.60%
2020-01-01 00:04:20,5,12,7441,433,7008,11.35%,5.82%
2020-01-01 00:04:20,6,1,1145,10,1135,1.75%,0.87%
2020-01-01 00:04:20,6,2,1240,10,1230,1.89%,0.81%
2020-01-01 00:04:20,6,3,1549,14,1535,2.36%,0.90%
2020-01-01 00:04:20,6,4,1407,6,1401,2.15%,0.43%
2020-01-01 00:04:20,6,5,14644,1509,13135,22.34%,10.30%
2020-01-01 00:04:20,6,6,4392,131,4261,6.70%,2.98%
2020-01-01 00:04:20,6,7,2310,51,2259,3.52%,2.21%
2020-01-01 00:04:20,6,8,1837,40,1797,2.80%,2.18%
2020-01-01 00:04:20,6,9,8165,506,7659,12.46%,6.20%
2020-01-01 00:04:20,6,10,3248,78,3170,4.96%,2.40%
2020-01-01 00:04:20,6,11,463,1,462,0.71%,0.22%
2020-01-01 00:04:20,6,12,4857,184,4673,7.41%,3.79%
2020-01-01 00:04:20,7,1,342,1,341,0.52%,0.29%
2020-01-01 00:04:20,7,2,136,0,136,0.21%,0.00%
2020-01-01 00:04:20,7,3,1481,14,1467,2.26%,0.94%
2020-01-01 00:04:20,7,4,1531,19,1512,2.34%,1.24%
2020-01-01 00:04:20,7,5,8784,483,8301,13.40%,5.50%
2020-01-01 00:04:20,7,6,13041,1163,11878,19.90%,8.92%
2020-01-01 00:04:20,7,7,2612,44,2568,3.99%,1.68%
2020-01-01 00:04:20,7,8,962,6,956,1.47%,0.62%
2020-01-01 00:04:20,7,9,7129,322,6807,10.88%,4.52%
2020-01-01 00:04:20,7,10,1766,16,1750,2.69%,0.91%
2020-01-01 00:04:20,7,11,84,0,84,0.13%,0.00%
2020-01-01 00:04:20,7,12,5349,195,5154,8.16%,3.64%
2020-01-01 00:04:20,8,1,430,1,429,0.66%,0.23%
2020-01-01 00:04:20,8,2,72,0,72,0.11%,0.00%
2020-01-01 00:04:20,8,3,1380,24,1356,2.11%,1.74%
2020-01-01 00:04:20,8,4,3084,61,3023,4.71%,1.98%
2020-01-01 00:04:20,8,5,7438,415,7023,11.35%,5.58%
2020-01-01 00:04:20,8,6,16127,1920,14207,24.61%,11.90%
2020-01-01 00:04:20,8,7,5498,246,5252,8.39%,4.47%
2020-01-01 00:04:20,8,8,2102,32,2070,3.21%,1.52%
2020-01-01 00:04:20,8,9,5842,244,5598,8.91%,4.18%
2020-01-01 00:04:20,8,10,1707,25,1682,2.60%,1.46%
2020-01-01 00:04:20,8,11,259,0,259,0.40%,0.00%
2020-01-01 00:04:20,8,12,4102,125,3977,6.26%,3.05%
2020-01-01 00:04:20,9,1,2278,12,2266,3.48%,0.53%
2020-01-01 00:04:20,9,2,7781,427,7354,11.87%,5.49%
2020-01-01 00:04:20,9,3,5015,182,4833,7.65%,3.63%
2020-01-01 00:04:20,9,4,7637,423,7214,11.65%,5.54%
2020-01-01 00:04:20,9,5,286,0,286,0.44%,0.00%
2020-01-01 00:04:20,9,6,8264,504,7760,12.61%,6.10%
2020-01-01 00:04:20,9,7,35031,7987,27044,53.45%,22.80%
2020-01-01 00:04:20,9,8,9815,734,9081,14.98%,7.48%
2020-01-01 00:04:20,9,9,161,0,161,0.25%,0.00%
2020-01-01 00:04:20,9,10,2168,36,2132,3.31%,1.66%
2020-01-01 00:04:20,9,11,8325,539,7786,12.70%,6.47%
2020-01-01 00:04:20,9,12,5813,261,5552,8.87%,4.49%
2020-01-01 00:04:20,10,1,1225,175,1050,1.87%,14.27%
2020-01-01 00:04:20,10,2,2541,221,2320,3.88%,8.69%
2020-01-01 00:04:20,10,3,1099,14,1085,1.68%,1.27%
2020-01-01 00:04:20,10,4,4186,630,3556,6.39%,15.05%
2020-01-01 00:04:20,10,5,651,0,651,0.99%,0.00%
2020-01-01 00:04:20,10,6,6158,755,5403,9.40%,12.26%
2020-01-01 00:04:20,10,7,10457,1436,9021,15.96%,13.73%
2020-01-01 00:04:20,10,8,29312,7074,22238,44.73%,24.13%
2020-01-01 00:04:20,10,9,544,1,543,0.83%,0.18%
2020-01-01 00:04:20,10,10,2762,57,2705,4.21%,2.06%
2020-01-01 00:04:20,10,11,14144,1902,12242,21.58%,13.45%
2020-01-01 00:04:20,10,12,10928,1381,9547,16.67%,12.64%
2020-01-01 00:04:20,11,1,2448,36,2412,3.74%,1.47%
2020-01-01 00:04:20,11,2,3434,81,3353,5.24%,2.36%
2020-01-01 00:04:20,11,3,876,8,868,1.34%,0.91%
2020-01-01 00:04:20,11,4,3382,82,3300,5.16%,2.42%
2020-01-01 00:04:20,11,5,175,1,174,0.27%,0.57%
2020-01-01 00:04:20,11,6,4240,135,4105,6.47%,3.18%
2020-01-01 00:04:20,11,7,9681,674,9007,14.77%,6.96%
2020-01-01 00:04:20,11,8,21762,3343,18419,33.21%,15.36%
2020-01-01 00:04:20,11,9,261,0,261,0.40%,0.00%
2020-01-01 00:04:20,11,10,2570,68,2502,3.92%,2.64%
2020-01-01 00:04:20,11,11,9315,632,8683,14.21%,6.78%
2020-01-01 00:04:20,11,12,6359,302,6057,9.70%,4.75%
2020-01-01 00:04:20,12,1,87,0,87,0.13%,0.00%
2020-01-01 00:04:20,12,2,725,212,513,1.11%,29.20%
2020-01-01 00:04:20,12,3,2435,237,2198,3.72%,9.73%
2020-01-01 00:04:20,12,4,2728,61,2667,4.16%,2.24%
2020-01-01 00:04:20,12,5,8534,656,7878,13.02%,7.69%
2020-01-01 00:04:20,12,6,5282,192,5090,8.06%,3.63%
2020-01-01 00:04:20,12,7,2422,53,2369,3.70%,2.19%
2020-01-01 00:04:20,12,8,952,334,618,1.45%,35.05%
2020-01-01 00:04:20,12,9,21379,4257,17122,32.62%,19.91%
2020-01-01 00:04:20,12,10,3560,419,3141,5.43%,11.77%
2020-01-01 00:04:20,12,11,1113,334,779,1.70%,29.98%
2020-01-01 00:04:20,12,12,8601,1352,7249,13.12%,15.72%
2020-01-01 00:04:20,13,1,2416,69,2347,3.69%,2.85%
2020-01-01 00:04:20,13,2,2739,80,2659,4.18%,2.92%
2020-01-01 00:04:20,13,3,583,6,577,0.89%,1.03%
2020-01-01 00:04:20,13,4,4914,453,4461,7.50%,9.22%
2020-01-01 00:04:20,13,5,6765,637,6128,10.32%,9.41%
2020-01-01 00:04:20,13,6,5442,479,4963,8.30%,8.80%
2020-01-01 00:04:20,13,7,5525,272,5253,8.43%,4.92%
2020-01-01 00:04:20,13,8,7485,447,7038,11.42%,5.97%
2020-01-01 00:04:20,13,9,7163,675,6488,10.93%,9.42%
2020-01-01 00:04:20,13,10,27403,5557,21846,41.81%,20.28%
2020-01-01 00:04:20,13,11,17509,2539,14970,26.72%,14.50%
2020-01-01 00:04:20,13,12,9587,1067,8520,14.63%,11.13%
2020-01-01 00:04:20,14,1,284,0,284,0.43%,0.00%
2020-01-01 00:04:20,14,2,1326,15,1311,2.02%,1.13%
2020-01-01 00:04:20,14,3,831,10,821,1.27%,1.20%
2020-01-01 00:04:20,14,4,4108,124,3984,6.27%,3.02%
2020-01-01 00:04:20,14,5,1314,10,1304,2.01%,0.76%
2020-01-01 00:04:20,14,6,4326,139,4187,6.60%,3.21%
2020-01-01 00:04:20,14,7,11147,818,10329,17.01%,7.34%
2020-01-01 00:04:20,14,8,12660,1061,11599,19.32%,8.38%
2020-01-01 00:04:20,14,9,1579,18,1561,2.41%,1.14%
2020-01-01 00:04:20,14,10,4332,152,4180,6.61%,3.51%
2020-01-01 00:04:20,14,11,25052,4118,20934,38.23%,16.44%
2020-01-01 00:04:20,14,12,7795,442,7353,11.89%,5.67%
2020-01-01 00:04:20,15,1,576,4,572,0.88%,0.69%
2020-01-01 00:04:20,15,2,286,1,285,0.44%,0.35%
2020-01-01 00:04:20,15,3,4602,172,4430,7.02%,3.74%
2020-01-01 00:04:20,15,4,4376,169,4207,6.68%,3.86%
2020-01-01 00:04:20,15,5,10761,875,9886,16.42%,8.13%
2020-01-01 00:04:20,15,6,4625,185,4440,7.06%,4.00%
2020-01-01 00:04:20,15,7,3817,129,3688,5.82%,3.38%
2020-01-01 00:04:20,15,8,5324,224,5100,8.12%,4.21%
2020-01-01 00:04:20,15,9,10972,905,10067,16.74%,8.25%
2020-01-01 00:04:20,15,10,3718,119,3599,5.67%,3.20%
2020-01-01 00:04:20,15,11,9184,659,8525,14.01%,7.17%
2020-01-01 00:04:20,15,12,26158,4876,21282,39.91%,18.64%
2020-01-01 00:04:20,16,1,337,1,336,0.51%,0.30%
2020-01-01 00:04:20,16,2,201,0,201,0.31%,0.00%
2020-01-01 00:04:20,16,3,1995,33,1962,3.04%,1.65%
2020-01-01 00:04:20,16,4,4332,159,4173,6.61%,3.67%
2020-01-01 00:04:20,16,5,8153,573,7580,12.44%,7.03%
2020-01-01 00:04:20,16,6,5065,202,4863,7.73%,3.99%
2020-01-01 00:04:20,16,7,3174,77,3097,4.84%,2.43%
2020-01-01 00:04:20,16,8,7425,490,6935,11.33%,6.60%
2020-01-01 00:04:20,16,9,8474,622,7852,12.93%,7.34%
2020-01-01 00:04:20,16,10,1625,21,1604,2.48%,1.29%
2020-01-01 00:04:20,16,11,9196,729,8467,14.03%,7.93%
2020-01-01 00:04:20,16,12,25540,4600,20940,38.97%,18.01%
2020-01-01 00:04:30,1,1,19550,2641,16909,29.83%,13.51%
2020-01-01 00:04:30,1,2,8587,508,8079,13.10%,5.92%
2020-01-01 00:04:30,1,3,1004,3,1001,1.53%,0.30%
2020-01-01 00:04:30,1,4,10470,800,9670,15.98%,7.64%
2020-01-01 00:04:30,1,5,10161,762,9399,15.50%,7.50%
2020-01-01 00:04:30,1,6,10155,760,9395,15.50%,7.48%
2020-01-01 00:04:30,1,7,7572,397,7175,11.55%,5.24%
2020-01-01 00:04:30,1,8,5687,209,5478,8.68%,3.67%
2020-01-01 00:04:30,1,9,10122,758,9364,15.44%,7.49%
2020-01-01 00:04:30,1,10,5153,182,4971,7.86%,3.53%
2020-01-01 00:04:30,1,11,5212,184,5028,7.95%,3.53%
2020-01-01 00:04:30,1,12,10094,756,9338,15.40%,7.49%
2020-01-01 00:04:30,2,1,473,1,472,0.72%,0.21%
2020-01-01 00:04:30,2,2,30858,6342,24516,47.09%,20.55%
2020-01-01 00:04:30,2,3,25344,4389,20955,38.67%,17.32%
2020-01-01 00:04:30,2,4,361,0,361,0.55%,0.00%
2020-01-01 00:04:30,2,5,15681,1768,13913,23.93%,11.27%
2020-01-01 00:04:30,2,6,40,0,40,0.06%,0.00%
2020-01-01 00:04:30,2,7,5013,192,4821,7.65%,3.83%
2020-01-01 00:04:30,2,8,3647,94,3553,5.56%,2.58%
2020-01-01 00:04:30,2,9,15532,1732,13800,23.70%,11.15%
2020-01-01 00:04:30,2,10,2960,62,2898,4.52%,2.09%
2020-01-01 00:04:30,2,11,2978,63,2915,4.54%,2.11%
2020-01-01 00:04:30,2,12,15359,1689,13670,23.44%,11.00%
2020-01-01 00:04:30,3,1,1590,12,1578,2.43%,0.75%
2020-01-01 00:04:30,3,2,22647,3426,19221,34.56%,15.13%
2020-01-01 00:04:30,3,3,69189,26358,42831,105.57%,38.10%
2020-01-01 00:04:30,3,4,4783,172,4611,7.30%,3.60%
2020-01-01 00:04:30,3,5,45796,12857,32939,69.88%,28.07%
2020-01-01 00:04:30,3,6,5860,241,5619,8.94%,4.11%
2020-01-01 00:04:30,3,7,19679,2626,17053,30.03%,13.34%
2020-01-01 00:04:30,3,8,17084,2007,15077,26.07%,11.75%
2020-01-01 00:04:30,3,9,39331,9811,29520,60.01%,24.94%
2020-01-01 00:04:30,3,10,5849,246,5603,8.92%,4.21%
2020-01-01 00:04:30,3,11,1765,30,1735,2.69%,1.70%
2020-01-01 00:04:30,3,12,30023,5946,24077,45.81%,19.80%
2020-01-01 00:04:30,4,1,583,2,581,0.89%,0.34%
2020-01-01 00:04:30,4,2,393,0,393,0.60%,0.00%
2020-01-01 00:04:30,4,3,622,4,618,0.95%,0.64%
2020-01-01 00:04:30,4,4,27342,5000,22342,41.72%,18.29%
2020-01-01 00:04:30,4,5,16823,2006,14817,25.67%,11.92%
2020-01-01 00:04:30,4,6,23319,3757,19562,35.58%,16.11%
2020-01-01 00:04:30,4,7,5009,184,4825,7.64%,3.67%
2020-01-01 00:04:30,4,8,2915,63,2852,4.45%,2.16%
2020-01-01 00:04:30,4,9,14865,1590,13275,22.68%,10.70%
2020-01-01 00:04:30,4,10,1973,29,1944,3.01%,1.47%
2020-01-01 00:04:30,4,11,263,0,263,0.40%,0.00%
2020-01-01 00:04:30,4,12,12308,1108,11200,18.78%,9.00%
2020-01-01 00:04:30,5,1,3060,73,2987,4.67%,2.38%
2020-01-01 00:04:30,5,2,1047,10,1037,1.60%,0.95%
2020-01-01 00:04:30,5,3,586,7,579,0.89%,1.19%
2020-01-01 00:04:30,5,4,21027,3045,17982,32.08%,14.48%
2020-01-01 00:04:30,5,5,9069,610,8459,13.84%,6.73%
2020-01-01 00:04:30,5,6,13768,1390,12378,21.01%,10.10%
2020-01-01 00:04:30,5,7,4248,146,4102,6.48%,3.44%
2020-01-01 00:04:30,5,8,3227,76,3151,4.92%,2.35%
2020-01-01 00:04:30,5,9,8351,507,7844,12.74%,6.07%
2020-01-01 00:04:30,5,10,1295,11,1284,1.98%,0.85%
2020-01-01 00:04:30,5,11,636,3,633,0.97%,0.47%
2020-01-01 00:04:30,5,12,6855,361,6494,10.46%,5.27%
2020-01-01 00:04:30,6,1,1296,14,1282,1.98%,1.08%
2020-01-01 00:04:30,6,2,1615,22,1593,2.46%,1.36%
2020-01-01 00:04:30,6,3,2246,35,2211,3.43%,1.56%
2020-01-01 00:04:30,6,4,1073,8,1065,1.64%,0.74%
2020-01-01 00:04:30,6,5,13017,1234,11783,19.86%,9.48%
2020-01-01 00:04:30,6,6,4947,190,4757,7.55%,3.84%
2020-01-01 00:04:30,6,7,3247,84,3163,4.95%,2.59%
2020-01-01 00:04:30,6,8,2741,60,2681,4.18%,2.19%
2020-01-01 00:04:30,6,9,5503,268,5235,8.40%,4.87%
2020-01-01 00:04:30,6,10,1880,24,1856,2.87%,1.28%
2020-01-01 00:04:30,6,11,372,0,372,0.57%,0.00%
2020-01-01 00:04:30,6,12,3587,145,3442,5.47%,4.04%
2020-01-01 00:04:30,7,1,411,5,406,0.63%,1.21%
2020-01-01 00:04:30,7,2,331,0,331,0.51%,0.00%
2020-01-01 00:04:30,7,3,488,7,481,0.74%,1.43%
2020-01-01 00:04:30,7,4,2126,54,2072,3.24%,2.54%
2020-01-01 00:04:30,7,5,6998,358,6640,10.68%,5.12%
2020-01-01 00:04:30,7,6,13019,1231,11788,19.87%,9.45%
2020-01-01 00:04:30,7,7,3821,117,3704,5.83%,3.06%
2020-01-01 00:04:30,7,8,1580,23,1557,2.41%,1.45%
2020-01-01 00:04:30,7,9,6116,271,5845,9.33%,4.43%
2020-01-01 00:04:30,7,10,1071,5,1066,1.63%,0.47%
2020-01-01 00:04:30,7,11,72,0,72,0.11%,0.00%
2020-01-01 00:04:30,7,12,5013,171,4842,7.65%,3.41%
2020-01-01 00:04:30,8,1,575,2,573,0.88%,0.35%
2020-01-01 00:04:30,8,2,58,0,58,0.09%,0.00%
2020-01-01 00:04:30,8,3,1621,23,1598,2.47%,1.42%
2020-01-01 00:04:30,8,4,3013,55,2958,4.60%,1.82%
2020-01-01 00:04:30,8,5,9241,602,8639,14.10%,6.51%
2020-01-01 00:04:30,8,6,17380,2117,15263,26.52%,12.18%
2020-01-01 00:04:30,8,7,4971,199,4772,7.59%,4.00%
2020-01-01 00:04:30,8,8,2043,34,2009,3.12%,1.66%
2020-01-01 00:04:30,8,9,7398,400,6998,11.29%,5.41%
2020-01-01 00:04:30,8,10,1703,18,1685,2.60%,1.06%
2020-01-01 00:04:30,8,11,132,0,132,0.20%,0.00%
2020-01-01 00:04:30,8,12,5657,240,5417,8.63%,4.24%
2020-01-01 00:04:30,9,1,463,2,461,0.71%,0.43%
2020-01-01 00:04:30,9,2,2217,45,2172,3.38%,2.03%
2020-01-01 00:04:30,9,3,1343,12,1331,2.05%,0.89%
2020-01-01 00:04:30,9,4,5966,257,5709,9.10%,4.31%
2020-01-01 00:04:30,9,5,582,2,580,0.89%,0.34%
2020-01-01 00:04:30,9,6,7335,403,6932,11.19%,5.49%
2020-01-01 00:04:30,9,7,30176,6029,24147,46.04%,19.98%
2020-01-01 00:04:30,9,8,13268,1276,11992,20.25%,9.62%
2020-01-01 00:04:30,9,9,264,0,264,0.40%,0.00%
2020-01-01 00:04:30,9,10,5334,202,5132,8.14%,3.79%
2020-01-01 00:04:30,9,11,11742,1010,10732,17.92%,8.60%
2020-01-01 00:04:30,9,12,5951,277,5674,9.08%,4.65%
2020-01-01 00:04:30,10,1,1445,217,1228,2.20%,15.01%
2020-01-01 00:04:30,10,2,3294,277,3017,5.03%,8.41%
2020-01-01 00:04:30,10,3,1712,20,1692,2.61%,1.17%
2020-01-01 00:04:30,10,4,3919,1129,2790,5.98%,28.80%
2020-01-01 00:04:30,10,5,967,112,855,1.48%,11.57%
2020-01-01 00:04:30,10,6,5905,1343,4562,9.01%,22.74%
2020-01-01 00:04:30,10,7,10515,1967,8548,16.04%,18.70%
2020-01-01 00:04:30,10,8,28324,7211,21113,43.22%,25.46%
2020-01-01 00:04:30,10,9,653,2,651,1.00%,0.31%
2020-01-01 00:04:30,10,10,2072,34,2038,3.16%,1.64%
2020-01-01 00:04:30,10,11,13835,1686,12149,21.11%,12.19%
2020-01-01 00:04:30,10,12,10937,1241,9696,16.69%,11.35%
2020-01-01 00:04:30,11,1,2453,43,2410,3.74%,1.75%
2020-01-01 00:04:30,11,2,6003,273,5730,9.16%,4.55%
2020-01-01 00:04:30,11,3,3392,91,3301,5.18%,2.68%
2020-01-01 00:04:30,11,4,3336,111,3225,5.09%,3.33%
2020-01-01 00:04:30,11,5,337,1,336,0.51%,0.30%
2020-01-01 00:04:30,11,6,4638,190,4448,7.08%,4.10%
2020-01-01 00:04:30,11,7,12360,1157,11203,18.86%,9.36%
2020-01-01 00:04:30,11,8,27153,4999,22154,41.43%,18.41%
2020-01-01 00:04:30,11,9,155,1,154,0.24%,0.64%
2020-01-01 00:04:30,11,10,2776,55,2721,4.24%,1.98%
2020-01-01 00:04:30,11,11,10365,744,9621,15.82%,7.18%
2020-01-01 00:04:30,11,12,7003,321,6682,10.69%,4.58%
2020-01-01 00:04:30,12,1,50,0,50,0.08%,0.00%
2020-01-01 00:04:30,12,2,483,115,368,0.74%,23.76%
2020-01-01 00:04:30,12,3,3352,190,3162,5.11%,5.67%
2020-01-01 00:04:30,12,4,2680,55,2625,4.09%,2.05%
2020-01-01 00:04:30,12,5,8333,584,7749,12.72%,7.01%
2020-01-01 00:04:30,12,6,4334,144,4190,6.61%,3.32%
2020-01-01 00:04:30,12,7,1539,23,1516,2.35%,1.49%
2020-01-01 00:04:30,12,8,1941,335,1606,2.96%,17.25%
2020-01-01 00:04:30,12,9,23025,4496,18529,35.13%,19.53%
2020-01-01 00:04:30,12,10,4730,452,4278,7.22%,9.55%
2020-01-01 00:04:30,12,11,2309,343,1966,3.52%,14.85%
2020-01-01 00:04:30,12,12,9279,1425,7854,14.16%,15.36%
2020-01-01 00:04:30,13,1,2011,30,1981,3.07%,1.49%
2020-01-01 00:04:30,13,2,2411,44,2367,3.68%,1.82%
2020-01-01 00:04:30,13,3,694,1,693,1.06%,0.14%
2020-01-01 00:04:30,13,4,4999,806,4193,7.63%,16.12%
2020-01-01 00:04:30,13,5,7644,1186,6458,11.66%,15.51%
2020-01-01 00:04:30,13,6,5567,838,4729,8.49%,15.05%
2020-01-01 00:04:30,13,7,4447,140,4307,6.79%,3.15%
2020-01-01 00:04:30,13,8,6530,316,6214,9.96%,4.84%
2020-01-01 00:04:30,13,9,7935,1217,6718,12.11%,15.34%
2020-01-01 00:04:30,13,10,27573,5699,21874,42.07%,20.67%
2020-01-01 00:04:30,13,11,17478,2267,15211,26.67%,12.97%
2020-01-01 00:04:30,13,12,10525,961,9564,16.06%,9.13%
2020-01-01 00:04:30,14,1,188,1,187,0.29%,0.53%
2020-01-01 00:04:30,14,2,1074,8,1066,1.64%,0.74%
2020-01-01 00:04:30,14,3,720,6,714,1.10%,0.83%
2020-01-01 00:04:30,14,4,3937,168,3769,6.01%,4.27%
2020-01-01 00:04:30,14,5,841,5,836,1.28%,0.59%
2020-01-01 00:04:30,14,6,4293,188,4105,6.55%,4.38%
2020-01-01 00:04:30,14,7,11587,986,10601,17.68%,8.51%
2020-01-01 00:04:30,14,8,13528,1371,12157,20.64%,10.13%
2020-01-01 00:04:30,14,9,1047,11,1036,1.60%,1.05%
2020-01-01 00:04:30,14,10,4069,151,3918,6.21%,3.71%
2020-01-01 00:04:30,14,11,26609,4877,21732,40.60%,18.33%
2020-01-01 00:04:30,14,12,8635,507,8128,13.18%,5.87%
2020-01-01 00:04:30,15,1,610,3,607,0.93%,0.49%
2020-01-01 00:04:30,15,2,154,0,154,0.23%,0.00%
2020-01-01 00:04:30,15,3,6967,322,6645,10.63%,4.62%
2020-01-01 00:04:30,15,4,4649,318,4331,7.09%,6.84%
2020-01-01 00:04:30,15,5,12594,1261,11333,19.22%,10.01%
2020-01-01 00:04:30,15,6,4895,382,4513,7.47%,7.80%
2020-01-01 00:04:30,15,7,3584,95,3489,5.47%,2.65%
2020-01-01 00:04:30,15,8,5533,247,5286,8.44%,4.46%
2020-01-01 00:04:30,15,9,12752,1294,11458,19.46%,10.15%
2020-01-01 00:04:30,15,10,5828,426,5402,8.89%,7.31%
2020-01-01 00:04:30,15,11,11629,1137,10492,17.74%,9.78%
2020-01-01 00:04:30,15,12,29749,6458,23291,45.39%,21.71%
2020-01-01 00:04:30,16,1,390,1,389,0.60%,0.26%
2020-01-01 00:04:30,16,2,231,0,231,0.35%,0.00%
2020-01-01 00:04:30,16,3,1218,15,1203,1.86%,1.23%
2020-01-01 00:04:30,16,4,4108,108,4000,6.27%,2.63%
2020-01-01 00:04:30,16,5,7990,517,7473,12.19%,6.47%
2020-01-01 00:04:30,16,6,5123,192,4931,7.82%,3.75%
2020-01-01 00:04:30,16,7,3483,96,3387,5.31%,2.76%
2020-01-01 00:04:30,16,8,7443,495,6948,11.36%,6.65%
2020-01-01 00:04:30,16,9,8392,557,7835,12.81%,6.64%
2020-01-01 00:04:30,16,10,1537,18,1519,2.35%,1.17%
2020-01-01 00:04:30,16,11,9204,719,8485,14.04%,7.81%
2020-01-01 00:04:30,16,12,26010,4604,21406,39.69%,17.70%
2020-01-01 00:04:40,1,1,20864,3081,17783,31.84%,14.77%
2020-01-01 00:04:40,1,2,9763,682,9081,14.90%,6.98%
2020-01-01 00:04:40,1,3,516,5,511,0.79%,0.97%
2020-01-01 00:04:40,1,4,10831,896,9935,16.53%,8.27%
2020-01-01 00:04:40,1,5,10488,853,9635,16.00%,8.13%
2020-01-01 00:04:40,1,6,10455,846,9609,15.95%,8.09%
2020-01-01 00:04:40,1,7,9235,613,8622,14.09%,6.64%
2020-01-01 00:04:40,1,8,6466,302,6164,9.87%,4.67%
2020-01-01 00:04:40,1,9,10392,837,9555,15.86%,8.05%
2020-01-01 00:04:40,1,10,5844,249,5595,8.92%,4.26%
2020-01-01 00:04:40,1,11,5949,261,5688,9.08%,4.39%
2020-01-01 00:04:40,1,12,10368,835,9533,15.82%,8.05%
2020-01-01 00:04:40,2,1,557,2,555,0.85%,0.36%
2020-01-01 00:04:40,2,2,34054,7444,26610,51.96%,21.86%
2020-01-01 00:04:40,2,3,28458,5393,23065,43.42%,18.95%
2020-01-01 00:04:40,2,4,437,0,437,0.67%,0.00%
2020-01-01 00:04:40,2,5,16865,2002,14863,25.73%,11.87%
2020-01-01 00:04:40,2,6,37,0,37,0.06%,0.00%
2020-01-01 00:04:40,2,7,5024,161,4863,7.67%,3.20%
2020-01-01 00:04:40,2,8,3857,87,3770,5.89%,2.26%
2020-01-01 00:04:40,2,9,16455,1897,14558,25.11%,11.53%
2020-01-01 00:04:40,2,10,2592,43,2549,3.96%,1.66%
2020-01-01 00:04:40,2,11,2604,43,2561,3.97%,1.65%
2020-01-01 00:04:40,2,12,16170,1837,14333,24.67%,11.36%
2020-01-01 00:04:40,3,1,1764,20,1744,2.69%,1.13%
2020-01-01 00:04:40,3,2,22670,3502,19168,34.59%,15.45%
2020-01-01 00:04:40,3,3,65845,24434,41411,100.47%,37.11%
2020-01-01 00:04:40,3,4,5716,227,5489,8.72%,3.97%
2020-01-01 00:04:40,3,5,41714,10928,30786,63.65%,26.20%
2020-01-01 00:04:40,3,6,6428,290,6138,9.81%,4.51%
2020-01-01 00:04:40,3,7,19343,2595,16748,29.52%,13.42%
2020-01-01 00:04:40,3,8,16465,1913,14552,25.12%,11.62%
2020-01-01 00:04:40,3,9,34901,7897,27004,53.25%,22.63%
2020-01-01 00:04:40,3,10,5262,215,5047,8.03%,4.09%
2020-01-01 00:04:40,3,11,2512,45,2467,3.83%,1.79%
2020-01-01 00:04:40,3,12,26606,4818,21788,40.60%,18.11%
2020-01-01 00:04:40,4,1,522,1,521,0.80%,0.19%
2020-01-01 00:04:40,4,2,266,0,266,0.41%,0.00%
2020-01-01 00:04:40,4,3,1031,10,1021,1.57%,0.97%
2020-01-01 00:04:40,4,4,28049,5188,22861,42.80%,18.50%
2020-01-01 00:04:40,4,5,18536,2326,16210,28.28%,12.55%
2020-01-01 00:04:40,4,6,24233,3929,20304,36.98%,16.21%
2020-01-01 00:04:40,4,7,4332,140,4192,6.61%,3.23%
2020-01-01 00:04:40,4,8,2952,66,2886,4.50%,2.24%
2020-01-01 00:04:40,4,9,16346,1846,14500,24.94%,11.29%
2020-01-01 00:04:40,4,10,2337,50,2287,3.57%,2.14%
2020-01-01 00:04:40,4,11,162,1,161,0.25%,0.61%
2020-01-01 00:04:40,4,12,13202,1209,11993,20.14%,9.16%
2020-01-01 00:04:40,5,1,2784,52,2732,4.25%,1.87%
2020-01-01 00:04:40,5,2,998,9,989,1.52%,0.90%
2020-01-01 00:04:40,5,3,2402,35,2367,3.67%,1.46%
2020-01-01 00:04:40,5,4,27300,4968,22332,41.66%,18.20%
2020-01-01 00:04:40,5,5,11779,1018,10761,17.97%,8.64%
2020-01-01 00:04:40,5,6,18204,2341,15863,27.78%,12.86%
2020-01-01 00:04:40,5,7,5855,275,5580,8.93%,4.70%
2020-01-01 00:04:40,5,8,4850,196,4654,7.40%,4.04%
2020-01-01 00:04:40,5,9,9109,613,8496,13.90%,6.73%
2020-01-01 00:04:40,5,10,1338,20,1318,2.04%,1.49%
2020-01-01 00:04:40,5,11,1218,19,1199,1.86%,1.56%
2020-01-01 00:04:40,5,12,7485,425,7060,11.42%,5.68%
2020-01-01 00:04:40,6,1,990,3,987,1.51%,0.30%
2020-01-01 00:04:40,6,2,1095,7,1088,1.67%,0.64%
2020-01-01 00:04:40,6,3,1382,10,1372,2.11%,0.72%
2020-01-01 00:04:40,6,4,1387,13,1374,2.12%,0.94%
2020-01-01 00:04:40,6,5,16500,1836,14664,25.18%,11.13%
2020-01-01 00:04:40,6,6,4900,168,4732,7.48%,3.43%
2020-01-01 00:04:40,6,7,2867,64,2803,4.37%,2.23%
2020-01-01 00:04:40,6,8,2280,47,2233,3.48%,2.06%
2020-01-01 00:04:40,6,9,9963,700,9263,15.20%,7.03%
2020-01-01 00:04:40,6,10,1969,39,1930,3.00%,1.98%
2020-01-01 00:04:40,6,11,467,0,467,0.71%,0.00%
2020-01-01 00:04:40,6,12,7928,447,7481,12.10%,5.64%
2020-01-01 00:04:40,7,1,467,4,463,0.71%,0.85%
2020-01-01 00:04:40,7,2,139,0,139,0.21%,0.00%
2020-01-01 00:04:40,7,3,1500,7,1493,2.29%,0.47%
2020-01-01 00:04:40,7,4,1524,20,1504,2.33%,1.31%
2020-01-01 00:04:40,7,5,7923,453,7470,12.09%,5.72%
2020-01-01 00:04:40,7,6,13309,1258,12051,20.31%,9.45%
2020-01-01 00:04:40,7,7,3826,114,3712,5.84%,2.98%
2020-01-01 00:04:40,7,8,1175,18,1157,1.79%,1.53%
2020-01-01 00:04:40,7,9,6288,293,5995,9.59%,4.66%
2020-01-01 00:04:40,7,10,1363,9,1354,2.08%,0.66%
2020-01-01 00:04:40,7,11,124,0,124,0.19%,0.00%
2020-01-01 00:04:40,7,12,4911,195,4716,7.49%,3.97%
2020-01-01 00:04:40,8,1,442,4,438,0.67%,0.90%
2020-01-01 00:04:40,8,2,62,0,62,0.09%,0.00%
2020-01-01 00:04:40,8,3,1389,16,1373,2.12%,1.15%
2020-01-01 00:04:40,8,4,2725,60,2665,4.16%,2.20%
2020-01-01 00:04:40,8,5,7951,476,7475,12.13%,5.99%
2020-01-01 00:04:40,8,6,16269,1851,14418,24.82%,11.38%
2020-01-01 00:04:40,8,7,5482,240,5242,8.36%,4.38%
2020-01-01 00:04:40,8,8,2081,39,2042,3.18%,1.87%
2020-01-01 00:04:40,8,9,6126,272,5854,9.35%,4.44%
2020-01-01 00:04:40,8,10,1771,17,1754,2.70%,0.96%
2020-01-01 00:04:40,8,11,323,0,323,0.49%,0.00%
2020-01-01 00:04:40,8,12,4210,145,4065,6.42%,3.44%
2020-01-01 00:04:40,9,1,300,0,300,0.46%,0.00%
2020-01-01 00:04:40,9,2,1859,28,1831,2.84%,1.51%
2020-01-01 00:04:40,9,3,1165,10,1155,1.78%,0.86%
2020-01-01 00:04:40,9,4,6860,335,6525,10.47%,4.88%
2020-01-01 00:04:40,9,5,744,5,739,1.14%,0.67%
2020-01-01 00:04:40,9,6,8430,515,7915,12.86%,6.11%
2020-01-01 00:04:40,9,7,26655,4830,21825,40.67%,18.12%
2020-01-01 00:04:40,9,8,9725,729,8996,14.84%,7.50%
2020-01-01 00:04:40,9,9,217,0,217,0.33%,0.00%
2020-01-01 00:04:40,9,10,3276,77,3199,5.00%,2.35%
2020-01-01 00:04:40,9,11,8684,575,8109,13.25%,6.62%
2020-01-01 00:04:40,9,12,5148,208,4940,7.86%,4.04%
2020-01-01 00:04:40,10,1,1304,428,876,1.99%,32.80%
2020-01-01 00:04:40,10,2,3727,503,3224,5.69%,13.49%
2020-01-01 00:04:40,10,3,2272,41,2231,3.47%,1.80%
2020-01-01 00:04:40,10,4,4241,910,3331,6.47%,21.45%
2020-01-01 00:04:40,10,5,642,9,633,0.98%,1.40%
2020-01-01 00:04:40,10,6,5899,1018,4881,9.00%,17.25%
2020-01-01 00:04:40,10,7,11514,1963,9551,17.57%,17.05%
2020-01-01 00:04:40,10,8,27664,6847,20817,42.21%,24.75%
2020-01-01 00:04:40,10,9,669,4,665,1.02%,0.60%
2020-01-01 00:04:40,10,10,2232,47,2185,3.41%,2.10%
2020-01-01 00:04:40,10,11,12803,1685,11118,19.54%,13.16%
2020-01-01 00:04:40,10,12,9763,1218,8545,14.90%,12.47%
2020-01-01 00:04:40,11,1,2420,54,2366,3.69%,2.23%
2020-01-01 00:04:40,11,2,3457,91,3366,5.27%,2.63%
2020-01-01 00:04:40,11,3,915,9,906,1.40%,0.98%
2020-01-01 00:04:40,11,4,3346,89,3257,5.11%,2.66%
2020-01-01 00:04:40,11,5,549,2,547,0.84%,0.36%
2020-01-01 00:04:40,11,6,4725,174,4551,7.21%,3.68%
2020-01-01 00:04:40,11,7,10096,720,9376,15.41%,7.13%
2020-01-01 00:04:40,11,8,24467,3955,20512,37.33%,16.16%
2020-01-01 00:04:40,11,9,253,0,253,0.39%,0.00%
2020-01-01 00:04:40,11,10,3187,78,3109,4.86%,2.45%
2020-01-01 00:04:40,11,11,9970,716,9254,15.21%,7.18%
2020-01-01 00:04:40,11,12,6569,311,6258,10.02%,4.73%
2020-01-01 00:04:40,12,1,30,0,30,0.05%,0.00%
2020-01-01 00:04:40,12,2,716,262,454,1.09%,36.54%
2020-01-01 00:04:40,12,3,3343,332,3011,5.10%,9.93%
2020-01-01 00:04:40,12,4,3122,65,3057,4.76%,2.08%
2020-01-01 00:04:40,12,5,10188,946,9242,15.55%,9.28%
2020-01-01 00:04:40,12,6,6130,233,5897,9.35%,3.80%
2020-01-01 00:04:40,12,7,2876,53,2823,4.39%,1.84%
2020-01-01 00:04:40,12,8,1299,202,1097,1.98%,15.54%
2020-01-01 00:04:40,12,9,21843,4163,17680,33.33%,19.06%
2020-01-01 00:04:40,12,10,3985,301,3684,6.08%,7.55%
2020-01-01 00:04:40,12,11,1524,207,1317,2.33%,13.57%
2020-01-01 00:04:40,12,12,7045,857,6188,10.75%,12.16%
2020-01-01 00:04:40,13,1,2230,43,2187,3.40%,1.93%
2020-01-01 00:04:40,13,2,2609,60,2549,3.98%,2.30%
2020-01-01 00:04:40,13,3,896,11,885,1.37%,1.23%
2020-01-01 00:04:40,13,4,5000,552,4448,7.63%,11.04%
2020-01-01 00:04:40,13,5,7305,898,6407,11.15%,12.29%
2020-01-01 00:04:40,13,6,5703,601,5102,8.70%,10.54%
2020-01-01 00:04:40,13,7,4946,171,4775,7.55%,3.46%
2020-01-01 00:04:40,13,8,6889,343,6546,10.51%,4.98%
2020-01-01 00:04:40,13,9,7619,929,6690,11.63%,12.19%
2020-01-01 00:04:40,13,10,26956,5474,21482,41.13%,20.31%
2020-01-01 00:04:40,13,11,16432,2148,14284,25.07%,13.07%
2020-01-01 00:04:40,13,12,8929,914,8015,13.62%,10.24%
2020-01-01 00:04:40,14,1,499,2,497,0.76%,0.40%
2020-01-01 00:04:40,14,2,1941,42,1899,2.96%,2.16%
2020-01-01 00:04:40,14,3,1211,28,1183,1.85%,2.31%
2020-01-01 00:04:40,14,4,5884,254,5630,8.98%,4.32%
2020-01-01 00:04:40,14,5,1418,16,1402,2.16%,1.13%
2020-01-01 00:04:40,14,6,6429,305,6124,9.81%,4.74%
2020-01-01 00:04:40,14,7,14043,1400,12643,21.43%,9.97%
2020-01-01 00:04:40,14,8,15388,1654,13734,23.48%,10.75%
2020-01-01 00:04:40,14,9,1653,20,1633,2.52%,1.21%
2020-01-01 00:04:40,14,10,4239,130,4109,6.47%,3.07%
2020-01-01 00:04:40,14,11,26801,4706,22095,40.90%,17.56%
2020-01-01 00:04:40,14,12,6860,349,6511,10.47%,5.09%
2020-01-01 00:04:40,15,1,397,0,397,0.61%,0.00%
2020-01-01 00:04:40,15,2,169,0,169,0.26%,0.00%
2020-01-01 00:04:40,15,3,4856,196,4660,7.41%,4.04%
2020-01-01 00:04:40,15,4,4681,156,4525,7.14%,3.33%
2020-01-01 00:04:40,15,5,10353,762,9591,15.80%,7.36%
2020-01-01 00:04:40,15,6,4885,175,4710,7.45%,3.58%
2020-01-01 00:04:40,15,7,3619,100,3519,5.52%,2.76%
2020-01-01 00:04:40,15,8,5276,249,5027,8.05%,4.72%
2020-01-01 00:04:40,15,9,10553,780,9773,16.10%,7.39%
2020-01-01 00:04:40,15,10,4241,165,4076,6.47%,3.89%
2020-01-01 00:04:40,15,11,9650,721,8929,14.72%,7.47%
2020-01-01 00:04:40,15,12,25935,4795,21140,39.57%,18.49%
2020-01-01 00:04:40,16,1,316,0,316,0.48%,0.00%
2020-01-01 00:04:40,16,2,260,0,260,0.40%,0.00%
2020-01-01 00:04:40,16,3,1450,12,1438,2.21%,0.83%
2020-01-01 00:04:40,16,4,4149,167,3982,6.33%,4.02%
2020-01-01 00:04:40,16,5,7861,539,7322,11.99%,6.86%
2020-01-01 00:04:40,16,6,5009,229,4780,7.64%,4.57%
2020-01-01 00:04:40,16,7,3464,96,3368,5.29%,2.77%
2020-01-01 00:04:40,16,8,7534,436,7098,11.50%,5.79%
2020-01-01 00:04:40,16,9,8282,590,7692,12.64%,7.12%
2020-01-01 00:04:40,16,10,2084,28,2056,3.18%,1.34%
2020-01-01 00:04:40,16,11,9838,700,9138,15.01%,7.11%
2020-01-01 00:04:40,16,12,27490,5104,22386,41.95%,18.57%
2020-01-01 00:04:50,1,1,21136,3127,18009,32.25%,14.79%
2020-01-01 00:04:50,1,2,8923,558,8365,13.62%,6.25%
2020-01-01 00:04:50,1,3,409,1,408,0.62%,0.24%
2020-01-01 00:04:50,1,4,11764,1060,10704,17.95%,9.01%
2020-01-01 00:04:50,1,5,11450,1019,10431,17.47%,8.90%
2020-01-01 00:04:50,1,6,11414,1016,10398,17.42%,8.90%
2020-01-01 00:04:50,1,7,8501,518,7983,12.97%,6.09%
2020-01-01 00:04:50,1,8,7013,344,6669,10.70%,4.90%
2020-01-01 00:04:50,1,9,11352,1005,10347,17.32%,8.85%
2020-01-01 00:04:50,1,10,6449,287,6162,9.84%,4.45%
2020-01-01 00:04:50,1,11,6533,295,6238,9.97%,4.51%
2020-01-01 00:04:50,1,12,11327,1001,10326,17.28%,8.84%
2020-01-01 00:04:50,2,1,1500,9,1491,2.29%,0.60%
2020-01-01 00:04:50,2,2,27594,5094,22500,42.11%,18.46%
2020-01-01 00:04:50,2,3,20380,2843,17537,31.10%,13.95%
2020-01-01 00:04:50,2,4,1404,8,1396,2.14%,0.57%
2020-01-01 00:04:50,2,5,13305,1226,12079,20.30%,9.21%
2020-01-01 00:04:50,2,6,28,0,28,0.04%,0.00%
2020-01-01 00:04:50,2,7,5699,251,5448,8.70%,4.40%
2020-01-01 00:04:50,2,8,4589,155,4434,7.00%,3.38%
2020-01-01 00:04:50,2,9,13093,1191,11902,19.98%,9.10%
2020-01-01 00:04:50,2,10,3639,89,3550,5.55%,2.45%
2020-01-01 00:04:50,2,11,3686,93,3593,5.62%,2.52%
2020-01-01 00:04:50,2,12,12912,1145,11767,19.70%,8.87%
2020-01-01 00:04:50,3,1,1536,11,1525,2.34%,0.72%
2020-01-01 00:04:50,3,2,25342,4327,21015,38.67%,17.07%
2020-01-01 00:04:50,3,3,65311,24144,41167,99.66%,36.97%
2020-01-01 00:04:50,3,4,6603,344,6259,10.08%,5.21%
2020-01-01 00:04:50,3,5,38008,9252,28756,58.00%,24.34%
2020-01-01 00:04:50,3,6,7977,484,7493,12.17%,6.07%
2020-01-01 00:04:50,3,7,22175,3379,18796,33.84%,15.24%
2020-01-01 00:04:50,3,8,18158,2314,15844,27.71%,12.74%
2020-01-01 00:04:50,3,9,29377,5798,23579,44.83%,19.74%
2020-01-01 00:04:50,3,10,4576,167,4409,6.98%,3.65%
2020-01-01 00:04:50,3,11,2605,60,2545,3.97%,2.30%
2020-01-01 00:04:50,3,12,21881,3316,18565,33.39%,15.15%
2020-01-01 00:04:50,4,1,551,5,546,0.84%,0.91%
2020-01-01 00:04:50,4,2,372,2,370,0.57%,0.54%
2020-01-01 00:04:50,4,3,992,11,981,1.51%,1.11%
2020-01-01 00:04:50,4,4,28366,5310,23056,43.28%,18.72%
2020-01-01 00:04:50,4,5,18397,2345,16052,28.07%,12.75%
2020-01-01 00:04:50,4,6,24432,4005,20427,37.28%,16.39%
2020-01-01 00:04:50,4,7,4891,166,4725,7.46%,3.39%
2020-01-01 00:04:50,4,8,2827,53,2774,4.31%,1.87%
2020-01-01 00:04:50,4,9,16043,1783,14260,24.48%,11.11%
2020-01-01 00:04:50,4,10,1981,42,1939,3.02%,2.12%
2020-01-01 00:04:50,4,11,141,0,141,0.22%,0.00%
2020-01-01 00:04:50,4,12,13237,1215,12022,20.20%,9.18%
2020-01-01 00:04:50,5,1,3015,69,2946,4.60%,2.29%
2020-01-01 00:04:50,5,2,930,3,927,1.42%,0.32%
2020-01-01 00:04:50,5,3,555,3,552,0.85%,0.54%
2020-01-01 00:04:50,5,4,24425,4088,20337,37.27%,16.74%
2020-01-01 00:04:50,5,5,11189,940,10249,17.07%,8.40%
2020-01-01 00:04:50,5,6,17273,2081,15192,26.36%,12.05%
2020-01-01 00:04:50,5,7,5401,218,5183,8.24%,4.04%
2020-01-01 00:04:50,5,8,4149,122,4027,6.33%,2.94%
2020-01-01 00:04:50,5,9,10478,817,9661,15.99%,7.80%
2020-01-01 00:04:50,5,10,1247,12,1235,1.90%,0.96%
2020-01-01 00:04:50,5,11,1075,7,1068,1.64%,0.65%
2020-01-01 00:04:50,5,12,8964,616,8348,13.68%,6.87%
2020-01-01 00:04:50,6,1,1029,14,1015,1.57%,1.36%
2020-01-01 00:04:50,6,2,1105,14,1091,1.69%,1.27%
2020-01-01 00:04:50,6,3,1707,28,1679,2.60%,1.64%
2020-01-01 00:04:50,6,4,1356,15,1341,2.07%,1.11%
2020-01-01 00:04:50,6,5,18360,2325,16035,28.02%,12.66%
2020-01-01 00:04:50,6,6,4533,193,4340,6.92%,4.26%
2020-01-01 00:04:50,6,7,2820,80,2740,4.30%,2.84%
2020-01-01 00:04:50,6,8,2302,61,2241,3.51%,2.65%
2020-01-01 00:04:50,6,9,11689,967,10722,17.84%,8.27%
2020-01-01 00:04:50,6,10,3111,62,3049,4.75%,1.99%
2020-01-01 00:04:50,6,11,457,1,456,0.70%,0.22%
2020-01-01 00:04:50,6,12,8526,554,7972,13.01%,6.50%
2020-01-01 00:04:50,7,1,391,3,388,0.60%,0.77%
2020-01-01 00:04:50,7,2,198,5,193,0.30%,2.51%
2020-01-01 00:04:50,7,3,1454,16,1438,2.22%,1.10%
2020-01-01 00:04:50,7,4,1466,20,1446,2.24%,1.36%
2020-01-01 00:04:50,7,5,8535,585,7950,13.02%,6.85%
2020-01-01 00:04:50,7,6,13411,1308,12103,20.46%,9.75%
2020-01-01 00:04:50,7,7,3320,90,3230,5.07%,2.71%
2020-01-01 00:04:50,7,8,1016,10,1006,1.55%,0.98%
2020-01-01 00:04:50,7,9,6963,385,6578,10.62%,5.53%
2020-01-01 00:04:50,7,10,1343,16,1327,2.05%,1.19%
2020-01-01 00:04:50,7,11,121,1,120,0.18%,0.82%
2020-01-01 00:04:50,7,12,5599,242,5357,8.54%,4.32%
2020-01-01 00:04:50,8,1,427,1,426,0.65%,0.23%
2020-01-01 00:04:50,8,2,104,0,104,0.16%,0.00%
2020-01-01 00:04:50,8,3,1726,21,1705,2.63%,1.22%
2020-01-01 00:04:50,8,4,2502,50,2452,3.82%,2.00%
2020-01-01 00:04:50,8,5,8410,525,7885,12.83%,6.24%
2020-01-01 00:04:50,8,6,16212,1847,14365,24.74%,11.39%
2020-01-01 00:04:50,8,7,5242,191,5051,8.00%,3.64%
2020-01-01 00:04:50,8,8,1974,31,1943,3.01%,1.57%
2020-01-01 00:04:50,8,9,6434,295,6139,9.82%,4.58%
2020-01-01 00:04:50,8,10,1715,15,1700,2.62%,0.87%
2020-01-01 00:04:50,8,11,252,0,252,0.38%,0.00%
2020-01-01 00:04:50,8,12,4417,139,4278,6.74%,3.15%
2020-01-01 00:04:50,9,1,544,1,543,0.83%,0.18%
2020-01-01 00:04:50,9,2,2881,58,2823,4.40%,2.01%
2020-01-01 00:04:50,9,3,1510,10,1500,2.30%,0.66%
2020-01-01 00:04:50,9,4,7785,434,7351,11.88%,5.57%
2020-01-01 00:04:50,9,5,587,2,585,0.90%,0.34%
2020-01-01 00:04:50,9,6,8829,551,8278,13.47%,6.24%
2020-01-01 00:04:50,9,7,28125,5234,22891,42.92%,18.61%
2020-01-01 00:04:50,9,8,10092,735,9357,15.40%,7.28%
2020-01-01 00:04:50,9,9,220,0,220,0.34%,0.00%
2020-01-01 00:04:50,9,10,2800,81,2719,4.27%,2.89%
2020-01-01 00:04:50,9,11,8654,566,8088,13.20%,6.54%
2020-01-01 00:04:50,9,12,5534,219,5315,8.44%,3.96%
2020-01-01 00:04:50,10,1,1081,310,771,1.65%,28.65%
2020-01-01 00:04:50,10,2,2821,360,2461,4.30%,12.76%
2020-01-01 00:04:50,10,3,1413,21,1392,2.16%,1.49%
2020-01-01 00:04:50,10,4,4810,1118,3692,7.34%,23.24%
2020-01-01 00:04:50,10,5,720,5,715,1.10%,0.69%
2020-01-01 00:04:50,10,6,6828,1262,5566,10.42%,18.48%
2020-01-01 00:04:50,10,7,11735,2189,9546,17.91%,18.65%
2020-01-01 00:04:50,10,8,29280,7501,21779,44.68%,25.62%
2020-01-01 00:04:50,10,9,681,2,679,1.04%,0.29%
2020-01-01 00:04:50,10,10,2269,28,2241,3.46%,1.23%
2020-01-01 00:04:50,10,11,12351,1393,10958,18.85%,11.28%
2020-01-01 00:04:50,10,12,9259,937,8322,14.13%,10.12%
2020-01-01 00:04:50,11,1,2181,28,2153,3.33%,1.28%
2020-01-01 00:04:50,11,2,3409,83,3326,5.20%,2.43%
2020-01-01 00:04:50,11,3,1075,10,1065,1.64%,0.93%
2020-01-01 00:04:50,11,4,3771,172,3599,5.75%,4.56%
2020-01-01 00:04:50,11,5,465,0,465,0.71%,0.00%
2020-01-01 00:04:50,11,6,4749,235,4514,7.25%,4.95%
2020-01-01 00:04:50,11,7,10094,810,9284,15.40%,8.02%
2020-01-01 00:04:50,11,8,24876,4280,20596,37.96%,17.20%
2020-01-01 00:04:50,11,9,475,3,472,0.72%,0.63%
2020-01-01 00:04:50,11,10,3725,114,3611,5.68%,3.06%
2020-01-01 00:04:50,11,11,10937,939,9998,16.69%,8.58%
2020-01-01 00:04:50,11,12,6958,398,6560,10.62%,5.72%
2020-01-01 00:04:50,12,1,38,0,38,0.06%,0.00%
2020-01-01 00:04:50,12,2,724,238,486,1.10%,32.83%
2020-01-01 00:04:50,12,3,2866,284,2582,4.37%,9.91%
2020-01-01 00:04:50,12,4,2775,100,2675,4.23%,3.60%
2020-01-01 00:04:50,12,5,10005,1020,8985,15.27%,10.19%
2020-01-01 00:04:50,12,6,6367,407,5960,9.72%,6.39%
2020-01-01 00:04:50,12,7,3415,117,3298,5.21%,3.43%
2020-01-01 00:04:50,12,8,1519,285,1234,2.32%,18.75%
2020-01-01 00:04:50,12,9,22472,4586,17886,34.29%,20.41%
2020-01-01 00:04:50,12,10,4218,401,3817,6.44%,9.50%
2020-01-01 00:04:50,12,11,1708,287,1421,2.61%,16.79%
2020-01-01 00:04:50,12,12,7624,1091,6533,11.63%,14.31%
2020-01-01 00:04:50,13,1,2567,53,2514,3.92%,2.06%
2020-01-01 00:04:50,13,2,2988,67,2921,4.56%,2.24%
2020-01-01 00:04:50,13,3,779,5,774,1.19%,0.64%
2020-01-01 00:04:50,13,4,4269,460,3809,6.51%,10.77%
2020-01-01 00:04:50,13,5,7136,862,6274,10.89%,12.08%
2020-01-01 00:04:50,13,6,5093,515,4578,7.77%,10.11%
2020-01-01 00:04:50,13,7,5824,254,5570,8.89%,4.36%
2020-01-01 00:04:50,13,8,7788,434,7354,11.88%,5.57%
2020-01-01 00:04:50,13,9,7499,903,6596,11.44%,12.04%
2020-01-01 00:04:50,13,10,28201,5934,22267,43.03%,21.04%
2020-01-01 00:04:50,13,11,17673,2472,15201,26.97%,13.99%
2020-01-01 00:04:50,13,12,9152,944,8208,13.96%,10.31%
2020-01-01 00:04:50,14,1,416,2,414,0.63%,0.48%
2020-01-01 00:04:50,14,2,1785,24,1761,2.72%,1.34%
2020-01-01 00:04:50,14,3,1173,8,1165,1.79%,0.68%
2020-01-01 00:04:50,14,4,4038,98,3940,6.16%,2.43%
2020-01-01 00:04:50,14,5,1389,30,1359,2.12%,2.16%
2020-01-01 00:04:50,14,6,4306,114,4192,6.57%,2.65%
2020-01-01 00:04:50,14,7,11388,948,10440,17.38%,8.32%
2020-01-01 00:04:50,14,8,12938,1210,11728,19.74%,9.35%
2020-01-01 00:04:50,14,9,1671,39,1632,2.55%,2.33%
2020-01-01 00:04:50,14,10,4191,151,4040,6.39%,3.60%
2020-01-01 00:04:50,14,11,25401,4404,20997,38.76%,17.34%
2020-01-01 00:04:50,14,12,8032,487,7545,12.26%,6.06%
2020-01-01 00:04:50,15,1,443,0,443,0.68%,0.00%
2020-01-01 00:04:50,15,2,207,0,207,0.32%,0.00%
2020-01-01 00:04:50,15,3,3985,115,3870,6.08%,2.89%
2020-01-01 00:04:50,15,4,6278,346,5932,9.58%,5.51%
2020-01-01 00:04:50,15,5,12182,1117,11065,18.59%,9.17%
2020-01-01 00:04:50,15,6,6556,368,6188,10.00%,5.61%
2020-01-01 00:04:50,15,7,4201,156,4045,6.41%,3.71%
2020-01-01 00:04:50,15,8,5835,274,5561,8.90%,4.69%
2020-01-01 00:04:50,15,9,12449,1176,11273,19.00%,9.45%
2020-01-01 00:04:50,15,10,4422,157,4265,6.75%,3.55%
2020-01-01 00:04:50,15,11,10383,835,9548,15.84%,8.04%
2020-01-01 00:04:50,15,12,29699,6259,23440,45.32%,21.07%
2020-01-01 00:04:50,16,1,444,1,443,0.68%,0.22%
2020-01-01 00:04:50,16,2,256,0,256,0.39%,0.00%
2020-01-01 00:04:50,16,3,1187,2,1185,1.81%,0.17%
2020-01-01 00:04:50,16,4,4226,156,4070,6.45%,3.69%
2020-01-01 00:04:50,16,5,7712,530,7182,11.77%,6.87%
2020-01-01 00:04:50,16,6,5106,208,4898,7.79%,4.07%
2020-01-01 00:04:50,16,7,4027,126,3901,6.14%,3.13%
2020-01-01 00:04:50,16,8,8795,615,8180,13.42%,6.99%
2020-01-01 00:04:50,16,9,8100,576,7524,12.36%,7.11%
2020-01-01 00:04:50,16,10,1711,15,1696,2.61%,0.88%
2020-01-01 00:04:50,16,11,10710,863,9847,16.34%,8.06%
2020-01-01 00:04:50,16,12,27132,5070,22062,41.40%,18.69%
2020-01-01 00:05:00,1,1,21374,3140,18234,32.61%,14.69%
2020-01-01 00:05:00,1,2,8078,498,7580,12.33%,6.16%
2020-01-01 00:05:00,1,3,1264,17,1247,1.93%,1.34%
2020-01-01 00:05:00,1,4,12910,1211,11699,19.70%,9.38%
2020-01-01 00:05:00,1,5,12783,1188,11595,19.51%,9.29%
2020-01-01 00:05:00,1,6,12716,1176,11540,19.40%,9.25%
2020-01-01 00:05:00,1,7,6796,356,6440,10.37%,5.24%
2020-01-01 00:05:00,1,8,6113,297,5816,9.33%,4.86%
2020-01-01 00:05:00,1,9,12681,1171,11510,19.35%,9.23%
2020-01-01 00:05:00,1,10,5409,223,5186,8.25%,4.12%
2020-01-01 00:05:00,1,11,5474,228,5246,8.35%,4.16%
2020-01-01 00:05:00,1,12,12655,1164,11491,19.31%,9.20%
2020-01-01 00:05:00,2,1,2646,51,2595,4.04%,1.93%
2020-01-01 00:05:00,2,2,28985,5524,23461,44.23%,19.06%
2020-01-01 00:05:00,2,3,22087,3219,18868,33.70%,14.57%
2020-01-01 00:05:00,2,4,2554,49,2505,3.90%,1.92%
2020-01-01 00:05:00,2,5,14385,1359,13026,21.95%,9.45%
2020-01-01 00:05:00,2,6,41,0,41,0.06%,0.00%
2020-01-01 00:05:00,2,7,4232,134,4098,6.46%,3.17%
2020-01-01 00:05:00,2,8,3051,75,2976,4.66%,2.46%
2020-01-01 00:05:00,2,9,14306,1340,12966,21.83%,9.37%
2020-01-01 00:05:00,2,10,2308,40,2268,3.52%,1.73%
2020-01-01 00:05:00,2,11,2321,41,2280,3.54%,1.77%
2020-01-01 00:05:00,2,12,14135,1311,12824,21.57%,9.27%
2020-01-01 00:05:00,3,1,1522,16,1506,2.32%,1.05%
2020-01-01 00:05:00,3,2,22112,3311,18801,33.74%,14.97%
2020-01-01 00:05:00,3,3,72005,28230,43775,109.87%,39.21%
2020-01-01 00:05:00,3,4,6990,339,6651,10.67%,4.85%
2020-01-01 00:05:00,3,5,48769,14331,34438,74.42%,29.38%
2020-01-01 00:05:00,3,6,8183,481,7702,12.49%,5.88%
2020-01-01 00:05:00,3,7,18818,2423,16395,28.71%,12.88%
2020-01-01 00:05:00,3,8,15406,1622,13784,23.51%,10.53%
2020-01-01 00:05:00,3,9,40253,10155,30098,61.42%,25.23%
2020-01-01 00:05:00,3,10,6809,367,6442,10.39%,5.39%
2020-01-01 00:05:00,3,11,1556,15,1541,2.37%,0.96%
2020-01-01 00:05:00,3,12,30291,6042,24249,46.22%,19.95%
2020-01-01 00:05:00,4,1,1633,23,1610,2.49%,1.41%
2020-01-01 00:05:00,4,2,260,3,257,0.40%,1.15%
2020-01-01 00:05:00,4,3,1646,21,1625,2.51%,1.28%
2020-01-01 00:05:00,4,4,29092,5521,23571,44.39%,18.98%
2020-01-01 00:05:00,4,5,17698,2189,15509,27.01%,12.37%
2020-01-01 00:05:00,4,6,24042,3851,20191,36.69%,16.02%
2020-01-01 00:05:00,4,7,5229,210,5019,7.98%,4.02%
2020-01-01 00:05:00,4,8,2561,53,2508,3.91%,2.07%
2020-01-01 00:05:00,4,9,14730,1518,13212,22.48%,10.30%
2020-01-01 00:05:00,4,10,1816,29,1787,2.77%,1.60%
2020-01-01 00:05:00,4,11,132,0,132,0.20%,0.00%
2020-01-01 00:05:00,4,12,12126,1032,11094,18.50%,8.51%
2020-01-01 00:05:00,5,1,2594,50,2544,3.96%,1.93%
2020-01-01 00:05:00,5,2,598,1,597,0.91%,0.17%
2020-01-01 00:05:00,5,3,386,1,385,0.59%,0.26%
2020-01-01 00:05:00,5,4,21178,3137,18041,32.32%,14.81%
2020-01-01 00:05:00,5,5,9897,753,9144,15.10%,7.61%
2020-01-01 00:05:00,5,6,14370,1547,12823,21.93%,10.76%
2020-01-01 00:05:00,5,7,3994,130,3864,6.09%,3.25%
2020-01-01 00:05:00,5,8,3173,88,3085,4.84%,2.77%
2020-01-01 00:05:00,5,9,9424,689,8735,14.38%,7.31%
2020-01-01 00:05:00,5,10,1037,8,1029,1.58%,0.77%
2020-01-01 00:05:00,5,11,853,8,845,1.30%,0.94%
2020-01-01 00:05:00,5,12,8050,519,7531,12.28%,6.45%
2020-01-01 00:05:00,6,1,953,5,948,1.45%,0.52%
2020-01-01 00:05:00,6,2,1131,7,1124,1.73%,0.62%
2020-01-01 00:05:00,6,3,1554,16,1538,2.37%,1.03%
2020-01-01 00:05:00,6,4,1670,35,1635,2.55%,2.09%
2020-01-01 00:05:00,6,5,13782,1343,12439,21.03%,9.74%
2020-01-01 00:05:00,6,6,4615,181,4434,7.04%,3.92%
2020-01-01 00:05:00,6,7,2315,49,2266,3.53%,2.12%
2020-01-01 00:05:00,6,8,1904,35,1869,2.91%,1.84%
2020-01-01 00:05:00,6,9,7156,400,6756,10.92%,5.59%
2020-01-01 00:05:00,6,10,2095,35,2060,3.20%,1.67%
2020-01-01 00:05:00,6,11,427,1,426,0.65%,0.23%
2020-01-01 00:05:00,6,12,4971,196,4775,7.59%,3.94%
2020-01-01 00:05:00,7,1,493,2,491,0.75%,0.40%
2020-01-01 00:05:00,7,2,85,0,85,0.13%,0.00%
2020-01-01 00:05:00,7,3,1737,13,1724,2.65%,0.75%
2020-01-01 00:05:00,7,4,2044,26,2018,3.12%,1.27%
2020-01-01 00:05:00,7,5,8320,460,7860,12.70%,5.53%
2020-01-01 00:05:00,7,6,13598,1289,12309,20.75%,9.48%
2020-01-01 00:05:00,7,7,3120,93,3027,4.76%,2.98%
2020-01-01 00:05:00,7,8,1115,16,1099,1.70%,1.43%
2020-01-01 00:05:00,7,9,6504,302,6202,9.92%,4.64%
2020-01-01 00:05:00,7,10,1272,13,1259,1.94%,1.02%
2020-01-01 00:05:00,7,11,72,0,72,0.11%,0.00%
2020-01-01 00:05:00,7,12,5210,200,5010,7.95%,3.84%
2020-01-01 00:05:00,8,1,479,0,479,0.73%,0.00%
2020-01-01 00:05:00,8,2,115,0,115,0.18%,0.00%
2020-01-01 00:05:00,8,3,1264,13,1251,1.93%,1.03%
2020-01-01 00:05:00,8,4,2626,56,2570,4.01%,2.13%
2020-01-01 00:05:00,8,5,8919,593,8326,13.61%,6.65%
2020-01-01 00:05:00,8,6,16705,1950,14755,25.49%,11.67%
2020-01-01 00:05:00,8,7,5073,184,4889,7.74%,3.63%
2020-01-01 00:05:00,8,8,1971,26,1945,3.01%,1.32%
2020-01-01 00:05:00,8,9,7433,416,7017,11.34%,5.60%
2020-01-01 00:05:00,8,10,2569,53,2516,3.92%,2.06%
2020-01-01 00:05:00,8,11,272,1,271,0.42%,0.37%
2020-01-01 00:05:00,8,12,4781,166,4615,7.30%,3.47%
2020-01-01 00:05:00,9,1,627,2,625,0.96%,0.32%
2020-01-01 00:05:00,9,2,2624,45,2579,4.00%,1.71%
2020-01-01 00:05:00,9,3,1424,14,1410,2.17%,0.98%
2020-01-01 00:05:00,9,4,6666,373,6293,10.17%,5.59%
2020-01-01 00:05:00,9,5,362,4,358,0.55%,1.10%
2020-01-01 00:05:00,9,6,7590,459,7131,11.58%,6.05%
2020-01-01 00:05:00,9,7,32508,7031,25477,49.60%,21.63%
2020-01-01 00:05:00,9,8,9416,653,8763,14.37%,6.93%
2020-01-01 00:05:00,9,9,218,1,217,0.33%,0.46%
2020-01-01 00:05:00,9,10,2414,45,2369,3.68%,1.86%
2020-01-01 00:05:00,9,11,8072,485,7587,12.32%,6.01%
2020-01-01 00:05:00,9,12,5301,223,5078,8.09%,4.21%
2020-01-01 00:05:00,10,1,1422,184,1238,2.17%,12.93%
2020-01-01 00:05:00,10,2,4378,305,4073,6.68%,6.97%
2020-01-01 00:05:00,10,3,2782,54,2728,4.24%,1.94%
2020-01-01 00:05:00,10,4,3725,962,2763,5.68%,25.82%
2020-01-01 00:05:00,10,5,600,3,597,0.92%,0.50%
2020-01-01 00:05:00,10,6,5536,1052,4484,8.45%,19.00%
2020-01-01 00:05:00,10,7,11653,1900,9753,17.78%,16.30%
2020-01-01 00:05:00,10,8,28354,6899,21455,43.26%,24.33%
2020-01-01 00:05:00,10,9,664,1,663,1.01%,0.15%
2020-01-01 00:05:00,10,10,1860,23,1837,2.84%,1.24%
2020-01-01 00:05:00,10,11,12440,1621,10819,18.98%,13.03%
2020-01-01 00:05:00,10,12,10123,1288,8835,15.45%,12.72%
2020-01-01 00:05:00,11,1,2352,52,2300,3.59%,2.21%
2020-01-01 00:05:00,11,2,3478,101,3377,5.31%,2.90%
2020-01-01 00:05:00,11,3,934,2,932,1.43%,0.21%
2020-01-01 00:05:00,11,4,6216,291,5925,9.48%,4.68%
2020-01-01 00:05:00,11,5,352,1,351,0.54%,0.28%
2020-01-01 00:05:00,11,6,7105,371,6734,10.84%,5.22%
2020-01-01 00:05:00,11,7,12276,1073,11203,18.73%,8.74%
2020-01-01 00:05:00,11,8,25759,4496,21263,39.31%,17.45%
2020-01-01 00:05:00,11,9,251,1,250,0.38%,0.40%
2020-01-01 00:05:00,11,10,2921,90,2831,4.46%,3.08%
2020-01-01 00:05:00,11,11,9892,736,9156,15.09%,7.44%
2020-01-01 00:05:00,11,12,6709,339,6370,10.24%,5.05%
2020-01-01 00:05:00,12,1,74,0,74,0.11%,0.00%
2020-01-01 00:05:00,12,2,708,213,495,1.08%,30.04%
2020-01-01 00:05:00,12,3,2978,274,2704,4.54%,9.20%
2020-01-01 00:05:00,12,4,2832,67,2765,4.32%,2.36%
2020-01-01 00:05:00,12,5,9183,781,8402,14.01%,8.50%
2020-01-01 00:05:00,12,6,5544,236,5308,8.46%,4.26%
2020-01-01 00:05:00,12,7,2382,43,2339,3.63%,1.80%
2020-01-01 00:05:00,12,8,1012,287,725,1.54%,28.33%
2020-01-01 00:05:00,12,9,21589,4191,17398,32.94%,19.41%
2020-01-01 00:05:00,12,10,3824,386,3438,5.83%,10.09%
2020-01-01 00:05:00,12,11,1240,290,950,1.89%,23.37%
2020-01-01 00:05:00,12,12,7747,1064,6683,11.82%,13.73%
2020-01-01 00:05:00,13,1,2389,52,2337,3.65%,2.18%
2020-01-01 00:05:00,13,2,2674,60,2614,4.08%,2.24%
2020-01-01 00:05:00,13,3,620,2,618,0.95%,0.32%
2020-01-01 00:05:00,13,4,5669,585,5084,8.65%,10.32%
2020-01-01 00:05:00,13,5,8024,891,7133,12.24%,11.10%
2020-01-01 00:05:00,13,6,6301,634,5667,9.61%,10.06%
2020-01-01 00:05:00,13,7,5125,202,4923,7.82%,3.94%
2020-01-01 00:05:00,13,8,7448,415,7033,11.36%,5.57%
2020-01-01 00:05:00,13,9,8296,914,7382,12.66%,11.02%
2020-01-01 00:05:00,13,10,27538,5890,21648,42.02%,21.39%
2020-01-01 00:05:00,13,11,16473,2444,14029,25.14%,14.84%
2020-01-01 00:05:00,13,12,8481,1058,7423,12.94%,12.47%
2020-01-01 00:05:00,14,1,239,0,239,0.36%,0.00%
2020-01-01 00:05:00,14,2,1125,7,1118,1.72%,0.62%
2020-01-01 00:05:00,14,3,734,4,730,1.12%,0.54%
2020-01-01 00:05:00,14,4,4736,167,4569,7.23%,3.53%
2020-01-01 00:05:00,14,5,1256,15,1241,1.92%,1.19%
2020-01-01 00:05:00,14,6,5024,193,4831,7.67%,3.84%
2020-01-01 00:05:00,14,7,11589,897,10692,17.68%,7.74%
2020-01-01 00:05:00,14,8,13117,1172,11945,20.01%,8.93%
2020-01-01 00:05:00,14,9,1476,18,1458,2.25%,1.22%
2020-01-01 00:05:00,14,10,4019,128,3891,6.13%,3.18%
2020-01-01 00:05:00,14,11,25177,4268,20909,38.42%,16.95%
2020-01-01 00:05:00,14,12,7856,471,7385,11.99%,5.99%
2020-01-01 00:05:00,15,1,500,2,498,0.76%,0.40%
2020-01-01 00:05:00,15,2,137,1,136,0.21%,0.72%
2020-01-01 00:05:00,15,3,3684,110,3574,5.62%,2.99%
2020-01-01 00:05:00,15,4,4929,232,4697,7.52%,4.71%
2020-01-01 00:05:00,15,5,10411,835,9576,15.89%,8.02%
2020-01-01 00:05:00,15,6,5168,247,4921,7.89%,4.78%
2020-01-01 00:05:00,15,7,4096,139,3957,6.25%,3.39%
2020-01-01 00:05:00,15,8,6005,316,5689,9.16%,5.26%
2020-01-01 00:05:00,15,9,10666,868,9798,16.28%,8.14%
2020-01-01 00:05:00,15,10,3856,203,3653,5.88%,5.26%
2020-01-01 00:05:00,15,11,9974,785,9189,15.22%,7.87%
2020-01-01 00:05:00,15,12,26722,5065,21657,40.77%,18.95%
2020-01-01 00:05:00,16,1,461,2,459,0.70%,0.43%
2020-01-01 00:05:00,16,2,267,2,265,0.41%,0.75%
2020-01-01 00:05:00,16,3,1395,19,1376,2.13%,1.36%
2020-01-01 00:05:00,16,4,4419,155,4264,6.74%,3.51%
2020-01-01 00:05:00,16,5,8122,546,7576,12.39%,6.72%
2020-01-01 00:05:00,16,6,5100,202,4898,7.78%,3.96%
2020-01-01 00:05:00,16,7,3219,74,3145,4.91%,2.30%
2020-01-01 00:05:00,16,8,7467,464,7003,11.39%,6.21%
2020-01-01 00:05:00,16,9,8680,602,8078,13.24%,6.93%
2020-01-01 00:05:00,16,10,1800,30,1770,2.75%,1.67%
2020-01-01 00:05:00,16,11,9465,720,8745,14.44%,7.61%
2020-01-01 00:05:00,16,12,25635,4507,21128,39.12%,17.58%
2020-01-01 00:05:10,1,1,14159,1464,12695,21.60%,10.34%
2020-01-01 00:05:10,1,2,5693,256,5437,8.69%,4.50%
2020-01-01 00:05:10,1,3,823,7,816,1.26%,0.85%
2020-01-01 00:05:10,1,4,7928,488,7440,12.10%,6.15%
2020-01-01 00:05:10,1,5,7584,459,7125,11.57%,6.05%
2020-01-01 00:05:10,1,6,7511,447,7064,11.46%,5.95%
2020-01-01 00:05:10,1,7,4858,189,4669,7.41%,3.89%
2020-01-01 00:05:10,1,8,4066,130,3936,6.20%,3.20%
2020-01-01 00:05:10,1,9,7462,444,7018,11.39%,5.95%
2020-01-01 00:05:10,1,10,3541,105,3436,5.40%,2.96%
2020-01-01 00:05:10,1,11,3608,107,3501,5.51%,2.96%
2020-01-01 00:05:10,1,12,7424,442,6982,11.33%,5.95%
2020-01-01 00:05:10,2,1,987,2,985,1.51%,0.20%
2020-01-01 00:05:10,2,2,28096,5232,22864,42.87%,18.62%
2020-01-01 00:05:10,2,3,22033,3282,18751,33.62%,14.90%
2020-01-01 00:05:10,2,4,902,2,900,1.38%,0.22%
2020-01-01 00:05:10,2,5,12189,1096,11093,18.60%,8.99%
2020-01-01 00:05:10,2,6,75,0,75,0.11%,0.00%
2020-01-01 00:05:10,2,7,5063,195,4868,7.73%,3.85%
2020-01-01 00:05:10,2,8,4157,138,4019,6.34%,3.32%
2020-01-01 00:05:10,2,9,12128,1088,11040,18.51%,8.97%
2020-01-01 00:05:10,2,10,2950,64,2886,4.50%,2.17%
2020-01-01 00:05:10,2,11,2956,64,2892,4.51%,2.16%
2020-01-01 00:05:10,2,12,11962,1062,10900,18.25%,8.88%
2020-01-01 00:05:10,3,1,1485,12,1473,2.27%,0.81%
2020-01-01 00:05:10,3,2,21742,3205,18537,33.18%,14.74%
2020-01-01 00:05:10,3,3,74105,29617,44488,113.08%,39.97%
2020-01-01 00:05:10,3,4,13096,1213,11883,19.98%,9.26%
2020-01-01 00:05:10,3,5,50277,15100,35177,76.72%,30.03%
2020-01-01 00:05:10,3,6,14397,1466,12931,21.97%,10.18%
2020-01-01 00:05:10,3,7,18560,2398,16162,28.32%,12.92%
2020-01-01 00:05:10,3,8,15180,1654,13526,23.16%,10.90%
2020-01-01 00:05:10,3,9,35540,8057,27483,54.23%,22.67%
2020-01-01 00:05:10,3,10,6207,283,5924,9.47%,4.56%
2020-01-01 00:05:10,3,11,1982,29,1953,3.02%,1.46%
2020-01-01 00:05:10,3,12,25545,4345,21200,38.98%,17.01%
2020-01-01 00:05:10,4,1,735,6,729,1.12%,0.82%
2020-01-01 00:05:10,4,2,560,2,558,0.85%,0.36%
2020-01-01 00:05:10,4,3,1012,9,1003,1.54%,0.89%
2020-01-01 00:05:10,4,4,27846,5116,22730,42.49%,18.37%
2020-01-01 00:05:10,4,5,16875,1967,14908,25.75%,11.66%
2020-01-01 00:05:10,4,6,23553,3730,19823,35.94%,15.84%
2020-01-01 00:05:10,4,7,5018,178,4840,7.66%,3.55%
2020-01-01 00:05:10,4,8,2782,55,2727,4.24%,1.98%
2020-01-01 00:05:10,4,9,14709,1550,13159,22.44%,10.54%
2020-01-01 00:05:10,4,10,1880,30,1850,2.87%,1.59%
2020-01-01 00:05:10,4,11,231,0,231,0.35%,0.00%
2020-01-01 00:05:10,4,12,11958,1049,10909,18.25%,8.77%
2020-01-01 00:05:10,5,1,2876,67,2809,4.39%,2.33%
2020-01-01 00:05:10,5,2,789,4,785,1.20%,0.51%
2020-01-01 00:05:10,5,3,479,1,478,0.73%,0.21%
2020-01-01 00:05:10,5,4,23376,3697,19679,35.67%,15.81%
2020-01-01 00:05:10,5,5,10067,707,9360,15.36%,7.02%
2020-01-01 00:05:10,5,6,14482,1458,13024,22.10%,10.07%
2020-01-01 00:05:10,5,7,3934,124,3810,6.00%,3.15%
2020-01-01 00:05:10,5,8,3027,80,2947,4.62%,2.64%
2020-01-01 00:05:10,5,9,9434,627,8807,14.40%,6.65%
2020-01-01 00:05:10,5,10,1379,22,1357,2.10%,1.59%
2020-01-01 00:05:10,5,11,706,2,704,1.08%,0.28%
2020-01-01 00:05:10,5,12,7876,426,7450,12.02%,5.41%
2020-01-01 00:05:10,6,1,1192,10,1182,1.82%,0.84%
2020-01-01 00:05:10,6,2,1297,16,1281,1.98%,1.23%
2020-01-01 00:05:10,6,3,1675,19,1656,2.56%,1.13%
2020-01-01 00:05:10,6,4,1078,7,1071,1.64%,0.65%
2020-01-01 00:05:10,6,5,12388,1106,11282,18.90%,8.93%
2020-01-01 00:05:10,6,6,4058,118,3940,6.19%,2.91%
2020-01-01 00:05:10,6,7,2388,42,2346,3.64%,1.76%
2020-01-01 00:05:10,6,8,1839,31,1808,2.81%,1.68%
2020-01-01 00:05:10,6,9,6397,285,6112,9.76%,4.45%
2020-01-01 00:05:10,6,10,2047,30,2017,3.12%,1.46%
2020-01-01 00:05:10,6,11,531,1,530,0.81%,0.19%
2020-01-01 00:05:10,6,12,4285,144,4141,6.54%,3.36%
2020-01-01 00:05:10,7,1,524,1,523,0.80%,0.19%
2020-01-01 00:05:10,7,2,168,0,168,0.26%,0.00%
2020-01-01 00:05:10,7,3,1090,3,1087,1.66%,0.27%
2020-01-01 00:05:10,7,4,2181,42,2139,3.33%,1.92%
2020-01-01 00:05:10,7,5,8350,538,7812,12.74%,6.44%
2020-01-01 00:05:10,7,6,14920,1576,13344,22.77%,10.56%
2020-01-01 00:05:10,7,7,4312,142,4170,6.58%,3.29%
2020-01-01 00:05:10,7,8,1456,22,1434,2.22%,1.51%
2020-01-01 00:05:10,7,9,6830,367,6463,10.42%,5.37%
2020-01-01 00:05:10,7,10,1212,13,1199,1.85%,1.07%
2020-01-01 00:05:10,7,11,79,0,79,0.12%,0.00%
2020-01-01 00:05:10,7,12,5595,243,5352,8.54%,4.34%
2020-01-01 00:05:10,8,1,437,2,435,0.67%,0.46%
2020-01-01 00:05:10,8,2,81,0,81,0.12%,0.00%
2020-01-01 00:05:10,8,3,1716,17,1699,2.62%,0.99%
2020-01-01 00:05:10,8,4,2672,54,2618,4.08%,2.02%
2020-01-01 00:05:10,8,5,8680,597,8083,13.24%,6.88%
2020-01-01 00:05:10,8,6,16695,2061,14634,25.47%,12.34%
2020-01-01 00:05:10,8,7,5212,222,4990,7.95%,4.26%
2020-01-01 00:05:10,8,8,2591,58,2533,3.95%,2.24%
2020-01-01 00:05:10,8,9,6750,370,6380,10.30%,5.48%
2020-01-01 00:05:10,8,10,2120,36,2084,3.23%,1.70%
2020-01-01 00:05:10,8,11,134,0,134,0.20%,0.00%
2020-01-01 00:05:10,8,12,4563,181,4382,6.96%,3.97%
2020-01-01 00:05:10,9,1,641,2,639,0.98%,0.31%
2020-01-01 00:05:10,9,2,2340,43,2297,3.57%,1.84%
2020-01-01 00:05:10,9,3,1219,9,1210,1.86%,0.74%
2020-01-01 00:05:10,9,4,5283,219,5064,8.06%,4.14%
2020-01-01 00:05:10,9,5,311,0,311,0.47%,0.00%
2020-01-01 00:05:10,9,6,6226,290,5936,9.50%,4.66%
2020-01-01 00:05:10,9,7,29977,5885,24092,45.74%,19.63%
2020-01-01 00:05:10,9,8,12772,1170,11602,19.49%,9.16%
2020-01-01 00:05:10,9,9,112,0,112,0.17%,0.00%
2020-01-01 00:05:10,9,10,6515,343,6172,9.94%,5.26%
2020-01-01 00:05:10,9,11,11639,995,10644,17.76%,8.55%
2020-01-01 00:05:10,9,12,4834,167,4667,7.38%,3.45%
2020-01-01 00:05:10,10,1,1367,209,1158,2.09%,15.28%
2020-01-01 00:05:10,10,2,3378,289,3089,5.15%,8.55%
2020-01-01 00:05:10,10,3,1880,37,1843,2.87%,1.97%
2020-01-01 00:05:10,10,4,3761,1314,2447,5.74%,34.93%
2020-01-01 00:05:10,10,5,716,51,665,1.09%,7.11%
2020-01-01 00:05:10,10,6,5915,1456,4459,9.03%,24.61%
2020-01-01 00:05:10,10,7,10880,2153,8727,16.60%,19.79%
2020-01-01 00:05:10,10,8,27673,6999,20674,42.23%,25.29%
2020-01-01 00:05:10,10,9,746,2,744,1.14%,0.27%
2020-01-01 00:05:10,10,10,2255,38,2217,3.44%,1.68%
2020-01-01 00:05:10,10,11,13068,1769,11299,19.94%,13.54%
2020-01-01 00:05:10,10,12,10233,1299,8934,15.61%,12.69%
2020-01-01 00:05:10,11,1,2492,67,2425,3.80%,2.69%
2020-01-01 00:05:10,11,2,6096,285,5811,9.30%,4.67%
2020-01-01 00:05:10,11,3,3331,75,3256,5.08%,2.25%
2020-01-01 00:05:10,11,4,3093,74,3019,4.72%,2.39%
2020-01-01 00:05:10,11,5,146,0,146,0.22%,0.00%
2020-01-01 00:05:10,11,6,4065,133,3932,6.20%,3.27%
2020-01-01 00:05:10,11,7,16494,1851,14643,25.17%,11.22%
2020-01-01 00:05:10,11,8,30245,5940,24305,46.15%,19.64%
2020-01-01 00:05:10,11,9,252,2,250,0.38%,0.79%
2020-01-01 00:05:10,11,10,3195,99,3096,4.88%,3.10%
2020-01-01 00:05:10,11,11,10019,728,9291,15.29%,7.27%
2020-01-01 00:05:10,11,12,6417,280,6137,9.79%,4.36%
2020-01-01 00:05:10,12,1,94,0,94,0.14%,0.00%
2020-01-01 00:05:10,12,2,615,174,441,0.94%,28.25%
2020-01-01 00:05:10,12,3,2680,223,2457,4.09%,8.32%
2020-01-01 00:05:10,12,4,3453,112,3341,5.27%,3.24%
2020-01-01 00:05:10,12,5,8759,718,8041,13.37%,8.20%
2020-01-01 00:05:10,12,6,5344,221,5123,8.15%,4.13%
2020-01-01 00:05:10,12,7,1624,17,1607,2.48%,1.05%
2020-01-01 00:05:10,12,8,1409,312,1097,2.15%,22.13%
2020-01-01 00:05:10,12,9,23359,4745,18614,35.64%,20.31%
2020-01-01 00:05:10,12,10,4583,451,4132,6.99%,9.84%
2020-01-01 00:05:10,12,11,1559,319,1240,2.38%,20.45%
2020-01-01 00:05:10,12,12,9124,1380,7744,13.92%,15.12%
2020-01-01 00:05:10,13,1,2237,43,2194,3.41%,1.92%
2020-01-01 00:05:10,13,2,2590,60,2530,3.95%,2.32%
2020-01-01 00:05:10,13,3,1180,29,1151,1.80%,2.46%
2020-01-01 00:05:10,13,4,5430,482,4948,8.29%,8.87%
2020-01-01 00:05:10,13,5,8530,961,7569,13.02%,11.26%
2020-01-01 00:05:10,13,6,6371,559,5812,9.72%,8.77%
2020-01-01 00:05:10,13,7,4532,155,4377,6.92%,3.42%
2020-01-01 00:05:10,13,8,6930,357,6573,10.57%,5.15%
2020-01-01 00:05:10,13,9,8853,1003,7850,13.51%,11.33%
2020-01-01 00:05:10,13,10,27773,5786,21987,42.38%,20.83%
2020-01-01 00:05:10,13,11,16317,2205,14112,24.90%,13.51%
2020-01-01 00:05:10,13,12,9078,970,8108,13.85%,10.68%
2020-01-01 00:05:10,14,1,172,0,172,0.26%,0.00%
2020-01-01 00:05:10,14,2,1029,7,1022,1.57%,0.68%
2020-01-01 00:05:10,14,3,644,2,642,0.98%,0.31%
2020-01-01 00:05:10,14,4,4073,149,3924,6.21%,3.66%
2020-01-01 00:05:10,14,5,1200,9,1191,1.83%,0.75%
2020-01-01 00:05:10,14,6,4406,169,4237,6.72%,3.83%
2020-01-01 00:05:10,14,7,11684,1029,10655,17.83%,8.81%
2020-01-01 00:05:10,14,8,13345,1351,11994,20.36%,10.12%
2020-01-01 00:05:10,14,9,1385,16,1369,2.11%,1.15%
2020-01-01 00:05:10,14,10,4059,117,3942,6.19%,2.88%
2020-01-01 00:05:10,14,11,29366,5777,23589,44.81%,19.67%
2020-01-01 00:05:10,14,12,11677,981,10696,17.82%,8.40%
2020-01-01 00:05:10,15,1,509,3,506,0.78%,0.59%
2020-01-01 00:05:10,15,2,128,0,128,0.20%,0.00%
2020-01-01 00:05:10,15,3,3859,126,3733,5.89%,3.26%
2020-01-01 00:05:10,15,4,5563,291,5272,8.49%,5.23%
2020-01-01 00:05:10,15,5,10499,858,9641,16.02%,8.17%
2020-01-01 00:05:10,15,6,5845,314,5531,8.92%,5.37%
2020-01-01 00:05:10,15,7,3519,108,3411,5.37%,3.07%
2020-01-01 00:05:10,15,8,5577,243,5334,8.51%,4.36%
2020-01-01 00:05:10,15,9,10724,898,9826,16.36%,8.37%
2020-01-01 00:05:10,15,10,4235,255,3980,6.46%,6.02%
2020-01-01 00:05:10,15,11,10081,831,9250,15.38%,8.24%
2020-01-01 00:05:10,15,12,26176,4955,21221,39.94%,18.93%
2020-01-01 00:05:10,16,1,498,4,494,0.76%,0.80%
2020-01-01 00:05:10,16,2,248,0,248,0.38%,0.00%
2020-01-01 00:05:10,16,3,1443,10,1433,2.20%,0.69%
2020-01-01 00:05:10,16,4,3327,77,3250,5.08%,2.31%
2020-01-01 00:05:10,16,5,6499,369,6130,9.92%,5.68%
2020-01-01 00:05:10,16,6,3934,98,3836,6.00%,2.49%
2020-01-01 00:05:10,16,7,3134,79,3055,4.78%,2.52%
2020-01-01 00:05:10,16,8,6954,413,6541,10.61%,5.94%
2020-01-01 00:05:10,16,9,7020,417,6603,10.71%,5.94%
2020-01-01 00:05:10,16,10,2009,37,1972,3.07%,1.84%
2020-01-01 00:05:10,16,11,9133,659,8474,13.94%,7.21%
2020-01-01 00:05:10,16,12,23847,3977,19870,36.39%,16.68%
2020-01-01 00:05:20,1,1,15119,1697,13422,23.07%,11.22%
2020-01-01 00:05:20,1,2,6429,290,6139,9.81%,4.51%
2020-01-01 00:05:20,1,3,447,2,445,0.68%,0.45%
2020-01-01 00:05:20,1,4,8265,553,7712,12.61%,6.69%
2020-01-01 00:05:20,1,5,7837,498,7339,11.96%,6.35%
2020-01-01 00:05:20,1,6,7751,489,7262,11.83%,6.31%
2020-01-01 00:05:20,1,7,5970,241,5729,9.11%,4.04%
2020-01-01 00:05:20,1,8,4113,110,4003,6.28%,2.67%
2020-01-01 00:05:20,1,9,7710,484,7226,11.76%,6.28%
2020-01-01 00:05:20,1,10,3577,70,3507,5.46%,1.96%
2020-01-01 00:05:20,1,11,3665,77,3588,5.59%,2.10%
2020-01-01 00:05:20,1,12,7312,441,6871,11.16%,6.03%
2020-01-01 00:05:20,2,1,979,6,973,1.49%,0.61%
2020-01-01 00:05:20,2,2,29616,5881,23735,45.19%,19.86%
2020-01-01 00:05:20,2,3,23584,3910,19674,35.99%,16.58%
2020-01-01 00:05:20,2,4,812,4,808,1.24%,0.49%
2020-01-01 00:05:20,2,5,13420,1274,12146,20.48%,9.49%
2020-01-01 00:05:20,2,6,58,0,58,0.09%,0.00%
2020-01-01 00:05:20,2,7,5037,184,4853,7.69%,3.65%
2020-01-01 00:05:20,2,8,3695,92,3603,5.64%,2.49%
2020-01-01 00:05:20,2,9,13357,1256,12101,20.38%,9.40%
2020-01-01 00:05:20,2,10,2951,53,2898,4.50%,1.80%
2020-01-01 00:05:20,2,11,2958,53,2905,4.51%,1.79%
2020-01-01 00:05:20,2,12,13141,1216,11925,20.05%,9.25%
2020-01-01 00:05:20,3,1,1603,16,1587,2.45%,1.00%
2020-01-01 00:05:20,3,2,22348,3409,18939,34.10%,15.25%
2020-01-01 00:05:20,3,3,63999,23185,40814,97.65%,36.23%
2020-01-01 00:05:20,3,4,6963,342,6621,10.62%,4.91%
2020-01-01 00:05:20,3,5,39494,9868,29626,60.26%,24.99%
2020-01-01 00:05:20,3,6,8054,451,7603,12.29%,5.60%
2020-01-01 00:05:20,3,7,18749,2456,16293,28.61%,13.10%
2020-01-01 00:05:20,3,8,15283,1631,13652,23.32%,10.67%
2020-01-01 00:05:20,3,9,31102,6400,24702,47.46%,20.58%
2020-01-01 00:05:20,3,10,4899,161,4738,7.48%,3.29%
2020-01-01 00:05:20,3,11,2292,42,2250,3.50%,1.83%
2020-01-01 00:05:20,3,12,23160,3683,19477,35.34%,15.90%
2020-01-01 00:05:20,4,1,518,2,516,0.79%,0.39%
2020-01-01 00:05:20,4,2,286,1,285,0.44%,0.35%
2020-01-01 00:05:20,4,3,717,2,715,1.09%,0.28%
2020-01-01 00:05:20,4,4,28446,5369,23077,43.41%,18.87%
2020-01-01 00:05:20,4,5,17050,2049,15001,26.02%,12.02%
2020-01-01 00:05:20,4,6,24058,3932,20126,36.71%,16.34%
2020-01-01 00:05:20,4,7,5450,220,5230,8.32%,4.04%
2020-01-01 00:05:20,4,8,3295,60,3235,5.03%,1.82%
2020-01-01 00:05:20,4,9,15073,1642,13431,23.00%,10.89%
2020-01-01 00:05:20,4,10,2007,35,1972,3.06%,1.74%
2020-01-01 00:05:20,4,11,165,0,165,0.25%,0.00%
2020-01-01 00:05:20,4,12,12403,1129,11274,18.93%,9.10%
2020-01-01 00:05:20,5,1,3222,71,3151,4.92%,2.20%
2020-01-01 00:05:20,5,2,967,10,957,1.48%,1.03%
2020-01-01 00:05:20,5,3,445,2,443,0.68%,0.45%
2020-01-01 00:05:20,5,4,24218,4062,20156,36.95%,16.77%
2020-01-01 00:05:20,5,5,9002,625,8377,13.74%,6.94%
2020-01-01 00:05:20,5,6,13573,1384,12189,20.71%,10.20%
2020-01-01 00:05:20,5,7,4060,141,3919,6.20%,3.47%
2020-01-01 00:05:20,5,8,2952,71,2881,4.50%,2.40%
2020-01-01 00:05:20,5,9,8367,542,7825,12.77%,6.48%
2020-01-01 00:05:20,5,10,887,6,881,1.35%,0.68%
2020-01-01 00:05:20,5,11,747,5,742,1.14%,0.67%
2020-01-01 00:05:20,5,12,7260,419,6841,11.08%,5.77%
2020-01-01 00:05:20,6,1,1101,14,1087,1.68%,1.27%
2020-01-01 00:05:20,6,2,1166,16,1150,1.78%,1.37%
2020-01-01 00:05:20,6,3,1769,26,1743,2.70%,1.47%
2020-01-01 00:05:20,6,4,1646,21,1625,2.51%,1.28%
2020-01-01 00:05:20,6,5,14443,1473,12970,22.04%,10.20%
2020-01-01 00:05:20,6,6,4578,152,4426,6.99%,3.32%
2020-01-01 00:05:20,6,7,2239,44,2195,3.42%,1.96%
2020-01-01 00:05:20,6,8,1792,38,1754,2.73%,2.12%
2020-01-01 00:05:20,6,9,7836,457,7379,11.96%,5.83%
2020-01-01 00:05:20,6,10,2425,39,2386,3.70%,1.61%
2020-01-01 00:05:20,6,11,477,2,475,0.73%,0.42%
2020-01-01 00:05:20,6,12,5330,192,5138,8.13%,3.60%
2020-01-01 00:05:20,7,1,473,1,472,0.72%,0.21%
2020-01-01 00:05:20,7,2,138,1,137,0.21%,0.72%
2020-01-01 00:05:20,7,3,980,6,974,1.50%,0.61%
2020-01-01 00:05:20,7,4,2245,39,2206,3.43%,1.74%
2020-01-01 00:05:20,7,5,8847,572,8275,13.50%,6.46%
2020-01-01 00:05:20,7,6,14612,1591,13021,22.30%,10.89%
2020-01-01 00:05:20,7,7,3423,84,3339,5.22%,2.45%
2020-01-01 00:05:20,7,8,1252,19,1233,1.91%,1.52%
2020-01-01 00:05:20,7,9,7661,443,7218,11.69%,5.78%
2020-01-01 00:05:20,7,10,1220,12,1208,1.86%,0.98%
2020-01-01 00:05:20,7,11,77,0,77,0.12%,0.00%
2020-01-01 00:05:20,7,12,6423,304,6119,9.80%,4.73%
2020-01-01 00:05:20,8,1,368,0,368,0.56%,0.00%
2020-01-01 00:05:20,8,2,96,0,96,0.15%,0.00%
2020-01-01 00:05:20,8,3,2047,40,2007,3.12%,1.95%
2020-01-01 00:05:20,8,4,3121,81,3040,4.76%,2.59%
2020-01-01 00:05:20,8,5,8023,488,7535,12.24%,6.08%
2020-01-01 00:05:20,8,6,15806,1794,14012,24.12%,11.35%
2020-01-01 00:05:20,8,7,4589,150,4439,7.00%,3.27%
2020-01-01 00:05:20,8,8,1765,23,1742,2.69%,1.30%
2020-01-01 00:05:20,8,9,5739,264,5475,8.76%,4.60%
2020-01-01 00:05:20,8,10,1406,13,1393,2.15%,0.92%
2020-01-01 00:05:20,8,11,165,0,165,0.25%,0.00%
2020-01-01 00:05:20,8,12,4136,147,3989,6.31%,3.55%
2020-01-01 00:05:20,9,1,1574,25,1549,2.40%,1.59%
2020-01-01 00:05:20,9,2,3540,93,3447,5.40%,2.63%
2020-01-01 00:05:20,9,3,1573,14,1559,2.40%,0.89%
2020-01-01 00:05:20,9,4,7451,399,7052,11.37%,5.35%
2020-01-01 00:05:20,9,5,186,0,186,0.28%,0.00%
2020-01-01 00:05:20,9,6,8661,548,8113,13.22%,6.33%
2020-01-01 00:05:20,9,7,31532,6634,24898,48.11%,21.04%
2020-01-01 00:05:20,9,8,10333,782,9551,15.77%,7.57%
2020-01-01 00:05:20,9,9,107,0,107,0.16%,0.00%
2020-01-01 00:05:20,9,10,3801,109,3692,5.80%,2.87%
2020-01-01 00:05:20,9,11,9162,638,8524,13.98%,6.96%
2020-01-01 00:05:20,9,12,5086,216,4870,7.76%,4.25%
2020-01-01 00:05:20,10,1,1324,187,1137,2.02%,14.11%
2020-01-01 00:05:20,10,2,4902,354,4548,7.48%,7.22%
2020-01-01 00:05:20,10,3,3431,93,3338,5.24%,2.71%
2020-01-01 00:05:20,10,4,3809,928,2881,5.81%,24.36%
2020-01-01 00:05:20,10,5,947,20,927,1.45%,2.11%
2020-01-01 00:05:20,10,6,5960,1067,4893,9.09%,17.90%
2020-01-01 00:05:20,10,7,12820,2083,10737,19.56%,16.25%
2020-01-01 00:05:20,10,8,31126,7882,23244,47.49%,25.32%
2020-01-01 00:05:20,10,9,935,12,923,1.43%,1.28%
2020-01-01 00:05:20,10,10,2884,72,2812,4.40%,2.50%
2020-01-01 00:05:20,10,11,13821,1741,12080,21.09%,12.60%
2020-01-01 00:05:20,10,12,10191,1145,9046,15.55%,11.23%
2020-01-01 00:05:20,11,1,2167,32,2135,3.31%,1.48%
2020-01-01 00:05:20,11,2,4805,170,4635,7.33%,3.54%
2020-01-01 00:05:20,11,3,2440,42,2398,3.72%,1.72%
2020-01-01 00:05:20,11,4,4920,219,4701,7.51%,4.45%
2020-01-01 00:05:20,11,5,193,0,193,0.29%,0.00%
2020-01-01 00:05:20,11,6,5698,283,5415,8.69%,4.97%
2020-01-01 00:05:20,11,7,17212,2083,15129,26.26%,12.10%
2020-01-01 00:05:20,11,8,30842,6306,24536,47.06%,20.45%
2020-01-01 00:05:20,11,9,217,0,217,0.33%,0.00%
2020-01-01 00:05:20,11,10,2840,47,2793,4.33%,1.65%
2020-01-01 00:05:20,11,11,9891,655,9236,15.09%,6.62%
2020-01-01 00:05:20,11,12,6619,279,6340,10.10%,4.21%
2020-01-01 00:05:20,12,1,52,1,51,0.08%,1.89%
2020-01-01 00:05:20,12,2,631,203,428,0.96%,32.12%
2020-01-01 00:05:20,12,3,2488,240,2248,3.80%,9.64%
2020-01-01 00:05:20,12,4,3097,74,3023,4.73%,2.39%
2020-01-01 00:05:20,12,5,8708,709,7999,13.29%,8.14%
2020-01-01 00:05:20,12,6,5237,186,5051,7.99%,3.55%
2020-01-01 00:05:20,12,7,1952,30,1922,2.98%,1.54%
2020-01-01 00:05:20,12,8,1450,292,1158,2.21%,20.12%
2020-01-01 00:05:20,12,9,22275,4314,17961,33.99%,19.37%
2020-01-01 00:05:20,12,10,4420,410,4010,6.74%,9.27%
2020-01-01 00:05:20,12,11,1877,300,1577,2.86%,15.97%
2020-01-01 00:05:20,12,12,8319,1182,7137,12.69%,14.21%
2020-01-01 00:05:20,13,1,2164,32,2132,3.30%,1.48%
2020-01-01 00:05:20,13,2,2390,40,2350,3.65%,1.67%
2020-01-01 00:05:20,13,3,1165,8,1157,1.78%,0.69%
2020-01-01 00:05:20,13,4,6344,680,5664,9.68%,10.72%
2020-01-01 00:05:20,13,5,9423,1087,8336,14.38%,11.53%
2020-01-01 00:05:20,13,6,7071,738,6333,10.79%,10.44%
2020-01-01 00:05:20,13,7,4572,163,4409,6.98%,3.56%
2020-01-01 00:05:20,13,8,7024,370,6654,10.72%,5.27%
2020-01-01 00:05:20,13,9,9638,1111,8527,14.71%,11.53%
2020-01-01 00:05:20,13,10,28221,5875,22346,43.06%,20.82%
2020-01-01 00:05:20,13,11,16106,2094,14012,24.58%,13.00%
2020-01-01 00:05:20,13,12,8720,877,7843,13.31%,10.06%
2020-01-01 00:05:20,14,1,281,0,281,0.43%,0.00%
2020-01-01 00:05:20,14,2,1846,30,1816,2.82%,1.62%
2020-01-01 00:05:20,14,3,1313,20,1293,2.00%,1.52%
2020-01-01 00:05:20,14,4,3841,89,3752,5.86%,2.32%
2020-01-01 00:05:20,14,5,1506,13,1493,2.30%,0.86%
2020-01-01 00:05:20,14,6,4241,112,4129,6.47%,2.64%
2020-01-01 00:05:20,14,7,12872,1238,11634,19.64%,9.62%
2020-01-01 00:05:20,14,8,14450,1529,12921,22.05%,10.58%
2020-01-01 00:05:20,14,9,1677,14,1663,2.56%,0.83%
2020-01-01 00:05:20,14,10,3923,99,3824,5.99%,2.52%
2020-01-01 00:05:20,14,11,27107,4916,22191,41.36%,18.13%
2020-01-01 00:05:20,14,12,8543,515,8028,13.04%,6.03%
2020-01-01 00:05:20,15,1,594,1,593,0.91%,0.17%
2020-01-01 00:05:20,15,2,228,0,228,0.35%,0.00%
2020-01-01 00:05:20,15,3,4795,166,4629,7.32%,3.46%
2020-01-01 00:05:20,15,4,6293,276,6017,9.60%,4.39%
2020-01-01 00:05:20,15,5,12397,1074,11323,18.92%,8.66%
2020-01-01 00:05:20,15,6,6524,292,6232,9.95%,4.48%
2020-01-01 00:05:20,15,7,3715,119,3596,5.67%,3.20%
2020-01-01 00:05:20,15,8,5504,245,5259,8.40%,4.45%
2020-01-01 00:05:20,15,9,12610,1114,11496,19.24%,8.83%
2020-01-01 00:05:20,15,10,4156,159,3997,6.34%,3.82%
2020-01-01 00:05:20,15,11,9855,768,9087,15.04%,7.79%
2020-01-01 00:05:20,15,12,27793,5399,22394,42.41%,19.43%
2020-01-01 00:05:20,16,1,451,5,446,0.69%,1.11%
2020-01-01 00:05:20,16,2,264,0,264,0.40%,0.00%
2020-01-01 00:05:20,16,3,1401,18,1383,2.14%,1.28%
2020-01-01 00:05:20,16,4,4672,141,4531,7.13%,3.02%
2020-01-01 00:05:20,16,5,7956,486,7470,12.14%,6.11%
2020-01-01 00:05:20,16,6,5373,194,5179,8.20%,3.61%
2020-01-01 00:05:20,16,7,3694,118,3576,5.64%,3.19%
2020-01-01 00:05:20,16,8,7006,443,6563,10.69%,6.32%
2020-01-01 00:05:20,16,9,8344,542,7802,12.73%,6.49%
2020-01-01 00:05:20,16,10,1542,19,1523,2.35%,1.23%
2020-01-01 00:05:20,16,11,8750,668,8082,13.35%,7.63%
2020-01-01 00:05:20,16,12,24846,4360,20486,37.91%,17.55%
2020-01-01 00:05:30,1,1,22609,3535,19074,34.50%,15.63%
2020-01-01 00:05:30,1,2,8932,614,8318,13.63%,6.87%
2020-01-01 00:05:30,1,3,745,3,742,1.14%,0.40%
2020-01-01 00:05:30,1,4,13188,1246,11942,20.12%,9.45%
2020-01-01 00:05:30,1,5,12739,1161,11578,19.44%,9.11%
2020-01-01 00:05:30,1,6,12699,1158,11541,19.38%,9.12%
2020-01-01 00:05:30,1,7,8171,521,7650,12.47%,6.38%
2020-01-01 00:05:30,1,8,5365,207,5158,8.19%,3.86%
2020-01-01 00:05:30,1,9,12663,1147,11516,19.32%,9.06%
2020-01-01 00:05:30,1,10,4828,163,4665,7.37%,3.38%
2020-01-01 00:05:30,1,11,4936,171,4765,7.53%,3.46%
2020-01-01 00:05:30,1,12,12529,1127,11402,19.12%,8.99%
2020-01-01 00:05:30,2,1,431,0,431,0.66%,0.00%
2020-01-01 00:05:30,2,2,31351,6385,24966,47.84%,20.37%
2020-01-01 00:05:30,2,3,20898,2963,17935,31.89%,14.18%
2020-01-01 00:05:30,2,4,373,0,373,0.57%,0.00%
2020-01-01 00:05:30,2,5,11663,944,10719,17.80%,8.09%
2020-01-01 00:05:30,2,6,26,0,26,0.04%,0.00%
2020-01-01 00:05:30,2,7,10008,712,9296,15.27%,7.11%
2020-01-01 00:05:30,2,8,9203,622,8581,14.04%,6.76%
2020-01-01 00:05:30,2,9,11597,933,10664,17.70%,8.04%
2020-01-01 00:05:30,2,10,8335,513,7822,12.72%,6.15%
2020-01-01 00:05:30,2,11,8361,515,7846,12.76%,6.16%
2020-01-01 00:05:30,2,12,11436,909,10527,17.45%,7.95%
2020-01-01 00:05:30,3,1,1736,18,1718,2.65%,1.04%
2020-01-01 00:05:30,3,2,22448,3430,19018,34.25%,15.28%
2020-01-01 00:05:30,3,3,72431,28659,43772,110.52%,39.57%
2020-01-01 00:05:30,3,4,11559,1005,10554,17.64%,8.69%
2020-01-01 00:05:30,3,5,47522,13681,33841,72.51%,28.79%
2020-01-01 00:05:30,3,6,12797,1195,11602,19.53%,9.34%
2020-01-01 00:05:30,3,7,18888,2469,16419,28.82%,13.07%
2020-01-01 00:05:30,3,8,14875,1535,13340,22.70%,10.32%
2020-01-01 00:05:30,3,9,34421,7614,26807,52.52%,22.12%
2020-01-01 00:05:30,3,10,5043,184,4859,7.70%,3.65%
2020-01-01 00:05:30,3,11,1750,21,1729,2.67%,1.20%
2020-01-01 00:05:30,3,12,26841,4802,22039,40.96%,17.89%
2020-01-01 00:05:30,4,1,470,1,469,0.72%,0.21%
2020-01-01 00:05:30,4,2,301,0,301,0.46%,0.00%
2020-01-01 00:05:30,4,3,804,6,798,1.23%,0.75%
2020-01-01 00:05:30,4,4,27557,5052,22505,42.05%,18.33%
2020-01-01 00:05:30,4,5,17096,2017,15079,26.09%,11.80%
2020-01-01 00:05:30,4,6,23482,3722,19760,35.83%,15.85%
2020-01-01 00:05:30,4,7,5168,194,4974,7.89%,3.75%
2020-01-01 00:05:30,4,8,3126,78,3048,4.77%,2.49%
2020-01-01 00:05:30,4,9,15122,1573,13549,23.07%,10.40%
2020-01-01 00:05:30,4,10,2003,28,1975,3.06%,1.40%
2020-01-01 00:05:30,4,11,188,0,188,0.29%,0.00%
2020-01-01 00:05:30,4,12,12003,1006,10997,18.32%,8.38%
2020-01-01 00:05:30,5,1,3240,81,3159,4.94%,2.50%
2020-01-01 00:05:30,5,2,802,3,799,1.22%,0.37%
2020-01-01 00:05:30,5,3,447,2,445,0.68%,0.45%
2020-01-01 00:05:30,5,4,21836,3200,18636,33.32%,14.65%
2020-01-01 00:05:30,5,5,9409,654,8755,14.36%,6.95%
2020-01-01 00:05:30,5,6,14460,1495,12965,22.06%,10.34%
2020-01-01 00:05:30,5,7,4590,140,4450,7.00%,3.05%
2020-01-01 00:05:30,5,8,3150,63,3087,4.81%,2.00%
2020-01-01 00:05:30,5,9,8807,578,8229,13.44%,6.56%
2020-01-01 00:05:30,5,10,945,12,933,1.44%,1.27%
2020-01-01 00:05:30,5,11,683,4,679,1.04%,0.58%
2020-01-01 00:05:30,5,12,7581,432,7149,11.57%,5.70%
2020-01-01 00:05:30,6,1,933,8,925,1.42%,0.86%
2020-01-01 00:05:30,6,2,999,9,990,1.52%,0.90%
2020-01-01 00:05:30,6,3,1662,32,1630,2.54%,1.92%
2020-01-01 00:05:30,6,4,1641,24,1617,2.50%,1.46%
2020-01-01 00:05:30,6,5,14421,1462,12959,22.00%,10.14%
2020-01-01 00:05:30,6,6,4332,138,4194,6.61%,3.18%
2020-01-01 00:05:30,6,7,2129,39,2090,3.25%,1.83%
2020-01-01 00:05:30,6,8,1558,22,1536,2.38%,1.41%
2020-01-01 00:05:30,6,9,8182,488,7694,12.48%,5.96%
2020-01-01 00:05:30,6,10,2093,34,2059,3.19%,1.62%
2020-01-01 00:05:30,6,11,447,2,445,0.68%,0.45%
2020-01-01 00:05:30,6,12,6034,262,5772,9.21%,4.34%
2020-01-01 00:05:30,7,1,525,1,524,0.80%,0.19%
2020-01-01 00:05:30,7,2,243,0,243,0.37%,0.00%
2020-01-01 00:05:30,7,3,1384,15,1369,2.11%,1.08%
2020-01-01 00:05:30,7,4,2278,27,2251,3.48%,1.18%
2020-01-01 00:05:30,7,5,8199,509,7690,12.51%,6.21%
2020-01-01 00:05:30,7,6,13824,1374,12450,21.09%,9.94%
2020-01-01 00:05:30,7,7,3278,79,3199,5.00%,2.41%
2020-01-01 00:05:30,7,8,1430,20,1410,2.18%,1.40%
2020-01-01 00:05:30,7,9,6745,340,6405,10.29%,5.04%
2020-01-01 00:05:30,7,10,938,10,928,1.43%,1.06%
2020-01-01 00:05:30,7,11,92,0,92,0.14%,0.00%
2020-01-01 00:05:30,7,12,5794,269,5525,8.84%,4.64%
2020-01-01 00:05:30,8,1,395,1,394,0.60%,0.25%
2020-01-01 00:05:30,8,2,101,0,101,0.15%,0.00%
2020-01-01 00:05:30,8,3,2123,28,2095,3.24%,1.32%
2020-01-01 00:05:30,8,4,2847,53,2794,4.34%,1.86%
2020-01-01 00:05:30,8,5,8325,537,7788,12.70%,6.45%
2020-01-01 00:05:30,8,6,15631,1728,13903,23.85%,11.05%
2020-01-01 00:05:30,8,7,4298,149,4149,6.56%,3.47%
2020-01-01 00:05:30,8,8,1823,27,1796,2.78%,1.48%
2020-01-01 00:05:30,8,9,5938,305,5633,9.06%,5.14%
2020-01-01 00:05:30,8,10,1603,34,1569,2.45%,2.12%
2020-01-01 00:05:30,8,11,137,0,137,0.21%,0.00%
2020-01-01 00:05:30,8,12,4205,154,4051,6.42%,3.66%
2020-01-01 00:05:30,9,1,590,1,589,0.90%,0.17%
2020-01-01 00:05:30,9,2,4880,168,4712,7.45%,3.44%
2020-01-01 00:05:30,9,3,3875,108,3767,5.91%,2.79%
2020-01-01 00:05:30,9,4,11626,944,10682,17.74%,8.12%
2020-01-01 00:05:30,9,5,466,2,464,0.71%,0.43%
2020-01-01 00:05:30,9,6,12966,1183,11783,19.78%,9.12%
2020-01-01 00:05:30,9,7,32057,6709,25348,48.92%,20.93%
2020-01-01 00:05:30,9,8,8158,509,7649,12.45%,6.24%
2020-01-01 00:05:30,9,9,325,1,324,0.50%,0.31%
2020-01-01 00:05:30,9,10,2023,31,1992,3.09%,1.53%
2020-01-01 00:05:30,9,11,7146,392,6754,10.90%,5.48%
2020-01-01 00:05:30,9,12,4827,185,4642,7.37%,3.83%
2020-01-01 00:05:30,10,1,1272,214,1058,1.94%,16.81%
2020-01-01 00:05:30,10,2,4348,348,4000,6.63%,8.00%
2020-01-01 00:05:30,10,3,2895,84,2811,4.42%,2.90%
2020-01-01 00:05:30,10,4,3776,1107,2669,5.76%,29.31%
2020-01-01 00:05:30,10,5,832,43,789,1.27%,5.16%
2020-01-01 00:05:30,10,6,5933,1268,4665,9.05%,21.37%
2020-01-01 00:05:30,10,7,11889,2110,9779,18.14%,17.75%
2020-01-01 00:05:30,10,8,30439,7800,22639,46.45%,25.62%
2020-01-01 00:05:30,10,9,804,4,800,1.23%,0.50%
2020-01-01 00:05:30,10,10,2770,50,2720,4.23%,1.80%
2020-01-01 00:05:30,10,11,14404,1959,12445,21.98%,13.60%
2020-01-01 00:05:30,10,12,10733,1327,9406,16.38%,12.36%
2020-01-01 00:05:30,11,1,2721,63,2658,4.15%,2.31%
2020-01-01 00:05:30,11,2,3954,126,3828,6.03%,3.19%
2020-01-01 00:05:30,11,3,1035,10,1025,1.58%,0.97%
2020-01-01 00:05:30,11,4,3300,91,3209,5.04%,2.76%
2020-01-01 00:05:30,11,5,316,1,315,0.48%,0.32%
2020-01-01 00:05:30,11,6,4211,146,4065,6.43%,3.47%
2020-01-01 00:05:30,11,7,9938,700,9238,15.16%,7.04%
2020-01-01 00:05:30,11,8,23492,3733,19759,35.85%,15.89%
2020-01-01 00:05:30,11,9,329,1,328,0.50%,0.30%
2020-01-01 00:05:30,11,10,2848,58,2790,4.35%,2.04%
2020-01-01 00:05:30,11,11,9728,708,9020,14.84%,7.28%
2020-01-01 00:05:30,11,12,6363,323,6040,9.71%,5.08%
2020-01-01 00:05:30,12,1,60,0,60,0.09%,0.00%
2020-01-01 00:05:30,12,2,800,179,621,1.22%,22.35%
2020-01-01 00:05:30,12,3,2844,232,2612,4.34%,8.15%
2020-01-01 00:05:30,12,4,3073,73,3000,4.69%,2.37%
2020-01-01 00:05:30,12,5,9543,833,8710,14.56%,8.73%
2020-01-01 00:05:30,12,6,4993,181,4812,7.62%,3.62%
2020-01-01 00:05:30,12,7,1767,18,1749,2.70%,1.02%
2020-01-01 00:05:30,12,8,1649,299,1350,2.52%,18.12%
2020-01-01 00:05:30,12,9,21951,4281,17670,33.49%,19.50%
2020-01-01 00:05:30,12,10,4618,432,4186,7.05%,9.35%
2020-01-01 00:05:30,12,11,1823,302,1521,2.78%,16.56%
2020-01-01 00:05:30,12,12,7319,1116,6203,11.17%,15.25%
2020-01-01 00:05:30,13,1,2183,49,2134,3.33%,2.24%
2020-01-01 00:05:30,13,2,2470,57,2413,3.77%,2.31%
2020-01-01 00:05:30,13,3,986,6,980,1.50%,0.61%
2020-01-01 00:05:30,13,4,4353,474,3879,6.64%,10.89%
2020-01-01 00:05:30,13,5,7067,778,6289,10.78%,11.01%
2020-01-01 00:05:30,13,6,5164,520,4644,7.88%,10.07%
2020-01-01 00:05:30,13,7,4680,170,4510,7.14%,3.63%
2020-01-01 00:05:30,13,8,6915,349,6566,10.55%,5.05%
2020-01-01 00:05:30,13,9,7324,801,6523,11.18%,10.94%
2020-01-01 00:05:30,13,10,26368,5234,21134,40.23%,19.85%
2020-01-01 00:05:30,13,11,16407,2139,14268,25.04%,13.04%
2020-01-01 00:05:30,13,12,9055,881,8174,13.82%,9.73%
2020-01-01 00:05:30,14,1,230,0,230,0.35%,0.00%
2020-01-01 00:05:30,14,2,1185,10,1175,1.81%,0.84%
2020-01-01 00:05:30,14,3,746,6,740,1.14%,0.80%
2020-01-01 00:05:30,14,4,4784,163,4621,7.30%,3.41%
2020-01-01 00:05:30,14,5,1528,18,1510,2.33%,1.18%
2020-01-01 00:05:30,14,6,5164,187,4977,7.88%,3.62%
2020-01-01 00:05:30,14,7,12326,1103,11223,18.81%,8.95%
2020-01-01 00:05:30,14,8,13741,1343,12398,20.97%,9.77%
2020-01-01 00:05:30,14,9,1716,21,1695,2.62%,1.22%
2020-01-01 00:05:30,14,10,3945,119,3826,6.02%,3.02%
2020-01-01 00:05:30,14,11,25530,4343,21187,38.96%,17.01%
2020-01-01 00:05:30,14,12,7635,432,7203,11.65%,5.66%
2020-01-01 00:05:30,15,1,530,4,526,0.81%,0.75%
2020-01-01 00:05:30,15,2,146,0,146,0.22%,0.00%
2020-01-01 00:05:30,15,3,3735,109,3626,5.70%,2.92%
2020-01-01 00:05:30,15,4,4957,205,4752,7.56%,4.13%
2020-01-01 00:05:30,15,5,9648,715,8933,14.72%,7.41%
2020-01-01 00:05:30,15,6,5163,219,4944,7.88%,4.24%
2020-01-01 00:05:30,15,7,3236,77,3159,4.94%,2.38%
2020-01-01 00:05:30,15,8,5130,197,4933,7.83%,3.84%
2020-01-01 00:05:30,15,9,9845,743,9102,15.02%,7.55%
2020-01-01 00:05:30,15,10,4727,340,4387,7.21%,7.19%
2020-01-01 00:05:30,15,11,10010,884,9126,15.27%,8.83%
2020-01-01 00:05:30,15,12,24997,4691,20306,38.14%,18.77%
2020-01-01 00:05:30,16,1,488,3,485,0.74%,0.61%
2020-01-01 00:05:30,16,2,232,0,232,0.35%,0.00%
2020-01-01 00:05:30,16,3,1316,12,1304,2.01%,0.91%
2020-01-01 00:05:30,16,4,4751,137,4614,7.25%,2.88%
2020-01-01 00:05:30,16,5,7890,447,7443,12.04%,5.66%
2020-01-01 00:05:30,16,6,5582,198,5384,8.52%,3.55%
2020-01-01 00:05:30,16,7,3391,89,3302,5.17%,2.62%
2020-01-01 00:05:30,16,8,7732,541,7191,11.80%,7.00%
2020-01-01 00:05:30,16,9,8318,496,7822,12.69%,5.96%
2020-01-01 00:05:30,16,10,1441,42,1399,2.20%,2.91%
2020-01-01 00:05:30,16,11,9392,760,8632,14.33%,8.09%
2020-01-01 00:05:30,16,12,25507,4418,21089,38.92%,17.32%
2020-01-01 00:05:40,1,1,21255,3151,18104,32.43%,14.82%
2020-01-01 00:05:40,1,2,9018,585,8433,13.76%,6.49%
2020-01-01 00:05:40,1,3,1942,29,1913,2.96%,1.49%
2020-01-01 00:05:40,1,4,11689,1080,10609,17.84%,9.24%
2020-01-01 00:05:40,1,5,11049,989,10060,16.86%,8.95%
2020-01-01 00:05:40,1,6,11026,986,10040,16.82%,8.94%
2020-01-01 00:05:40,1,7,7062,373,6689,10.78%,5.28%
2020-01-01 00:05:40,1,8,5980,277,5703,9.12%,4.63%
2020-01-01 00:05:40,1,9,10976,976,10000,16.75%,8.89%
2020-01-01 00:05:40,1,10,5432,231,5201,8.29%,4.25%
2020-01-01 00:05:40,1,11,5521,236,5285,8.42%,4.27%
2020-01-01 00:05:40,1,12,10945,973,9972,16.70%,8.89%
2020-01-01 00:05:40,2,1,3833,119,3714,5.85%,3.10%
2020-01-01 00:05:40,2,2,32474,6917,25557,49.55%,21.30%
2020-01-01 00:05:40,2,3,19748,2748,17000,30.13%,13.91%
2020-01-01 00:05:40,2,4,3750,119,3631,5.72%,3.17%
2020-01-01 00:05:40,2,5,11817,1055,10762,18.03%,8.93%
2020-01-01 00:05:40,2,6,42,0,42,0.06%,0.00%
2020-01-01 00:05:40,2,7,8874,583,8291,13.54%,6.57%
2020-01-01 00:05:40,2,8,7830,455,7375,11.95%,5.81%
2020-01-01 00:05:40,2,9,11771,1042,10729,17.96%,8.85%
2020-01-01 00:05:40,2,10,6769,329,6440,10.33%,4.86%
2020-01-01 00:05:40,2,11,6786,331,6455,10.35%,4.88%
2020-01-01 00:05:40,2,12,11583,1012,10571,17.67%,8.74%
2020-01-01 00:05:40,3,1,2525,53,2472,3.85%,2.10%
2020-01-01 00:05:40,3,2,23777,3825,19952,36.28%,16.09%
2020-01-01 00:05:40,3,3,68652,26090,42562,104.75%,38.00%
2020-01-01 00:05:40,3,4,8744,545,8199,13.34%,6.23%
2020-01-01 00:05:40,3,5,42082,11101,30981,64.21%,26.38%
2020-01-01 00:05:40,3,6,10058,719,9339,15.35%,7.15%
2020-01-01 00:05:40,3,7,19385,2573,16812,29.58%,13.27%
2020-01-01 00:05:40,3,8,16009,1735,14274,24.43%,10.84%
2020-01-01 00:05:40,3,9,31651,6558,25093,48.30%,20.72%
2020-01-01 00:05:40,3,10,5260,184,5076,8.03%,3.50%
2020-01-01 00:05:40,3,11,1738,23,1715,2.65%,1.32%
2020-01-01 00:05:40,3,12,22362,3367,18995,34.12%,15.06%
2020-01-01 00:05:40,4,1,584,0,584,0.89%,0.00%
2020-01-01 00:05:40,4,2,373,0,373,0.57%,0.00%
2020-01-01 00:05:40,4,3,1025,10,1015,1.56%,0.97%
2020-01-01 00:05:40,4,4,29564,5767,23797,45.11%,19.51%
2020-01-01 00:05:40,4,5,18576,2376,16200,28.34%,12.79%
2020-01-01 00:05:40,4,6,25557,4367,21190,39.00%,17.09%
2020-01-01 00:05:40,4,7,5742,235,5507,8.76%,4.09%
2020-01-01 00:05:40,4,8,3349,78,3271,5.11%,2.33%
2020-01-01 00:05:40,4,9,16229,1845,14384,24.76%,11.37%
2020-01-01 00:05:40,4,10,2080,37,2043,3.17%,1.78%
2020-01-01 00:05:40,4,11,202,0,202,0.31%,0.00%
2020-01-01 00:05:40,4,12,12629,1134,11495,19.27%,8.98%
2020-01-01 00:05:40,5,1,3196,77,3119,4.88%,2.41%
2020-01-01 00:05:40,5,2,812,7,805,1.24%,0.86%
2020-01-01 00:05:40,5,3,1866,25,1841,2.85%,1.34%
2020-01-01 00:05:40,5,4,22874,3495,19379,34.90%,15.28%
2020-01-01 00:05:40,5,5,10966,869,10097,16.73%,7.92%
2020-01-01 00:05:40,5,6,16218,1826,14392,24.75%,11.26%
2020-01-01 00:05:40,5,7,4648,173,4475,7.09%,3.72%
2020-01-01 00:05:40,5,8,3758,118,3640,5.73%,3.14%
2020-01-01 00:05:40,5,9,8770,533,8237,13.38%,6.08%
2020-01-01 00:05:40,5,10,1195,10,1185,1.82%,0.84%
2020-01-01 00:05:40,5,11,567,4,563,0.87%,0.70%
2020-01-01 00:05:40,5,12,7259,374,6885,11.08%,5.15%
2020-01-01 00:05:40,6,1,1078,12,1066,1.64%,1.11%
2020-01-01 00:05:40,6,2,1143,12,1131,1.74%,1.05%
2020-01-01 00:05:40,6,3,1819,21,1798,2.78%,1.15%
2020-01-01 00:05:40,6,4,1581,15,1566,2.41%,0.95%
2020-01-01 00:05:40,6,5,14345,1418,12927,21.89%,9.88%
2020-01-01 00:05:40,6,6,5515,203,5312,8.42%,3.68%
2020-01-01 00:05:40,6,7,3250,74,3176,4.96%,2.28%
2020-01-01 00:05:40,6,8,2544,52,2492,3.88%,2.04%
2020-01-01 00:05:40,6,9,6796,329,6467,10.37%,4.84%
2020-01-01 00:05:40,6,10,2198,38,2160,3.35%,1.73%
2020-01-01 00:05:40,6,11,503,4,499,0.77%,0.79%
2020-01-01 00:05:40,6,12,4547,146,4401,6.94%,3.21%
2020-01-01 00:05:40,7,1,653,3,650,1.00%,0.46%
2020-01-01 00:05:40,7,2,207,0,207,0.32%,0.00%
2020-01-01 00:05:40,7,3,1548,24,1524,2.36%,1.55%
2020-01-01 00:05:40,7,4,2968,52,2916,4.53%,1.75%
2020-01-01 00:05:40,7,5,8304,503,7801,12.67%,6.06%
2020-01-01 00:05:40,7,6,14418,1434,12984,22.00%,9.95%
2020-01-01 00:05:40,7,7,3074,53,3021,4.69%,1.72%
2020-01-01 00:05:40,7,8,1224,11,1213,1.87%,0.90%
2020-01-01 00:05:40,7,9,6702,323,6379,10.23%,4.82%
2020-01-01 00:05:40,7,10,970,11,959,1.48%,1.13%
2020-01-01 00:05:40,7,11,90,0,90,0.14%,0.00%
2020-01-01 00:05:40,7,12,5714,251,5463,8.72%,4.39%
2020-01-01 00:05:40,8,1,477,0,477,0.73%,0.00%
2020-01-01 00:05:40,8,2,106,0,106,0.16%,0.00%
2020-01-01 00:05:40,8,3,1665,21,1644,2.54%,1.26%
2020-01-01 00:05:40,8,4,2816,64,2752,4.30%,2.27%
2020-01-01 00:05:40,8,5,7917,476,7441,12.08%,6.01%
2020-01-01 00:05:40,8,6,15343,1659,13684,23.41%,10.81%
2020-01-01 00:05:40,8,7,4437,155,4282,6.77%,3.49%
2020-01-01 00:05:40,8,8,1851,34,1817,2.82%,1.84%
2020-01-01 00:05:40,8,9,6027,281,5746,9.20%,4.66%
2020-01-01 00:05:40,8,10,1831,29,1802,2.79%,1.58%
2020-01-01 00:05:40,8,11,163,0,163,0.25%,0.00%
2020-01-01 00:05:40,8,12,4147,141,4006,6.33%,3.40%
2020-01-01 00:05:40,9,1,873,3,870,1.33%,0.34%
2020-01-01 00:05:40,9,2,3458,70,3388,5.28%,2.02%
2020-01-01 00:05:40,9,3,2210,22,2188,3.37%,1.00%
2020-01-01 00:05:40,9,4,7563,429,7134,11.54%,5.67%
2020-01-01 00:05:40,9,5,403,0,403,0.61%,0.00%
2020-01-01 00:05:40,9,6,8638,556,8082,13.18%,6.44%
2020-01-01 00:05:40,9,7,27427,5025,22402,41.85%,18.32%
2020-01-01 00:05:40,9,8,9469,653,8816,14.45%,6.90%
2020-01-01 00:05:40,9,9,143,0,143,0.22%,0.00%
2020-01-01 00:05:40,9,10,3295,121,3174,5.03%,3.67%
2020-01-01 00:05:40,9,11,8268,520,7748,12.62%,6.29%
2020-01-01 00:05:40,9,12,4655,160,4495,7.10%,3.44%
2020-01-01 00:05:40,10,1,1275,190,1085,1.95%,14.89%
2020-01-01 00:05:40,10,2,2747,231,2516,4.19%,8.41%
2020-01-01 00:05:40,10,3,1320,17,1303,2.01%,1.29%
2020-01-01 00:05:40,10,4,3954,1167,2787,6.03%,29.51%
2020-01-01 00:05:40,10,5,699,20,679,1.07%,2.86%
2020-01-01 00:05:40,10,6,6156,1304,4852,9.39%,21.18%
2020-01-01 00:05:40,10,7,10923,1969,8954,16.67%,18.02%
2020-01-01 00:05:40,10,8,29324,7497,21827,44.74%,25.57%
2020-01-01 00:05:40,10,9,826,6,820,1.26%,0.73%
2020-01-01 00:05:40,10,10,2714,59,2655,4.14%,2.17%
2020-01-01 00:05:40,10,11,14946,2047,12899,22.81%,13.70%
2020-01-01 00:05:40,10,12,11444,1411,10033,17.46%,12.33%
2020-01-01 00:05:40,11,1,2222,53,2169,3.39%,2.38%
2020-01-01 00:05:40,11,2,3356,113,3243,5.12%,3.37%
2020-01-01 00:05:40,11,3,908,11,897,1.39%,1.21%
2020-01-01 00:05:40,11,4,5320,257,5063,8.12%,4.83%
2020-01-01 00:05:40,11,5,196,0,196,0.30%,0.00%
2020-01-01 00:05:40,11,6,6419,338,6081,9.79%,5.26%
2020-01-01 00:05:40,11,7,11420,1004,10416,17.43%,8.79%
2020-01-01 00:05:40,11,8,24930,4258,20672,38.04%,17.08%
2020-01-01 00:05:40,11,9,310,0,310,0.47%,0.00%
2020-01-01 00:05:40,11,10,3073,66,3007,4.69%,2.15%
2020-01-01 00:05:40,11,11,10202,760,9442,15.57%,7.45%
2020-01-01 00:05:40,11,12,6600,345,6255,10.07%,5.23%
2020-01-01 00:05:40,12,1,71,0,71,0.11%,0.00%
2020-01-01 00:05:40,12,2,715,170,545,1.09%,23.74%
2020-01-01 00:05:40,12,3,2593,212,2381,3.96%,8.17%
2020-01-01 00:05:40,12,4,3378,74,3304,5.15%,2.19%
2020-01-01 00:05:40,12,5,9355,754,8601,14.27%,8.06%
2020-01-01 00:05:40,12,6,5517,228,5289,8.42%,4.13%
2020-01-01 00:05:40,12,7,1974,47,1927,3.01%,2.38%
2020-01-01 00:05:40,12,8,1582,343,1239,2.41%,21.67%
2020-01-01 00:05:40,12,9,22470,4298,18172,34.29%,19.13%
2020-01-01 00:05:40,12,10,4576,485,4091,6.98%,10.60%
2020-01-01 00:05:40,12,11,1774,346,1428,2.71%,19.49%
2020-01-01 00:05:40,12,12,8014,1107,6907,12.23%,13.81%
2020-01-01 00:05:40,13,1,2374,35,2339,3.62%,1.47%
2020-01-01 00:05:40,13,2,2697,45,2652,4.12%,1.67%
2020-01-01 00:05:40,13,3,988,11,977,1.51%,1.11%
2020-01-01 00:05:40,13,4,4145,358,3787,6.32%,8.63%
2020-01-01 00:05:40,13,5,6945,633,6312,10.60%,9.11%
2020-01-01 00:05:40,13,6,5130,405,4725,7.83%,7.89%
2020-01-01 00:05:40,13,7,4908,173,4735,7.49%,3.52%
2020-01-01 00:05:40,13,8,6985,384,6601,10.66%,5.50%
2020-01-01 00:05:40,13,9,7291,665,6626,11.13%,9.12%
2020-01-01 00:05:40,13,10,26142,5100,21042,39.89%,19.51%
2020-01-01 00:05:40,13,11,16228,2243,13985,24.76%,13.82%
2020-01-01 00:05:40,13,12,8834,1000,7834,13.48%,11.32%
2020-01-01 00:05:40,14,1,170,0,170,0.26%,0.00%
2020-01-01 00:05:40,14,2,1066,8,1058,1.63%,0.75%
2020-01-01 00:05:40,14,3,621,3,618,0.95%,0.48%
2020-01-01 00:05:40,14,4,6913,343,6570,10.55%,4.96%
2020-01-01 00:05:40,14,5,1537,13,1524,2.35%,0.85%
2020-01-01 00:05:40,14,6,7271,386,6885,11.09%,5.31%
2020-01-01 00:05:40,14,7,14812,1490,13322,22.60%,10.06%
2020-01-01 00:05:40,14,8,16303,1829,14474,24.88%,11.22%
2020-01-01 00:05:40,14,9,1680,16,1664,2.56%,0.95%
2020-01-01 00:05:40,14,10,4418,140,4278,6.74%,3.17%
2020-01-01 00:05:40,14,11,29418,5685,23733,44.89%,19.32%
2020-01-01 00:05:40,14,12,8408,524,7884,12.83%,6.23%
2020-01-01 00:05:40,15,1,610,2,608,0.93%,0.33%
2020-01-01 00:05:40,15,2,178,0,178,0.27%,0.00%
2020-01-01 00:05:40,15,3,3799,106,3693,5.80%,2.79%
2020-01-01 00:05:40,15,4,5758,329,5429,8.79%,5.71%
2020-01-01 00:05:40,15,5,10278,856,9422,15.68%,8.33%
2020-01-01 00:05:40,15,6,5968,346,5622,9.11%,5.80%
2020-01-01 00:05:40,15,7,3875,117,3758,5.91%,3.02%
2020-01-01 00:05:40,15,8,5845,255,5590,8.92%,4.36%
2020-01-01 00:05:40,15,9,10492,894,9598,16.01%,8.52%
2020-01-01 00:05:40,15,10,4067,200,3867,6.21%,4.92%
2020-01-01 00:05:40,15,11,10063,812,9251,15.35%,8.07%
2020-01-01 00:05:40,15,12,26633,5193,21440,40.64%,19.50%
2020-01-01 00:05:40,16,1,381,1,380,0.58%,0.26%
2020-01-01 00:05:40,16,2,299,0,299,0.46%,0.00%
2020-01-01 00:05:40,16,3,1249,13,1236,1.91%,1.04%
2020-01-01 00:05:40,16,4,4322,143,4179,6.59%,3.31%
2020-01-01 00:05:40,16,5,7585,452,7133,11.57%,5.96%
2020-01-01 00:05:40,16,6,5425,231,5194,8.28%,4.26%
2020-01-01 00:05:40,16,7,3233,51,3182,4.93%,1.58%
2020-01-01 00:05:40,16,8,7431,461,6970,11.34%,6.20%
2020-01-01 00:05:40,16,9,8019,496,7523,12.24%,6.18%
2020-01-01 00:05:40,16,10,1267,11,1256,1.93%,0.87%
2020-01-01 00:05:40,16,11,8953,631,8322,13.66%,7.05%
2020-01-01 00:05:40,16,12,24732,4156,20576,37.74%,16.80%
2020-01-01 00:05:50,1,1,19501,2648,16853,29.76%,13.58%
2020-01-01 00:05:50,1,2,8885,576,8309,13.56%,6.48%
2020-01-01 00:05:50,1,3,1906,26,1880,2.91%,1.36%
2020-01-01 00:05:50,1,4,10072,735,9337,15.37%,7.30%
2020-01-01 00:05:50,1,5,9530,652,8878,14.54%,6.84%
2020-01-01 00:05:50,1,6,9467,648,8819,14.45%,6.84%
2020-01-01 00:05:50,1,7,6952,383,6569,10.61%,5.51%
2020-01-01 00:05:50,1,8,6026,283,5743,9.19%,4.70%
2020-01-01 00:05:50,1,9,9411,639,8772,14.36%,6.79%
2020-01-01 00:05:50,1,10,5337,216,5121,8.14%,4.05%
2020-01-01 00:05:50,1,11,5450,236,5214,8.32%,4.33%
2020-01-01 00:05:50,1,12,9392,636,8756,14.33%,6.77%
2020-01-01 00:05:50,2,1,693,4,689,1.06%,0.58%
2020-01-01 00:05:50,2,2,25893,4527,21366,39.51%,17.48%
2020-01-01 00:05:50,2,3,20088,2824,17264,30.65%,14.06%
2020-01-01 00:05:50,2,4,644,2,642,0.98%,0.31%
2020-01-01 00:05:50,2,5,11421,955,10466,17.43%,8.36%
2020-01-01 00:05:50,2,6,41,0,41,0.06%,0.00%
2020-01-01 00:05:50,2,7,5099,187,4912,7.78%,3.67%
2020-01-01 00:05:50,2,8,4203,118,4085,6.41%,2.81%
2020-01-01 00:05:50,2,9,11355,944,10411,17.33%,8.31%
2020-01-01 00:05:50,2,10,3504,80,3424,5.35%,2.28%
2020-01-01 00:05:50,2,11,3527,80,3447,5.38%,2.27%
2020-01-01 00:05:50,2,12,11189,918,10271,17.07%,8.20%
2020-01-01 00:05:50,3,1,1360,12,1348,2.08%,0.88%
2020-01-01 00:05:50,3,2,25295,4251,21044,38.60%,16.81%
2020-01-01 00:05:50,3,3,71201,27742,43459,108.64%,38.96%
2020-01-01 00:05:50,3,4,8538,514,8024,13.03%,6.02%
2020-01-01 00:05:50,3,5,44345,12126,32219,67.67%,27.34%
2020-01-01 00:05:50,3,6,9706,665,9041,14.81%,6.85%
2020-01-01 00:05:50,3,7,22359,3332,19027,34.12%,14.90%
2020-01-01 00:05:50,3,8,18149,2231,15918,27.69%,12.29%
2020-01-01 00:05:50,3,9,34209,7571,26638,52.20%,22.13%
2020-01-01 00:05:50,3,10,5445,219,5226,8.31%,4.02%
2020-01-01 00:05:50,3,11,2050,36,2014,3.13%,1.76%
2020-01-01 00:05:50,3,12,24885,4155,20730,37.97%,16.70%
2020-01-01 00:05:50,4,1,581,5,576,0.89%,0.86%
2020-01-01 00:05:50,4,2,351,1,350,0.54%,0.28%
2020-01-01 00:05:50,4,3,763,13,750,1.16%,1.70%
2020-01-01 00:05:50,4,4,30024,5928,24096,45.81%,19.74%
2020-01-01 00:05:50,4,5,18059,2250,15809,27.56%,12.46%
2020-01-01 00:05:50,4,6,25419,4317,21102,38.79%,16.98%
2020-01-01 00:05:50,4,7,5982,317,5665,9.13%,5.30%
2020-01-01 00:05:50,4,8,3376,99,3277,5.15%,2.93%
2020-01-01 00:05:50,4,9,16069,1756,14313,24.52%,10.93%
2020-01-01 00:05:50,4,10,1965,25,1940,3.00%,1.27%
2020-01-01 00:05:50,4,11,180,1,179,0.27%,0.55%
2020-01-01 00:05:50,4,12,12812,1163,11649,19.55%,9.08%
2020-01-01 00:05:50,5,1,3281,88,3193,5.01%,2.68%
2020-01-01 00:05:50,5,2,725,10,715,1.11%,1.38%
2020-01-01 00:05:50,5,3,1004,7,997,1.53%,0.70%
2020-01-01 00:05:50,5,4,23559,3857,19702,35.95%,16.37%
2020-01-01 00:05:50,5,5,10234,778,9456,15.62%,7.60%
2020-01-01 00:05:50,5,6,15296,1698,13598,23.34%,11.10%
2020-01-01 00:05:50,5,7,4458,142,4316,6.80%,3.18%
2020-01-01 00:05:50,5,8,3521,87,3434,5.37%,2.47%
2020-01-01 00:05:50,5,9,8447,541,7906,12.89%,6.40%
2020-01-01 00:05:50,5,10,1271,30,1241,1.94%,2.36%
2020-01-01 00:05:50,5,11,565,5,560,0.86%,0.88%
2020-01-01 00:05:50,5,12,7003,351,6652,10.69%,5.01%
2020-01-01 00:05:50,6,1,1188,14,1174,1.81%,1.18%
2020-01-01 00:05:50,6,2,1222,14,1208,1.86%,1.14%
2020-01-01 00:05:50,6,3,1934,27,1907,2.95%,1.40%
2020-01-01 00:05:50,6,4,1048,11,1037,1.60%,1.05%
2020-01-01 00:05:50,6,5,12555,1179,11376,19.16%,9.39%
2020-01-01 00:05:50,6,6,4562,146,4416,6.96%,3.20%
2020-01-01 00:05:50,6,7,2734,48,2686,4.17%,1.76%
2020-01-01 00:05:50,6,8,2146,33,2113,3.27%,1.54%
2020-01-01 00:05:50,6,9,5750,250,5500,8.77%,4.35%
2020-01-01 00:05:50,6,10,2084,37,2047,3.18%,1.77%
2020-01-01 00:05:50,6,11,511,1,510,0.78%,0.20%
2020-01-01 00:05:50,6,12,3601,107,3494,5.49%,2.97%
2020-01-01 00:05:50,7,1,424,3,421,0.65%,0.71%
2020-01-01 00:05:50,7,2,224,0,224,0.34%,0.00%
2020-01-01 00:05:50,7,3,1012,3,1009,1.54%,0.30%
2020-01-01 00:05:50,7,4,2115,46,2069,3.23%,2.17%
2020-01-01 00:05:50,7,5,8044,435,7609,12.27%,5.41%
2020-01-01 00:05:50,7,6,13858,1336,12522,21.15%,9.64%
2020-01-01 00:05:50,7,7,3617,111,3506,5.52%,3.07%
2020-01-01 00:05:50,7,8,1522,25,1497,2.32%,1.64%
2020-01-01 00:05:50,7,9,6975,345,6630,10.64%,4.95%
2020-01-01 00:05:50,7,10,1444,11,1433,2.20%,0.76%
2020-01-01 00:05:50,7,11,128,1,127,0.20%,0.78%
2020-01-01 00:05:50,7,12,5477,198,5279,8.36%,3.61%
2020-01-01 00:05:50,8,1,358,1,357,0.55%,0.28%
2020-01-01 00:05:50,8,2,62,0,62,0.09%,0.00%
2020-01-01 00:05:50,8,3,1521,23,1498,2.32%,1.51%
2020-01-01 00:05:50,8,4,3365,85,3280,5.13%,2.53%
2020-01-01 00:05:50,8,5,7574,437,7137,11.56%,5.77%
2020-01-01 00:05:50,8,6,16458,1889,14569,25.11%,11.48%
2020-01-01 00:05:50,8,7,5367,220,5147,8.19%,4.10%
2020-01-01 00:05:50,8,8,2857,61,2796,4.36%,2.13%
2020-01-01 00:05:50,8,9,5857,274,5583,8.94%,4.68%
2020-01-01 00:05:50,8,10,1619,19,1600,2.47%,1.17%
2020-01-01 00:05:50,8,11,131,0,131,0.20%,0.00%
2020-01-01 00:05:50,8,12,4203,151,4052,6.41%,3.59%
2020-01-01 00:05:50,9,1,863,5,858,1.32%,0.58%
2020-01-01 00:05:50,9,2,5096,205,4891,7.78%,4.02%
2020-01-01 00:05:50,9,3,3695,124,3571,5.64%,3.35%
2020-01-01 00:05:50,9,4,9804,683,9121,14.96%,6.97%
2020-01-01 00:05:50,9,5,200,0,200,0.31%,0.00%
2020-01-01 00:05:50,9,6,10942,847,10095,16.70%,7.74%
2020-01-01 00:05:50,9,7,30870,6257,24613,47.10%,20.27%
2020-01-01 00:05:50,9,8,8652,546,8106,13.20%,6.31%
2020-01-01 00:05:50,9,9,113,0,113,0.17%,0.00%
2020-01-01 00:05:50,9,10,2349,40,2309,3.58%,1.70%
2020-01-01 00:05:50,9,11,7608,434,7174,11.61%,5.70%
2020-01-01 00:05:50,9,12,4975,195,4780,7.59%,3.92%
2020-01-01 00:05:50,10,1,1048,170,878,1.60%,16.21%
2020-01-01 00:05:50,10,2,2873,225,2648,4.38%,7.83%
2020-01-01 00:05:50,10,3,1605,24,1581,2.45%,1.49%
2020-01-01 00:05:50,10,4,3967,1176,2791,6.05%,29.64%
2020-01-01 00:05:50,10,5,682,40,642,1.04%,5.86%
2020-01-01 00:05:50,10,6,6011,1318,4693,9.17%,21.92%
2020-01-01 00:05:50,10,7,11302,2013,9289,17.25%,17.81%
2020-01-01 00:05:50,10,8,27861,6861,21000,42.51%,24.62%
2020-01-01 00:05:50,10,9,908,13,895,1.39%,1.43%
2020-01-01 00:05:50,10,10,2505,49,2456,3.82%,1.96%
2020-01-01 00:05:50,10,11,13443,1786,11657,20.51%,13.28%
2020-01-01 00:05:50,10,12,10085,1247,8838,15.39%,12.36%
2020-01-01 00:05:50,11,1,2510,54,2456,3.83%,2.15%
2020-01-01 00:05:50,11,2,3618,117,3501,5.52%,3.23%
2020-01-01 00:05:50,11,3,903,8,895,1.38%,0.88%
2020-01-01 00:05:50,11,4,7654,424,7230,11.68%,5.54%
2020-01-01 00:05:50,11,5,137,0,137,0.21%,0.00%
2020-01-01 00:05:50,11,6,8852,570,8282,13.51%,6.44%
2020-01-01 00:05:50,11,7,14712,1500,13212,22.45%,10.20%
2020-01-01 00:05:50,11,8,28864,5452,23412,44.04%,18.89%
2020-01-01 00:05:50,11,9,153,0,153,0.23%,0.00%
2020-01-01 00:05:50,11,10,3348,86,3262,5.11%,2.57%
2020-01-01 00:05:50,11,11,10698,835,9863,16.32%,7.80%
2020-01-01 00:05:50,11,12,6692,315,6377,10.21%,4.71%
2020-01-01 00:05:50,12,1,82,0,82,0.13%,0.00%
2020-01-01 00:05:50,12,2,646,164,482,0.99%,25.35%
2020-01-01 00:05:50,12,3,2397,208,2189,3.66%,8.67%
2020-01-01 00:05:50,12,4,3190,73,3117,4.87%,2.29%
2020-01-01 00:05:50,12,5,8637,721,7916,13.18%,8.35%
2020-01-01 00:05:50,12,6,5429,256,5173,8.28%,4.71%
2020-01-01 00:05:50,12,7,2044,41,2003,3.12%,2.00%
2020-01-01 00:05:50,12,8,1465,299,1166,2.24%,20.40%
2020-01-01 00:05:50,12,9,21819,4076,17743,33.29%,18.68%
2020-01-01 00:05:50,12,10,4368,403,3965,6.67%,9.22%
2020-01-01 00:05:50,12,11,1663,303,1360,2.54%,18.21%
2020-01-01 00:05:50,12,12,8186,1064,7122,12.49%,13.00%
2020-01-01 00:05:50,13,1,2348,33,2315,3.58%,1.40%
2020-01-01 00:05:50,13,2,2658,55,2603,4.06%,2.07%
2020-01-01 00:05:50,13,3,858,20,838,1.31%,2.33%
2020-01-01 00:05:50,13,4,4648,506,4142,7.09%,10.88%
2020-01-01 00:05:50,13,5,6914,790,6124,10.55%,11.42%
2020-01-01 00:05:50,13,6,5314,560,4754,8.11%,10.54%
2020-01-01 00:05:50,13,7,4799,166,4633,7.32%,3.46%
2020-01-01 00:05:50,13,8,6936,342,6594,10.58%,4.93%
2020-01-01 00:05:50,13,9,7250,826,6424,11.06%,11.39%
2020-01-01 00:05:50,13,10,27924,5940,21984,42.61%,21.27%
2020-01-01 00:05:50,13,11,18011,2826,15185,27.48%,15.69%
2020-01-01 00:05:50,13,12,10644,1405,9239,16.24%,13.20%
2020-01-01 00:05:50,14,1,210,0,210,0.32%,0.00%
2020-01-01 00:05:50,14,2,1146,14,1132,1.75%,1.22%
2020-01-01 00:05:50,14,3,667,8,659,1.02%,1.20%
2020-01-01 00:05:50,14,4,5309,216,5093,8.10%,4.07%
2020-01-01 00:05:50,14,5,1176,13,1163,1.79%,1.10%
2020-01-01 00:05:50,14,6,5685,250,5435,8.67%,4.40%
2020-01-01 00:05:50,14,7,13038,1231,11807,19.89%,9.44%
2020-01-01 00:05:50,14,8,14816,1548,13268,22.61%,10.45%
2020-01-01 00:05:50,14,9,1354,18,1336,2.07%,1.33%
2020-01-01 00:05:50,14,10,3458,101,3357,5.28%,2.92%
2020-01-01 00:05:50,14,11,27206,4927,22279,41.51%,18.11%
2020-01-01 00:05:50,14,12,8725,554,8171,13.31%,6.35%
2020-01-01 00:05:50,15,1,507,1,506,0.77%,0.20%
2020-01-01 00:05:50,15,2,142,0,142,0.22%,0.00%
2020-01-01 00:05:50,15,3,4193,116,4077,6.40%,2.77%
2020-01-01 00:05:50,15,4,5791,228,5563,8.84%,3.94%
2020-01-01 00:05:50,15,5,10752,816,9936,16.41%,7.59%
2020-01-01 00:05:50,15,6,6049,245,5804,9.23%,4.05%
2020-01-01 00:05:50,15,7,3856,109,3747,5.88%,2.83%
2020-01-01 00:05:50,15,8,5869,256,5613,8.96%,4.36%
2020-01-01 00:05:50,15,9,10940,841,10099,16.69%,7.69%
2020-01-01 00:05:50,15,10,4771,171,4600,7.28%,3.58%
2020-01-01 00:05:50,15,11,10789,844,9945,16.46%,7.82%
2020-01-01 00:05:50,15,12,27351,5349,22002,41.73%,19.56%
2020-01-01 00:05:50,16,1,562,6,556,0.86%,1.07%
2020-01-01 00:05:50,16,2,318,0,318,0.49%,0.00%
2020-01-01 00:05:50,16,3,1107,9,1098,1.69%,0.81%
2020-01-01 00:05:50,16,4,3942,127,3815,6.02%,3.22%
2020-01-01 00:05:50,16,5,7351,424,6927,11.22%,5.77%
2020-01-01 00:05:50,16,6,4836,186,4650,7.38%,3.85%
2020-01-01 00:05:50,16,7,3772,109,3663,5.76%,2.89%
2020-01-01 00:05:50,16,8,7472,525,6947,11.40%,7.03%
2020-01-01 00:05:50,16,9,7731,475,7256,11.80%,6.14%
2020-01-01 00:05:50,16,10,1796,21,1775,2.74%,1.17%
2020-01-01 00:05:50,16,11,9474,773,8701,14.46%,8.16%
2020-01-01 00:05:50,16,12,25057,4321,20736,38.23%,17.24%
2020-01-01 00:06:00,1,1,20487,3019,17468,31.26%,14.74%
2020-01-01 00:06:00,1,2,12249,1088,11161,18.69%,8.88%
2020-01-01 00:06:00,1,3,1492,11,1481,2.28%,0.74%
2020-01-01 00:06:00,1,4,7816,472,7344,11.93%,6.04%
2020-01-01 00:06:00,1,5,7486,437,7049,11.42%,5.84%
2020-01-01 00:06:00,1,6,7410,428,6982,11.31%,5.78%
2020-01-01 00:06:00,1,7,10733,849,9884,16.38%,7.91%
2020-01-01 00:06:00,1,8,10102,751,9351,15.41%,7.43%
2020-01-01 00:06:00,1,9,7364,423,6941,11.24%,5.74%
2020-01-01 00:06:00,1,10,9426,656,8770,14.38%,6.96%
2020-01-01 00:06:00,1,11,9558,674,8884,14.58%,7.05%
2020-01-01 00:06:00,1,12,7334,418,6916,11.19%,5.70%
2020-01-01 00:06:00,2,1,557,1,556,0.85%,0.18%
2020-01-01 00:06:00,2,2,30663,6201,24462,46.79%,20.22%
2020-01-01 00:06:00,2,3,26105,4575,21530,39.83%,17.52%
2020-01-01 00:06:00,2,4,496,1,495,0.76%,0.20%
2020-01-01 00:06:00,2,5,13582,1275,12307,20.72%,9.39%
2020-01-01 00:06:00,2,6,30,0,30,0.05%,0.00%
2020-01-01 00:06:00,2,7,3978,124,3854,6.07%,3.12%
2020-01-01 00:06:00,2,8,2935,60,2875,4.48%,2.04%
2020-01-01 00:06:00,2,9,12785,1136,11649,19.51%,8.88%
2020-01-01 00:06:00,2,10,2142,32,2110,3.27%,1.49%
2020-01-01 00:06:00,2,11,2154,33,2121,3.29%,1.53%
2020-01-01 00:06:00,2,12,12594,1099,11495,19.22%,8.73%
2020-01-01 00:06:00,3,1,1281,8,1273,1.95%,0.62%
2020-01-01 00:06:00,3,2,22061,3388,18673,33.66%,15.36%
2020-01-01 00:06:00,3,3,72938,28994,43944,111.29%,39.75%
2020-01-01 00:06:00,3,4,11592,947,10645,17.69%,8.17%
2020-01-01 00:06:00,3,5,49798,15030,34768,75.99%,30.18%
2020-01-01 00:06:00,3,6,13534,1253,12281,20.65%,9.26%
2020-01-01 00:06:00,3,7,19319,2638,16681,29.48%,13.65%
2020-01-01 00:06:00,3,8,16491,1945,14546,25.16%,11.79%
2020-01-01 00:06:00,3,9,35934,8378,27556,54.83%,23.31%
2020-01-01 00:06:00,3,10,6668,348,6320,10.17%,5.22%
2020-01-01 00:06:00,3,11,1839,28,1811,2.81%,1.52%
2020-01-01 00:06:00,3,12,26390,4712,21678,40.27%,17.85%
2020-01-01 00:06:00,4,1,483,2,481,0.74%,0.41%
2020-01-01 00:06:00,4,2,289,1,288,0.44%,0.34%
2020-01-01 00:06:00,4,3,950,3,947,1.45%,0.32%
2020-01-01 00:06:00,4,4,28555,5493,23062,43.57%,19.24%
2020-01-01 00:06:00,4,5,18477,2427,16050,28.19%,13.13%
2020-01-01 00:06:00,4,6,24582,4151,20431,37.51%,16.89%
2020-01-01 00:06:00,4,7,4802,168,4634,7.33%,3.50%
2020-01-01 00:06:00,4,8,3014,70,2944,4.60%,2.32%
2020-01-01 00:06:00,4,9,16210,1893,14317,24.73%,11.68%
2020-01-01 00:06:00,4,10,1847,23,1824,2.82%,1.24%
2020-01-01 00:06:00,4,11,144,0,144,0.22%,0.00%
2020-01-01 00:06:00,4,12,13374,1308,12066,20.41%,9.78%
2020-01-01 00:06:00,5,1,2820,52,2768,4.30%,1.84%
2020-01-01 00:06:00,5,2,868,5,863,1.32%,0.58%
2020-01-01 00:06:00,5,3,456,3,453,0.70%,0.66%
2020-01-01 00:06:00,5,4,23535,3771,19764,35.91%,16.02%
2020-01-01 00:06:00,5,5,9092,609,8483,13.87%,6.70%
2020-01-01 00:06:00,5,6,14037,1354,12683,21.42%,9.65%
2020-01-01 00:06:00,5,7,4381,135,4246,6.68%,3.08%
2020-01-01 00:06:00,5,8,3431,84,3347,5.24%,2.45%
2020-01-01 00:06:00,5,9,8422,522,7900,12.85%,6.20%
2020-01-01 00:06:00,5,10,975,7,968,1.49%,0.72%
2020-01-01 00:06:00,5,11,698,1,697,1.07%,0.14%
2020-01-01 00:06:00,5,12,7086,372,6714,10.81%,5.25%
2020-01-01 00:06:00,6,1,1075,9,1066,1.64%,0.84%
2020-01-01 00:06:00,6,2,1161,9,1152,1.77%,0.77%
2020-01-01 00:06:00,6,3,1696,22,1674,2.59%,1.30%
2020-01-01 00:06:00,6,4,1435,25,1410,2.19%,1.74%
2020-01-01 00:06:00,6,5,14765,1537,13228,22.53%,10.41%
2020-01-01 00:06:00,6,6,3790,116,3674,5.78%,3.06%
2020-01-01 00:06:00,6,7,1882,28,1854,2.87%,1.49%
2020-01-01 00:06:00,6,8,1285,14,1271,1.96%,1.09%
2020-01-01 00:06:00,6,9,9043,581,8462,13.80%,6.42%
2020-01-01 00:06:00,6,10,2255,40,2215,3.44%,1.77%
2020-01-01 00:06:00,6,11,455,2,453,0.69%,0.44%
2020-01-01 00:06:00,6,12,6649,312,6337,10.15%,4.69%
2020-01-01 00:06:00,7,1,492,5,487,0.75%,1.01%
2020-01-01 00:06:00,7,2,95,1,94,0.14%,1.04%
2020-01-01 00:06:00,7,3,1123,6,1117,1.71%,0.53%
2020-01-01 00:06:00,7,4,2441,39,2402,3.72%,1.60%
2020-01-01 00:06:00,7,5,7676,454,7222,11.71%,5.91%
2020-01-01 00:06:00,7,6,13655,1344,12311,20.84%,9.84%
2020-01-01 00:06:00,7,7,3474,91,3383,5.30%,2.62%
2020-01-01 00:06:00,7,8,1382,14,1368,2.11%,1.01%
2020-01-01 00:06:00,7,9,6510,333,6177,9.93%,5.11%
2020-01-01 00:06:00,7,10,1686,13,1673,2.57%,0.77%
2020-01-01 00:06:00,7,11,196,0,196,0.30%,0.00%
2020-01-01 00:06:00,7,12,4790,201,4589,7.31%,4.20%
2020-01-01 00:06:00,8,1,373,1,372,0.57%,0.27%
2020-01-01 00:06:00,8,2,64,0,64,0.10%,0.00%
2020-01-01 00:06:00,8,3,1456,19,1437,2.22%,1.30%
2020-01-01 00:06:00,8,4,3010,60,2950,4.59%,1.99%
2020-01-01 00:06:00,8,5,8156,503,7653,12.45%,6.17%
2020-01-01 00:06:00,8,6,17407,2140,15267,26.56%,12.29%
2020-01-01 00:06:00,8,7,6053,289,5764,9.24%,4.77%
2020-01-01 00:06:00,8,8,3045,92,2953,4.65%,3.02%
2020-01-01 00:06:00,8,9,6425,303,6122,9.80%,4.72%
2020-01-01 00:06:00,8,10,1882,33,1849,2.87%,1.75%
2020-01-01 00:06:00,8,11,249,0,249,0.38%,0.00%
2020-01-01 00:06:00,8,12,4438,149,4289,6.77%,3.36%
2020-01-01 00:06:00,9,1,402,3,399,0.61%,0.74%
2020-01-01 00:06:00,9,2,2064,40,2024,3.15%,1.94%
2020-01-01 00:06:00,9,3,1250,14,1236,1.91%,1.12%
2020-01-01 00:06:00,9,4,5640,214,5426,8.61%,3.79%
2020-01-01 00:06:00,9,5,220,0,220,0.34%,0.00%
2020-01-01 00:06:00,9,6,6461,285,6176,9.86%,4.41%
2020-01-01 00:06:00,9,7,23475,3712,19763,35.82%,15.81%
2020-01-01 00:06:00,9,8,9701,667,9034,14.80%,6.87%
2020-01-01 00:06:00,9,9,158,0,158,0.24%,0.00%
2020-01-01 00:06:00,9,10,2733,56,2677,4.17%,2.05%
2020-01-01 00:06:00,9,11,8397,501,7896,12.81%,5.97%
2020-01-01 00:06:00,9,12,5338,189,5149,8.15%,3.54%
2020-01-01 00:06:00,10,1,1200,296,904,1.83%,24.65%
2020-01-01 00:06:00,10,2,3200,349,2851,4.88%,10.90%
2020-01-01 00:06:00,10,3,1782,24,1758,2.72%,1.35%
2020-01-01 00:06:00,10,4,4268,1197,3071,6.51%,28.04%
2020-01-01 00:06:00,10,5,619,24,595,0.94%,3.87%
2020-01-01 00:06:00,10,6,6553,1363,5190,10.00%,20.80%
2020-01-01 00:06:00,10,7,11798,2221,9577,18.00%,18.82%
2020-01-01 00:06:00,10,8,27318,6673,20645,41.68%,24.43%
2020-01-01 00:06:00,10,9,741,8,733,1.13%,1.08%
2020-01-01 00:06:00,10,10,2447,46,2401,3.73%,1.88%
2020-01-01 00:06:00,10,11,12482,1433,11049,19.05%,11.48%
2020-01-01 00:06:00,10,12,9523,1020,8503,14.53%,10.71%
2020-01-01 00:06:00,11,1,2909,78,2831,4.44%,2.68%
2020-01-01 00:06:00,11,2,4815,167,4648,7.35%,3.47%
2020-01-01 00:06:00,11,3,1578,16,1562,2.41%,1.01%
2020-01-01 00:06:00,11,4,6852,346,6506,10.46%,5.05%
2020-01-01 00:06:00,11,5,157,0,157,0.24%,0.00%
2020-01-01 00:06:00,11,6,7823,456,7367,11.94%,5.83%
2020-01-01 00:06:00,11,7,15094,1592,13502,23.03%,10.55%
2020-01-01 00:06:00,11,8,29191,5585,23606,44.54%,19.13%
2020-01-01 00:06:00,11,9,252,2,250,0.38%,0.79%
2020-01-01 00:06:00,11,10,3428,107,3321,5.23%,3.12%
2020-01-01 00:06:00,11,11,10203,750,9453,15.57%,7.35%
2020-01-01 00:06:00,11,12,6318,287,6031,9.64%,4.54%
2020-01-01 00:06:00,12,1,38,0,38,0.06%,0.00%
2020-01-01 00:06:00,12,2,697,226,471,1.06%,32.38%
2020-01-01 00:06:00,12,3,2754,264,2490,4.20%,9.58%
2020-01-01 00:06:00,12,4,3603,62,3541,5.50%,1.72%
2020-01-01 00:06:00,12,5,9709,846,8863,14.81%,8.71%
2020-01-01 00:06:00,12,6,5984,242,5742,9.13%,4.04%
2020-01-01 00:06:00,12,7,2248,48,2200,3.43%,2.13%
2020-01-01 00:06:00,12,8,1398,277,1121,2.13%,19.80%
2020-01-01 00:06:00,12,9,22828,4490,18338,34.83%,19.67%
2020-01-01 00:06:00,12,10,4305,395,3910,6.57%,9.17%
2020-01-01 00:06:00,12,11,1685,281,1404,2.57%,16.67%
2020-01-01 00:06:00,12,12,8150,979,7171,12.44%,12.01%
2020-01-01 00:06:00,13,1,2327,40,2287,3.55%,1.72%
2020-01-01 00:06:00,13,2,2687,50,2637,4.10%,1.86%
2020-01-01 00:06:00,13,3,863,4,859,1.32%,0.46%
2020-01-01 00:06:00,13,4,4578,525,4053,6.99%,11.47%
2020-01-01 00:06:00,13,5,6756,797,5959,10.31%,11.80%
2020-01-01 00:06:00,13,6,5204,570,4634,7.94%,10.95%
2020-01-01 00:06:00,13,7,4678,150,4528,7.14%,3.21%
2020-01-01 00:06:00,13,8,7318,405,6913,11.17%,5.53%
2020-01-01 00:06:00,13,9,7139,834,6305,10.89%,11.68%
2020-01-01 00:06:00,13,10,27062,5615,21447,41.29%,20.75%
2020-01-01 00:06:00,13,11,17140,2487,14653,26.15%,14.51%
2020-01-01 00:06:00,13,12,9321,1072,8249,14.22%,11.50%
2020-01-01 00:06:00,14,1,519,3,516,0.79%,0.58%
2020-01-01 00:06:00,14,2,2184,35,2149,3.33%,1.60%
2020-01-01 00:06:00,14,3,1480,17,1463,2.26%,1.15%
2020-01-01 00:06:00,14,4,4057,137,3920,6.19%,3.38%
2020-01-01 00:06:00,14,5,1315,17,1298,2.01%,1.29%
2020-01-01 00:06:00,14,6,4470,165,4305,6.82%,3.69%
2020-01-01 00:06:00,14,7,12090,1113,10977,18.45%,9.21%
2020-01-01 00:06:00,14,8,14239,1572,12667,21.73%,11.04%
2020-01-01 00:06:00,14,9,1604,19,1585,2.45%,1.18%
2020-01-01 00:06:00,14,10,4042,135,3907,6.17%,3.34%
2020-01-01 00:06:00,14,11,26111,4709,21402,39.84%,18.03%
2020-01-01 00:06:00,14,12,7615,453,7162,11.62%,5.95%
2020-01-01 00:06:00,15,1,433,1,432,0.66%,0.23%
2020-01-01 00:06:00,15,2,165,1,164,0.25%,0.60%
2020-01-01 00:06:00,15,3,3703,124,3579,5.65%,3.35%
2020-01-01 00:06:00,15,4,4613,193,4420,7.04%,4.18%
2020-01-01 00:06:00,15,5,9167,686,8481,13.99%,7.48%
2020-01-01 00:06:00,15,6,4816,207,4609,7.35%,4.30%
2020-01-01 00:06:00,15,7,3330,85,3245,5.08%,2.55%
2020-01-01 00:06:00,15,8,5079,191,4888,7.75%,3.76%
2020-01-01 00:06:00,15,9,9325,703,8622,14.23%,7.54%
2020-01-01 00:06:00,15,10,4085,192,3893,6.23%,4.70%
2020-01-01 00:06:00,15,11,9317,680,8637,14.22%,7.30%
2020-01-01 00:06:00,15,12,24638,4514,20124,37.59%,18.32%
2020-01-01 00:06:00,16,1,574,0,574,0.88%,0.00%
2020-01-01 00:06:00,16,2,258,1,257,0.39%,0.39%
2020-01-01 00:06:00,16,3,1389,17,1372,2.12%,1.22%
2020-01-01 00:06:00,16,4,4748,179,4569,7.24%,3.77%
2020-01-01 00:06:00,16,5,8695,604,8091,13.27%,6.95%
2020-01-01 00:06:00,16,6,5511,228,5283,8.41%,4.14%
2020-01-01 00:06:00,16,7,3205,82,3123,4.89%,2.56%
2020-01-01 00:06:00,16,8,7535,471,7064,11.50%,6.25%
2020-01-01 00:06:00,16,9,9160,673,8487,13.98%,7.35%
2020-01-01 00:06:00,16,10,1999,32,1967,3.05%,1.60%
2020-01-01 00:06:00,16,11,9750,717,9033,14.88%,7.35%
2020-01-01 00:06:00,16,12,27373,5052,22321,41.77%,18.46%
2020-01-01 00:06:10,1,1,15632,1707,13925,23.85%,10.92%
2020-01-01 00:06:10,1,2,5169,218,4951,7.89%,4.22%
2020-01-01 00:06:10,1,3,516,3,513,0.79%,0.58%
2020-01-01 00:06:10,1,4,10069,737,9332,15.36%,7.32%
2020-01-01 00:06:10,1,5,9431,650,8781,14.39%,6.89%
2020-01-01 00:06:10,1,6,9376,639,8737,14.31%,6.81%
2020-01-01 00:06:10,1,7,4636,187,4449,7.07%,4.03%
2020-01-01 00:06:10,1,8,3505,111,3394,5.35%,3.17%
2020-01-01 00:06:10,1,9,9326,632,8694,14.23%,6.78%
2020-01-01 00:06:10,1,10,2952,74,2878,4.50%,2.51%
2020-01-01 00:06:10,1,11,3085,88,2997,4.71%,2.85%
2020-01-01 00:06:10,1,12,9298,626,8672,14.19%,6.73%
2020-01-01 00:06:10,2,1,3868,25,3843,5.90%,0.65%
2020-01-01 00:06:10,2,2,31926,6593,25333,48.72%,20.65%
2020-01-01 00:06:10,2,3,23912,3927,19985,36.49%,16.42%
2020-01-01 00:06:10,2,4,3680,24,3656,5.62%,0.65%
2020-01-01 00:06:10,2,5,12335,1084,11251,18.82%,8.79%
2020-01-01 00:06:10,2,6,16,0,16,0.02%,0.00%
2020-01-01 00:06:10,2,7,4137,131,4006,6.31%,3.17%
2020-01-01 00:06:10,2,8,3237,85,3152,4.94%,2.63%
2020-01-01 00:06:10,2,9,11884,1004,10880,18.13%,8.45%
2020-01-01 00:06:10,2,10,2341,43,2298,3.57%,1.84%
2020-01-01 00:06:10,2,11,2352,43,2309,3.59%,1.83%
2020-01-01 00:06:10,2,12,11713,973,10740,17.87%,8.31%
2020-01-01 00:06:10,3,1,1881,41,1840,2.87%,2.18%
2020-01-01 00:06:10,3,2,23281,3574,19707,35.52%,15.35%
2020-01-01 00:06:10,3,3,67453,25171,42282,102.93%,37.32%
2020-01-01 00:06:10,3,4,9237,628,8609,14.09%,6.80%
2020-01-01 00:06:10,3,5,43106,11463,31643,65.77%,26.59%
2020-01-01 00:06:10,3,6,10658,826,9832,16.26%,7.75%
2020-01-01 00:06:10,3,7,19654,2588,17066,29.99%,13.17%
2020-01-01 00:06:10,3,8,17173,2011,15162,26.20%,11.71%
2020-01-01 00:06:10,3,9,32154,6681,25473,49.06%,20.78%
2020-01-01 00:06:10,3,10,4556,141,4415,6.95%,3.09%
2020-01-01 00:06:10,3,11,1617,14,1603,2.47%,0.87%
2020-01-01 00:06:10,3,12,25519,4327,21192,38.94%,16.96%
2020-01-01 00:06:10,4,1,499,0,499,0.76%,0.00%
2020-01-01 00:06:10,4,2,298,0,298,0.45%,0.00%
2020-01-01 00:06:10,4,3,744,5,739,1.14%,0.67%
2020-01-01 00:06:10,4,4,27119,4878,22241,41.38%,17.99%
2020-01-01 00:06:10,4,5,17222,2125,15097,26.28%,12.34%
2020-01-01 00:06:10,4,6,23259,3669,19590,35.49%,15.77%
2020-01-01 00:06:10,4,7,4652,147,4505,7.10%,3.16%
2020-01-01 00:06:10,4,8,2987,49,2938,4.56%,1.64%
2020-01-01 00:06:10,4,9,15436,1737,13699,23.55%,11.25%
2020-01-01 00:06:10,4,10,1929,47,1882,2.94%,2.44%
2020-01-01 00:06:10,4,11,195,1,194,0.30%,0.51%
2020-01-01 00:06:10,4,12,12593,1146,11447,19.22%,9.10%
2020-01-01 00:06:10,5,1,2856,64,2792,4.36%,2.24%
2020-01-01 00:06:10,5,2,884,7,877,1.35%,0.79%
2020-01-01 00:06:10,5,3,4527,155,4372,6.91%,3.42%
2020-01-01 00:06:10,5,4,25096,4301,20795,38.29%,17.14%
2020-01-01 00:06:10,5,5,12797,1212,11585,19.53%,9.47%
2020-01-01 00:06:10,5,6,17702,2264,15438,27.01%,12.79%
2020-01-01 00:06:10,5,7,4472,162,4310,6.82%,3.62%
2020-01-01 00:06:10,5,8,3431,98,3333,5.24%,2.86%
2020-01-01 00:06:10,5,9,8136,500,7636,12.41%,6.14%
2020-01-01 00:06:10,5,10,901,10,891,1.37%,1.11%
2020-01-01 00:06:10,5,11,777,9,768,1.19%,1.16%
2020-01-01 00:06:10,5,12,6869,362,6507,10.48%,5.27%
2020-01-01 00:06:10,6,1,946,8,938,1.44%,0.84%
2020-01-01 00:06:10,6,2,1031,10,1021,1.57%,0.97%
2020-01-01 00:06:10,6,3,1497,24,1473,2.28%,1.60%
2020-01-01 00:06:10,6,4,1913,24,1889,2.92%,1.25%
2020-01-01 00:06:10,6,5,14587,1563,13024,22.26%,10.71%
2020-01-01 00:06:10,6,6,4231,130,4101,6.46%,3.07%
2020-01-01 00:06:10,6,7,1846,41,1805,2.82%,2.22%
2020-01-01 00:06:10,6,8,1401,27,1374,2.14%,1.93%
2020-01-01 00:06:10,6,9,8635,569,8066,13.18%,6.59%
2020-01-01 00:06:10,6,10,1874,29,1845,2.86%,1.55%
2020-01-01 00:06:10,6,11,453,0,453,0.69%,0.00%
2020-01-01 00:06:10,6,12,6622,342,6280,10.10%,5.16%
2020-01-01 00:06:10,7,1,445,2,443,0.68%,0.45%
2020-01-01 00:06:10,7,2,161,0,161,0.25%,0.00%
2020-01-01 00:06:10,7,3,1160,5,1155,1.77%,0.43%
2020-01-01 00:06:10,7,4,2177,32,2145,3.32%,1.47%
2020-01-01 00:06:10,7,5,7654,398,7256,11.68%,5.20%
2020-01-01 00:06:10,7,6,13789,1309,12480,21.04%,9.49%
2020-01-01 00:06:10,7,7,3894,110,3784,5.94%,2.82%
2020-01-01 00:06:10,7,8,1429,17,1412,2.18%,1.19%
2020-01-01 00:06:10,7,9,6304,275,6029,9.62%,4.36%
2020-01-01 00:06:10,7,10,1312,6,1306,2.00%,0.46%
2020-01-01 00:06:10,7,11,107,0,107,0.16%,0.00%
2020-01-01 00:06:10,7,12,4960,174,4786,7.57%,3.51%
2020-01-01 00:06:10,8,1,385,2,383,0.59%,0.52%
2020-01-01 00:06:10,8,2,92,0,92,0.14%,0.00%
2020-01-01 00:06:10,8,3,2151,57,2094,3.28%,2.65%
2020-01-01 00:06:10,8,4,2418,44,2374,3.69%,1.82%
2020-01-01 00:06:10,8,5,8664,533,8131,13.22%,6.15%
2020-01-01 00:06:10,8,6,15555,1654,13901,23.74%,10.63%
2020-01-01 00:06:10,8,7,4357,146,4211,6.65%,3.35%
2020-01-01 00:06:10,8,8,1622,21,1601,2.47%,1.29%
2020-01-01 00:06:10,8,9,6248,288,5960,9.53%,4.61%
2020-01-01 00:06:10,8,10,1865,23,1842,2.85%,1.23%
2020-01-01 00:06:10,8,11,248,0,248,0.38%,0.00%
2020-01-01 00:06:10,8,12,4329,141,4188,6.61%,3.26%
2020-01-01 00:06:10,9,1,322,0,322,0.49%,0.00%
2020-01-01 00:06:10,9,2,2100,34,2066,3.20%,1.62%
2020-01-01 00:06:10,9,3,1373,17,1356,2.10%,1.24%
2020-01-01 00:06:10,9,4,14838,1527,13311,22.64%,10.29%
2020-01-01 00:06:10,9,5,238,1,237,0.36%,0.42%
2020-01-01 00:06:10,9,6,15757,1719,14038,24.04%,10.91%
2020-01-01 00:06:10,9,7,34849,7778,27071,53.18%,22.32%
2020-01-01 00:06:10,9,8,11333,955,10378,17.29%,8.43%
2020-01-01 00:06:10,9,9,179,1,178,0.27%,0.56%
2020-01-01 00:06:10,9,10,4338,168,4170,6.62%,3.87%
2020-01-01 00:06:10,9,11,10155,780,9375,15.50%,7.68%
2020-01-01 00:06:10,9,12,5483,204,5279,8.37%,3.72%
2020-01-01 00:06:10,10,1,1297,302,995,1.98%,23.27%
2020-01-01 00:06:10,10,2,2971,363,2608,4.53%,12.21%
2020-01-01 00:06:10,10,3,1523,34,1489,2.32%,2.23%
2020-01-01 00:06:10,10,4,4087,1194,2893,6.24%,29.21%
2020-01-01 00:06:10,10,5,599,28,571,0.91%,4.67%
2020-01-01 00:06:10,10,6,5954,1327,4627,9.09%,22.28%
2020-01-01 00:06:10,10,7,10651,2009,8642,16.25%,18.86%
2020-01-01 00:06:10,10,8,27600,6926,20674,42.11%,25.09%
2020-01-01 00:06:10,10,9,602,7,595,0.92%,1.16%
2020-01-01 00:06:10,10,10,2371,48,2323,3.62%,2.02%
2020-01-01 00:06:10,10,11,13253,1592,11661,20.22%,12.01%
2020-01-01 00:06:10,10,12,10062,1104,8958,15.35%,10.97%
2020-01-01 00:06:10,11,1,2656,72,2584,4.05%,2.71%
2020-01-01 00:06:10,11,2,3975,131,3844,6.07%,3.29%
2020-01-01 00:06:10,11,3,1176,11,1165,1.79%,0.93%
2020-01-01 00:06:10,11,4,7865,472,7393,12.00%,6.00%
2020-01-01 00:06:10,11,5,290,1,289,0.44%,0.34%
2020-01-01 00:06:10,11,6,8775,572,8203,13.39%,6.52%
2020-01-01 00:06:10,11,7,14686,1518,13168,22.41%,10.34%
2020-01-01 00:06:10,11,8,28319,5370,22949,43.21%,18.96%
2020-01-01 00:06:10,11,9,360,0,360,0.55%,0.00%
2020-01-01 00:06:10,11,10,3123,73,3050,4.77%,2.34%
2020-01-01 00:06:10,11,11,9770,691,9079,14.91%,7.07%
2020-01-01 00:06:10,11,12,6186,288,5898,9.44%,4.65%
2020-01-01 00:06:10,12,1,25,0,25,0.04%,0.00%
2020-01-01 00:06:10,12,2,750,214,536,1.14%,28.50%
2020-01-01 00:06:10,12,3,3601,295,3306,5.49%,8.19%
2020-01-01 00:06:10,12,4,3421,62,3359,5.22%,1.81%
2020-01-01 00:06:10,12,5,10902,993,9909,16.64%,9.11%
2020-01-01 00:06:10,12,6,5764,236,5528,8.80%,4.09%
2020-01-01 00:06:10,12,7,2200,42,2158,3.36%,1.91%
2020-01-01 00:06:10,12,8,1232,306,926,1.88%,24.82%
2020-01-01 00:06:10,12,9,23047,4542,18505,35.17%,19.71%
2020-01-01 00:06:10,12,10,4111,409,3702,6.27%,9.95%
2020-01-01 00:06:10,12,11,1474,307,1167,2.25%,20.81%
2020-01-01 00:06:10,12,12,7373,1004,6369,11.25%,13.62%
2020-01-01 00:06:10,13,1,2496,42,2454,3.81%,1.68%
2020-01-01 00:06:10,13,2,2804,53,2751,4.28%,1.89%
2020-01-01 00:06:10,13,3,1068,9,1059,1.63%,0.84%
2020-01-01 00:06:10,13,4,5102,499,4603,7.79%,9.78%
2020-01-01 00:06:10,13,5,7957,899,7058,12.14%,11.30%
2020-01-01 00:06:10,13,6,6046,568,5478,9.23%,9.39%
2020-01-01 00:06:10,13,7,4877,177,4700,7.44%,3.63%
2020-01-01 00:06:10,13,8,6958,334,6624,10.62%,4.80%
2020-01-01 00:06:10,13,9,8267,926,7341,12.61%,11.20%
2020-01-01 00:06:10,13,10,26883,5390,21493,41.02%,20.05%
2020-01-01 00:06:10,13,11,15753,2010,13743,24.04%,12.76%
2020-01-01 00:06:10,13,12,8295,822,7473,12.66%,9.91%
2020-01-01 00:06:10,14,1,396,0,396,0.60%,0.00%
2020-01-01 00:06:10,14,2,1642,19,1623,2.51%,1.16%
2020-01-01 00:06:10,14,3,1073,6,1067,1.64%,0.56%
2020-01-01 00:06:10,14,4,4346,146,4200,6.63%,3.36%
2020-01-01 00:06:10,14,5,1418,13,1405,2.16%,0.92%
2020-01-01 00:06:10,14,6,4800,176,4624,7.32%,3.67%
2020-01-01 00:06:10,14,7,11666,970,10696,17.80%,8.31%
2020-01-01 00:06:10,14,8,13773,1374,12399,21.02%,9.98%
2020-01-01 00:06:10,14,9,1694,18,1676,2.58%,1.06%
2020-01-01 00:06:10,14,10,3967,114,3853,6.05%,2.87%
2020-01-01 00:06:10,14,11,25775,4519,21256,39.33%,17.53%
2020-01-01 00:06:10,14,12,7792,479,7313,11.89%,6.15%
2020-01-01 00:06:10,15,1,567,13,554,0.87%,2.29%
2020-01-01 00:06:10,15,2,171,4,167,0.26%,2.33%
2020-01-01 00:06:10,15,3,3708,108,3600,5.66%,2.91%
2020-01-01 00:06:10,15,4,5074,239,4835,7.74%,4.71%
2020-01-01 00:06:10,15,5,9654,809,8845,14.73%,8.38%
2020-01-01 00:06:10,15,6,5280,256,5024,8.06%,4.85%
2020-01-01 00:06:10,15,7,3207,68,3139,4.89%,2.12%
2020-01-01 00:06:10,15,8,5097,178,4919,7.78%,3.49%
2020-01-01 00:06:10,15,9,9835,834,9001,15.01%,8.48%
2020-01-01 00:06:10,15,10,4066,363,3703,6.20%,8.93%
2020-01-01 00:06:10,15,11,9273,828,8445,14.15%,8.93%
2020-01-01 00:06:10,15,12,24655,4593,20062,37.62%,18.63%
2020-01-01 00:06:10,16,1,576,0,576,0.88%,0.00%
2020-01-01 00:06:10,16,2,218,0,218,0.33%,0.00%
2020-01-01 00:06:10,16,3,1397,15,1382,2.13%,1.07%
2020-01-01 00:06:10,16,4,4884,181,4703,7.45%,3.71%
2020-01-01 00:06:10,16,5,8423,602,7821,12.85%,7.15%
2020-01-01 00:06:10,16,6,5800,263,5537,8.85%,4.53%
2020-01-01 00:06:10,16,7,3509,129,3380,5.35%,3.68%
2020-01-01 00:06:10,16,8,7686,506,7180,11.73%,6.58%
2020-01-01 00:06:10,16,9,8949,663,8286,13.66%,7.41%
2020-01-01 00:06:10,16,10,2359,44,2315,3.60%,1.86%
2020-01-01 00:06:10,16,11,10258,851,9407,15.65%,8.30%
2020-01-01 00:06:10,16,12,27716,5197,22519,42.29%,18.75%
2020-01-01 00:06:20,1,1,31886,6609,25277,48.65%,20.73%
2020-01-01 00:06:20,1,2,21626,3143,18483,33.00%,14.53%
2020-01-01 00:06:20,1,3,676,7,669,1.03%,1.03%
2020-01-01 00:06:20,1,4,9666,732,8934,14.75%,7.57%
2020-01-01 00:06:20,1,5,9126,660,8466,13.93%,7.23%
2020-01-01 00:06:20,1,6,9052,651,8401,13.81%,7.19%
2020-01-01 00:06:20,1,7,20924,2940,17984,31.93%,14.05%
2020-01-01 00:06:20,1,8,19900,2681,17219,30.36%,13.47%
2020-01-01 00:06:20,1,9,9010,646,8364,13.75%,7.17%
2020-01-01 00:06:20,1,10,19232,2503,16729,29.35%,13.01%
2020-01-01 00:06:20,1,11,19342,2535,16807,29.51%,13.11%
2020-01-01 00:06:20,1,12,8970,638,8332,13.69%,7.11%
2020-01-01 00:06:20,2,1,2182,31,2151,3.33%,1.42%
2020-01-01 00:06:20,2,2,27710,5137,22573,42.28%,18.54%
2020-01-01 00:06:20,2,3,19609,2745,16864,29.92%,14.00%
2020-01-01 00:06:20,2,4,2136,30,2106,3.26%,1.40%
2020-01-01 00:06:20,2,5,10298,804,9494,15.71%,7.81%
2020-01-01 00:06:20,2,6,39,0,39,0.06%,0.00%
2020-01-01 00:06:20,2,7,5912,270,5642,9.02%,4.57%
2020-01-01 00:06:20,2,8,4916,187,4729,7.50%,3.80%
2020-01-01 00:06:20,2,9,10238,790,9448,15.62%,7.72%
2020-01-01 00:06:20,2,10,4025,131,3894,6.14%,3.25%
2020-01-01 00:06:20,2,11,4036,134,3902,6.16%,3.32%
2020-01-01 00:06:20,2,12,10067,754,9313,15.36%,7.49%
2020-01-01 00:06:20,3,1,2814,60,2754,4.29%,2.13%
2020-01-01 00:06:20,3,2,25686,4450,21236,39.19%,17.32%
2020-01-01 00:06:20,3,3,72063,28217,43846,109.96%,39.16%
2020-01-01 00:06:20,3,4,8091,498,7593,12.35%,6.15%
2020-01-01 00:06:20,3,5,45396,12518,32878,69.27%,27.57%
2020-01-01 00:06:20,3,6,9096,611,8485,13.88%,6.72%
2020-01-01 00:06:20,3,7,21188,3083,18105,32.33%,14.55%
2020-01-01 00:06:20,3,8,15960,1827,14133,24.35%,11.45%
2020-01-01 00:06:20,3,9,35922,8215,27707,54.81%,22.87%
2020-01-01 00:06:20,3,10,5634,216,5418,8.60%,3.83%
2020-01-01 00:06:20,3,11,1724,27,1697,2.63%,1.57%
2020-01-01 00:06:20,3,12,27161,4967,22194,41.44%,18.29%
2020-01-01 00:06:20,4,1,528,5,523,0.81%,0.95%
2020-01-01 00:06:20,4,2,321,1,320,0.49%,0.31%
2020-01-01 00:06:20,4,3,640,2,638,0.98%,0.31%
2020-01-01 00:06:20,4,4,28119,5350,22769,42.91%,19.03%
2020-01-01 00:06:20,4,5,17575,2164,15411,26.82%,12.31%
2020-01-01 00:06:20,4,6,24206,3991,20215,36.94%,16.49%
2020-01-01 00:06:20,4,7,5401,228,5173,8.24%,4.22%
2020-01-01 00:06:20,4,8,2996,74,2922,4.57%,2.47%
2020-01-01 00:06:20,4,9,15778,1769,14009,24.08%,11.21%
2020-01-01 00:06:20,4,10,1831,26,1805,2.79%,1.42%
2020-01-01 00:06:20,4,11,194,0,194,0.30%,0.00%
2020-01-01 00:06:20,4,12,12330,1090,11240,18.81%,8.84%
2020-01-01 00:06:20,5,1,2715,67,2648,4.14%,2.47%
2020-01-01 00:06:20,5,2,688,5,683,1.05%,0.73%
2020-01-01 00:06:20,5,3,1537,16,1521,2.35%,1.04%
2020-01-01 00:06:20,5,4,21136,3137,17999,32.25%,14.84%
2020-01-01 00:06:20,5,5,10370,775,9595,15.82%,7.47%
2020-01-01 00:06:20,5,6,14955,1569,13386,22.82%,10.49%
2020-01-01 00:06:20,5,7,4121,137,3984,6.29%,3.32%
2020-01-01 00:06:20,5,8,3132,81,3051,4.78%,2.59%
2020-01-01 00:06:20,5,9,8716,556,8160,13.30%,6.38%
2020-01-01 00:06:20,5,10,970,11,959,1.48%,1.13%
2020-01-01 00:06:20,5,11,518,3,515,0.79%,0.58%
2020-01-01 00:06:20,5,12,7410,390,7020,11.31%,5.26%
2020-01-01 00:06:20,6,1,1179,15,1164,1.80%,1.27%
2020-01-01 00:06:20,6,2,1221,16,1205,1.86%,1.31%
2020-01-01 00:06:20,6,3,1954,29,1925,2.98%,1.48%
2020-01-01 00:06:20,6,4,1154,9,1145,1.76%,0.78%
2020-01-01 00:06:20,6,5,13258,1301,11957,20.23%,9.81%
2020-01-01 00:06:20,6,6,4302,171,4131,6.56%,3.97%
2020-01-01 00:06:20,6,7,2616,70,2546,3.99%,2.67%
2020-01-01 00:06:20,6,8,2171,48,2123,3.31%,2.21%
2020-01-01 00:06:20,6,9,6712,341,6371,10.24%,5.08%
2020-01-01 00:06:20,6,10,2181,43,2138,3.33%,1.97%
2020-01-01 00:06:20,6,11,458,2,456,0.70%,0.44%
2020-01-01 00:06:20,6,12,4446,142,4304,6.78%,3.19%
2020-01-01 00:06:20,7,1,511,3,508,0.78%,0.59%
2020-01-01 00:06:20,7,2,176,0,176,0.27%,0.00%
2020-01-01 00:06:20,7,3,1204,7,1197,1.84%,0.58%
2020-01-01 00:06:20,7,4,1849,18,1831,2.82%,0.97%
2020-01-01 00:06:20,7,5,8216,463,7753,12.54%,5.63%
2020-01-01 00:06:20,7,6,13740,1333,12407,20.97%,9.70%
2020-01-01 00:06:20,7,7,3606,100,3506,5.50%,2.77%
2020-01-01 00:06:20,7,8,1481,13,1468,2.26%,0.88%
2020-01-01 00:06:20,7,9,6931,321,6610,10.58%,4.63%
2020-01-01 00:06:20,7,10,1597,20,1577,2.44%,1.25%
2020-01-01 00:06:20,7,11,138,0,138,0.21%,0.00%
2020-01-01 00:06:20,7,12,5299,163,5136,8.09%,3.08%
2020-01-01 00:06:20,8,1,577,0,577,0.88%,0.00%
2020-01-01 00:06:20,8,2,96,0,96,0.15%,0.00%
2020-01-01 00:06:20,8,3,2020,19,2001,3.08%,0.94%
2020-01-01 00:06:20,8,4,2990,76,2914,4.56%,2.54%
2020-01-01 00:06:20,8,5,8307,519,7788,12.68%,6.25%
2020-01-01 00:06:20,8,6,16147,1881,14266,24.64%,11.65%
2020-01-01 00:06:20,8,7,4678,170,4508,7.14%,3.63%
2020-01-01 00:06:20,8,8,2016,38,1978,3.08%,1.88%
2020-01-01 00:06:20,8,9,6021,271,5750,9.19%,4.50%
2020-01-01 00:06:20,8,10,1654,15,1639,2.52%,0.91%
2020-01-01 00:06:20,8,11,117,0,117,0.18%,0.00%
2020-01-01 00:06:20,8,12,4306,145,4161,6.57%,3.37%
2020-01-01 00:06:20,9,1,1049,9,1040,1.60%,0.86%
2020-01-01 00:06:20,9,2,3403,74,3329,5.19%,2.17%
2020-01-01 00:06:20,9,3,2001,18,1983,3.05%,0.90%
2020-01-01 00:06:20,9,4,5368,213,5155,8.19%,3.97%
2020-01-01 00:06:20,9,5,297,3,294,0.45%,1.01%
2020-01-01 00:06:20,9,6,6283,295,5988,9.59%,4.69%
2020-01-01 00:06:20,9,7,26159,4550,21609,39.92%,17.39%
2020-01-01 00:06:20,9,8,9046,572,8474,13.80%,6.32%
2020-01-01 00:06:20,9,9,199,1,198,0.30%,0.50%
2020-01-01 00:06:20,9,10,2647,46,2601,4.04%,1.74%
2020-01-01 00:06:20,9,11,7927,438,7489,12.10%,5.52%
2020-01-01 00:06:20,9,12,5043,173,4870,7.70%,3.43%
2020-01-01 00:06:20,10,1,1251,199,1052,1.91%,15.89%
2020-01-01 00:06:20,10,2,3260,258,3002,4.97%,7.91%
2020-01-01 00:06:20,10,3,1858,21,1837,2.84%,1.13%
2020-01-01 00:06:20,10,4,3878,1099,2779,5.92%,28.33%
2020-01-01 00:06:20,10,5,740,58,682,1.13%,7.83%
2020-01-01 00:06:20,10,6,5840,1257,4583,8.91%,21.52%
2020-01-01 00:06:20,10,7,10784,1927,8857,16.46%,17.87%
2020-01-01 00:06:20,10,8,28379,7053,21326,43.30%,24.85%
2020-01-01 00:06:20,10,9,704,3,701,1.07%,0.43%
2020-01-01 00:06:20,10,10,2440,42,2398,3.72%,1.72%
2020-01-01 00:06:20,10,11,13707,1751,11956,20.92%,12.77%
2020-01-01 00:06:20,10,12,10304,1191,9113,15.72%,11.56%
2020-01-01 00:06:20,11,1,2622,55,2567,4.00%,2.10%
2020-01-01 00:06:20,11,2,3624,111,3513,5.53%,3.06%
2020-01-01 00:06:20,11,3,800,20,780,1.22%,2.50%
2020-01-01 00:06:20,11,4,3159,70,3089,4.82%,2.22%
2020-01-01 00:06:20,11,5,221,0,221,0.34%,0.00%
2020-01-01 00:06:20,11,6,4032,119,3913,6.15%,2.95%
2020-01-01 00:06:20,11,7,9515,691,8824,14.52%,7.26%
2020-01-01 00:06:20,11,8,22694,3533,19161,34.63%,15.57%
2020-01-01 00:06:20,11,9,200,1,199,0.31%,0.50%
2020-01-01 00:06:20,11,10,2898,69,2829,4.42%,2.38%
2020-01-01 00:06:20,11,11,9633,677,8956,14.70%,7.03%
2020-01-01 00:06:20,11,12,6303,313,5990,9.62%,4.97%
2020-01-01 00:06:20,12,1,54,0,54,0.08%,0.00%
2020-01-01 00:06:20,12,2,631,157,474,0.96%,24.84%
2020-01-01 00:06:20,12,3,2891,221,2670,4.41%,7.64%
2020-01-01 00:06:20,12,4,2897,58,2839,4.42%,2.00%
2020-01-01 00:06:20,12,5,9634,798,8836,14.70%,8.28%
2020-01-01 00:06:20,12,6,5256,228,5028,8.02%,4.34%
2020-01-01 00:06:20,12,7,2166,47,2119,3.31%,2.17%
2020-01-01 00:06:20,12,8,1975,316,1659,3.01%,15.99%
2020-01-01 00:06:20,12,9,24123,4747,19376,36.81%,19.68%
2020-01-01 00:06:20,12,10,4776,447,4329,7.29%,9.36%
2020-01-01 00:06:20,12,11,2102,316,1786,3.21%,15.03%
2020-01-01 00:06:20,12,12,9124,1248,7876,13.92%,13.68%
2020-01-01 00:06:20,13,1,2087,34,2053,3.18%,1.63%
2020-01-01 00:06:20,13,2,2460,54,2406,3.75%,2.19%
2020-01-01 00:06:20,13,3,792,3,789,1.21%,0.38%
2020-01-01 00:06:20,13,4,5668,580,5088,8.65%,10.23%
2020-01-01 00:06:20,13,5,8132,886,7246,12.41%,10.89%
2020-01-01 00:06:20,13,6,6585,649,5936,10.05%,9.85%
2020-01-01 00:06:20,13,7,4645,188,4457,7.09%,4.05%
2020-01-01 00:06:20,13,8,6918,364,6554,10.56%,5.26%
2020-01-01 00:06:20,13,9,8385,913,7472,12.79%,10.89%
2020-01-01 00:06:20,13,10,28183,5819,22364,43.00%,20.65%
2020-01-01 00:06:20,13,11,17167,2394,14773,26.19%,13.94%
2020-01-01 00:06:20,13,12,9740,1036,8704,14.86%,10.64%
2020-01-01 00:06:20,14,1,201,0,201,0.31%,0.00%
2020-01-01 00:06:20,14,2,1041,7,1034,1.59%,0.67%
2020-01-01 00:06:20,14,3,615,5,610,0.94%,0.81%
2020-01-01 00:06:20,14,4,3877,121,3756,5.92%,3.12%
2020-01-01 00:06:20,14,5,1593,14,1579,2.43%,0.88%
2020-01-01 00:06:20,14,6,4209,141,4068,6.42%,3.35%
2020-01-01 00:06:20,14,7,11590,967,10623,17.68%,8.34%
2020-01-01 00:06:20,14,8,13063,1224,11839,19.93%,9.37%
2020-01-01 00:06:20,14,9,1808,18,1790,2.76%,1.00%
2020-01-01 00:06:20,14,10,4156,131,4025,6.34%,3.15%
2020-01-01 00:06:20,14,11,25431,4370,21061,38.80%,17.18%
2020-01-01 00:06:20,14,12,7982,471,7511,12.18%,5.90%
2020-01-01 00:06:20,15,1,523,1,522,0.80%,0.19%
2020-01-01 00:06:20,15,2,160,0,160,0.24%,0.00%
2020-01-01 00:06:20,15,3,3971,136,3835,6.06%,3.42%
2020-01-01 00:06:20,15,4,4877,171,4706,7.44%,3.51%
2020-01-01 00:06:20,15,5,9630,720,8910,14.69%,7.48%
2020-01-01 00:06:20,15,6,5087,188,4899,7.76%,3.69%
2020-01-01 00:06:20,15,7,3111,87,3024,4.75%,2.80%
2020-01-01 00:06:20,15,8,5303,234,5069,8.09%,4.41%
2020-01-01 00:06:20,15,9,9828,740,9088,15.00%,7.53%
2020-01-01 00:06:20,15,10,4549,274,4275,6.94%,6.02%
2020-01-01 00:06:20,15,11,9954,860,9094,15.19%,8.64%
2020-01-01 00:06:20,15,12,24906,4715,20191,38.00%,18.93%
2020-01-01 00:06:20,16,1,526,1,525,0.80%,0.19%
2020-01-01 00:06:20,16,2,336,0,336,0.51%,0.00%
2020-01-01 00:06:20,16,3,1350,17,1333,2.06%,1.26%
2020-01-01 00:06:20,16,4,4772,173,4599,7.28%,3.62%
2020-01-01 00:06:20,16,5,8050,518,7532,12.28%,6.43%
2020-01-01 00:06:20,16,6,5591,234,5357,8.53%,4.18%
2020-01-01 00:06:20,16,7,4332,135,4197,6.61%,3.12%
2020-01-01 00:06:20,16,8,8260,566,7694,12.60%,6.85%
2020-01-01 00:06:20,16,9,8578,579,7999,13.09%,6.75%
2020-01-01 00:06:20,16,10,1502,24,1478,2.29%,1.60%
2020-01-01 00:06:20,16,11,10039,790,9249,15.32%,7.87%
2020-01-01 00:06:20,16,12,26067,4735,21332,39.78%,18.16%
2020-01-01 00:06:30,1,1,28412,5359,23053,43.35%,18.86%
2020-01-01 00:06:30,1,2,16594,1941,14653,25.32%,11.70%
2020-01-01 00:06:30,1,3,375,0,375,0.57%,0.00%
2020-01-01 00:06:30,1,4,11311,933,10378,17.26%,8.25%
2020-01-01 00:06:30,1,5,10980,875,10105,16.75%,7.97%
2020-01-01 00:06:30,1,6,10905,859,10046,16.64%,7.88%
2020-01-01 00:06:30,1,7,16195,1842,14353,24.71%,11.37%
2020-01-01 00:06:30,1,8,15174,1638,13536,23.15%,10.79%
2020-01-01 00:06:30,1,9,10872,855,10017,16.59%,7.86%
2020-01-01 00:06:30,1,10,14498,1489,13009,22.12%,10.27%
2020-01-01 00:06:30,1,11,14556,1498,13058,22.21%,10.29%
2020-01-01 00:06:30,1,12,10850,849,10001,16.56%,7.82%
2020-01-01 00:06:30,2,1,2575,45,2530,3.93%,1.75%
2020-01-01 00:06:30,2,2,26001,4535,21466,39.67%,17.44%
2020-01-01 00:06:30,2,3,17067,2026,15041,26.04%,11.87%
2020-01-01 00:06:30,2,4,2500,42,2458,3.81%,1.68%
2020-01-01 00:06:30,2,5,10223,739,9484,15.60%,7.23%
2020-01-01 00:06:30,2,6,28,0,28,0.04%,0.00%
2020-01-01 00:06:30,2,7,6351,316,6035,9.69%,4.97%
2020-01-01 00:06:30,2,8,5186,214,4972,7.91%,4.13%
2020-01-01 00:06:30,2,9,10110,722,9388,15.43%,7.14%
2020-01-01 00:06:30,2,10,4469,163,4306,6.82%,3.65%
2020-01-01 00:06:30,2,11,4486,165,4321,6.85%,3.68%
2020-01-01 00:06:30,2,12,9979,700,9279,15.23%,7.01%
2020-01-01 00:06:30,3,1,1700,20,1680,2.59%,1.18%
2020-01-01 00:06:30,3,2,23663,3818,19845,36.11%,16.13%
2020-01-01 00:06:30,3,3,70646,27511,43135,107.80%,38.94%
2020-01-01 00:06:30,3,4,9456,591,8865,14.43%,6.25%
2020-01-01 00:06:30,3,5,45664,12853,32811,69.68%,28.15%
2020-01-01 00:06:30,3,6,10795,786,10009,16.47%,7.28%
2020-01-01 00:06:30,3,7,20416,2877,17539,31.15%,14.09%
2020-01-01 00:06:30,3,8,16384,1897,14487,25.00%,11.58%
2020-01-01 00:06:30,3,9,34383,7861,26522,52.46%,22.86%
2020-01-01 00:06:30,3,10,4102,322,3780,6.26%,7.85%
2020-01-01 00:06:30,3,11,1992,30,1962,3.04%,1.51%
2020-01-01 00:06:30,3,12,28087,5300,22787,42.86%,18.87%
2020-01-01 00:06:30,4,1,585,1,584,0.89%,0.17%
2020-01-01 00:06:30,4,2,352,0,352,0.54%,0.00%
2020-01-01 00:06:30,4,3,817,5,812,1.25%,0.61%
2020-01-01 00:06:30,4,4,28795,5399,23396,43.94%,18.75%
2020-01-01 00:06:30,4,5,18107,2230,15877,27.63%,12.31%
2020-01-01 00:06:30,4,6,24574,3979,20595,37.50%,16.19%
2020-01-01 00:06:30,4,7,5367,193,5174,8.19%,3.60%
2020-01-01 00:06:30,4,8,3081,66,3015,4.70%,2.14%
2020-01-01 00:06:30,4,9,15471,1653,13818,23.61%,10.68%
2020-01-01 00:06:30,4,10,1906,31,1875,2.91%,1.63%
2020-01-01 00:06:30,4,11,135,0,135,0.21%,0.00%
2020-01-01 00:06:30,4,12,12340,1053,11287,18.83%,8.53%
2020-01-01 00:06:30,5,1,2645,51,2594,4.04%,1.93%
2020-01-01 00:06:30,5,2,673,7,666,1.03%,1.04%
2020-01-01 00:06:30,5,3,474,2,472,0.72%,0.42%
2020-01-01 00:06:30,5,4,21621,3276,18345,32.99%,15.15%
2020-01-01 00:06:30,5,5,9661,691,8970,14.74%,7.15%
2020-01-01 00:06:30,5,6,14359,1530,12829,21.91%,10.65%
2020-01-01 00:06:30,5,7,4158,157,4001,6.34%,3.77%
2020-01-01 00:06:30,5,8,3350,98,3252,5.11%,2.92%
2020-01-01 00:06:30,5,9,9070,612,8458,13.84%,6.75%
2020-01-01 00:06:30,5,10,1200,19,1181,1.83%,1.58%
2020-01-01 00:06:30,5,11,664,4,660,1.01%,0.60%
2020-01-01 00:06:30,5,12,7608,445,7163,11.61%,5.85%
2020-01-01 00:06:30,6,1,952,8,944,1.45%,0.84%
2020-01-01 00:06:30,6,2,1040,14,1026,1.59%,1.34%
2020-01-01 00:06:30,6,3,1576,23,1553,2.40%,1.46%
2020-01-01 00:06:30,6,4,1458,8,1450,2.22%,0.55%
2020-01-01 00:06:30,6,5,15423,1729,13694,23.53%,11.21%
2020-01-01 00:06:30,6,6,5191,203,4988,7.92%,3.91%
2020-01-01 00:06:30,6,7,3197,93,3104,4.88%,2.91%
2020-01-01 00:06:30,6,8,2579,64,2515,3.94%,2.48%
2020-01-01 00:06:30,6,9,8380,493,7887,12.79%,5.88%
2020-01-01 00:06:30,6,10,2498,64,2434,3.81%,2.56%
2020-01-01 00:06:30,6,11,428,1,427,0.65%,0.23%
2020-01-01 00:06:30,6,12,5753,212,5541,8.78%,3.68%
2020-01-01 00:06:30,7,1,421,2,419,0.64%,0.47%
2020-01-01 00:06:30,7,2,227,0,227,0.35%,0.00%
2020-01-01 00:06:30,7,3,1242,8,1234,1.90%,0.64%
2020-01-01 00:06:30,7,4,1342,12,1330,2.05%,0.89%
2020-01-01 00:06:30,7,5,8637,529,8108,13.18%,6.12%
2020-01-01 00:06:30,7,6,13521,1354,12167,20.63%,10.01%
2020-01-01 00:06:30,7,7,3487,105,3382,5.32%,3.01%
2020-01-01 00:06:30,7,8,1247,11,1236,1.90%,0.88%
2020-01-01 00:06:30,7,9,7324,396,6928,11.18%,5.41%
2020-01-01 00:06:30,7,10,2463,31,2432,3.76%,1.26%
2020-01-01 00:06:30,7,11,108,0,108,0.16%,0.00%
2020-01-01 00:06:30,7,12,4786,172,4614,7.30%,3.59%
2020-01-01 00:06:30,8,1,393,0,393,0.60%,0.00%
2020-01-01 00:06:30,8,2,107,0,107,0.16%,0.00%
2020-01-01 00:06:30,8,3,1641,19,1622,2.50%,1.16%
2020-01-01 00:06:30,8,4,2497,42,2455,3.81%,1.68%
2020-01-01 00:06:30,8,5,8302,508,7794,12.67%,6.12%
2020-01-01 00:06:30,8,6,15831,1762,14069,24.16%,11.13%
2020-01-01 00:06:30,8,7,4932,217,4715,7.53%,4.40%
2020-01-01 00:06:30,8,8,1853,31,1822,2.83%,1.67%
2020-01-01 00:06:30,8,9,6449,310,6139,9.84%,4.81%
2020-01-01 00:06:30,8,10,1705,23,1682,2.60%,1.35%
2020-01-01 00:06:30,8,11,153,0,153,0.23%,0.00%
2020-01-01 00:06:30,8,12,4613,157,4456,7.04%,3.40%
2020-01-01 00:06:30,9,1,848,17,831,1.29%,2.00%
2020-01-01 00:06:30,9,2,2672,49,2623,4.08%,1.83%
2020-01-01 00:06:30,9,3,1328,8,1320,2.03%,0.60%
2020-01-01 00:06:30,9,4,6650,309,6341,10.15%,4.65%
2020-01-01 00:06:30,9,5,258,0,258,0.39%,0.00%
2020-01-01 00:06:30,9,6,7352,389,6963,11.22%,5.29%
2020-01-01 00:06:30,9,7,27830,5127,22703,42.47%,18.42%
2020-01-01 00:06:30,9,8,11974,1058,10916,18.27%,8.84%
2020-01-01 00:06:30,9,9,143,0,143,0.22%,0.00%
2020-01-01 00:06:30,9,10,3679,108,3571,5.61%,2.93%
2020-01-01 00:06:30,9,11,10649,826,9823,16.25%,7.76%
2020-01-01 00:06:30,9,12,6643,321,6322,10.14%,4.83%
2020-01-01 00:06:30,10,1,1370,217,1153,2.09%,15.83%
2020-01-01 00:06:30,10,2,3170,264,2906,4.84%,8.33%
2020-01-01 00:06:30,10,3,1570,17,1553,2.40%,1.08%
2020-01-01 00:06:30,10,4,3780,919,2861,5.77%,24.31%
2020-01-01 00:06:30,10,5,735,39,696,1.12%,5.30%
2020-01-01 00:06:30,10,6,5772,1073,4699,8.81%,18.59%
2020-01-01 00:06:30,10,7,10534,1752,8782,16.07%,16.63%
2020-01-01 00:06:30,10,8,27374,6549,20825,41.77%,23.92%
2020-01-01 00:06:30,10,9,923,3,920,1.41%,0.32%
2020-01-01 00:06:30,10,10,2466,34,2432,3.76%,1.38%
2020-01-01 00:06:30,10,11,12968,1547,11421,19.79%,11.93%
2020-01-01 00:06:30,10,12,9641,1074,8567,14.71%,11.14%
2020-01-01 00:06:30,11,1,2444,33,2411,3.73%,1.35%
2020-01-01 00:06:30,11,2,3733,144,3589,5.70%,3.86%
2020-01-01 00:06:30,11,3,1065,51,1014,1.63%,4.78%
2020-01-01 00:06:30,11,4,5112,179,4933,7.80%,3.50%
2020-01-01 00:06:30,11,5,816,9,807,1.25%,1.10%
2020-01-01 00:06:30,11,6,6541,296,6245,9.98%,4.52%
2020-01-01 00:06:30,11,7,12259,1093,11166,18.71%,8.92%
2020-01-01 00:06:30,11,8,25746,4426,21320,39.29%,17.19%
2020-01-01 00:06:30,11,9,208,0,208,0.32%,0.00%
2020-01-01 00:06:30,11,10,3304,81,3223,5.04%,2.45%
2020-01-01 00:06:30,11,11,10145,786,9359,15.48%,7.75%
2020-01-01 00:06:30,11,12,6514,309,6205,9.94%,4.74%
2020-01-01 00:06:30,12,1,40,0,40,0.06%,0.00%
2020-01-01 00:06:30,12,2,616,186,430,0.94%,30.15%
2020-01-01 00:06:30,12,3,2999,245,2754,4.58%,8.17%
2020-01-01 00:06:30,12,4,2646,62,2584,4.04%,2.34%
2020-01-01 00:06:30,12,5,9897,913,8984,15.10%,9.22%
2020-01-01 00:06:30,12,6,6034,288,5746,9.21%,4.77%
2020-01-01 00:06:30,12,7,3247,90,3157,4.95%,2.77%
2020-01-01 00:06:30,12,8,1547,315,1232,2.36%,20.35%
2020-01-01 00:06:30,12,9,24249,4978,19271,37.00%,20.53%
2020-01-01 00:06:30,12,10,4287,424,3863,6.54%,9.89%
2020-01-01 00:06:30,12,11,1699,319,1380,2.59%,18.76%
2020-01-01 00:06:30,12,12,9573,1247,8326,14.61%,13.02%
2020-01-01 00:06:30,13,1,1988,29,1959,3.03%,1.46%
2020-01-01 00:06:30,13,2,2371,69,2302,3.62%,2.91%
2020-01-01 00:06:30,13,3,745,6,739,1.14%,0.80%
2020-01-01 00:06:30,13,4,5235,556,4679,7.99%,10.62%
2020-01-01 00:06:30,13,5,7451,859,6592,11.37%,11.53%
2020-01-01 00:06:30,13,6,6068,620,5448,9.26%,10.22%
2020-01-01 00:06:30,13,7,5357,225,5132,8.17%,4.20%
2020-01-01 00:06:30,13,8,7482,432,7050,11.42%,5.77%
2020-01-01 00:06:30,13,9,7710,880,6830,11.76%,11.41%
2020-01-01 00:06:30,13,10,28198,5932,22266,43.03%,21.04%
2020-01-01 00:06:30,13,11,17971,2609,15362,27.42%,14.52%
2020-01-01 00:06:30,13,12,9957,1149,8808,15.19%,11.54%
2020-01-01 00:06:30,14,1,379,2,377,0.58%,0.53%
2020-01-01 00:06:30,14,2,1231,17,1214,1.88%,1.38%
2020-01-01 00:06:30,14,3,604,8,596,0.92%,1.32%
2020-01-01 00:06:30,14,4,3797,105,3692,5.79%,2.76%
2020-01-01 00:06:30,14,5,1326,10,1316,2.02%,0.75%
2020-01-01 00:06:30,14,6,4069,129,3940,6.21%,3.17%
2020-01-01 00:06:30,14,7,11583,991,10592,17.67%,8.55%
2020-01-01 00:06:30,14,8,12936,1215,11721,19.74%,9.39%
2020-01-01 00:06:30,14,9,1530,18,1512,2.33%,1.18%
2020-01-01 00:06:30,14,10,4009,120,3889,6.12%,2.99%
2020-01-01 00:06:30,14,11,24936,4273,20663,38.05%,17.14%
2020-01-01 00:06:30,14,12,7779,463,7316,11.87%,5.95%
2020-01-01 00:06:30,15,1,602,1,601,0.92%,0.17%
2020-01-01 00:06:30,15,2,195,0,195,0.30%,0.00%
2020-01-01 00:06:30,15,3,4195,131,4064,6.40%,3.12%
2020-01-01 00:06:30,15,4,5224,222,5002,7.97%,4.25%
2020-01-01 00:06:30,15,5,10736,844,9892,16.38%,7.86%
2020-01-01 00:06:30,15,6,5510,249,5261,8.41%,4.52%
2020-01-01 00:06:30,15,7,3506,95,3411,5.35%,2.71%
2020-01-01 00:06:30,15,8,5516,224,5292,8.42%,4.06%
2020-01-01 00:06:30,15,9,10939,883,10056,16.69%,8.07%
2020-01-01 00:06:30,15,10,4057,115,3942,6.19%,2.83%
2020-01-01 00:06:30,15,11,9694,659,9035,14.79%,6.80%
2020-01-01 00:06:30,15,12,25903,4795,21108,39.52%,18.51%
2020-01-01 00:06:30,16,1,464,1,463,0.71%,0.22%
2020-01-01 00:06:30,16,2,278,0,278,0.42%,0.00%
2020-01-01 00:06:30,16,3,1186,9,1177,1.81%,0.76%
2020-01-01 00:06:30,16,4,3800,98,3702,5.80%,2.58%
2020-01-01 00:06:30,16,5,7099,417,6682,10.83%,5.87%
2020-01-01 00:06:30,16,6,4466,134,4332,6.81%,3.00%
2020-01-01 00:06:30,16,7,4264,155,4109,6.51%,3.63%
2020-01-01 00:06:30,16,8,7964,519,7445,12.15%,6.52%
2020-01-01 00:06:30,16,9,7508,469,7039,11.46%,6.25%
2020-01-01 00:06:30,16,10,1677,29,1648,2.56%,1.73%
2020-01-01 00:06:30,16,11,9921,755,9166,15.14%,7.61%
2020-01-01 00:06:30,16,12,25515,4480,21035,38.93%,17.56%
2020-01-01 00:06:40,1,1,21594,3222,18372,32.95%,14.92%
2020-01-01 00:06:40,1,2,10312,759,9553,15.73%,7.36%
2020-01-01 00:06:40,1,3,504,0,504,0.77%,0.00%
2020-01-01 00:06:40,1,4,10943,870,10073,16.70%,7.95%
2020-01-01 00:06:40,1,5,10664,830,9834,16.27%,7.78%
2020-01-01 00:06:40,1,6,10617,818,9799,16.20%,7.70%
2020-01-01 00:06:40,1,7,9791,686,9105,14.94%,7.01%
2020-01-01 00:06:40,1,8,7865,428,7437,12.00%,5.44%
2020-01-01 00:06:40,1,9,10558,812,9746,16.11%,7.69%
2020-01-01 00:06:40,1,10,7300,367,6933,11.14%,5.03%
2020-01-01 00:06:40,1,11,7368,380,6988,11.24%,5.16%
2020-01-01 00:06:40,1,12,10544,811,9733,16.09%,7.69%
2020-01-01 00:06:40,2,1,1397,5,1392,2.13%,0.36%
2020-01-01 00:06:40,2,2,26283,4606,21677,40.10%,17.52%
2020-01-01 00:06:40,2,3,19981,2760,17221,30.49%,13.81%
2020-01-01 00:06:40,2,4,1339,5,1334,2.04%,0.37%
2020-01-01 00:06:40,2,5,12218,1060,11158,18.64%,8.68%
2020-01-01 00:06:40,2,6,61,0,61,0.09%,0.00%
2020-01-01 00:06:40,2,7,4891,188,4703,7.46%,3.84%
2020-01-01 00:06:40,2,8,3914,114,3800,5.97%,2.91%
2020-01-01 00:06:40,2,9,12094,1036,11058,18.45%,8.57%
2020-01-01 00:06:40,2,10,3237,85,3152,4.94%,2.63%
2020-01-01 00:06:40,2,11,3276,88,3188,5.00%,2.69%
2020-01-01 00:06:40,2,12,11906,997,10909,18.17%,8.37%
2020-01-01 00:06:40,3,1,1217,7,1210,1.86%,0.57%
2020-01-01 00:06:40,3,2,24876,4215,20661,37.96%,16.94%
2020-01-01 00:06:40,3,3,71308,27857,43451,108.81%,39.07%
2020-01-01 00:06:40,3,4,5271,205,5066,8.04%,3.89%
2020-01-01 00:06:40,3,5,43028,11405,31623,65.66%,26.51%
2020-01-01 00:06:40,3,6,7292,387,6905,11.13%,5.31%
2020-01-01 00:06:40,3,7,21723,3279,18444,33.15%,15.09%
2020-01-01 00:06:40,3,8,18274,2367,15907,27.88%,12.95%
2020-01-01 00:06:40,3,9,35346,7920,27426,53.93%,22.41%
2020-01-01 00:06:40,3,10,6927,349,6578,10.57%,5.04%
2020-01-01 00:06:40,3,11,1800,25,1775,2.75%,1.39%
2020-01-01 00:06:40,3,12,25917,4421,21496,39.55%,17.06%
2020-01-01 00:06:40,4,1,484,0,484,0.74%,0.00%
2020-01-01 00:06:40,4,2,306,0,306,0.47%,0.00%
2020-01-01 00:06:40,4,3,981,13,968,1.50%,1.32%
2020-01-01 00:06:40,4,4,26673,4780,21893,40.70%,17.92%
2020-01-01 00:06:40,4,5,17242,2143,15099,26.31%,12.43%
2020-01-01 00:06:40,4,6,23089,3668,19421,35.23%,15.89%
2020-01-01 00:06:40,4,7,4709,163,4546,7.19%,3.46%
2020-01-01 00:06:40,4,8,2793,59,2734,4.26%,2.11%
2020-01-01 00:06:40,4,9,14579,1547,13032,22.25%,10.61%
2020-01-01 00:06:40,4,10,1848,29,1819,2.82%,1.57%
2020-01-01 00:06:40,4,11,148,0,148,0.23%,0.00%
2020-01-01 00:06:40,4,12,12166,1092,11074,18.56%,8.98%
2020-01-01 00:06:40,5,1,3043,68,2975,4.64%,2.23%
2020-01-01 00:06:40,5,2,820,5,815,1.25%,0.61%
2020-01-01 00:06:40,5,3,439,1,438,0.67%,0.23%
2020-01-01 00:06:40,5,4,21566,3256,18310,32.91%,15.10%
2020-01-01 00:06:40,5,5,10213,777,9436,15.58%,7.61%
2020-01-01 00:06:40,5,6,14850,1595,13255,22.66%,10.74%
2020-01-01 00:06:40,5,7,4172,147,4025,6.37%,3.52%
2020-01-01 00:06:40,5,8,3460,97,3363,5.28%,2.80%
2020-01-01 00:06:40,5,9,9633,708,8925,14.70%,7.35%
2020-01-01 00:06:40,5,10,881,6,875,1.34%,0.68%
2020-01-01 00:06:40,5,11,931,9,922,1.42%,0.97%
2020-01-01 00:06:40,5,12,8455,550,7905,12.90%,6.50%
2020-01-01 00:06:40,6,1,1045,6,1039,1.59%,0.57%
2020-01-01 00:06:40,6,2,1132,9,1123,1.73%,0.79%
2020-01-01 00:06:40,6,3,2085,28,2057,3.18%,1.34%
2020-01-01 00:06:40,6,4,1433,24,1409,2.19%,1.67%
2020-01-01 00:06:40,6,5,18180,2338,15842,27.74%,12.86%
2020-01-01 00:06:40,6,6,5152,195,4957,7.86%,3.78%
2020-01-01 00:06:40,6,7,3238,87,3151,4.94%,2.69%
2020-01-01 00:06:40,6,8,2621,55,2566,4.00%,2.10%
2020-01-01 00:06:40,6,9,10546,862,9684,16.09%,8.17%
2020-01-01 00:06:40,6,10,2623,72,2551,4.00%,2.74%
2020-01-01 00:06:40,6,11,453,3,450,0.69%,0.66%
2020-01-01 00:06:40,6,12,7861,487,7374,11.99%,6.19%
2020-01-01 00:06:40,7,1,338,3,335,0.52%,0.88%
2020-01-01 00:06:40,7,2,249,0,249,0.38%,0.00%
2020-01-01 00:06:40,7,3,1444,15,1429,2.20%,1.04%
2020-01-01 00:06:40,7,4,1376,18,1358,2.10%,1.31%
2020-01-01 00:06:40,7,5,7703,402,7301,11.75%,5.22%
2020-01-01 00:06:40,7,6,12343,1058,11285,18.83%,8.57%
2020-01-01 00:06:40,7,7,3198,67,3131,4.88%,2.09%
2020-01-01 00:06:40,7,8,1127,5,1122,1.72%,0.44%
2020-01-01 00:06:40,7,9,6194,273,5921,9.45%,4.41%
2020-01-01 00:06:40,7,10,1658,11,1647,2.53%,0.66%
2020-01-01 00:06:40,7,11,94,0,94,0.14%,0.00%
2020-01-01 00:06:40,7,12,4509,134,4375,6.88%,2.97%
2020-01-01 00:06:40,8,1,409,2,407,0.62%,0.49%
2020-01-01 00:06:40,8,2,121,1,120,0.18%,0.82%
2020-01-01 00:06:40,8,3,1713,23,1690,2.61%,1.34%
2020-01-01 00:06:40,8,4,2400,47,2353,3.66%,1.96%
2020-01-01 00:06:40,8,5,8383,530,7853,12.79%,6.32%
2020-01-01 00:06:40,8,6,16592,1975,14617,25.32%,11.90%
2020-01-01 00:06:40,8,7,5712,271,5441,8.72%,4.74%
2020-01-01 00:06:40,8,8,2679,63,2616,4.09%,2.35%
2020-01-01 00:06:40,8,9,6416,321,6095,9.79%,5.00%
2020-01-01 00:06:40,8,10,1690,16,1674,2.58%,0.95%
2020-01-01 00:06:40,8,11,148,0,148,0.23%,0.00%
2020-01-01 00:06:40,8,12,4514,168,4346,6.89%,3.72%
2020-01-01 00:06:40,9,1,347,0,347,0.53%,0.00%
2020-01-01 00:06:40,9,2,2871,76,2795,4.38%,2.65%
2020-01-01 00:06:40,9,3,1822,38,1784,2.78%,2.08%
2020-01-01 00:06:40,9,4,12107,986,11121,18.47%,8.14%
2020-01-01 00:06:40,9,5,452,1,451,0.69%,0.22%
2020-01-01 00:06:40,9,6,13010,1139,11871,19.85%,8.75%
2020-01-01 00:06:40,9,7,35062,7839,27223,53.50%,22.36%
2020-01-01 00:06:40,9,8,12862,1190,11672,19.63%,9.25%
2020-01-01 00:06:40,9,9,357,1,356,0.54%,0.28%
2020-01-01 00:06:40,9,10,5919,285,5634,9.03%,4.81%
2020-01-01 00:06:40,9,11,11428,966,10462,17.44%,8.45%
2020-01-01 00:06:40,9,12,5165,206,4959,7.88%,3.99%
2020-01-01 00:06:40,10,1,1164,277,887,1.78%,23.78%
2020-01-01 00:06:40,10,2,3628,360,3268,5.54%,9.92%
2020-01-01 00:06:40,10,3,2245,38,2207,3.43%,1.69%
2020-01-01 00:06:40,10,4,4047,995,3052,6.18%,24.58%
2020-01-01 00:06:40,10,5,577,1,576,0.88%,0.17%
2020-01-01 00:06:40,10,6,6068,1119,4949,9.26%,18.44%
2020-01-01 00:06:40,10,7,11524,1970,9554,17.58%,17.09%
2020-01-01 00:06:40,10,8,28279,7137,21142,43.15%,25.24%
2020-01-01 00:06:40,10,9,679,2,677,1.04%,0.29%
2020-01-01 00:06:40,10,10,2405,40,2365,3.67%,1.66%
2020-01-01 00:06:40,10,11,12442,1477,10965,18.98%,11.87%
2020-01-01 00:06:40,10,12,9335,1036,8299,14.24%,11.10%
2020-01-01 00:06:40,11,1,1916,28,1888,2.92%,1.46%
2020-01-01 00:06:40,11,2,3219,68,3151,4.91%,2.11%
2020-01-01 00:06:40,11,3,1136,7,1129,1.73%,0.62%
2020-01-01 00:06:40,11,4,3438,94,3344,5.25%,2.73%
2020-01-01 00:06:40,11,5,382,1,381,0.58%,0.26%
2020-01-01 00:06:40,11,6,4330,152,4178,6.61%,3.51%
2020-01-01 00:06:40,11,7,10420,791,9629,15.90%,7.59%
2020-01-01 00:06:40,11,8,23376,3757,19619,35.67%,16.07%
2020-01-01 00:06:40,11,9,221,0,221,0.34%,0.00%
2020-01-01 00:06:40,11,10,3373,104,3269,5.15%,3.08%
2020-01-01 00:06:40,11,11,9931,764,9167,15.15%,7.69%
2020-01-01 00:06:40,11,12,6338,315,6023,9.67%,4.97%
2020-01-01 00:06:40,12,1,15,0,15,0.02%,0.00%
2020-01-01 00:06:40,12,2,693,217,476,1.06%,31.27%
2020-01-01 00:06:40,12,3,2845,256,2589,4.34%,9.00%
2020-01-01 00:06:40,12,4,2487,61,2426,3.79%,2.45%
2020-01-01 00:06:40,12,5,10003,907,9096,15.26%,9.07%
2020-01-01 00:06:40,12,6,6046,262,5784,9.23%,4.33%
2020-01-01 00:06:40,12,7,3459,82,3377,5.28%,2.37%
2020-01-01 00:06:40,12,8,1268,282,986,1.93%,22.22%
2020-01-01 00:06:40,12,9,22483,4522,17961,34.31%,20.11%
2020-01-01 00:06:40,12,10,4362,401,3961,6.66%,9.19%
2020-01-01 00:06:40,12,11,1401,282,1119,2.14%,20.11%
2020-01-01 00:06:40,12,12,7397,1029,6368,11.29%,13.91%
2020-01-01 00:06:40,13,1,2256,38,2218,3.44%,1.68%
2020-01-01 00:06:40,13,2,2641,56,2585,4.03%,2.12%
2020-01-01 00:06:40,13,3,631,0,631,0.96%,0.00%
2020-01-01 00:06:40,13,4,4775,558,4217,7.29%,11.68%
2020-01-01 00:06:40,13,5,7255,866,6389,11.07%,11.93%
2020-01-01 00:06:40,13,6,5823,622,5201,8.89%,10.68%
2020-01-01 00:06:40,13,7,6292,305,5987,9.60%,4.85%
2020-01-01 00:06:40,13,8,8480,541,7939,12.94%,6.38%
2020-01-01 00:06:40,13,9,7541,900,6641,11.51%,11.93%
2020-01-01 00:06:40,13,10,28467,6013,22454,43.44%,21.12%
2020-01-01 00:06:40,13,11,18496,2738,15758,28.22%,14.80%
2020-01-01 00:06:40,13,12,9366,1040,8326,14.29%,11.10%
2020-01-01 00:06:40,14,1,420,2,418,0.64%,0.48%
2020-01-01 00:06:40,14,2,1709,21,1688,2.61%,1.23%
2020-01-01 00:06:40,14,3,1026,4,1022,1.57%,0.39%
2020-01-01 00:06:40,14,4,3748,102,3646,5.72%,2.72%
2020-01-01 00:06:40,14,5,1180,8,1172,1.80%,0.68%
2020-01-01 00:06:40,14,6,4056,118,3938,6.19%,2.91%
2020-01-01 00:06:40,14,7,11372,914,10458,17.35%,8.04%
2020-01-01 00:06:40,14,8,13305,1270,12035,20.30%,9.54%
2020-01-01 00:06:40,14,9,1482,12,1470,2.26%,0.81%
2020-01-01 00:06:40,14,10,3790,97,3693,5.78%,2.56%
2020-01-01 00:06:40,14,11,24735,4154,20581,37.74%,16.79%
2020-01-01 00:06:40,14,12,7453,391,7062,11.37%,5.25%
2020-01-01 00:06:40,15,1,398,0,398,0.61%,0.00%
2020-01-01 00:06:40,15,2,185,0,185,0.28%,0.00%
2020-01-01 00:06:40,15,3,3640,95,3545,5.55%,2.61%
2020-01-01 00:06:40,15,4,5291,212,5079,8.07%,4.01%
2020-01-01 00:06:40,15,5,10638,826,9812,16.23%,7.76%
2020-01-01 00:06:40,15,6,5570,229,5341,8.50%,4.11%
2020-01-01 00:06:40,15,7,3808,129,3679,5.81%,3.39%
2020-01-01 00:06:40,15,8,5756,269,5487,8.78%,4.67%
2020-01-01 00:06:40,15,9,10865,849,10016,16.58%,7.81%
2020-01-01 00:06:40,15,10,5065,203,4862,7.73%,4.01%
2020-01-01 00:06:40,15,11,10949,887,10062,16.71%,8.10%
2020-01-01 00:06:40,15,12,27607,5405,22202,42.12%,19.58%
2020-01-01 00:06:40,16,1,351,1,350,0.54%,0.28%
2020-01-01 00:06:40,16,2,234,0,234,0.36%,0.00%
2020-01-01 00:06:40,16,3,1015,9,1006,1.55%,0.89%
2020-01-01 00:06:40,16,4,4058,148,3910,6.19%,3.65%
2020-01-01 00:06:40,16,5,7296,527,6769,11.13%,7.22%
2020-01-01 00:06:40,16,6,4800,184,4616,7.32%,3.83%
2020-01-01 00:06:40,16,7,3674,97,3577,5.61%,2.64%
2020-01-01 00:06:40,16,8,7989,514,7475,12.19%,6.43%
2020-01-01 00:06:40,16,9,7648,570,7078,11.67%,7.45%
2020-01-01 00:06:40,16,10,1517,19,1498,2.31%,1.25%
2020-01-01 00:06:40,16,11,9771,766,9005,14.91%,7.84%
2020-01-01 00:06:40,16,12,25453,4527,20926,38.84%,17.79%
2020-01-01 00:06:50,1,1,17460,2219,15241,26.64%,12.71%
2020-01-01 00:06:50,1,2,7327,414,6913,11.18%,5.65%
2020-01-01 00:06:50,1,3,489,2,487,0.75%,0.41%
2020-01-01 00:06:50,1,4,9787,777,9010,14.93%,7.94%
2020-01-01 00:06:50,1,5,9418,716,8702,14.37%,7.60%
2020-01-01 00:06:50,1,6,9375,712,8663,14.31%,7.59%
2020-01-01 00:06:50,1,7,6827,367,6460,10.42%,5.37%
2020-01-01 00:06:50,1,8,6124,293,5831,9.34%,4.78%
2020-01-01 00:06:50,1,9,9325,698,8627,14.23%,7.48%
2020-01-01 00:06:50,1,10,5587,236,5351,8.53%,4.22%
2020-01-01 00:06:50,1,11,5670,246,5424,8.65%,4.34%
2020-01-01 00:06:50,1,12,9296,695,8601,14.18%,7.48%
2020-01-01 00:06:50,2,1,2602,52,2550,3.97%,2.00%
2020-01-01 00:06:50,2,2,25572,4345,21227,39.02%,16.99%
2020-01-01 00:06:50,2,3,19234,2520,16714,29.35%,13.10%
2020-01-01 00:06:50,2,4,2558,52,2506,3.90%,2.03%
2020-01-01 00:06:50,2,5,11714,988,10726,17.87%,8.43%
2020-01-01 00:06:50,2,6,40,0,40,0.06%,0.00%
2020-01-01 00:06:50,2,7,3719,119,3600,5.67%,3.20%
2020-01-01 00:06:50,2,8,2514,56,2458,3.84%,2.23%
2020-01-01 00:06:50,2,9,11598,968,10630,17.70%,8.35%
2020-01-01 00:06:50,2,10,1794,31,1763,2.74%,1.73%
2020-01-01 00:06:50,2,11,1830,31,1799,2.79%,1.69%
2020-01-01 00:06:50,2,12,11380,934,10446,17.36%,8.21%
2020-01-01 00:06:50,3,1,1197,9,1188,1.83%,0.75%
2020-01-01 00:06:50,3,2,24905,4242,20663,38.00%,17.03%
2020-01-01 00:06:50,3,3,70525,27417,43108,107.61%,38.88%
2020-01-01 00:06:50,3,4,6644,334,6310,10.14%,5.03%
2020-01-01 00:06:50,3,5,44368,12133,32235,67.70%,27.35%
2020-01-01 00:06:50,3,6,8152,482,7670,12.44%,5.91%
2020-01-01 00:06:50,3,7,20923,3067,17856,31.93%,14.66%
2020-01-01 00:06:50,3,8,17783,2241,15542,27.13%,12.60%
2020-01-01 00:06:50,3,9,35827,8221,27606,54.67%,22.95%
2020-01-01 00:06:50,3,10,8853,535,8318,13.51%,6.04%
2020-01-01 00:06:50,3,11,2109,36,2073,3.22%,1.71%
2020-01-01 00:06:50,3,12,24274,4014,20260,37.04%,16.54%
2020-01-01 00:06:50,4,1,455,1,454,0.69%,0.22%
2020-01-01 00:06:50,4,2,276,1,275,0.42%,0.36%
2020-01-01 00:06:50,4,3,1021,3,1018,1.56%,0.29%
2020-01-01 00:06:50,4,4,27026,4902,22124,41.24%,18.14%
2020-01-01 00:06:50,4,5,16872,1947,14925,25.74%,11.54%
2020-01-01 00:06:50,4,6,22914,3539,19375,34.96%,15.44%
2020-01-01 00:06:50,4,7,5020,190,4830,7.66%,3.78%
2020-01-01 00:06:50,4,8,2565,49,2516,3.91%,1.91%
2020-01-01 00:06:50,4,9,14931,1538,13393,22.78%,10.30%
2020-01-01 00:06:50,4,10,1762,20,1742,2.69%,1.13%
2020-01-01 00:06:50,4,11,148,0,148,0.23%,0.00%
2020-01-01 00:06:50,4,12,12553,1106,11447,19.15%,8.81%
2020-01-01 00:06:50,5,1,2967,65,2902,4.53%,2.19%
2020-01-01 00:06:50,5,2,797,6,791,1.22%,0.75%
2020-01-01 00:06:50,5,3,364,0,364,0.56%,0.00%
2020-01-01 00:06:50,5,4,22283,3459,18824,34.00%,15.52%
2020-01-01 00:06:50,5,5,10215,768,9447,15.59%,7.52%
2020-01-01 00:06:50,5,6,14926,1639,13287,22.78%,10.98%
2020-01-01 00:06:50,5,7,4260,155,4105,6.50%,3.64%
2020-01-01 00:06:50,5,8,3292,93,3199,5.02%,2.82%
2020-01-01 00:06:50,5,9,9757,704,9053,14.89%,7.21%
2020-01-01 00:06:50,5,10,963,8,955,1.47%,0.83%
2020-01-01 00:06:50,5,11,923,6,917,1.41%,0.65%
2020-01-01 00:06:50,5,12,8257,500,7757,12.60%,6.05%
2020-01-01 00:06:50,6,1,1058,18,1040,1.61%,1.70%
2020-01-01 00:06:50,6,2,1164,20,1144,1.78%,1.72%
2020-01-01 00:06:50,6,3,1905,34,1871,2.91%,1.78%
2020-01-01 00:06:50,6,4,1327,35,1292,2.02%,2.64%
2020-01-01 00:06:50,6,5,17711,2230,15481,27.02%,12.59%
2020-01-01 00:06:50,6,6,4369,181,4188,6.67%,4.14%
2020-01-01 00:06:50,6,7,2536,45,2491,3.87%,1.77%
2020-01-01 00:06:50,6,8,2038,25,2013,3.11%,1.23%
2020-01-01 00:06:50,6,9,11030,859,10171,16.83%,7.79%
2020-01-01 00:06:50,6,10,2461,35,2426,3.76%,1.42%
2020-01-01 00:06:50,6,11,365,3,362,0.56%,0.82%
2020-01-01 00:06:50,6,12,8528,514,8014,13.01%,6.03%
2020-01-01 00:06:50,7,1,373,5,368,0.57%,1.34%
2020-01-01 00:06:50,7,2,206,1,205,0.31%,0.48%
2020-01-01 00:06:50,7,3,1620,20,1600,2.47%,1.23%
2020-01-01 00:06:50,7,4,1330,19,1311,2.03%,1.43%
2020-01-01 00:06:50,7,5,7501,395,7106,11.45%,5.27%
2020-01-01 00:06:50,7,6,12330,1062,11268,18.81%,8.61%
2020-01-01 00:06:50,7,7,3333,86,3247,5.09%,2.58%
2020-01-01 00:06:50,7,8,1146,17,1129,1.75%,1.48%
2020-01-01 00:06:50,7,9,5804,221,5583,8.86%,3.81%
2020-01-01 00:06:50,7,10,1265,13,1252,1.93%,1.03%
2020-01-01 00:06:50,7,11,84,0,84,0.13%,0.00%
2020-01-01 00:06:50,7,12,4502,127,4375,6.87%,2.82%
2020-01-01 00:06:50,8,1,464,5,459,0.71%,1.08%
2020-01-01 00:06:50,8,2,108,0,108,0.16%,0.00%
2020-01-01 00:06:50,8,3,1671,24,1647,2.55%,1.44%
2020-01-01 00:06:50,8,4,2685,59,2626,4.10%,2.20%
2020-01-01 00:06:50,8,5,8237,475,7762,12.57%,5.77%
2020-01-01 00:06:50,8,6,16800,1939,14861,25.63%,11.54%
2020-01-01 00:06:50,8,7,5831,247,5584,8.90%,4.24%
2020-01-01 00:06:50,8,8,2580,50,2530,3.94%,1.94%
2020-01-01 00:06:50,8,9,6350,295,6055,9.69%,4.64%
2020-01-01 00:06:50,8,10,1866,31,1835,2.85%,1.66%
2020-01-01 00:06:50,8,11,220,0,220,0.34%,0.00%
2020-01-01 00:06:50,8,12,4271,132,4139,6.52%,3.09%
2020-01-01 00:06:50,9,1,770,2,768,1.17%,0.26%
2020-01-01 00:06:50,9,2,4157,118,4039,6.34%,2.84%
2020-01-01 00:06:50,9,3,2597,49,2548,3.96%,1.89%
2020-01-01 00:06:50,9,4,11179,929,10250,17.06%,8.31%
2020-01-01 00:06:50,9,5,483,1,482,0.74%,0.21%
2020-01-01 00:06:50,9,6,11939,1071,10868,18.22%,8.97%
2020-01-01 00:06:50,9,7,34312,7439,26873,52.36%,21.68%
2020-01-01 00:06:50,9,8,11461,890,10571,17.49%,7.76%
2020-01-01 00:06:50,9,9,371,1,370,0.57%,0.27%
2020-01-01 00:06:50,9,10,3086,70,3016,4.71%,2.27%
2020-01-01 00:06:50,9,11,9992,707,9285,15.25%,7.07%
2020-01-01 00:06:50,9,12,6475,300,6175,9.88%,4.63%
2020-01-01 00:06:50,10,1,1272,286,986,1.94%,22.47%
2020-01-01 00:06:50,10,2,2998,335,2663,4.57%,11.17%
2020-01-01 00:06:50,10,3,1552,21,1531,2.37%,1.35%
2020-01-01 00:06:50,10,4,4636,1059,3577,7.07%,22.84%
2020-01-01 00:06:50,10,5,525,3,522,0.80%,0.57%
2020-01-01 00:06:50,10,6,6599,1179,5420,10.07%,17.86%
2020-01-01 00:06:50,10,7,11353,1991,9362,17.32%,17.54%
2020-01-01 00:06:50,10,8,28110,7055,21055,42.89%,25.10%
2020-01-01 00:06:50,10,9,576,2,574,0.88%,0.35%
2020-01-01 00:06:50,10,10,2170,37,2133,3.31%,1.70%
2020-01-01 00:06:50,10,11,11516,1298,10218,17.57%,11.27%
2020-01-01 00:06:50,10,12,8764,908,7856,13.37%,10.36%
2020-01-01 00:06:50,11,1,1969,29,1940,3.00%,1.47%
2020-01-01 00:06:50,11,2,3142,77,3065,4.79%,2.45%
2020-01-01 00:06:50,11,3,1011,9,1002,1.54%,0.89%
2020-01-01 00:06:50,11,4,4805,175,4630,7.33%,3.64%
2020-01-01 00:06:50,11,5,745,2,743,1.14%,0.27%
2020-01-01 00:06:50,11,6,5975,269,5706,9.12%,4.50%
2020-01-01 00:06:50,11,7,12115,1111,11004,18.49%,9.17%
2020-01-01 00:06:50,11,8,24946,4292,20654,38.06%,17.20%
2020-01-01 00:06:50,11,9,165,0,165,0.25%,0.00%
2020-01-01 00:06:50,11,10,3159,77,3082,4.82%,2.44%
2020-01-01 00:06:50,11,11,10142,751,9391,15.48%,7.40%
2020-01-01 00:06:50,11,12,6728,357,6371,10.27%,5.31%
2020-01-01 00:06:50,12,1,90,0,90,0.14%,0.00%
2020-01-01 00:06:50,12,2,736,224,512,1.12%,30.39%
2020-01-01 00:06:50,12,3,2671,270,2401,4.08%,10.10%
2020-01-01 00:06:50,12,4,2526,49,2477,3.85%,1.94%
2020-01-01 00:06:50,12,5,10214,973,9241,15.59%,9.53%
2020-01-01 00:06:50,12,6,5827,276,5551,8.89%,4.74%
2020-01-01 00:06:50,12,7,3181,83,3098,4.85%,2.61%
2020-01-01 00:06:50,12,8,1168,239,929,1.78%,20.44%
2020-01-01 00:06:50,12,9,22498,4474,18024,34.33%,19.89%
2020-01-01 00:06:50,12,10,3796,325,3471,5.79%,8.56%
2020-01-01 00:06:50,12,11,1360,239,1121,2.08%,17.56%
2020-01-01 00:06:50,12,12,7563,1125,6438,11.54%,14.87%
2020-01-01 00:06:50,13,1,2325,33,2292,3.55%,1.42%
2020-01-01 00:06:50,13,2,2668,47,2621,4.07%,1.76%
2020-01-01 00:06:50,13,3,621,4,617,0.95%,0.64%
2020-01-01 00:06:50,13,4,4864,527,4337,7.42%,10.83%
2020-01-01 00:06:50,13,5,7267,856,6411,11.09%,11.78%
2020-01-01 00:06:50,13,6,5881,605,5276,8.97%,10.29%
2020-01-01 00:06:50,13,7,5352,209,5143,8.17%,3.90%
2020-01-01 00:06:50,13,8,7431,397,7034,11.34%,5.34%
2020-01-01 00:06:50,13,9,7692,896,6796,11.74%,11.65%
2020-01-01 00:06:50,13,10,28961,6123,22838,44.19%,21.14%
2020-01-01 00:06:50,13,11,18324,2596,15728,27.96%,14.17%
2020-01-01 00:06:50,13,12,10213,1077,9136,15.58%,10.54%
2020-01-01 00:06:50,14,1,336,0,336,0.51%,0.00%
2020-01-01 00:06:50,14,2,1417,16,1401,2.16%,1.13%
2020-01-01 00:06:50,14,3,952,5,947,1.45%,0.52%
2020-01-01 00:06:50,14,4,4542,158,4384,6.93%,3.48%
2020-01-01 00:06:50,14,5,1455,16,1439,2.22%,1.10%
2020-01-01 00:06:50,14,6,4909,183,4726,7.49%,3.73%
2020-01-01 00:06:50,14,7,11760,991,10769,17.94%,8.43%
2020-01-01 00:06:50,14,8,13715,1323,12392,20.93%,9.65%
2020-01-01 00:06:50,14,9,1787,26,1761,2.73%,1.45%
2020-01-01 00:06:50,14,10,4225,138,4087,6.45%,3.27%
2020-01-01 00:06:50,14,11,26646,4718,21928,40.66%,17.71%
2020-01-01 00:06:50,14,12,8415,515,7900,12.84%,6.12%
2020-01-01 00:06:50,15,1,499,2,497,0.76%,0.40%
2020-01-01 00:06:50,15,2,199,0,199,0.30%,0.00%
2020-01-01 00:06:50,15,3,3906,143,3763,5.96%,3.66%
2020-01-01 00:06:50,15,4,5367,241,5126,8.19%,4.49%
2020-01-01 00:06:50,15,5,11012,912,10100,16.80%,8.28%
2020-01-01 00:06:50,15,6,5603,261,5342,8.55%,4.66%
2020-01-01 00:06:50,15,7,4026,97,3929,6.14%,2.41%
2020-01-01 00:06:50,15,8,6081,284,5797,9.28%,4.67%
2020-01-01 00:06:50,15,9,11241,945,10296,17.15%,8.41%
2020-01-01 00:06:50,15,10,5564,265,5299,8.49%,4.76%
2020-01-01 00:06:50,15,11,11814,1043,10771,18.03%,8.83%
2020-01-01 00:06:50,15,12,29511,6068,23443,45.03%,20.56%
2020-01-01 00:06:50,16,1,364,2,362,0.56%,0.55%
2020-01-01 00:06:50,16,2,235,4,231,0.36%,1.69%
2020-01-01 00:06:50,16,3,1196,9,1187,1.82%,0.75%
2020-01-01 00:06:50,16,4,4304,144,4160,6.57%,3.34%
2020-01-01 00:06:50,16,5,7508,534,6974,11.46%,7.11%
2020-01-01 00:06:50,16,6,5079,230,4849,7.75%,4.53%
2020-01-01 00:06:50,16,7,3759,110,3649,5.74%,2.93%
2020-01-01 00:06:50,16,8,7311,479,6832,11.16%,6.55%
2020-01-01 00:06:50,16,9,7870,578,7292,12.01%,7.34%
2020-01-01 00:06:50,16,10,1693,45,1648,2.58%,2.66%
2020-01-01 00:06:50,16,11,9229,724,8505,14.08%,7.84%
2020-01-01 00:06:50,16,12,25310,4546,20764,38.62%,17.96%
2020-01-01 00:07:00,1,1,16983,2087,14896,25.91%,12.29%
2020-01-01 00:07:00,1,2,6509,324,6185,9.93%,4.98%
2020-01-01 00:07:00,1,3,665,5,660,1.01%,0.75%
2020-01-01 00:07:00,1,4,9939,788,9151,15.17%,7.93%
2020-01-01 00:07:00,1,5,9671,744,8927,14.76%,7.69%
2020-01-01 00:07:00,1,6,9630,742,8888,14.69%,7.70%
2020-01-01 00:07:00,1,7,5818,253,5565,8.88%,4.35%
2020-01-01 00:07:00,1,8,4600,157,4443,7.02%,3.41%
2020-01-01 00:07:00,1,9,9569,731,8838,14.60%,7.64%
2020-01-01 00:07:00,1,10,4078,123,3955,6.22%,3.02%
2020-01-01 00:07:00,1,11,4151,127,4024,6.33%,3.06%
2020-01-01 00:07:00,1,12,9541,728,8813,14.56%,7.63%
2020-01-01 00:07:00,2,1,1719,9,1710,2.62%,0.52%
2020-01-01 00:07:00,2,2,24669,4116,20553,37.64%,16.68%
2020-01-01 00:07:00,2,3,18683,2415,16268,28.51%,12.93%
2020-01-01 00:07:00,2,4,1651,7,1644,2.52%,0.42%
2020-01-01 00:07:00,2,5,12017,1022,10995,18.34%,8.50%
2020-01-01 00:07:00,2,6,45,0,45,0.07%,0.00%
2020-01-01 00:07:00,2,7,4258,158,4100,6.50%,3.71%
2020-01-01 00:07:00,2,8,3107,79,3028,4.74%,2.54%
2020-01-01 00:07:00,2,9,11938,1009,10929,18.22%,8.45%
2020-01-01 00:07:00,2,10,2355,51,2304,3.59%,2.16%
2020-01-01 00:07:00,2,11,2401,53,2348,3.66%,2.21%
2020-01-01 00:07:00,2,12,11810,989,10821,18.02%,8.37%
2020-01-01 00:07:00,3,1,1401,7,1394,2.14%,0.50%
2020-01-01 00:07:00,3,2,24147,3972,20175,36.85%,16.45%
2020-01-01 00:07:00,3,3,70963,27712,43251,108.28%,39.05%
2020-01-01 00:07:00,3,4,8437,535,7902,12.87%,6.34%
2020-01-01 00:07:00,3,5,44674,12465,32209,68.17%,27.90%
2020-01-01 00:07:00,3,6,9800,721,9079,14.95%,7.36%
2020-01-01 00:07:00,3,7,18565,2444,16121,28.33%,13.16%
2020-01-01 00:07:00,3,8,15331,1759,13572,23.39%,11.47%
2020-01-01 00:07:00,3,9,34403,7832,26571,52.49%,22.76%
2020-01-01 00:07:00,3,10,7030,372,6658,10.73%,5.29%
2020-01-01 00:07:00,3,11,1618,24,1594,2.47%,1.48%
2020-01-01 00:07:00,3,12,25226,4462,20764,38.49%,17.69%
2020-01-01 00:07:00,4,1,569,2,567,0.87%,0.35%
2020-01-01 00:07:00,4,2,346,2,344,0.53%,0.58%
2020-01-01 00:07:00,4,3,1020,8,1012,1.56%,0.78%
2020-01-01 00:07:00,4,4,28993,5559,23434,44.24%,19.17%
2020-01-01 00:07:00,4,5,18049,2341,15708,27.54%,12.97%
2020-01-01 00:07:00,4,6,24813,4171,20642,37.86%,16.81%
2020-01-01 00:07:00,4,7,5545,201,5344,8.46%,3.62%
2020-01-01 00:07:00,4,8,3122,57,3065,4.76%,1.83%
2020-01-01 00:07:00,4,9,15809,1823,13986,24.12%,11.53%
2020-01-01 00:07:00,4,10,1956,43,1913,2.98%,2.20%
2020-01-01 00:07:00,4,11,179,0,179,0.27%,0.00%
2020-01-01 00:07:00,4,12,13180,1286,11894,20.11%,9.76%
2020-01-01 00:07:00,5,1,2831,60,2771,4.32%,2.12%
2020-01-01 00:07:00,5,2,780,3,777,1.19%,0.38%
2020-01-01 00:07:00,5,3,479,1,478,0.73%,0.21%
2020-01-01 00:07:00,5,4,24436,4060,20376,37.29%,16.61%
2020-01-01 00:07:00,5,5,9987,746,9241,15.24%,7.47%
2020-01-01 00:07:00,5,6,17467,2187,15280,26.65%,12.52%
2020-01-01 00:07:00,5,7,6977,389,6588,10.65%,5.57%
2020-01-01 00:07:00,5,8,3691,147,3544,5.63%,3.98%
2020-01-01 00:07:00,5,9,9363,676,8687,14.29%,7.22%
2020-01-01 00:07:00,5,10,1457,21,1436,2.22%,1.44%
2020-01-01 00:07:00,5,11,800,11,789,1.22%,1.37%
2020-01-01 00:07:00,5,12,7657,445,7212,11.68%,5.81%
2020-01-01 00:07:00,6,1,1084,6,1078,1.65%,0.55%
2020-01-01 00:07:00,6,2,1181,8,1173,1.80%,0.68%
2020-01-01 00:07:00,6,3,1847,23,1824,2.82%,1.24%
2020-01-01 00:07:00,6,4,1331,10,1321,2.03%,0.75%
2020-01-01 00:07:00,6,5,16860,1978,14882,25.73%,11.73%
2020-01-01 00:07:00,6,6,4352,121,4231,6.64%,2.78%
2020-01-01 00:07:00,6,7,2487,49,2438,3.79%,1.97%
2020-01-01 00:07:00,6,8,2019,39,1980,3.08%,1.93%
2020-01-01 00:07:00,6,9,10296,770,9526,15.71%,7.48%
2020-01-01 00:07:00,6,10,2741,51,2690,4.18%,1.86%
2020-01-01 00:07:00,6,11,397,0,397,0.61%,0.00%
2020-01-01 00:07:00,6,12,7505,419,7086,11.45%,5.58%
2020-01-01 00:07:00,7,1,421,5,416,0.64%,1.18%
2020-01-01 00:07:00,7,2,159,1,158,0.24%,0.62%
2020-01-01 00:07:00,7,3,903,7,896,1.38%,0.77%
2020-01-01 00:07:00,7,4,2299,32,2267,3.51%,1.39%
2020-01-01 00:07:00,7,5,7839,443,7396,11.96%,5.65%
2020-01-01 00:07:00,7,6,13775,1348,12427,21.02%,9.79%
2020-01-01 00:07:00,7,7,3545,72,3473,5.41%,2.03%
2020-01-01 00:07:00,7,8,1337,17,1320,2.04%,1.27%
2020-01-01 00:07:00,7,9,6849,335,6514,10.45%,4.89%
2020-01-01 00:07:00,7,10,1637,18,1619,2.50%,1.10%
2020-01-01 00:07:00,7,11,76,0,76,0.12%,0.00%
2020-01-01 00:07:00,7,12,5180,202,4978,7.90%,3.90%
2020-01-01 00:07:00,8,1,637,10,627,0.97%,1.57%
2020-01-01 00:07:00,8,2,101,0,101,0.15%,0.00%
2020-01-01 00:07:00,8,3,1743,27,1716,2.66%,1.55%
2020-01-01 00:07:00,8,4,2716,75,2641,4.14%,2.76%
2020-01-01 00:07:00,8,5,8831,559,8272,13.48%,6.33%
2020-01-01 00:07:00,8,6,19820,2681,17139,30.24%,13.53%
2020-01-01 00:07:00,8,7,8155,468,7687,12.44%,5.74%
2020-01-01 00:07:00,8,8,4936,173,4763,7.53%,3.50%
2020-01-01 00:07:00,8,9,6839,333,6506,10.44%,4.87%
2020-01-01 00:07:00,8,10,1750,29,1721,2.67%,1.66%
2020-01-01 00:07:00,8,11,155,0,155,0.24%,0.00%
2020-01-01 00:07:00,8,12,4876,159,4717,7.44%,3.26%
2020-01-01 00:07:00,9,1,696,4,692,1.06%,0.57%
2020-01-01 00:07:00,9,2,4258,131,4127,6.50%,3.08%
2020-01-01 00:07:00,9,3,2956,63,2893,4.51%,2.13%
2020-01-01 00:07:00,9,4,7850,456,7394,11.98%,5.81%
2020-01-01 00:07:00,9,5,361,1,360,0.55%,0.28%
2020-01-01 00:07:00,9,6,8857,571,8286,13.51%,6.45%
2020-01-01 00:07:00,9,7,29629,5860,23769,45.21%,19.78%
2020-01-01 00:07:00,9,8,9835,787,9048,15.01%,8.00%
2020-01-01 00:07:00,9,9,186,0,186,0.28%,0.00%
2020-01-01 00:07:00,9,10,2579,131,2448,3.94%,5.08%
2020-01-01 00:07:00,9,11,8398,610,7788,12.81%,7.26%
2020-01-01 00:07:00,9,12,5311,209,5102,8.10%,3.93%
2020-01-01 00:07:00,10,1,1363,291,1072,2.08%,21.33%
2020-01-01 00:07:00,10,2,3025,336,2689,4.62%,11.10%
2020-01-01 00:07:00,10,3,1408,7,1401,2.15%,0.50%
2020-01-01 00:07:00,10,4,4134,1062,3072,6.31%,25.68%
2020-01-01 00:07:00,10,5,727,37,690,1.11%,5.08%
2020-01-01 00:07:00,10,6,6269,1243,5026,9.57%,19.82%
2020-01-01 00:07:00,10,7,11003,1961,9042,16.79%,17.82%
2020-01-01 00:07:00,10,8,27990,7055,20935,42.71%,25.20%
2020-01-01 00:07:00,10,9,490,0,490,0.75%,0.00%
2020-01-01 00:07:00,10,10,2028,23,2005,3.09%,1.13%
2020-01-01 00:07:00,10,11,12835,1457,11378,19.58%,11.35%
2020-01-01 00:07:00,10,12,10146,1032,9114,15.48%,10.17%
2020-01-01 00:07:00,11,1,2135,29,2106,3.26%,1.36%
2020-01-01 00:07:00,11,2,3375,100,3275,5.15%,2.96%
2020-01-01 00:07:00,11,3,1013,10,1003,1.55%,0.99%
2020-01-01 00:07:00,11,4,3604,101,3503,5.50%,2.80%
2020-01-01 00:07:00,11,5,649,3,646,0.99%,0.46%
2020-01-01 00:07:00,11,6,4882,186,4696,7.45%,3.81%
2020-01-01 00:07:00,11,7,10467,791,9676,15.97%,7.56%
2020-01-01 00:07:00,11,8,24492,4046,20446,37.37%,16.52%
2020-01-01 00:07:00,11,9,220,0,220,0.34%,0.00%
2020-01-01 00:07:00,11,10,3479,91,3388,5.31%,2.61%
2020-01-01 00:07:00,11,11,10828,853,9975,16.52%,7.88%
2020-01-01 00:07:00,11,12,7030,380,6650,10.73%,5.40%
2020-01-01 00:07:00,12,1,93,0,93,0.14%,0.00%
2020-01-01 00:07:00,12,2,648,192,456,0.99%,29.58%
2020-01-01 00:07:00,12,3,2576,235,2341,3.93%,9.12%
2020-01-01 00:07:00,12,4,2735,61,2674,4.17%,2.23%
2020-01-01 00:07:00,12,5,9344,819,8525,14.26%,8.76%
2020-01-01 00:07:00,12,6,5957,262,5695,9.09%,4.40%
2020-01-01 00:07:00,12,7,3064,73,2991,4.68%,2.38%
2020-01-01 00:07:00,12,8,1292,243,1049,1.97%,18.79%
2020-01-01 00:07:00,12,9,22021,4389,17632,33.60%,19.93%
2020-01-01 00:07:00,12,10,4019,344,3675,6.13%,8.56%
2020-01-01 00:07:00,12,11,1458,247,1211,2.22%,16.93%
2020-01-01 00:07:00,12,12,8169,1302,6867,12.46%,15.94%
2020-01-01 00:07:00,13,1,2167,37,2130,3.31%,1.71%
2020-01-01 00:07:00,13,2,2577,59,2518,3.93%,2.29%
2020-01-01 00:07:00,13,3,592,4,588,0.90%,0.67%
2020-01-01 00:07:00,13,4,4258,588,3670,6.50%,13.81%
2020-01-01 00:07:00,13,5,6879,898,5981,10.50%,13.05%
2020-01-01 00:07:00,13,6,5387,658,4729,8.22%,12.21%
2020-01-01 00:07:00,13,7,4928,179,4749,7.52%,3.63%
2020-01-01 00:07:00,13,8,7321,399,6922,11.17%,5.45%
2020-01-01 00:07:00,13,9,7242,936,6306,11.05%,12.92%
2020-01-01 00:07:00,13,10,27699,5771,21928,42.27%,20.83%
2020-01-01 00:07:00,13,11,18094,2602,15492,27.61%,14.38%
2020-01-01 00:07:00,13,12,10271,1114,9157,15.67%,10.85%
2020-01-01 00:07:00,14,1,365,2,363,0.56%,0.55%
2020-01-01 00:07:00,14,2,1564,17,1547,2.39%,1.09%
2020-01-01 00:07:00,14,3,1052,9,1043,1.61%,0.85%
2020-01-01 00:07:00,14,4,3885,101,3784,5.93%,2.60%
2020-01-01 00:07:00,14,5,1277,15,1262,1.95%,1.17%
2020-01-01 00:07:00,14,6,4243,119,4124,6.47%,2.80%
2020-01-01 00:07:00,14,7,11774,981,10793,17.97%,8.33%
2020-01-01 00:07:00,14,8,13600,1286,12314,20.75%,9.46%
2020-01-01 00:07:00,14,9,1596,24,1572,2.44%,1.50%
2020-01-01 00:07:00,14,10,4275,149,4126,6.52%,3.48%
2020-01-01 00:07:00,14,11,26552,4767,21785,40.52%,17.95%
2020-01-01 00:07:00,14,12,8348,534,7814,12.74%,6.40%
2020-01-01 00:07:00,15,1,561,2,559,0.86%,0.36%
2020-01-01 00:07:00,15,2,117,0,117,0.18%,0.00%
2020-01-01 00:07:00,15,3,4066,116,3950,6.20%,2.85%
2020-01-01 00:07:00,15,4,6009,310,5699,9.17%,5.16%
2020-01-01 00:07:00,15,5,11490,982,10508,17.53%,8.55%
2020-01-01 00:07:00,15,6,6313,351,5962,9.63%,5.56%
2020-01-01 00:07:00,15,7,3605,116,3489,5.50%,3.22%
2020-01-01 00:07:00,15,8,5694,259,5435,8.69%,4.55%
2020-01-01 00:07:00,15,9,11712,1013,10699,17.87%,8.65%
2020-01-01 00:07:00,15,10,4983,262,4721,7.60%,5.26%
2020-01-01 00:07:00,15,11,10841,905,9936,16.54%,8.35%
2020-01-01 00:07:00,15,12,29458,6083,23375,44.95%,20.65%
2020-01-01 00:07:00,16,1,375,0,375,0.57%,0.00%
2020-01-01 00:07:00,16,2,238,0,238,0.36%,0.00%
2020-01-01 00:07:00,16,3,1317,11,1306,2.01%,0.83%
2020-01-01 00:07:00,16,4,4170,116,4054,6.36%,2.78%
2020-01-01 00:07:00,16,5,7774,515,7259,11.86%,6.62%
2020-01-01 00:07:00,16,6,5000,177,4823,7.63%,3.54%
2020-01-01 00:07:00,16,7,3311,80,3231,5.05%,2.42%
2020-01-01 00:07:00,16,8,7267,455,6812,11.09%,6.26%
2020-01-01 00:07:00,16,9,8300,571,7729,12.66%,6.88%
2020-01-01 00:07:00,16,10,1615,12,1603,2.46%,0.74%
2020-01-01 00:07:00,16,11,9076,682,8394,13.85%,7.51%
2020-01-01 00:07:00,16,12,25661,4529,21132,39.16%,17.65%
2020-01-01 00:07:10,1,1,25501,4472,21029,38.91%,17.54%
2020-01-01 00:07:10,1,2,12616,1151,11465,19.25%,9.12%
2020-01-01 00:07:10,1,3,2002,35,1967,3.05%,1.75%
2020-01-01 00:07:10,1,4,12323,1153,11170,18.80%,9.36%
2020-01-01 00:07:10,1,5,11897,1059,10838,18.15%,8.90%
2020-01-01 00:07:10,1,6,11855,1065,10790,18.09%,8.98%
2020-01-01 00:07:10,1,7,10586,828,9758,16.15%,7.82%
2020-01-01 00:07:10,1,8,9788,714,9074,14.94%,7.29%
2020-01-01 00:07:10,1,9,11808,1050,10758,18.02%,8.89%
2020-01-01 00:07:10,1,10,9220,626,8594,14.07%,6.79%
2020-01-01 00:07:10,1,11,9307,637,8670,14.20%,6.84%
2020-01-01 00:07:10,1,12,11779,1043,10736,17.97%,8.85%
2020-01-01 00:07:10,2,1,821,5,816,1.25%,0.61%
2020-01-01 00:07:10,2,2,23132,3564,19568,35.30%,15.41%
2020-01-01 00:07:10,2,3,18172,2281,15891,27.73%,12.55%
2020-01-01 00:07:10,2,4,745,3,742,1.14%,0.40%
2020-01-01 00:07:10,2,5,11899,987,10912,18.16%,8.29%
2020-01-01 00:07:10,2,6,40,2,38,0.06%,4.88%
2020-01-01 00:07:10,2,7,4124,120,4004,6.29%,2.91%
2020-01-01 00:07:10,2,8,2484,45,2439,3.79%,1.81%
2020-01-01 00:07:10,2,9,11848,977,10871,18.08%,8.25%
2020-01-01 00:07:10,2,10,1615,22,1593,2.46%,1.36%
2020-01-01 00:07:10,2,11,1624,23,1601,2.48%,1.42%
2020-01-01 00:07:10,2,12,11717,957,10760,17.88%,8.17%
2020-01-01 00:07:10,3,1,1355,20,1335,2.07%,1.47%
2020-01-01 00:07:10,3,2,25376,4426,20950,38.72%,17.44%
2020-01-01 00:07:10,3,3,73328,29133,44195,111.89%,39.73%
2020-01-01 00:07:10,3,4,11902,923,10979,18.16%,7.75%
2020-01-01 00:07:10,3,5,47182,13562,33620,71.99%,28.74%
2020-01-01 00:07:10,3,6,12719,1065,11654,19.41%,8.37%
2020-01-01 00:07:10,3,7,22378,3510,18868,34.15%,15.68%
2020-01-01 00:07:10,3,8,18893,2574,16319,28.83%,13.62%
2020-01-01 00:07:10,3,9,33972,7491,26481,51.84%,22.05%
2020-01-01 00:07:10,3,10,7820,364,7456,11.93%,4.65%
2020-01-01 00:07:10,3,11,2294,50,2244,3.50%,2.18%
2020-01-01 00:07:10,3,12,23113,3642,19471,35.27%,15.76%
2020-01-01 00:07:10,4,1,625,1,624,0.95%,0.16%
2020-01-01 00:07:10,4,2,428,1,427,0.65%,0.23%
2020-01-01 00:07:10,4,3,910,4,906,1.39%,0.44%
2020-01-01 00:07:10,4,4,28427,5399,23028,43.38%,18.99%
2020-01-01 00:07:10,4,5,17493,2195,15298,26.69%,12.55%
2020-01-01 00:07:10,4,6,24208,4005,20203,36.94%,16.54%
2020-01-01 00:07:10,4,7,5395,209,5186,8.23%,3.87%
2020-01-01 00:07:10,4,8,3385,79,3306,5.17%,2.33%
2020-01-01 00:07:10,4,9,15195,1659,13536,23.19%,10.92%
2020-01-01 00:07:10,4,10,2397,58,2339,3.66%,2.42%
2020-01-01 00:07:10,4,11,211,0,211,0.32%,0.00%
2020-01-01 00:07:10,4,12,12199,1068,11131,18.61%,8.75%
2020-01-01 00:07:10,5,1,2771,62,2709,4.23%,2.24%
2020-01-01 00:07:10,5,2,704,4,700,1.07%,0.57%
2020-01-01 00:07:10,5,3,496,2,494,0.76%,0.40%
2020-01-01 00:07:10,5,4,24575,4112,20463,37.50%,16.73%
2020-01-01 00:07:10,5,5,9304,641,8663,14.20%,6.89%
2020-01-01 00:07:10,5,6,17684,2225,15459,26.98%,12.58%
2020-01-01 00:07:10,5,7,7941,500,7441,12.12%,6.30%
2020-01-01 00:07:10,5,8,3217,93,3124,4.91%,2.89%
2020-01-01 00:07:10,5,9,8620,551,8069,13.15%,6.39%
2020-01-01 00:07:10,5,10,1152,14,1138,1.76%,1.21%
2020-01-01 00:07:10,5,11,610,5,605,0.93%,0.82%
2020-01-01 00:07:10,5,12,7311,414,6897,11.16%,5.66%
2020-01-01 00:07:10,6,1,1113,8,1105,1.70%,0.72%
2020-01-01 00:07:10,6,2,1199,10,1189,1.83%,0.83%
2020-01-01 00:07:10,6,3,1708,24,1684,2.61%,1.40%
2020-01-01 00:07:10,6,4,1162,5,1157,1.77%,0.43%
2020-01-01 00:07:10,6,5,14105,1436,12669,21.52%,10.18%
2020-01-01 00:07:10,6,6,6279,272,6007,9.58%,4.33%
2020-01-01 00:07:10,6,7,4624,175,4449,7.06%,3.78%
2020-01-01 00:07:10,6,8,4226,145,4081,6.45%,3.43%
2020-01-01 00:07:10,6,9,5893,261,5632,8.99%,4.43%
2020-01-01 00:07:10,6,10,1972,30,1942,3.01%,1.52%
2020-01-01 00:07:10,6,11,510,2,508,0.78%,0.39%
2020-01-01 00:07:10,6,12,3858,126,3732,5.89%,3.27%
2020-01-01 00:07:10,7,1,356,2,354,0.54%,0.56%
2020-01-01 00:07:10,7,2,141,0,141,0.22%,0.00%
2020-01-01 00:07:10,7,3,623,4,619,0.95%,0.64%
2020-01-01 00:07:10,7,4,2304,51,2253,3.52%,2.21%
2020-01-01 00:07:10,7,5,6861,367,6494,10.47%,5.35%
2020-01-01 00:07:10,7,6,13174,1271,11903,20.10%,9.65%
2020-01-01 00:07:10,7,7,3941,121,3820,6.01%,3.07%
2020-01-01 00:07:10,7,8,1687,23,1664,2.57%,1.36%
2020-01-01 00:07:10,7,9,6177,299,5878,9.43%,4.84%
2020-01-01 00:07:10,7,10,1319,7,1312,2.01%,0.53%
2020-01-01 00:07:10,7,11,107,0,107,0.16%,0.00%
2020-01-01 00:07:10,7,12,4839,195,4644,7.38%,4.03%
2020-01-01 00:07:10,8,1,610,2,608,0.93%,0.33%
2020-01-01 00:07:10,8,2,84,0,84,0.13%,0.00%
2020-01-01 00:07:10,8,3,1899,19,1880,2.90%,1.00%
2020-01-01 00:07:10,8,4,2803,66,2737,4.28%,2.35%
2020-01-01 00:07:10,8,5,8833,556,8277,13.48%,6.29%
2020-01-01 00:07:10,8,6,16516,1889,14627,25.20%,11.44%
2020-01-01 00:07:10,8,7,4706,165,4541,7.18%,3.51%
2020-01-01 00:07:10,8,8,1958,31,1927,2.99%,1.58%
2020-01-01 00:07:10,8,9,6611,334,6277,10.09%,5.05%
2020-01-01 00:07:10,8,10,1857,27,1830,2.83%,1.45%
2020-01-01 00:07:10,8,11,137,0,137,0.21%,0.00%
2020-01-01 00:07:10,8,12,4718,177,4541,7.20%,3.75%
2020-01-01 00:07:10,9,1,567,4,563,0.87%,0.70%
2020-01-01 00:07:10,9,2,1905,34,1871,2.91%,1.78%
2020-01-01 00:07:10,9,3,1074,14,1060,1.64%,1.30%
2020-01-01 00:07:10,9,4,6180,254,5926,9.43%,4.11%
2020-01-01 00:07:10,9,5,504,0,504,0.77%,0.00%
2020-01-01 00:07:10,9,6,7460,385,7075,11.38%,5.16%
2020-01-01 00:07:10,9,7,27933,5127,22806,42.62%,18.35%
2020-01-01 00:07:10,9,8,12289,1044,11245,18.75%,8.49%
2020-01-01 00:07:10,9,9,277,0,277,0.42%,0.00%
2020-01-01 00:07:10,9,10,5614,230,5384,8.57%,4.10%
2020-01-01 00:07:10,9,11,11409,910,10499,17.41%,7.98%
2020-01-01 00:07:10,9,12,5432,212,5220,8.29%,3.90%
2020-01-01 00:07:10,10,1,1500,286,1214,2.29%,19.05%
2020-01-01 00:07:10,10,2,4456,409,4047,6.80%,9.18%
2020-01-01 00:07:10,10,3,2778,63,2715,4.24%,2.27%
2020-01-01 00:07:10,10,4,3588,957,2631,5.47%,26.66%
2020-01-01 00:07:10,10,5,1023,113,910,1.56%,11.04%
2020-01-01 00:07:10,10,6,5774,1171,4603,8.81%,20.28%
2020-01-01 00:07:10,10,7,11701,2088,9613,17.85%,17.84%
2020-01-01 00:07:10,10,8,29884,7610,22274,45.60%,25.46%
2020-01-01 00:07:10,10,9,584,1,583,0.89%,0.17%
2020-01-01 00:07:10,10,10,2181,30,2151,3.33%,1.37%
2020-01-01 00:07:10,10,11,13112,1512,11600,20.01%,11.53%
2020-01-01 00:07:10,10,12,10135,1027,9108,15.46%,10.13%
2020-01-01 00:07:10,11,1,2029,36,1993,3.10%,1.77%
2020-01-01 00:07:10,11,2,3063,82,2981,4.67%,2.68%
2020-01-01 00:07:10,11,3,820,10,810,1.25%,1.22%
2020-01-01 00:07:10,11,4,5577,241,5336,8.51%,4.32%
2020-01-01 00:07:10,11,5,203,1,202,0.31%,0.49%
2020-01-01 00:07:10,11,6,6574,346,6228,10.03%,5.26%
2020-01-01 00:07:10,11,7,12533,1279,11254,19.12%,10.20%
2020-01-01 00:07:10,11,8,26429,4913,21516,40.33%,18.59%
2020-01-01 00:07:10,11,9,204,0,204,0.31%,0.00%
2020-01-01 00:07:10,11,10,2925,72,2853,4.46%,2.46%
2020-01-01 00:07:10,11,11,10224,764,9460,15.60%,7.47%
2020-01-01 00:07:10,11,12,6739,330,6409,10.28%,4.90%
2020-01-01 00:07:10,12,1,132,0,132,0.20%,0.00%
2020-01-01 00:07:10,12,2,510,110,400,0.78%,21.53%
2020-01-01 00:07:10,12,3,3034,174,2860,4.63%,5.73%
2020-01-01 00:07:10,12,4,3113,54,3059,4.75%,1.73%
2020-01-01 00:07:10,12,5,8564,647,7917,13.07%,7.55%
2020-01-01 00:07:10,12,6,4902,134,4768,7.48%,2.73%
2020-01-01 00:07:10,12,7,1628,22,1606,2.48%,1.35%
2020-01-01 00:07:10,12,8,1330,301,1029,2.03%,22.61%
2020-01-01 00:07:10,12,9,21292,4296,16996,32.49%,20.18%
2020-01-01 00:07:10,12,10,4172,420,3752,6.37%,10.06%
2020-01-01 00:07:10,12,11,1529,305,1224,2.33%,19.93%
2020-01-01 00:07:10,12,12,8053,1457,6596,12.29%,18.09%
2020-01-01 00:07:10,13,1,1904,29,1875,2.91%,1.52%
2020-01-01 00:07:10,13,2,2251,43,2208,3.43%,1.91%
2020-01-01 00:07:10,13,3,775,7,768,1.18%,0.90%
2020-01-01 00:07:10,13,4,5568,907,4661,8.50%,16.29%
2020-01-01 00:07:10,13,5,7982,1250,6732,12.18%,15.66%
2020-01-01 00:07:10,13,6,6132,941,5191,9.36%,15.34%
2020-01-01 00:07:10,13,7,4365,133,4232,6.66%,3.05%
2020-01-01 00:07:10,13,8,6846,333,6513,10.45%,4.86%
2020-01-01 00:07:10,13,9,8443,1311,7132,12.88%,15.53%
2020-01-01 00:07:10,13,10,28439,6133,22306,43.39%,21.56%
2020-01-01 00:07:10,13,11,17428,2352,15076,26.59%,13.49%
2020-01-01 00:07:10,13,12,10146,1041,9105,15.48%,10.26%
2020-01-01 00:07:10,14,1,188,0,188,0.29%,0.00%
2020-01-01 00:07:10,14,2,1599,13,1586,2.44%,0.81%
2020-01-01 00:07:10,14,3,1053,3,1050,1.61%,0.28%
2020-01-01 00:07:10,14,4,3056,71,2985,4.66%,2.32%
2020-01-01 00:07:10,14,5,1374,18,1356,2.10%,1.31%
2020-01-01 00:07:10,14,6,3472,84,3388,5.30%,2.42%
2020-01-01 00:07:10,14,7,11205,864,10341,17.10%,7.71%
2020-01-01 00:07:10,14,8,12895,1149,11746,19.68%,8.91%
2020-01-01 00:07:10,14,9,1508,24,1484,2.30%,1.59%
2020-01-01 00:07:10,14,10,4750,193,4557,7.25%,4.06%
2020-01-01 00:07:10,14,11,26919,4784,22135,41.08%,17.77%
2020-01-01 00:07:10,14,12,8883,549,8334,13.55%,6.18%
2020-01-01 00:07:10,15,1,483,6,477,0.74%,1.24%
2020-01-01 00:07:10,15,2,115,0,115,0.18%,0.00%
2020-01-01 00:07:10,15,3,3602,110,3492,5.50%,3.05%
2020-01-01 00:07:10,15,4,4775,192,4583,7.29%,4.02%
2020-01-01 00:07:10,15,5,9313,686,8627,14.21%,7.37%
2020-01-01 00:07:10,15,6,5143,260,4883,7.85%,5.05%
2020-01-01 00:07:10,15,7,3441,97,3344,5.25%,2.82%
2020-01-01 00:07:10,15,8,5521,263,5258,8.42%,4.76%
2020-01-01 00:07:10,15,9,9472,703,8769,14.45%,7.42%
2020-01-01 00:07:10,15,10,3940,335,3605,6.01%,8.50%
2020-01-01 00:07:10,15,11,9676,916,8760,14.76%,9.47%
2020-01-01 00:07:10,15,12,25855,5054,20801,39.45%,19.55%
2020-01-01 00:07:10,16,1,303,1,302,0.46%,0.33%
2020-01-01 00:07:10,16,2,226,1,225,0.34%,0.44%
2020-01-01 00:07:10,16,3,1432,10,1422,2.19%,0.70%
2020-01-01 00:07:10,16,4,3849,138,3711,5.87%,3.58%
2020-01-01 00:07:10,16,5,7295,479,6816,11.13%,6.57%
2020-01-01 00:07:10,16,6,4697,194,4503,7.17%,4.13%
2020-01-01 00:07:10,16,7,3373,101,3272,5.15%,2.99%
2020-01-01 00:07:10,16,8,7256,467,6789,11.07%,6.44%
2020-01-01 00:07:10,16,9,7870,542,7328,12.01%,6.89%
2020-01-01 00:07:10,16,10,1557,21,1536,2.38%,1.35%
2020-01-01 00:07:10,16,11,9025,657,8368,13.77%,7.28%
2020-01-01 00:07:10,16,12,24492,4193,20299,37.37%,17.12%
2020-01-01 00:07:20,1,1,25085,4390,20695,38.28%,17.50%
2020-01-01 00:07:20,1,2,11704,1052,10652,17.86%,8.99%
2020-01-01 00:07:20,1,3,725,5,720,1.11%,0.69%
2020-01-01 00:07:20,1,4,12838,1214,11624,19.59%,9.46%
2020-01-01 00:07:20,1,5,12411,1154,11257,18.94%,9.30%
2020-01-01 00:07:20,1,6,12303,1136,11167,18.77%,9.23%
2020-01-01 00:07:20,1,7,10962,935,10027,16.73%,8.53%
2020-01-01 00:07:20,1,8,7632,497,7135,11.65%,6.51%
2020-01-01 00:07:20,1,9,12249,1124,11125,18.69%,9.18%
2020-01-01 00:07:20,1,10,7035,426,6609,10.73%,6.05%
2020-01-01 00:07:20,1,11,7151,436,6715,10.91%,6.10%
2020-01-01 00:07:20,1,12,12232,1123,11109,18.66%,9.18%
2020-01-01 00:07:20,2,1,1109,9,1100,1.69%,0.81%
2020-01-01 00:07:20,2,2,24740,4179,20561,37.75%,16.89%
2020-01-01 00:07:20,2,3,19517,2659,16858,29.78%,13.62%
2020-01-01 00:07:20,2,4,1058,8,1050,1.61%,0.76%
2020-01-01 00:07:20,2,5,10196,811,9385,15.56%,7.95%
2020-01-01 00:07:20,2,6,36,0,36,0.05%,0.00%
2020-01-01 00:07:20,2,7,4095,123,3972,6.25%,3.00%
2020-01-01 00:07:20,2,8,2668,60,2608,4.07%,2.25%
2020-01-01 00:07:20,2,9,10132,802,9330,15.46%,7.91%
2020-01-01 00:07:20,2,10,1942,29,1913,2.96%,1.49%
2020-01-01 00:07:20,2,11,1955,29,1926,2.98%,1.48%
2020-01-01 00:07:20,2,12,9950,770,9180,15.18%,7.74%
2020-01-01 00:07:20,3,1,1890,17,1873,2.88%,0.90%
2020-01-01 00:07:20,3,2,25420,4279,21141,38.79%,16.83%
2020-01-01 00:07:20,3,3,70517,27371,43146,107.60%,38.81%
2020-01-01 00:07:20,3,4,8170,514,7656,12.47%,6.29%
2020-01-01 00:07:20,3,5,44276,12086,32190,67.56%,27.30%
2020-01-01 00:07:20,3,6,9053,615,8438,13.81%,6.79%
2020-01-01 00:07:20,3,7,21752,3261,18491,33.19%,14.99%
2020-01-01 00:07:20,3,8,18514,2382,16132,28.25%,12.87%
2020-01-01 00:07:20,3,9,34602,7727,26875,52.80%,22.33%
2020-01-01 00:07:20,3,10,7858,469,7389,11.99%,5.97%
2020-01-01 00:07:20,3,11,2178,25,2153,3.32%,1.15%
2020-01-01 00:07:20,3,12,24431,4094,20337,37.28%,16.76%
2020-01-01 00:07:20,4,1,575,1,574,0.88%,0.17%
2020-01-01 00:07:20,4,2,398,1,397,0.61%,0.25%
2020-01-01 00:07:20,4,3,740,2,738,1.13%,0.27%
2020-01-01 00:07:20,4,4,27078,4969,22109,41.32%,18.35%
2020-01-01 00:07:20,4,5,16330,1927,14403,24.92%,11.80%
2020-01-01 00:07:20,4,6,23003,3646,19357,35.10%,15.85%
2020-01-01 00:07:20,4,7,5385,236,5149,8.22%,4.38%
2020-01-01 00:07:20,4,8,3151,89,3062,4.81%,2.82%
2020-01-01 00:07:20,4,9,14507,1538,12969,22.14%,10.60%
2020-01-01 00:07:20,4,10,1873,33,1840,2.86%,1.76%
2020-01-01 00:07:20,4,11,198,0,198,0.30%,0.00%
2020-01-01 00:07:20,4,12,11830,1039,10791,18.05%,8.78%
2020-01-01 00:07:20,5,1,2487,41,2446,3.79%,1.65%
2020-01-01 00:07:20,5,2,555,2,553,0.85%,0.36%
2020-01-01 00:07:20,5,3,516,0,516,0.79%,0.00%
2020-01-01 00:07:20,5,4,22344,3385,18959,34.09%,15.15%
2020-01-01 00:07:20,5,5,8510,534,7976,12.99%,6.27%
2020-01-01 00:07:20,5,6,13758,1318,12440,20.99%,9.58%
2020-01-01 00:07:20,5,7,4671,155,4516,7.13%,3.32%
2020-01-01 00:07:20,5,8,3271,71,3200,4.99%,2.17%
2020-01-01 00:07:20,5,9,7890,474,7416,12.04%,6.01%
2020-01-01 00:07:20,5,10,941,4,937,1.44%,0.42%
2020-01-01 00:07:20,5,11,491,0,491,0.75%,0.00%
2020-01-01 00:07:20,5,12,6762,362,6400,10.32%,5.35%
2020-01-01 00:07:20,6,1,1025,12,1013,1.56%,1.17%
2020-01-01 00:07:20,6,2,1076,13,1063,1.64%,1.21%
2020-01-01 00:07:20,6,3,1607,19,1588,2.45%,1.18%
2020-01-01 00:07:20,6,4,1146,10,1136,1.75%,0.87%
2020-01-01 00:07:20,6,5,12806,1215,11591,19.54%,9.49%
2020-01-01 00:07:20,6,6,4798,189,4609,7.32%,3.94%
2020-01-01 00:07:20,6,7,3241,76,3165,4.95%,2.34%
2020-01-01 00:07:20,6,8,2730,52,2678,4.17%,1.90%
2020-01-01 00:07:20,6,9,6213,290,5923,9.48%,4.67%
2020-01-01 00:07:20,6,10,1794,29,1765,2.74%,1.62%
2020-01-01 00:07:20,6,11,468,0,468,0.71%,0.00%
2020-01-01 00:07:20,6,12,4348,150,4198,6.63%,3.45%
2020-01-01 00:07:20,7,1,387,1,386,0.59%,0.26%
2020-01-01 00:07:20,7,2,237,0,237,0.36%,0.00%
2020-01-01 00:07:20,7,3,628,1,627,0.96%,0.16%
2020-01-01 00:07:20,7,4,2215,35,2180,3.38%,1.58%
2020-01-01 00:07:20,7,5,6979,372,6607,10.65%,5.33%
2020-01-01 00:07:20,7,6,13087,1250,11837,19.97%,9.55%
2020-01-01 00:07:20,7,7,3801,96,3705,5.80%,2.52%
2020-01-01 00:07:20,7,8,1523,23,1500,2.32%,1.51%
2020-01-01 00:07:20,7,9,6251,300,5951,9.54%,4.80%
2020-01-01 00:07:20,7,10,936,4,932,1.43%,0.43%
2020-01-01 00:07:20,7,11,148,1,147,0.23%,0.67%
2020-01-01 00:07:20,7,12,5296,203,5093,8.08%,3.83%
2020-01-01 00:07:20,8,1,614,3,611,0.94%,0.49%
2020-01-01 00:07:20,8,2,88,0,88,0.13%,0.00%
2020-01-01 00:07:20,8,3,2030,47,1983,3.10%,2.31%
2020-01-01 00:07:20,8,4,2826,50,2776,4.31%,1.77%
2020-01-01 00:07:20,8,5,8976,651,8325,13.70%,7.25%
2020-01-01 00:07:20,8,6,16846,2008,14838,25.70%,11.92%
2020-01-01 00:07:20,8,7,4920,185,4735,7.51%,3.76%
2020-01-01 00:07:20,8,8,2426,49,2377,3.70%,2.02%
2020-01-01 00:07:20,8,9,6444,300,6144,9.83%,4.65%
2020-01-01 00:07:20,8,10,1923,34,1889,2.93%,1.77%
2020-01-01 00:07:20,8,11,119,0,119,0.18%,0.00%
2020-01-01 00:07:20,8,12,4471,134,4337,6.82%,3.00%
2020-01-01 00:07:20,9,1,1419,10,1409,2.17%,0.70%
2020-01-01 00:07:20,9,2,3524,100,3424,5.38%,2.84%
2020-01-01 00:07:20,9,3,1781,24,1757,2.72%,1.35%
2020-01-01 00:07:20,9,4,3933,135,3798,6.00%,3.43%
2020-01-01 00:07:20,9,5,427,4,423,0.65%,0.93%
2020-01-01 00:07:20,9,6,5459,237,5222,8.33%,4.34%
2020-01-01 00:07:20,9,7,24839,4188,20651,37.90%,16.86%
2020-01-01 00:07:20,9,8,10563,869,9694,16.12%,8.23%
2020-01-01 00:07:20,9,9,287,1,286,0.44%,0.35%
2020-01-01 00:07:20,9,10,3776,106,3670,5.76%,2.81%
2020-01-01 00:07:20,9,11,9548,718,8830,14.57%,7.52%
2020-01-01 00:07:20,9,12,5448,242,5206,8.31%,4.44%
2020-01-01 00:07:20,10,1,1489,265,1224,2.27%,17.79%
2020-01-01 00:07:20,10,2,4995,437,4558,7.62%,8.75%
2020-01-01 00:07:20,10,3,3354,108,3246,5.12%,3.22%
2020-01-01 00:07:20,10,4,3803,971,2832,5.80%,25.53%
2020-01-01 00:07:20,10,5,942,101,841,1.44%,10.71%
2020-01-01 00:07:20,10,6,6018,1178,4840,9.18%,19.57%
2020-01-01 00:07:20,10,7,12584,2179,10405,19.20%,17.31%
2020-01-01 00:07:20,10,8,30926,8110,22816,47.19%,26.22%
2020-01-01 00:07:20,10,9,909,9,900,1.39%,0.99%
2020-01-01 00:07:20,10,10,2703,45,2658,4.12%,1.66%
2020-01-01 00:07:20,10,11,14679,1827,12852,22.40%,12.45%
2020-01-01 00:07:20,10,12,11163,1198,9965,17.03%,10.73%
2020-01-01 00:07:20,11,1,2464,42,2422,3.76%,1.70%
2020-01-01 00:07:20,11,2,3428,77,3351,5.23%,2.25%
2020-01-01 00:07:20,11,3,807,7,800,1.23%,0.87%
2020-01-01 00:07:20,11,4,7876,479,7397,12.02%,6.08%
2020-01-01 00:07:20,11,5,235,0,235,0.36%,0.00%
2020-01-01 00:07:20,11,6,8849,573,8276,13.50%,6.47%
2020-01-01 00:07:20,11,7,13911,1361,12550,21.23%,9.78%
2020-01-01 00:07:20,11,8,28479,5293,23186,43.46%,18.58%
2020-01-01 00:07:20,11,9,244,2,242,0.37%,0.82%
2020-01-01 00:07:20,11,10,2966,76,2890,4.53%,2.56%
2020-01-01 00:07:20,11,11,9975,715,9260,15.22%,7.17%
2020-01-01 00:07:20,11,12,6576,319,6257,10.03%,4.85%
2020-01-01 00:07:20,12,1,58,0,58,0.09%,0.00%
2020-01-01 00:07:20,12,2,593,123,470,0.90%,20.71%
2020-01-01 00:07:20,12,3,3619,232,3387,5.52%,6.41%
2020-01-01 00:07:20,12,4,3691,100,3591,5.63%,2.71%
2020-01-01 00:07:20,12,5,10003,829,9174,15.26%,8.29%
2020-01-01 00:07:20,12,6,5731,242,5489,8.74%,4.22%
2020-01-01 00:07:20,12,7,1901,20,1881,2.90%,1.05%
2020-01-01 00:07:20,12,8,1336,344,992,2.04%,25.73%
2020-01-01 00:07:20,12,9,23030,4738,18292,35.14%,20.57%
2020-01-01 00:07:20,12,10,4670,471,4199,7.13%,10.08%
2020-01-01 00:07:20,12,11,1685,351,1334,2.57%,20.82%
2020-01-01 00:07:20,12,12,7982,1267,6715,12.18%,15.87%
2020-01-01 00:07:20,13,1,2199,46,2153,3.36%,2.09%
2020-01-01 00:07:20,13,2,2486,56,2430,3.79%,2.25%
2020-01-01 00:07:20,13,3,960,9,951,1.46%,0.94%
2020-01-01 00:07:20,13,4,6758,894,5864,10.31%,13.23%
2020-01-01 00:07:20,13,5,9204,1273,7931,14.04%,13.83%
2020-01-01 00:07:20,13,6,7361,945,6416,11.23%,12.84%
2020-01-01 00:07:20,13,7,4658,174,4484,7.11%,3.73%
2020-01-01 00:07:20,13,8,6801,346,6455,10.38%,5.09%
2020-01-01 00:07:20,13,9,9571,1326,8245,14.60%,13.85%
2020-01-01 00:07:20,13,10,30945,7029,23916,47.22%,22.71%
2020-01-01 00:07:20,13,11,18079,2612,15467,27.59%,14.45%
2020-01-01 00:07:20,13,12,10943,1241,9702,16.70%,11.34%
2020-01-01 00:07:20,14,1,296,0,296,0.45%,0.00%
2020-01-01 00:07:20,14,2,1834,25,1809,2.80%,1.36%
2020-01-01 00:07:20,14,3,1217,11,1206,1.86%,0.90%
2020-01-01 00:07:20,14,4,4139,124,4015,6.32%,3.00%
2020-01-01 00:07:20,14,5,1307,11,1296,1.99%,0.84%
2020-01-01 00:07:20,14,6,4529,152,4377,6.91%,3.36%
2020-01-01 00:07:20,14,7,12387,1044,11343,18.90%,8.43%
2020-01-01 00:07:20,14,8,14391,1429,12962,21.96%,9.93%
2020-01-01 00:07:20,14,9,1641,16,1625,2.50%,0.97%
2020-01-01 00:07:20,14,10,4117,116,4001,6.28%,2.82%
2020-01-01 00:07:20,14,11,25735,4370,21365,39.27%,16.98%
2020-01-01 00:07:20,14,12,6847,327,6520,10.45%,4.78%
2020-01-01 00:07:20,15,1,511,6,505,0.78%,1.17%
2020-01-01 00:07:20,15,2,183,0,183,0.28%,0.00%
2020-01-01 00:07:20,15,3,3843,101,3742,5.86%,2.63%
2020-01-01 00:07:20,15,4,4911,215,4696,7.49%,4.38%
2020-01-01 00:07:20,15,5,9443,699,8744,14.41%,7.40%
2020-01-01 00:07:20,15,6,5196,249,4947,7.93%,4.79%
2020-01-01 00:07:20,15,7,3899,113,3786,5.95%,2.90%
2020-01-01 00:07:20,15,8,6457,304,6153,9.85%,4.71%
2020-01-01 00:07:20,15,9,9641,727,8914,14.71%,7.54%
2020-01-01 00:07:20,15,10,5571,417,5154,8.50%,7.48%
2020-01-01 00:07:20,15,11,12164,1274,10890,18.56%,10.47%
2020-01-01 00:07:20,15,12,27440,5717,21723,41.87%,20.83%
2020-01-01 00:07:20,16,1,407,6,401,0.62%,1.47%
2020-01-01 00:07:20,16,2,278,0,278,0.42%,0.00%
2020-01-01 00:07:20,16,3,1759,21,1738,2.68%,1.19%
2020-01-01 00:07:20,16,4,3410,94,3316,5.20%,2.76%
2020-01-01 00:07:20,16,5,7728,500,7228,11.79%,6.47%
2020-01-01 00:07:20,16,6,4351,148,4203,6.64%,3.40%
2020-01-01 00:07:20,16,7,3597,126,3471,5.49%,3.50%
2020-01-01 00:07:20,16,8,7902,514,7388,12.06%,6.50%
2020-01-01 00:07:20,16,9,8318,575,7743,12.69%,6.91%
2020-01-01 00:07:20,16,10,1530,16,1514,2.33%,1.05%
2020-01-01 00:07:20,16,11,9734,736,8998,14.85%,7.56%
2020-01-01 00:07:20,16,12,26104,4641,21463,39.83%,17.78%
2020-01-01 00:07:30,1,1,16505,1906,14599,25.18%,11.55%
2020-01-01 00:07:30,1,2,6014,282,5732,9.18%,4.69%
2020-01-01 00:07:30,1,3,524,4,520,0.80%,0.76%
2020-01-01 00:07:30,1,4,10078,730,9348,15.38%,7.24%
2020-01-01 00:07:30,1,5,9682,676,9006,14.77%,6.98%
2020-01-01 00:07:30,1,6,9620,661,8959,14.68%,6.87%
2020-01-01 00:07:30,1,7,5460,241,5219,8.33%,4.41%
2020-01-01 00:07:30,1,8,4524,165,4359,6.90%,3.65%
2020-01-01 00:07:30,1,9,9559,656,8903,14.59%,6.86%
2020-01-01 00:07:30,1,10,3785,110,3675,5.78%,2.91%
2020-01-01 00:07:30,1,11,3877,115,3762,5.92%,2.97%
2020-01-01 00:07:30,1,12,8856,569,8287,13.51%,6.42%
2020-01-01 00:07:30,2,1,483,3,480,0.74%,0.62%
2020-01-01 00:07:30,2,2,31168,6335,24833,47.56%,20.32%
2020-01-01 00:07:30,2,3,25660,4446,21214,39.15%,17.33%
2020-01-01 00:07:30,2,4,411,3,408,0.63%,0.73%
2020-01-01 00:07:30,2,5,14269,1452,12817,21.77%,10.18%
2020-01-01 00:07:30,2,6,44,0,44,0.07%,0.00%
2020-01-01 00:07:30,2,7,5011,153,4858,7.65%,3.05%
2020-01-01 00:07:30,2,8,4141,105,4036,6.32%,2.54%
2020-01-01 00:07:30,2,9,14215,1448,12767,21.69%,10.19%
2020-01-01 00:07:30,2,10,3217,65,3152,4.91%,2.02%
2020-01-01 00:07:30,2,11,3235,65,3170,4.94%,2.01%
2020-01-01 00:07:30,2,12,14043,1418,12625,21.43%,10.10%
2020-01-01 00:07:30,3,1,1372,7,1365,2.09%,0.51%
2020-01-01 00:07:30,3,2,25848,4489,21359,39.44%,17.37%
2020-01-01 00:07:30,3,3,71675,28144,43531,109.37%,39.27%
2020-01-01 00:07:30,3,4,9211,613,8598,14.05%,6.65%
2020-01-01 00:07:30,3,5,44784,12427,32357,68.33%,27.75%
2020-01-01 00:07:30,3,6,10506,813,9693,16.03%,7.74%
2020-01-01 00:07:30,3,7,22786,3522,19264,34.77%,15.46%
2020-01-01 00:07:30,3,8,16891,1991,14900,25.77%,11.79%
2020-01-01 00:07:30,3,9,33976,7494,26482,51.84%,22.06%
2020-01-01 00:07:30,3,10,4883,179,4704,7.45%,3.67%
2020-01-01 00:07:30,3,11,1921,24,1897,2.93%,1.25%
2020-01-01 00:07:30,3,12,25261,4375,20886,38.55%,17.32%
2020-01-01 00:07:30,4,1,568,2,566,0.87%,0.35%
2020-01-01 00:07:30,4,2,382,0,382,0.58%,0.00%
2020-01-01 00:07:30,4,3,604,2,602,0.92%,0.33%
2020-01-01 00:07:30,4,4,28305,5385,22920,43.19%,19.02%
2020-01-01 00:07:30,4,5,17507,2231,15276,26.71%,12.74%
2020-01-01 00:07:30,4,6,24387,4115,20272,37.21%,16.87%
2020-01-01 00:07:30,4,7,5615,218,5397,8.57%,3.88%
2020-01-01 00:07:30,4,8,3288,67,3221,5.02%,2.04%
2020-01-01 00:07:30,4,9,15708,1834,13874,23.97%,11.67%
2020-01-01 00:07:30,4,10,1957,42,1915,2.99%,2.15%
2020-01-01 00:07:30,4,11,140,0,140,0.21%,0.00%
2020-01-01 00:07:30,4,12,12455,1148,11307,19.00%,9.22%
2020-01-01 00:07:30,5,1,3219,82,3137,4.91%,2.55%
2020-01-01 00:07:30,5,2,843,6,837,1.29%,0.71%
2020-01-01 00:07:30,5,3,551,3,548,0.84%,0.54%
2020-01-01 00:07:30,5,4,24025,3880,20145,36.66%,16.15%
2020-01-01 00:07:30,5,5,8837,579,8258,13.48%,6.55%
2020-01-01 00:07:30,5,6,14448,1459,12989,22.05%,10.10%
2020-01-01 00:07:30,5,7,5174,217,4957,7.89%,4.19%
2020-01-01 00:07:30,5,8,3792,122,3670,5.79%,3.22%
2020-01-01 00:07:30,5,9,8103,487,7616,12.36%,6.01%
2020-01-01 00:07:30,5,10,947,7,940,1.45%,0.74%
2020-01-01 00:07:30,5,11,562,3,559,0.86%,0.53%
2020-01-01 00:07:30,5,12,6826,354,6472,10.42%,5.19%
2020-01-01 00:07:30,6,1,1000,7,993,1.53%,0.70%
2020-01-01 00:07:30,6,2,1038,7,1031,1.58%,0.67%
2020-01-01 00:07:30,6,3,1660,18,1642,2.53%,1.08%
2020-01-01 00:07:30,6,4,1400,10,1390,2.14%,0.71%
2020-01-01 00:07:30,6,5,14827,1618,13209,22.62%,10.91%
2020-01-01 00:07:30,6,6,5844,268,5576,8.92%,4.59%
2020-01-01 00:07:30,6,7,3811,94,3717,5.82%,2.47%
2020-01-01 00:07:30,6,8,3049,59,2990,4.65%,1.93%
2020-01-01 00:07:30,6,9,7028,385,6643,10.72%,5.48%
2020-01-01 00:07:30,6,10,2167,44,2123,3.31%,2.03%
2020-01-01 00:07:30,6,11,434,1,433,0.66%,0.23%
2020-01-01 00:07:30,6,12,4812,169,4643,7.34%,3.51%
2020-01-01 00:07:30,7,1,462,3,459,0.70%,0.65%
2020-01-01 00:07:30,7,2,155,1,154,0.24%,0.64%
2020-01-01 00:07:30,7,3,1419,8,1411,2.17%,0.56%
2020-01-01 00:07:30,7,4,2138,86,2052,3.26%,4.02%
2020-01-01 00:07:30,7,5,8171,516,7655,12.47%,6.31%
2020-01-01 00:07:30,7,6,14420,1526,12894,22.00%,10.58%
2020-01-01 00:07:30,7,7,4043,116,3927,6.17%,2.87%
2020-01-01 00:07:30,7,8,1784,28,1756,2.72%,1.57%
2020-01-01 00:07:30,7,9,6679,357,6322,10.19%,5.34%
2020-01-01 00:07:30,7,10,1302,10,1292,1.99%,0.77%
2020-01-01 00:07:30,7,11,103,0,103,0.16%,0.00%
2020-01-01 00:07:30,7,12,5338,248,5090,8.15%,4.65%
2020-01-01 00:07:30,8,1,440,2,438,0.67%,0.45%
2020-01-01 00:07:30,8,2,54,0,54,0.08%,0.00%
2020-01-01 00:07:30,8,3,1801,23,1778,2.75%,1.28%
2020-01-01 00:07:30,8,4,2663,52,2611,4.06%,1.95%
2020-01-01 00:07:30,8,5,8240,524,7716,12.57%,6.36%
2020-01-01 00:07:30,8,6,16706,1982,14724,25.49%,11.86%
2020-01-01 00:07:30,8,7,5634,254,5380,8.60%,4.51%
2020-01-01 00:07:30,8,8,2675,53,2622,4.08%,1.98%
2020-01-01 00:07:30,8,9,6223,299,5924,9.50%,4.80%
2020-01-01 00:07:30,8,10,1700,24,1676,2.59%,1.41%
2020-01-01 00:07:30,8,11,229,0,229,0.35%,0.00%
2020-01-01 00:07:30,8,12,4480,150,4330,6.84%,3.35%
2020-01-01 00:07:30,9,1,1061,7,1054,1.62%,0.66%
2020-01-01 00:07:30,9,2,5697,223,5474,8.69%,3.91%
2020-01-01 00:07:30,9,3,4175,123,4052,6.37%,2.95%
2020-01-01 00:07:30,9,4,5090,191,4899,7.77%,3.75%
2020-01-01 00:07:30,9,5,254,0,254,0.39%,0.00%
2020-01-01 00:07:30,9,6,6431,292,6139,9.81%,4.54%
2020-01-01 00:07:30,9,7,27050,4824,22226,41.28%,17.83%
2020-01-01 00:07:30,9,8,8159,451,7708,12.45%,5.53%
2020-01-01 00:07:30,9,9,151,0,151,0.23%,0.00%
2020-01-01 00:07:30,9,10,2220,29,2191,3.39%,1.31%
2020-01-01 00:07:30,9,11,7157,347,6810,10.92%,4.85%
2020-01-01 00:07:30,9,12,4663,156,4507,7.12%,3.34%
2020-01-01 00:07:30,10,1,1150,214,936,1.75%,18.59%
2020-01-01 00:07:30,10,2,3119,273,2846,4.76%,8.75%
2020-01-01 00:07:30,10,3,1825,27,1798,2.78%,1.48%
2020-01-01 00:07:30,10,4,4087,1035,3052,6.24%,25.32%
2020-01-01 00:07:30,10,5,659,45,614,1.01%,6.82%
2020-01-01 00:07:30,10,6,6163,1187,4976,9.40%,19.26%
2020-01-01 00:07:30,10,7,11235,1937,9298,17.14%,17.24%
2020-01-01 00:07:30,10,8,28736,7123,21613,43.85%,24.79%
2020-01-01 00:07:30,10,9,815,3,812,1.24%,0.37%
2020-01-01 00:07:30,10,10,2331,38,2293,3.56%,1.63%
2020-01-01 00:07:30,10,11,13908,1721,12187,21.22%,12.37%
2020-01-01 00:07:30,10,12,10716,1203,9513,16.35%,11.23%
2020-01-01 00:07:30,11,1,2595,55,2540,3.96%,2.12%
2020-01-01 00:07:30,11,2,3817,110,3707,5.82%,2.88%
2020-01-01 00:07:30,11,3,1041,8,1033,1.59%,0.77%
2020-01-01 00:07:30,11,4,5058,263,4795,7.72%,5.20%
2020-01-01 00:07:30,11,5,215,1,214,0.33%,0.46%
2020-01-01 00:07:30,11,6,6264,360,5904,9.56%,5.75%
2020-01-01 00:07:30,11,7,12451,1142,11309,19.00%,9.17%
2020-01-01 00:07:30,11,8,26444,4781,21663,40.35%,18.08%
2020-01-01 00:07:30,11,9,255,3,252,0.39%,1.17%
2020-01-01 00:07:30,11,10,2720,73,2647,4.15%,2.68%
2020-01-01 00:07:30,11,11,9857,763,9094,15.04%,7.74%
2020-01-01 00:07:30,11,12,6646,346,6300,10.14%,5.21%
2020-01-01 00:07:30,12,1,40,0,40,0.06%,0.00%
2020-01-01 00:07:30,12,2,632,174,458,0.96%,27.49%
2020-01-01 00:07:30,12,3,3169,246,2923,4.84%,7.76%
2020-01-01 00:07:30,12,4,3304,70,3234,5.04%,2.12%
2020-01-01 00:07:30,12,5,9430,812,8618,14.39%,8.61%
2020-01-01 00:07:30,12,6,5415,189,5226,8.26%,3.49%
2020-01-01 00:07:30,12,7,1963,26,1937,3.00%,1.32%
2020-01-01 00:07:30,12,8,1544,259,1285,2.36%,16.76%
2020-01-01 00:07:30,12,9,23170,4481,18689,35.35%,19.34%
2020-01-01 00:07:30,12,10,4436,392,4044,6.77%,8.83%
2020-01-01 00:07:30,12,11,1701,261,1440,2.60%,15.33%
2020-01-01 00:07:30,12,12,8746,1112,7634,13.35%,12.71%
2020-01-01 00:07:30,13,1,2269,41,2228,3.46%,1.81%
2020-01-01 00:07:30,13,2,2571,51,2520,3.92%,1.98%
2020-01-01 00:07:30,13,3,693,3,690,1.06%,0.43%
2020-01-01 00:07:30,13,4,6055,584,5471,9.24%,9.64%
2020-01-01 00:07:30,13,5,8177,871,7306,12.48%,10.65%
2020-01-01 00:07:30,13,6,6708,640,6068,10.24%,9.54%
2020-01-01 00:07:30,13,7,5022,203,4819,7.66%,4.04%
2020-01-01 00:07:30,13,8,7454,444,7010,11.37%,5.96%
2020-01-01 00:07:30,13,9,8545,906,7639,13.04%,10.60%
2020-01-01 00:07:30,13,10,28403,6035,22368,43.34%,21.25%
2020-01-01 00:07:30,13,11,16930,2507,14423,25.83%,14.81%
2020-01-01 00:07:30,13,12,9099,1102,7997,13.88%,12.11%
2020-01-01 00:07:30,14,1,352,0,352,0.54%,0.00%
2020-01-01 00:07:30,14,2,1489,25,1464,2.27%,1.68%
2020-01-01 00:07:30,14,3,920,8,912,1.40%,0.87%
2020-01-01 00:07:30,14,4,4443,136,4307,6.78%,3.06%
2020-01-01 00:07:30,14,5,1303,14,1289,1.99%,1.07%
2020-01-01 00:07:30,14,6,4861,164,4697,7.42%,3.37%
2020-01-01 00:07:30,14,7,12751,1123,11628,19.46%,8.81%
2020-01-01 00:07:30,14,8,14406,1439,12967,21.98%,9.99%
2020-01-01 00:07:30,14,9,1476,17,1459,2.25%,1.15%
2020-01-01 00:07:30,14,10,4065,116,3949,6.20%,2.85%
2020-01-01 00:07:30,14,11,26604,4714,21890,40.59%,17.72%
2020-01-01 00:07:30,14,12,7823,456,7367,11.94%,5.83%
2020-01-01 00:07:30,15,1,464,1,463,0.71%,0.22%
2020-01-01 00:07:30,15,2,193,1,192,0.29%,0.52%
2020-01-01 00:07:30,15,3,3877,114,3763,5.92%,2.94%
2020-01-01 00:07:30,15,4,5056,194,4862,7.71%,3.84%
2020-01-01 00:07:30,15,5,9932,753,9179,15.16%,7.58%
2020-01-01 00:07:30,15,6,5326,225,5101,8.13%,4.22%
2020-01-01 00:07:30,15,7,3766,120,3646,5.75%,3.19%
2020-01-01 00:07:30,15,8,6129,299,5830,9.35%,4.88%
2020-01-01 00:07:30,15,9,10079,779,9300,15.38%,7.73%
2020-01-01 00:07:30,15,10,4122,121,4001,6.29%,2.93%
2020-01-01 00:07:30,15,11,10355,794,9561,15.80%,7.67%
2020-01-01 00:07:30,15,12,25784,4778,21006,39.34%,18.53%
2020-01-01 00:07:30,16,1,445,0,445,0.68%,0.00%
2020-01-01 00:07:30,16,2,274,0,274,0.42%,0.00%
2020-01-01 00:07:30,16,3,3656,94,3562,5.58%,2.57%
2020-01-01 00:07:30,16,4,4134,131,4003,6.31%,3.17%
2020-01-01 00:07:30,16,5,9847,743,9104,15.03%,7.54%
2020-01-01 00:07:30,16,6,4913,174,4739,7.50%,3.54%
2020-01-01 00:07:30,16,7,3057,76,2981,4.66%,2.49%
2020-01-01 00:07:30,16,8,6737,486,6251,10.28%,7.21%
2020-01-01 00:07:30,16,9,10250,799,9451,15.64%,7.79%
2020-01-01 00:07:30,16,10,1612,24,1588,2.46%,1.49%
2020-01-01 00:07:30,16,11,8610,689,7921,13.14%,8.00%
2020-01-01 00:07:30,16,12,26179,4642,21537,39.95%,17.73%
2020-01-01 00:07:40,1,1,17060,2094,14966,26.03%,12.27%
2020-01-01 00:07:40,1,2,5029,183,4846,7.67%,3.64%
2020-01-01 00:07:40,1,3,726,6,720,1.11%,0.83%
2020-01-01 00:07:40,1,4,11614,1019,10595,17.72%,8.77%
2020-01-01 00:07:40,1,5,11274,959,10315,17.20%,8.51%
2020-01-01 00:07:40,1,6,11206,955,10251,17.10%,8.52%
2020-01-01 00:07:40,1,7,4286,134,4152,6.54%,3.13%
2020-01-01 00:07:40,1,8,3350,85,3265,5.11%,2.54%
2020-01-01 00:07:40,1,9,11145,941,10204,17.01%,8.44%
2020-01-01 00:07:40,1,10,2823,62,2761,4.31%,2.20%
2020-01-01 00:07:40,1,11,2858,64,2794,4.36%,2.24%
2020-01-01 00:07:40,1,12,10160,780,9380,15.50%,7.68%
2020-01-01 00:07:40,2,1,397,1,396,0.61%,0.25%
2020-01-01 00:07:40,2,2,26029,4582,21447,39.72%,17.60%
2020-01-01 00:07:40,2,3,19657,2711,16946,29.99%,13.79%
2020-01-01 00:07:40,2,4,373,1,372,0.57%,0.27%
2020-01-01 00:07:40,2,5,9920,702,9218,15.14%,7.08%
2020-01-01 00:07:40,2,6,53,0,53,0.08%,0.00%
2020-01-01 00:07:40,2,7,5958,286,5672,9.09%,4.80%
2020-01-01 00:07:40,2,8,4275,163,4112,6.52%,3.81%
2020-01-01 00:07:40,2,9,9866,696,9170,15.05%,7.05%
2020-01-01 00:07:40,2,10,3589,122,3467,5.48%,3.40%
2020-01-01 00:07:40,2,11,3595,122,3473,5.49%,3.39%
2020-01-01 00:07:40,2,12,9707,671,9036,14.81%,6.91%
2020-01-01 00:07:40,3,1,1693,13,1680,2.58%,0.77%
2020-01-01 00:07:40,3,2,24560,4068,20492,37.48%,16.56%
2020-01-01 00:07:40,3,3,75614,30663,44951,115.38%,40.55%
2020-01-01 00:07:40,3,4,8005,453,7552,12.21%,5.66%
2020-01-01 00:07:40,3,5,49492,14658,34834,75.52%,29.62%
2020-01-01 00:07:40,3,6,9441,643,8798,14.41%,6.81%
2020-01-01 00:07:40,3,7,20918,3017,17901,31.92%,14.42%
2020-01-01 00:07:40,3,8,16727,1921,14806,25.52%,11.48%
2020-01-01 00:07:40,3,9,39746,9864,29882,60.65%,24.82%
2020-01-01 00:07:40,3,10,4228,124,4104,6.45%,2.93%
2020-01-01 00:07:40,3,11,1957,23,1934,2.99%,1.17%
2020-01-01 00:07:40,3,12,31682,6554,25128,48.34%,20.69%
2020-01-01 00:07:40,4,1,486,3,483,0.74%,0.62%
2020-01-01 00:07:40,4,2,332,1,331,0.51%,0.30%
2020-01-01 00:07:40,4,3,681,3,678,1.04%,0.44%
2020-01-01 00:07:40,4,4,27571,5251,22320,42.07%,19.04%
2020-01-01 00:07:40,4,5,16872,2117,14755,25.74%,12.55%
2020-01-01 00:07:40,4,6,23646,3924,19722,36.08%,16.59%
2020-01-01 00:07:40,4,7,5445,231,5214,8.31%,4.24%
2020-01-01 00:07:40,4,8,3149,85,3064,4.80%,2.70%
2020-01-01 00:07:40,4,9,15015,1687,13328,22.91%,11.23%
2020-01-01 00:07:40,4,10,2157,48,2109,3.29%,2.22%
2020-01-01 00:07:40,4,11,187,1,186,0.29%,0.53%
2020-01-01 00:07:40,4,12,12168,1124,11044,18.57%,9.24%
2020-01-01 00:07:40,5,1,3522,82,3440,5.37%,2.33%
2020-01-01 00:07:40,5,2,1102,2,1100,1.68%,0.18%
2020-01-01 00:07:40,5,3,490,0,490,0.75%,0.00%
2020-01-01 00:07:40,5,4,24177,4017,20160,36.89%,16.61%
2020-01-01 00:07:40,5,5,9617,654,8963,14.67%,6.80%
2020-01-01 00:07:40,5,6,16198,1878,14320,24.72%,11.59%
2020-01-01 00:07:40,5,7,6152,352,5800,9.39%,5.72%
2020-01-01 00:07:40,5,8,4579,176,4403,6.99%,3.84%
2020-01-01 00:07:40,5,9,8964,571,8393,13.68%,6.37%
2020-01-01 00:07:40,5,10,1042,12,1030,1.59%,1.15%
2020-01-01 00:07:40,5,11,587,6,581,0.90%,1.02%
2020-01-01 00:07:40,5,12,7477,399,7078,11.41%,5.34%
2020-01-01 00:07:40,6,1,1083,6,1077,1.65%,0.55%
2020-01-01 00:07:40,6,2,1136,8,1128,1.73%,0.70%
2020-01-01 00:07:40,6,3,1558,16,1542,2.38%,1.03%
2020-01-01 00:07:40,6,4,1103,7,1096,1.68%,0.63%
2020-01-01 00:07:40,6,5,13721,1283,12438,20.94%,9.35%
2020-01-01 00:07:40,6,6,4563,154,4409,6.96%,3.37%
2020-01-01 00:07:40,6,7,3066,69,2997,4.68%,2.25%
2020-01-01 00:07:40,6,8,2314,41,2273,3.53%,1.77%
2020-01-01 00:07:40,6,9,7283,385,6898,11.11%,5.29%
2020-01-01 00:07:40,6,10,2215,38,2177,3.38%,1.71%
2020-01-01 00:07:40,6,11,466,1,465,0.71%,0.21%
2020-01-01 00:07:40,6,12,5000,178,4822,7.63%,3.56%
2020-01-01 00:07:40,7,1,490,0,490,0.75%,0.00%
2020-01-01 00:07:40,7,2,137,0,137,0.21%,0.00%
2020-01-01 00:07:40,7,3,712,5,707,1.09%,0.70%
2020-01-01 00:07:40,7,4,1957,25,1932,2.99%,1.28%
2020-01-01 00:07:40,7,5,8398,532,7866,12.81%,6.33%
2020-01-01 00:07:40,7,6,14045,1367,12678,21.43%,9.73%
2020-01-01 00:07:40,7,7,3571,101,3470,5.45%,2.83%
2020-01-01 00:07:40,7,8,1540,23,1517,2.35%,1.49%
2020-01-01 00:07:40,7,9,7532,429,7103,11.49%,5.69%
2020-01-01 00:07:40,7,10,1432,15,1417,2.19%,1.05%
2020-01-01 00:07:40,7,11,116,0,116,0.18%,0.00%
2020-01-01 00:07:40,7,12,6040,290,5750,9.22%,4.80%
2020-01-01 00:07:40,8,1,378,1,377,0.58%,0.26%
2020-01-01 00:07:40,8,2,70,4,66,0.11%,5.63%
2020-01-01 00:07:40,8,3,1750,27,1723,2.67%,1.54%
2020-01-01 00:07:40,8,4,3093,58,3035,4.72%,1.87%
2020-01-01 00:07:40,8,5,8007,479,7528,12.22%,5.98%
2020-01-01 00:07:40,8,6,16216,1867,14349,24.74%,11.51%
2020-01-01 00:07:40,8,7,5063,192,4871,7.73%,3.79%
2020-01-01 00:07:40,8,8,2232,33,2199,3.41%,1.48%
2020-01-01 00:07:40,8,9,6077,288,5789,9.27%,4.74%
2020-01-01 00:07:40,8,10,1618,20,1598,2.47%,1.24%
2020-01-01 00:07:40,8,11,291,0,291,0.44%,0.00%
2020-01-01 00:07:40,8,12,4424,146,4278,6.75%,3.30%
2020-01-01 00:07:40,9,1,1681,220,1461,2.57%,13.08%
2020-01-01 00:07:40,9,2,5637,424,5213,8.60%,7.52%
2020-01-01 00:07:40,9,3,3520,87,3433,5.37%,2.47%
2020-01-01 00:07:40,9,4,6005,316,5689,9.16%,5.26%
2020-01-01 00:07:40,9,5,183,1,182,0.28%,0.54%
2020-01-01 00:07:40,9,6,7050,416,6634,10.76%,5.90%
2020-01-01 00:07:40,9,7,29835,6082,23753,45.52%,20.38%
2020-01-01 00:07:40,9,8,9861,756,9105,15.05%,7.67%
2020-01-01 00:07:40,9,9,160,1,159,0.24%,0.62%
2020-01-01 00:07:40,9,10,3297,72,3225,5.03%,2.18%
2020-01-01 00:07:40,9,11,8940,617,8323,13.64%,6.90%
2020-01-01 00:07:40,9,12,5304,203,5101,8.09%,3.83%
2020-01-01 00:07:40,10,1,1091,178,913,1.66%,16.30%
2020-01-01 00:07:40,10,2,2598,220,2378,3.96%,8.46%
2020-01-01 00:07:40,10,3,1374,21,1353,2.10%,1.53%
2020-01-01 00:07:40,10,4,3756,855,2901,5.73%,22.76%
2020-01-01 00:07:40,10,5,989,22,967,1.51%,2.22%
2020-01-01 00:07:40,10,6,5854,994,4860,8.93%,16.98%
2020-01-01 00:07:40,10,7,10478,1611,8867,15.99%,15.37%
2020-01-01 00:07:40,10,8,27831,6598,21233,42.47%,23.71%
2020-01-01 00:07:40,10,9,766,8,758,1.17%,1.04%
2020-01-01 00:07:40,10,10,2451,39,2412,3.74%,1.59%
2020-01-01 00:07:40,10,11,13524,1629,11895,20.64%,12.04%
2020-01-01 00:07:40,10,12,10305,1120,9185,15.72%,10.87%
2020-01-01 00:07:40,11,1,2501,59,2442,3.82%,2.36%
2020-01-01 00:07:40,11,2,6685,346,6339,10.20%,5.17%
2020-01-01 00:07:40,11,3,4014,112,3902,6.12%,2.79%
2020-01-01 00:07:40,11,4,4933,221,4712,7.53%,4.48%
2020-01-01 00:07:40,11,5,197,0,197,0.30%,0.00%
2020-01-01 00:07:40,11,6,5655,274,5381,8.63%,4.84%
2020-01-01 00:07:40,11,7,14320,1567,12753,21.85%,10.94%
2020-01-01 00:07:40,11,8,27461,5136,22325,41.90%,18.70%
2020-01-01 00:07:40,11,9,204,0,204,0.31%,0.00%
2020-01-01 00:07:40,11,10,2879,65,2814,4.39%,2.26%
2020-01-01 00:07:40,11,11,9666,640,9026,14.75%,6.62%
2020-01-01 00:07:40,11,12,6528,313,6215,9.96%,4.79%
2020-01-01 00:07:40,12,1,45,1,44,0.07%,2.17%
2020-01-01 00:07:40,12,2,521,196,325,0.79%,37.55%
2020-01-01 00:07:40,12,3,3011,259,2752,4.59%,8.60%
2020-01-01 00:07:40,12,4,2602,75,2527,3.97%,2.88%
2020-01-01 00:07:40,12,5,8739,777,7962,13.33%,8.89%
2020-01-01 00:07:40,12,6,4782,222,4560,7.30%,4.64%
2020-01-01 00:07:40,12,7,2061,63,1998,3.14%,3.06%
2020-01-01 00:07:40,12,8,1349,243,1106,2.06%,18.00%
2020-01-01 00:07:40,12,9,21144,4007,17137,32.26%,18.95%
2020-01-01 00:07:40,12,10,4367,358,4009,6.66%,8.20%
2020-01-01 00:07:40,12,11,1954,257,1697,2.98%,13.15%
2020-01-01 00:07:40,12,12,7314,1075,6239,11.16%,14.70%
2020-01-01 00:07:40,13,1,2414,47,2367,3.68%,1.95%
2020-01-01 00:07:40,13,2,2730,61,2669,4.17%,2.23%
2020-01-01 00:07:40,13,3,730,2,728,1.11%,0.27%
2020-01-01 00:07:40,13,4,5078,599,4479,7.75%,11.79%
2020-01-01 00:07:40,13,5,7123,836,6287,10.87%,11.73%
2020-01-01 00:07:40,13,6,5626,639,4987,8.58%,11.36%
2020-01-01 00:07:40,13,7,5214,231,4983,7.96%,4.43%
2020-01-01 00:07:40,13,8,7801,481,7320,11.90%,6.17%
2020-01-01 00:07:40,13,9,7377,864,6513,11.26%,11.71%
2020-01-01 00:07:40,13,10,27070,5517,21553,41.31%,20.38%
2020-01-01 00:07:40,13,11,16879,2322,14557,25.76%,13.76%
2020-01-01 00:07:40,13,12,8722,895,7827,13.31%,10.26%
2020-01-01 00:07:40,14,1,368,1,367,0.56%,0.27%
2020-01-01 00:07:40,14,2,1484,18,1466,2.26%,1.21%
2020-01-01 00:07:40,14,3,945,4,941,1.44%,0.42%
2020-01-01 00:07:40,14,4,4299,148,4151,6.56%,3.44%
2020-01-01 00:07:40,14,5,1312,9,1303,2.00%,0.69%
2020-01-01 00:07:40,14,6,4615,166,4449,7.04%,3.60%
2020-01-01 00:07:40,14,7,12953,1190,11763,19.76%,9.19%
2020-01-01 00:07:40,14,8,14558,1481,13077,22.21%,10.17%
2020-01-01 00:07:40,14,9,1504,14,1490,2.29%,0.93%
2020-01-01 00:07:40,14,10,4256,139,4117,6.49%,3.27%
2020-01-01 00:07:40,14,11,27014,4821,22193,41.22%,17.85%
2020-01-01 00:07:40,14,12,7993,458,7535,12.20%,5.73%
2020-01-01 00:07:40,15,1,489,1,488,0.75%,0.20%
2020-01-01 00:07:40,15,2,157,0,157,0.24%,0.00%
2020-01-01 00:07:40,15,3,5287,212,5075,8.07%,4.01%
2020-01-01 00:07:40,15,4,6561,314,6247,10.01%,4.79%
2020-01-01 00:07:40,15,5,13357,1320,12037,20.38%,9.88%
2020-01-01 00:07:40,15,6,6883,353,6530,10.50%,5.13%
2020-01-01 00:07:40,15,7,3843,130,3713,5.86%,3.38%
2020-01-01 00:07:40,15,8,6215,326,5889,9.48%,5.24%
2020-01-01 00:07:40,15,9,13548,1358,12190,20.67%,10.02%
2020-01-01 00:07:40,15,10,3984,157,3827,6.08%,3.94%
2020-01-01 00:07:40,15,11,10328,810,9518,15.76%,7.84%
2020-01-01 00:07:40,15,12,29550,6106,23444,45.09%,20.66%
2020-01-01 00:07:40,16,1,553,5,548,0.84%,0.90%
2020-01-01 00:07:40,16,2,241,0,241,0.37%,0.00%
2020-01-01 00:07:40,16,3,1762,28,1734,2.69%,1.59%
2020-01-01 00:07:40,16,4,4912,175,4737,7.50%,3.56%
2020-01-01 00:07:40,16,5,8765,571,8194,13.37%,6.51%
2020-01-01 00:07:40,16,6,5646,214,5432,8.62%,3.79%
2020-01-01 00:07:40,16,7,3594,117,3477,5.48%,3.25%
2020-01-01 00:07:40,16,8,7495,467,7028,11.44%,6.23%
2020-01-01 00:07:40,16,9,9114,614,8500,13.91%,6.74%
2020-01-01 00:07:40,16,10,1560,24,1536,2.38%,1.54%
2020-01-01 00:07:40,16,11,9252,694,8558,14.12%,7.50%
2020-01-01 00:07:40,16,12,25663,4531,21132,39.16%,17.66%
2020-01-01 00:07:50,1,1,16129,1850,14279,24.61%,11.47%
2020-01-01 00:07:50,1,2,5120,203,4917,7.81%,3.96%
2020-01-01 00:07:50,1,3,1244,12,1232,1.90%,0.96%
2020-01-01 00:07:50,1,4,10520,793,9727,16.05%,7.54%
2020-01-01 00:07:50,1,5,10270,767,9503,15.67%,7.47%
2020-01-01 00:07:50,1,6,10242,757,9485,15.63%,7.39%
2020-01-01 00:07:50,1,7,3857,119,3738,5.89%,3.08%
2020-01-01 00:07:50,1,8,2848,77,2771,4.35%,2.70%
2020-01-01 00:07:50,1,9,10202,755,9447,15.57%,7.40%
2020-01-01 00:07:50,1,10,2166,45,2121,3.31%,2.08%
2020-01-01 00:07:50,1,11,2281,51,2230,3.48%,2.23%
2020-01-01 00:07:50,1,12,10176,749,9427,15.53%,7.36%
2020-01-01 00:07:50,2,1,611,2,609,0.93%,0.33%
2020-01-01 00:07:50,2,2,33630,7276,26354,51.32%,21.63%
2020-01-01 00:07:50,2,3,25691,4446,21245,39.20%,17.30%
2020-01-01 00:07:50,2,4,539,2,537,0.82%,0.37%
2020-01-01 00:07:50,2,5,12471,1126,11345,19.03%,9.03%
2020-01-01 00:07:50,2,6,56,0,56,0.09%,0.00%
2020-01-01 00:07:50,2,7,7309,391,6918,11.15%,5.35%
2020-01-01 00:07:50,2,8,5594,247,5347,8.54%,4.41%
2020-01-01 00:07:50,2,9,12391,1109,11282,18.91%,8.95%
2020-01-01 00:07:50,2,10,4623,179,4444,7.05%,3.87%
2020-01-01 00:07:50,2,11,4640,179,4461,7.08%,3.86%
2020-01-01 00:07:50,2,12,12235,1081,11154,18.67%,8.83%
2020-01-01 00:07:50,3,1,1455,16,1439,2.22%,1.10%
2020-01-01 00:07:50,3,2,24999,4178,20821,38.15%,16.71%
2020-01-01 00:07:50,3,3,71736,28034,43702,109.46%,39.08%
2020-01-01 00:07:50,3,4,9748,680,9068,14.87%,6.98%
2020-01-01 00:07:50,3,5,44097,11958,32139,67.29%,27.12%
2020-01-01 00:07:50,3,6,11290,911,10379,17.23%,8.07%
2020-01-01 00:07:50,3,7,22105,3330,18775,33.73%,15.06%
2020-01-01 00:07:50,3,8,17868,2224,15644,27.26%,12.45%
2020-01-01 00:07:50,3,9,32415,6820,25595,49.46%,21.04%
2020-01-01 00:07:50,3,10,3101,72,3029,4.73%,2.32%
2020-01-01 00:07:50,3,11,1991,30,1961,3.04%,1.51%
2020-01-01 00:07:50,3,12,26070,4622,21448,39.78%,17.73%
2020-01-01 00:07:50,4,1,510,4,506,0.78%,0.78%
2020-01-01 00:07:50,4,2,309,2,307,0.47%,0.65%
2020-01-01 00:07:50,4,3,788,0,788,1.20%,0.00%
2020-01-01 00:07:50,4,4,27259,4939,22320,41.59%,18.12%
2020-01-01 00:07:50,4,5,16707,1926,14781,25.49%,11.53%
2020-01-01 00:07:50,4,6,23207,3594,19613,35.41%,15.49%
2020-01-01 00:07:50,4,7,5231,208,5023,7.98%,3.98%
2020-01-01 00:07:50,4,8,2877,72,2805,4.39%,2.50%
2020-01-01 00:07:50,4,9,14786,1555,13231,22.56%,10.52%
2020-01-01 00:07:50,4,10,1761,21,1740,2.69%,1.19%
2020-01-01 00:07:50,4,11,194,0,194,0.30%,0.00%
2020-01-01 00:07:50,4,12,12432,1128,11304,18.97%,9.07%
2020-01-01 00:07:50,5,1,2962,62,2900,4.52%,2.09%
2020-01-01 00:07:50,5,2,789,7,782,1.20%,0.89%
2020-01-01 00:07:50,5,3,375,0,375,0.57%,0.00%
2020-01-01 00:07:50,5,4,20433,3067,17366,31.18%,15.01%
2020-01-01 00:07:50,5,5,9223,697,8526,14.07%,7.56%
2020-01-01 00:07:50,5,6,13208,1349,11859,20.15%,10.21%
2020-01-01 00:07:50,5,7,3530,125,3405,5.39%,3.54%
2020-01-01 00:07:50,5,8,2894,79,2815,4.42%,2.73%
2020-01-01 00:07:50,5,9,8703,626,8077,13.28%,7.19%
2020-01-01 00:07:50,5,10,1060,17,1043,1.62%,1.60%
2020-01-01 00:07:50,5,11,569,6,563,0.87%,1.05%
2020-01-01 00:07:50,5,12,7344,446,6898,11.21%,6.07%
2020-01-01 00:07:50,6,1,982,10,972,1.50%,1.02%
2020-01-01 00:07:50,6,2,1128,11,1117,1.72%,0.97%
2020-01-01 00:07:50,6,3,1491,17,1474,2.28%,1.14%
2020-01-01 00:07:50,6,4,1035,7,1028,1.58%,0.68%
2020-01-01 00:07:50,6,5,12851,1219,11632,19.61%,9.48%
2020-01-01 00:07:50,6,6,5214,217,4997,7.96%,4.16%
2020-01-01 00:07:50,6,7,3824,135,3689,5.83%,3.53%
2020-01-01 00:07:50,6,8,2864,91,2773,4.37%,3.18%
2020-01-01 00:07:50,6,9,5833,240,5593,8.90%,4.11%
2020-01-01 00:07:50,6,10,1762,29,1733,2.69%,1.64%
2020-01-01 00:07:50,6,11,434,2,432,0.66%,0.46%
2020-01-01 00:07:50,6,12,4007,108,3899,6.11%,2.69%
2020-01-01 00:07:50,7,1,406,2,404,0.62%,0.49%
2020-01-01 00:07:50,7,2,165,1,164,0.25%,0.60%
2020-01-01 00:07:50,7,3,736,3,733,1.12%,0.41%
2020-01-01 00:07:50,7,4,2333,31,2302,3.56%,1.33%
2020-01-01 00:07:50,7,5,6529,300,6229,9.96%,4.59%
2020-01-01 00:07:50,7,6,12704,1132,11572,19.38%,8.91%
2020-01-01 00:07:50,7,7,3758,106,3652,5.73%,2.82%
2020-01-01 00:07:50,7,8,1957,37,1920,2.99%,1.89%
2020-01-01 00:07:50,7,9,5491,208,5283,8.38%,3.79%
2020-01-01 00:07:50,7,10,913,2,911,1.39%,0.22%
2020-01-01 00:07:50,7,11,235,0,235,0.36%,0.00%
2020-01-01 00:07:50,7,12,4516,144,4372,6.89%,3.19%
2020-01-01 00:07:50,8,1,479,5,474,0.73%,1.04%
2020-01-01 00:07:50,8,2,73,0,73,0.11%,0.00%
2020-01-01 00:07:50,8,3,1799,31,1768,2.75%,1.72%
2020-01-01 00:07:50,8,4,3116,65,3051,4.75%,2.09%
2020-01-01 00:07:50,8,5,8724,612,8112,13.31%,7.01%
2020-01-01 00:07:50,8,6,16509,1906,14603,25.19%,11.54%
2020-01-01 00:07:50,8,7,4478,124,4354,6.83%,2.77%
2020-01-01 00:07:50,8,8,1700,18,1682,2.59%,1.06%
2020-01-01 00:07:50,8,9,6734,343,6391,10.28%,5.09%
2020-01-01 00:07:50,8,10,1832,25,1807,2.80%,1.36%
2020-01-01 00:07:50,8,11,194,0,194,0.30%,0.00%
2020-01-01 00:07:50,8,12,4847,182,4665,7.40%,3.75%
2020-01-01 00:07:50,9,1,346,3,343,0.53%,0.86%
2020-01-01 00:07:50,9,2,2986,66,2920,4.56%,2.21%
2020-01-01 00:07:50,9,3,2198,36,2162,3.35%,1.64%
2020-01-01 00:07:50,9,4,5172,159,5013,7.89%,3.07%
2020-01-01 00:07:50,9,5,346,0,346,0.53%,0.00%
2020-01-01 00:07:50,9,6,6071,222,5849,9.26%,3.66%
2020-01-01 00:07:50,9,7,29580,6065,23515,45.14%,20.50%
2020-01-01 00:07:50,9,8,13918,1596,12322,21.24%,11.47%
2020-01-01 00:07:50,9,9,142,0,142,0.22%,0.00%
2020-01-01 00:07:50,9,10,5816,497,5319,8.87%,8.54%
2020-01-01 00:07:50,9,11,12866,1387,11479,19.63%,10.78%
2020-01-01 00:07:50,9,12,6726,353,6373,10.26%,5.25%
2020-01-01 00:07:50,10,1,1249,228,1021,1.91%,18.24%
2020-01-01 00:07:50,10,2,2766,272,2494,4.22%,9.83%
2020-01-01 00:07:50,10,3,1387,18,1369,2.12%,1.30%
2020-01-01 00:07:50,10,4,4146,1114,3032,6.33%,26.86%
2020-01-01 00:07:50,10,5,1006,105,901,1.54%,10.43%
2020-01-01 00:07:50,10,6,5902,1317,4585,9.01%,22.31%
2020-01-01 00:07:50,10,7,10370,1988,8382,15.82%,19.17%
2020-01-01 00:07:50,10,8,27761,6919,20842,42.36%,24.92%
2020-01-01 00:07:50,10,9,646,2,644,0.99%,0.31%
2020-01-01 00:07:50,10,10,1941,33,1908,2.96%,1.70%
2020-01-01 00:07:50,10,11,12120,1301,10819,18.49%,10.73%
2020-01-01 00:07:50,10,12,9368,876,8492,14.29%,9.35%
2020-01-01 00:07:50,11,1,2167,34,2133,3.31%,1.57%
2020-01-01 00:07:50,11,2,3165,74,3091,4.83%,2.34%
2020-01-01 00:07:50,11,3,843,8,835,1.29%,0.95%
2020-01-01 00:07:50,11,4,3524,97,3427,5.38%,2.75%
2020-01-01 00:07:50,11,5,235,2,233,0.36%,0.85%
2020-01-01 00:07:50,11,6,4278,133,4145,6.53%,3.11%
2020-01-01 00:07:50,11,7,9246,603,8643,14.11%,6.52%
2020-01-01 00:07:50,11,8,23713,3818,19895,36.18%,16.10%
2020-01-01 00:07:50,11,9,191,2,189,0.29%,1.04%
2020-01-01 00:07:50,11,10,2970,79,2891,4.53%,2.66%
2020-01-01 00:07:50,11,11,10401,796,9605,15.87%,7.65%
2020-01-01 00:07:50,11,12,6957,349,6608,10.62%,5.02%
2020-01-01 00:07:50,12,1,59,0,59,0.09%,0.00%
2020-01-01 00:07:50,12,2,458,124,334,0.70%,27.02%
2020-01-01 00:07:50,12,3,4276,266,4010,6.52%,6.22%
2020-01-01 00:07:50,12,4,3330,89,3241,5.08%,2.67%
2020-01-01 00:07:50,12,5,9806,815,8991,14.96%,8.31%
2020-01-01 00:07:50,12,6,4893,186,4707,7.47%,3.80%
2020-01-01 00:07:50,12,7,1465,20,1445,2.24%,1.36%
2020-01-01 00:07:50,12,8,1460,248,1212,2.23%,16.97%
2020-01-01 00:07:50,12,9,22806,4417,18389,34.80%,19.37%
2020-01-01 00:07:50,12,10,4103,325,3778,6.26%,7.92%
2020-01-01 00:07:50,12,11,1733,249,1484,2.64%,14.36%
2020-01-01 00:07:50,12,12,7828,1201,6627,11.94%,15.34%
2020-01-01 00:07:50,13,1,2144,45,2099,3.27%,2.10%
2020-01-01 00:07:50,13,2,2528,63,2465,3.86%,2.49%
2020-01-01 00:07:50,13,3,586,6,580,0.89%,1.02%
2020-01-01 00:07:50,13,4,5435,932,4503,8.29%,17.14%
2020-01-01 00:07:50,13,5,7629,1272,6357,11.64%,16.67%
2020-01-01 00:07:50,13,6,5840,954,4886,8.91%,16.33%
2020-01-01 00:07:50,13,7,4744,176,4568,7.24%,3.71%
2020-01-01 00:07:50,13,8,7216,394,6822,11.01%,5.46%
2020-01-01 00:07:50,13,9,7982,1303,6679,12.18%,16.32%
2020-01-01 00:07:50,13,10,27076,5608,21468,41.31%,20.71%
2020-01-01 00:07:50,13,11,17076,2177,14899,26.06%,12.75%
2020-01-01 00:07:50,13,12,9454,822,8632,14.43%,8.69%
2020-01-01 00:07:50,14,1,432,0,432,0.66%,0.00%
2020-01-01 00:07:50,14,2,1608,24,1584,2.45%,1.49%
2020-01-01 00:07:50,14,3,925,16,909,1.41%,1.73%
2020-01-01 00:07:50,14,4,4003,128,3875,6.11%,3.20%
2020-01-01 00:07:50,14,5,1391,9,1382,2.12%,0.65%
2020-01-01 00:07:50,14,6,4377,156,4221,6.68%,3.56%
2020-01-01 00:07:50,14,7,12251,1156,11095,18.69%,9.44%
2020-01-01 00:07:50,14,8,14097,1471,12626,21.51%,10.43%
2020-01-01 00:07:50,14,9,1557,11,1546,2.38%,0.71%
2020-01-01 00:07:50,14,10,4096,120,3976,6.25%,2.93%
2020-01-01 00:07:50,14,11,28100,5379,22721,42.88%,19.14%
2020-01-01 00:07:50,14,12,9543,694,8849,14.56%,7.27%
2020-01-01 00:07:50,15,1,534,3,531,0.81%,0.56%
2020-01-01 00:07:50,15,2,122,0,122,0.19%,0.00%
2020-01-01 00:07:50,15,3,10806,867,9939,16.49%,8.02%
2020-01-01 00:07:50,15,4,4813,196,4617,7.34%,4.07%
2020-01-01 00:07:50,15,5,16555,1976,14579,25.26%,11.94%
2020-01-01 00:07:50,15,6,5110,255,4855,7.80%,4.99%
2020-01-01 00:07:50,15,7,3060,87,2973,4.67%,2.84%
2020-01-01 00:07:50,15,8,4995,190,4805,7.62%,3.80%
2020-01-01 00:07:50,15,9,16741,2018,14723,25.54%,12.05%
2020-01-01 00:07:50,15,10,4512,453,4059,6.88%,10.04%
2020-01-01 00:07:50,15,11,9673,959,8714,14.76%,9.91%
2020-01-01 00:07:50,15,12,32290,7216,25074,49.27%,22.35%
2020-01-01 00:07:50,16,1,427,3,424,0.65%,0.70%
2020-01-01 00:07:50,16,2,241,0,241,0.37%,0.00%
2020-01-01 00:07:50,16,3,1834,22,1812,2.80%,1.20%
2020-01-01 00:07:50,16,4,5059,195,4864,7.72%,3.85%
2020-01-01 00:07:50,16,5,9189,659,8530,14.02%,7.17%
2020-01-01 00:07:50,16,6,5877,253,5624,8.97%,4.30%
2020-01-01 00:07:50,16,7,3297,78,3219,5.03%,2.37%
2020-01-01 00:07:50,16,8,7655,480,7175,11.68%,6.27%
2020-01-01 00:07:50,16,9,9713,715,8998,14.82%,7.36%
2020-01-01 00:07:50,16,10,1603,24,1579,2.45%,1.50%
2020-01-01 00:07:50,16,11,9482,721,8761,14.47%,7.60%
2020-01-01 00:07:50,16,12,27424,5154,22270,41.85%,18.79%
2020-01-01 00:08:00,1,1,15701,1830,13871,23.96%,11.65%
2020-01-01 00:08:00,1,2,5053,222,4831,7.71%,4.39%
2020-01-01 00:08:00,1,3,395,0,395,0.60%,0.00%
2020-01-01 00:08:00,1,4,10406,839,9567,15.88%,8.06%
2020-01-01 00:08:00,1,5,10080,793,9287,15.38%,7.87%
2020-01-01 00:08:00,1,6,10085,794,9291,15.39%,7.87%
2020-01-01 00:08:00,1,7,4627,190,4437,7.06%,4.11%
2020-01-01 00:08:00,1,8,3899,124,3775,5.95%,3.18%
2020-01-01 00:08:00,1,9,10043,790,9253,15.32%,7.87%
2020-01-01 00:08:00,1,10,3247,86,3161,4.95%,2.65%
2020-01-01 00:08:00,1,11,3365,92,3273,5.13%,2.73%
2020-01-01 00:08:00,1,12,10025,788,9237,15.30%,7.86%
2020-01-01 00:08:00,2,1,540,1,539,0.82%,0.18%
2020-01-01 00:08:00,2,2,41630,10803,30827,63.52%,25.95%
2020-01-01 00:08:00,2,3,28597,5440,23157,43.64%,19.02%
2020-01-01 00:08:00,2,4,439,1,438,0.67%,0.23%
2020-01-01 00:08:00,2,5,17347,2062,15285,26.47%,11.89%
2020-01-01 00:08:00,2,6,53,0,53,0.08%,0.00%
2020-01-01 00:08:00,2,7,12477,1114,11363,19.04%,8.93%
2020-01-01 00:08:00,2,8,10727,834,9893,16.37%,7.77%
2020-01-01 00:08:00,2,9,16918,1961,14957,25.81%,11.59%
2020-01-01 00:08:00,2,10,10031,729,9302,15.31%,7.27%
2020-01-01 00:08:00,2,11,10036,731,9305,15.31%,7.28%
2020-01-01 00:08:00,2,12,16775,1931,14844,25.60%,11.51%
2020-01-01 00:08:00,3,1,1469,20,1449,2.24%,1.36%
2020-01-01 00:08:00,3,2,26433,4650,21783,40.33%,17.59%
2020-01-01 00:08:00,3,3,65640,24146,41494,100.16%,36.78%
2020-01-01 00:08:00,3,4,6890,364,6526,10.51%,5.28%
2020-01-01 00:08:00,3,5,38221,9199,29022,58.32%,24.07%
2020-01-01 00:08:00,3,6,8751,572,8179,13.35%,6.54%
2020-01-01 00:08:00,3,7,22663,3415,19248,34.58%,15.07%
2020-01-01 00:08:00,3,8,17668,2155,15513,26.96%,12.20%
2020-01-01 00:08:00,3,9,28655,5425,23230,43.72%,18.93%
2020-01-01 00:08:00,3,10,6226,258,5968,9.50%,4.14%
2020-01-01 00:08:00,3,11,2085,31,2054,3.18%,1.49%
2020-01-01 00:08:00,3,12,20523,2893,17630,31.32%,14.10%
2020-01-01 00:08:00,4,1,497,2,495,0.76%,0.40%
2020-01-01 00:08:00,4,2,291,1,290,0.44%,0.34%
2020-01-01 00:08:00,4,3,931,4,927,1.42%,0.43%
2020-01-01 00:08:00,4,4,26236,4639,21597,40.03%,17.68%
2020-01-01 00:08:00,4,5,17411,2146,15265,26.57%,12.32%
2020-01-01 00:08:00,4,6,22661,3540,19121,34.58%,15.62%
2020-01-01 00:08:00,4,7,4026,121,3905,6.14%,3.00%
2020-01-01 00:08:00,4,8,2717,65,2652,4.15%,2.39%
2020-01-01 00:08:00,4,9,15367,1665,13702,23.45%,10.83%
2020-01-01 00:08:00,4,10,1759,21,1738,2.68%,1.19%
2020-01-01 00:08:00,4,11,87,0,87,0.13%,0.00%
2020-01-01 00:08:00,4,12,12768,1188,11580,19.48%,9.30%
2020-01-01 00:08:00,5,1,2712,56,2656,4.14%,2.06%
2020-01-01 00:08:00,5,2,819,5,814,1.25%,0.61%
2020-01-01 00:08:00,5,3,1225,6,1219,1.87%,0.49%
2020-01-01 00:08:00,5,4,23415,3697,19718,35.73%,15.79%
2020-01-01 00:08:00,5,5,10237,765,9472,15.62%,7.47%
2020-01-01 00:08:00,5,6,15931,1797,14134,24.31%,11.28%
2020-01-01 00:08:00,5,7,5225,227,4998,7.97%,4.34%
2020-01-01 00:08:00,5,8,4367,161,4206,6.66%,3.69%
2020-01-01 00:08:00,5,9,8878,562,8316,13.55%,6.33%
2020-01-01 00:08:00,5,10,1187,15,1172,1.81%,1.26%
2020-01-01 00:08:00,5,11,894,9,885,1.36%,1.01%
2020-01-01 00:08:00,5,12,7384,393,6991,11.27%,5.32%
2020-01-01 00:08:00,6,1,1152,16,1136,1.76%,1.39%
2020-01-01 00:08:00,6,2,1244,19,1225,1.90%,1.53%
2020-01-01 00:08:00,6,3,1446,23,1423,2.21%,1.59%
2020-01-01 00:08:00,6,4,1389,7,1382,2.12%,0.50%
2020-01-01 00:08:00,6,5,15484,1642,13842,23.63%,10.60%
2020-01-01 00:08:00,6,6,4255,123,4132,6.49%,2.89%
2020-01-01 00:08:00,6,7,2349,37,2312,3.58%,1.57%
2020-01-01 00:08:00,6,8,1763,27,1736,2.69%,1.53%
2020-01-01 00:08:00,6,9,9434,630,8804,14.40%,6.68%
2020-01-01 00:08:00,6,10,2125,40,2085,3.24%,1.88%
2020-01-01 00:08:00,6,11,479,2,477,0.73%,0.42%
2020-01-01 00:08:00,6,12,7185,350,6835,10.96%,4.87%
2020-01-01 00:08:00,7,1,535,1,534,0.82%,0.19%
2020-01-01 00:08:00,7,2,145,1,144,0.22%,0.68%
2020-01-01 00:08:00,7,3,915,2,913,1.40%,0.22%
2020-01-01 00:08:00,7,4,1899,31,1868,2.90%,1.63%
2020-01-01 00:08:00,7,5,6628,285,6343,10.11%,4.30%
2020-01-01 00:08:00,7,6,12229,1022,11207,18.66%,8.36%
2020-01-01 00:08:00,7,7,3656,133,3523,5.58%,3.64%
2020-01-01 00:08:00,7,8,1501,8,1493,2.29%,0.53%
2020-01-01 00:08:00,7,9,5673,215,5458,8.66%,3.79%
2020-01-01 00:08:00,7,10,935,7,928,1.43%,0.75%
2020-01-01 00:08:00,7,11,208,0,208,0.32%,0.00%
2020-01-01 00:08:00,7,12,4694,149,4545,7.16%,3.17%
2020-01-01 00:08:00,8,1,376,2,374,0.57%,0.53%
2020-01-01 00:08:00,8,2,60,0,60,0.09%,0.00%
2020-01-01 00:08:00,8,3,1627,18,1609,2.48%,1.11%
2020-01-01 00:08:00,8,4,2517,56,2461,3.84%,2.22%
2020-01-01 00:08:00,8,5,7575,405,7170,11.56%,5.35%
2020-01-01 00:08:00,8,6,14743,1535,13208,22.50%,10.41%
2020-01-01 00:08:00,8,7,4557,137,4420,6.95%,3.01%
2020-01-01 00:08:00,8,8,1668,20,1648,2.55%,1.20%
2020-01-01 00:08:00,8,9,5797,242,5555,8.85%,4.17%
2020-01-01 00:08:00,8,10,1731,25,1706,2.64%,1.44%
2020-01-01 00:08:00,8,11,323,0,323,0.49%,0.00%
2020-01-01 00:08:00,8,12,3981,115,3866,6.07%,2.89%
2020-01-01 00:08:00,9,1,266,1,265,0.41%,0.37%
2020-01-01 00:08:00,9,2,3233,80,3153,4.93%,2.47%
2020-01-01 00:08:00,9,3,2605,52,2553,3.97%,2.00%
2020-01-01 00:08:00,9,4,11757,981,10776,17.94%,8.34%
2020-01-01 00:08:00,9,5,217,0,217,0.33%,0.00%
2020-01-01 00:08:00,9,6,12183,1049,11134,18.59%,8.61%
2020-01-01 00:08:00,9,7,32023,6758,25265,48.86%,21.10%
2020-01-01 00:08:00,9,8,10887,895,9992,16.61%,8.22%
2020-01-01 00:08:00,9,9,176,0,176,0.27%,0.00%
2020-01-01 00:08:00,9,10,4181,127,4054,6.38%,3.04%
2020-01-01 00:08:00,9,11,9687,715,8972,14.78%,7.38%
2020-01-01 00:08:00,9,12,5203,211,4992,7.94%,4.05%
2020-01-01 00:08:00,10,1,932,311,621,1.42%,33.33%
2020-01-01 00:08:00,10,2,4032,407,3625,6.15%,10.09%
2020-01-01 00:08:00,10,3,2903,58,2845,4.43%,2.00%
2020-01-01 00:08:00,10,4,4041,1067,2974,6.17%,26.40%
2020-01-01 00:08:00,10,5,643,14,629,0.98%,2.17%
2020-01-01 00:08:00,10,6,5831,1190,4641,8.90%,20.40%
2020-01-01 00:08:00,10,7,11763,2100,9663,17.95%,17.85%
2020-01-01 00:08:00,10,8,27237,6637,20600,41.56%,24.37%
2020-01-01 00:08:00,10,9,690,3,687,1.05%,0.43%
2020-01-01 00:08:00,10,10,2646,57,2589,4.04%,2.15%
2020-01-01 00:08:00,10,11,12049,1352,10697,18.39%,11.22%
2020-01-01 00:08:00,10,12,8889,866,8023,13.56%,9.74%
2020-01-01 00:08:00,11,1,2494,55,2439,3.81%,2.20%
2020-01-01 00:08:00,11,2,3927,134,3793,5.99%,3.41%
2020-01-01 00:08:00,11,3,1290,13,1277,1.97%,1.01%
2020-01-01 00:08:00,11,4,7142,373,6769,10.90%,5.22%
2020-01-01 00:08:00,11,5,209,2,207,0.32%,0.95%
2020-01-01 00:08:00,11,6,7969,467,7502,12.16%,5.86%
2020-01-01 00:08:00,11,7,14040,1419,12621,21.42%,10.11%
2020-01-01 00:08:00,11,8,28511,5443,23068,43.50%,19.09%
2020-01-01 00:08:00,11,9,330,0,330,0.50%,0.00%
2020-01-01 00:08:00,11,10,3532,89,3443,5.39%,2.52%
2020-01-01 00:08:00,11,11,10171,726,9445,15.52%,7.14%
2020-01-01 00:08:00,11,12,6309,295,6014,9.63%,4.68%
2020-01-01 00:08:00,12,1,17,0,17,0.03%,0.00%
2020-01-01 00:08:00,12,2,654,251,403,1.00%,38.32%
2020-01-01 00:08:00,12,3,3172,301,2871,4.84%,9.49%
2020-01-01 00:08:00,12,4,3655,96,3559,5.58%,2.63%
2020-01-01 00:08:00,12,5,10252,931,9321,15.64%,9.08%
2020-01-01 00:08:00,12,6,6165,256,5909,9.41%,4.15%
2020-01-01 00:08:00,12,7,2402,29,2373,3.67%,1.21%
2020-01-01 00:08:00,12,8,1283,201,1082,1.96%,15.65%
2020-01-01 00:08:00,12,9,24340,4743,19597,37.14%,19.49%
2020-01-01 00:08:00,12,10,3706,281,3425,5.65%,7.58%
2020-01-01 00:08:00,12,11,1539,205,1334,2.35%,13.31%
2020-01-01 00:08:00,12,12,9651,1179,8472,14.73%,12.22%
2020-01-01 00:08:00,13,1,2386,45,2341,3.64%,1.89%
2020-01-01 00:08:00,13,2,2686,57,2629,4.10%,2.12%
2020-01-01 00:08:00,13,3,1000,7,993,1.53%,0.70%
2020-01-01 00:08:00,13,4,5339,489,4850,8.15%,9.16%
2020-01-01 00:08:00,13,5,7590,792,6798,11.58%,10.43%
2020-01-01 00:08:00,13,6,5939,536,5403,9.06%,9.02%
2020-01-01 00:08:00,13,7,4730,176,4554,7.22%,3.72%
2020-01-01 00:08:00,13,8,6845,384,6461,10.44%,5.61%
2020-01-01 00:08:00,13,9,7883,825,7058,12.03%,10.46%
2020-01-01 00:08:00,13,10,26950,5384,21566,41.12%,19.98%
2020-01-01 00:08:00,13,11,16574,2180,14394,25.29%,13.15%
2020-01-01 00:08:00,13,12,9407,893,8514,14.35%,9.49%
2020-01-01 00:08:00,14,1,414,0,414,0.63%,0.00%
2020-01-01 00:08:00,14,2,2054,55,1999,3.13%,2.68%
2020-01-01 00:08:00,14,3,1419,31,1388,2.17%,2.18%
2020-01-01 00:08:00,14,4,4306,136,4170,6.57%,3.16%
2020-01-01 00:08:00,14,5,1451,25,1426,2.21%,1.72%
2020-01-01 00:08:00,14,6,4581,153,4428,6.99%,3.34%
2020-01-01 00:08:00,14,7,11321,942,10379,17.27%,8.32%
2020-01-01 00:08:00,14,8,13230,1256,11974,20.19%,9.49%
2020-01-01 00:08:00,14,9,1665,30,1635,2.54%,1.80%
2020-01-01 00:08:00,14,10,3952,141,3811,6.03%,3.57%
2020-01-01 00:08:00,14,11,23766,3897,19869,36.26%,16.40%
2020-01-01 00:08:00,14,12,6332,307,6025,9.66%,4.85%
2020-01-01 00:08:00,15,1,463,2,461,0.71%,0.43%
2020-01-01 00:08:00,15,2,245,1,244,0.37%,0.41%
2020-01-01 00:08:00,15,3,3544,113,3431,5.41%,3.19%
2020-01-01 00:08:00,15,4,4865,182,4683,7.42%,3.74%
2020-01-01 00:08:00,15,5,9283,754,8529,14.16%,8.12%
2020-01-01 00:08:00,15,6,5081,196,4885,7.75%,3.86%
2020-01-01 00:08:00,15,7,3383,108,3275,5.16%,3.19%
2020-01-01 00:08:00,15,8,5217,220,4997,7.96%,4.22%
2020-01-01 00:08:00,15,9,9422,770,8652,14.38%,8.17%
2020-01-01 00:08:00,15,10,5008,334,4674,7.64%,6.67%
2020-01-01 00:08:00,15,11,10326,932,9394,15.76%,9.02%
2020-01-01 00:08:00,15,12,25559,4842,20717,39.00%,18.94%
2020-01-01 00:08:00,16,1,499,0,499,0.76%,0.00%
2020-01-01 00:08:00,16,2,213,1,212,0.33%,0.47%
2020-01-01 00:08:00,16,3,1453,14,1439,2.22%,0.96%
2020-01-01 00:08:00,16,4,4513,143,4370,6.89%,3.17%
2020-01-01 00:08:00,16,5,8142,628,7514,12.42%,7.71%
2020-01-01 00:08:00,16,6,5363,235,5128,8.18%,4.38%
2020-01-01 00:08:00,16,7,2914,60,2854,4.45%,2.06%
2020-01-01 00:08:00,16,8,6633,350,6283,10.12%,5.28%
2020-01-01 00:08:00,16,9,8584,669,7915,13.10%,7.79%
2020-01-01 00:08:00,16,10,2281,42,2239,3.48%,1.84%
2020-01-01 00:08:00,16,11,9097,631,8466,13.88%,6.94%
2020-01-01 00:08:00,16,12,26537,4924,21613,40.49%,18.55%
2020-01-01 00:08:10,1,1,20319,2806,17513,31.00%,13.81%
2020-01-01 00:08:10,1,2,7472,417,7055,11.40%,5.58%
2020-01-01 00:08:10,1,3,586,3,583,0.89%,0.51%
2020-01-01 00:08:10,1,4,12314,1101,11213,18.79%,8.94%
2020-01-01 00:08:10,1,5,12060,1060,11000,18.40%,8.79%
2020-01-01 00:08:10,1,6,12016,1052,10964,18.33%,8.75%
2020-01-01 00:08:10,1,7,6874,347,6527,10.49%,5.05%
2020-01-01 00:08:10,1,8,4169,121,4048,6.36%,2.90%
2020-01-01 00:08:10,1,9,11927,1037,10890,18.20%,8.69%
2020-01-01 00:08:10,1,10,3228,69,3159,4.93%,2.14%
2020-01-01 00:08:10,1,11,3335,82,3253,5.09%,2.46%
2020-01-01 00:08:10,1,12,11901,1034,10867,18.16%,8.69%
2020-01-01 00:08:10,2,1,448,3,445,0.68%,0.67%
2020-01-01 00:08:10,2,2,27050,4960,22090,41.28%,18.34%
2020-01-01 00:08:10,2,3,22467,3483,18984,34.28%,15.50%
2020-01-01 00:08:10,2,4,378,2,376,0.58%,0.53%
2020-01-01 00:08:10,2,5,12543,1155,11388,19.14%,9.21%
2020-01-01 00:08:10,2,6,33,0,33,0.05%,0.00%
2020-01-01 00:08:10,2,7,4123,142,3981,6.29%,3.44%
2020-01-01 00:08:10,2,8,3185,77,3108,4.86%,2.42%
2020-01-01 00:08:10,2,9,12479,1138,11341,19.04%,9.12%
2020-01-01 00:08:10,2,10,2152,33,2119,3.28%,1.53%
2020-01-01 00:08:10,2,11,2158,34,2124,3.29%,1.57%
2020-01-01 00:08:10,2,12,12313,1110,11203,18.79%,9.01%
2020-01-01 00:08:10,3,1,1852,31,1821,2.83%,1.67%
2020-01-01 00:08:10,3,2,22456,3467,18989,34.27%,15.44%
2020-01-01 00:08:10,3,3,66479,24802,41677,101.44%,37.31%
2020-01-01 00:08:10,3,4,11948,986,10962,18.23%,8.25%
2020-01-01 00:08:10,3,5,42789,11308,31481,65.29%,26.43%
2020-01-01 00:08:10,3,6,13226,1201,12025,20.18%,9.08%
2020-01-01 00:08:10,3,7,18973,2473,16500,28.95%,13.03%
2020-01-01 00:08:10,3,8,15136,1605,13531,23.10%,10.60%
2020-01-01 00:08:10,3,9,29077,5577,23500,44.37%,19.18%
2020-01-01 00:08:10,3,10,6099,262,5837,9.31%,4.30%
2020-01-01 00:08:10,3,11,1979,29,1950,3.02%,1.46%
2020-01-01 00:08:10,3,12,21204,3079,18125,32.35%,14.52%
2020-01-01 00:08:10,4,1,576,6,570,0.88%,1.04%
2020-01-01 00:08:10,4,2,331,2,329,0.51%,0.60%
2020-01-01 00:08:10,4,3,987,4,983,1.51%,0.40%
2020-01-01 00:08:10,4,4,30348,6110,24238,46.31%,20.13%
2020-01-01 00:08:10,4,5,18230,2332,15898,27.82%,12.79%
2020-01-01 00:08:10,4,6,25125,4288,20837,38.34%,17.07%
2020-01-01 00:08:10,4,7,5248,208,5040,8.01%,3.96%
2020-01-01 00:08:10,4,8,2951,76,2875,4.50%,2.57%
2020-01-01 00:08:10,4,9,16044,1834,14210,24.48%,11.43%
2020-01-01 00:08:10,4,10,2255,39,2216,3.44%,1.73%
2020-01-01 00:08:10,4,11,234,1,233,0.36%,0.43%
2020-01-01 00:08:10,4,12,12936,1181,11755,19.74%,9.13%
2020-01-01 00:08:10,5,1,3139,72,3067,4.79%,2.29%
2020-01-01 00:08:10,5,2,849,3,846,1.30%,0.35%
2020-01-01 00:08:10,5,3,489,2,487,0.75%,0.41%
2020-01-01 00:08:10,5,4,21442,3177,18265,32.72%,14.82%
2020-01-01 00:08:10,5,5,8309,511,7798,12.68%,6.15%
2020-01-01 00:08:10,5,6,13466,1245,12221,20.55%,9.24%
2020-01-01 00:08:10,5,7,4532,148,4384,6.92%,3.26%
2020-01-01 00:08:10,5,8,3454,72,3382,5.27%,2.08%
2020-01-01 00:08:10,5,9,7694,442,7252,11.74%,5.74%
2020-01-01 00:08:10,5,10,1000,10,990,1.53%,1.00%
2020-01-01 00:08:10,5,11,413,2,411,0.63%,0.48%
2020-01-01 00:08:10,5,12,6440,324,6116,9.83%,5.03%
2020-01-01 00:08:10,6,1,1209,7,1202,1.84%,0.58%
2020-01-01 00:08:10,6,2,1278,8,1270,1.95%,0.63%
2020-01-01 00:08:10,6,3,1663,14,1649,2.54%,0.84%
2020-01-01 00:08:10,6,4,1434,12,1422,2.19%,0.84%
2020-01-01 00:08:10,6,5,13139,1230,11909,20.05%,9.36%
2020-01-01 00:08:10,6,6,4218,127,4091,6.44%,3.01%
2020-01-01 00:08:10,6,7,2405,44,2361,3.67%,1.83%
2020-01-01 00:08:10,6,8,1709,21,1688,2.61%,1.23%
2020-01-01 00:08:10,6,9,6947,358,6589,10.60%,5.15%
2020-01-01 00:08:10,6,10,2193,41,2152,3.35%,1.87%
2020-01-01 00:08:10,6,11,501,2,499,0.76%,0.40%
2020-01-01 00:08:10,6,12,4685,152,4533,7.15%,3.24%
2020-01-01 00:08:10,7,1,617,4,613,0.94%,0.65%
2020-01-01 00:08:10,7,2,600,1,599,0.92%,0.17%
2020-01-01 00:08:10,7,3,708,3,705,1.08%,0.42%
2020-01-01 00:08:10,7,4,2631,52,2579,4.01%,1.98%
2020-01-01 00:08:10,7,5,7154,372,6782,10.92%,5.20%
2020-01-01 00:08:10,7,6,13487,1284,12203,20.58%,9.52%
2020-01-01 00:08:10,7,7,3631,82,3549,5.54%,2.26%
2020-01-01 00:08:10,7,8,1243,13,1230,1.90%,1.05%
2020-01-01 00:08:10,7,9,6400,323,6077,9.77%,5.05%
2020-01-01 00:08:10,7,10,1071,3,1068,1.63%,0.28%
2020-01-01 00:08:10,7,11,73,0,73,0.11%,0.00%
2020-01-01 00:08:10,7,12,5275,230,5045,8.05%,4.36%
2020-01-01 00:08:10,8,1,516,4,512,0.79%,0.77%
2020-01-01 00:08:10,8,2,71,4,67,0.11%,5.56%
2020-01-01 00:08:10,8,3,2083,29,2054,3.18%,1.39%
2020-01-01 00:08:10,8,4,2968,71,2897,4.53%,2.39%
2020-01-01 00:08:10,8,5,8800,565,8235,13.43%,6.42%
2020-01-01 00:08:10,8,6,17719,2246,15473,27.04%,12.67%
2020-01-01 00:08:10,8,7,5792,278,5514,8.84%,4.80%
2020-01-01 00:08:10,8,8,1838,32,1806,2.80%,1.74%
2020-01-01 00:08:10,8,9,6460,297,6163,9.86%,4.60%
2020-01-01 00:08:10,8,10,1905,26,1879,2.91%,1.36%
2020-01-01 00:08:10,8,11,79,0,79,0.12%,0.00%
2020-01-01 00:08:10,8,12,4523,152,4371,6.90%,3.36%
2020-01-01 00:08:10,9,1,497,2,495,0.76%,0.40%
2020-01-01 00:08:10,9,2,2186,44,2142,3.34%,2.01%
2020-01-01 00:08:10,9,3,1381,30,1351,2.11%,2.17%
2020-01-01 00:08:10,9,4,3692,117,3575,5.63%,3.17%
2020-01-01 00:08:10,9,5,799,2,797,1.22%,0.25%
2020-01-01 00:08:10,9,6,5150,220,4930,7.86%,4.27%
2020-01-01 00:08:10,9,7,25856,4555,21301,39.45%,17.62%
2020-01-01 00:08:10,9,8,12303,1073,11230,18.77%,8.72%
2020-01-01 00:08:10,9,9,752,2,750,1.15%,0.27%
2020-01-01 00:08:10,9,10,3568,90,3478,5.44%,2.52%
2020-01-01 00:08:10,9,11,9816,671,9145,14.98%,6.84%
2020-01-01 00:08:10,9,12,5905,264,5641,9.01%,4.47%
2020-01-01 00:08:10,10,1,1692,289,1403,2.58%,17.07%
2020-01-01 00:08:10,10,2,3419,346,3073,5.22%,10.12%
2020-01-01 00:08:10,10,3,1596,27,1569,2.44%,1.69%
2020-01-01 00:08:10,10,4,4228,1186,3042,6.45%,28.04%
2020-01-01 00:08:10,10,5,1035,112,923,1.58%,10.81%
2020-01-01 00:08:10,10,6,6523,1444,5079,9.95%,22.13%
2020-01-01 00:08:10,10,7,11490,2253,9237,17.53%,19.61%
2020-01-01 00:08:10,10,8,33233,9321,23912,50.71%,28.05%
2020-01-01 00:08:10,10,9,532,3,529,0.81%,0.56%
2020-01-01 00:08:10,10,10,3362,71,3291,5.13%,2.11%
2020-01-01 00:08:10,10,11,16349,2425,13924,24.95%,14.83%
2020-01-01 00:08:10,10,12,12123,1618,10505,18.50%,13.35%
2020-01-01 00:08:10,11,1,3055,71,2984,4.66%,2.32%
2020-01-01 00:08:10,11,2,3950,119,3831,6.03%,3.01%
2020-01-01 00:08:10,11,3,697,3,694,1.06%,0.43%
2020-01-01 00:08:10,11,4,5582,252,5330,8.52%,4.51%
2020-01-01 00:08:10,11,5,197,0,197,0.30%,0.00%
2020-01-01 00:08:10,11,6,6471,326,6145,9.87%,5.04%
2020-01-01 00:08:10,11,7,12255,1070,11185,18.70%,8.73%
2020-01-01 00:08:10,11,8,26825,4775,22050,40.93%,17.80%
2020-01-01 00:08:10,11,9,217,2,215,0.33%,0.92%
2020-01-01 00:08:10,11,10,2872,61,2811,4.38%,2.12%
2020-01-01 00:08:10,11,11,10838,877,9961,16.54%,8.09%
2020-01-01 00:08:10,11,12,7393,453,6940,11.28%,6.13%
2020-01-01 00:08:10,12,1,45,0,45,0.07%,0.00%
2020-01-01 00:08:10,12,2,562,175,387,0.86%,31.08%
2020-01-01 00:08:10,12,3,2633,216,2417,4.02%,8.20%
2020-01-01 00:08:10,12,4,3225,151,3074,4.92%,4.68%
2020-01-01 00:08:10,12,5,8595,756,7839,13.11%,8.79%
2020-01-01 00:08:10,12,6,5208,277,4931,7.95%,5.32%
2020-01-01 00:08:10,12,7,1812,26,1786,2.76%,1.43%
2020-01-01 00:08:10,12,8,1849,359,1490,2.82%,19.41%
2020-01-01 00:08:10,12,9,22793,4714,18079,34.78%,20.68%
2020-01-01 00:08:10,12,10,5584,552,5032,8.52%,9.88%
2020-01-01 00:08:10,12,11,2220,365,1855,3.39%,16.43%
2020-01-01 00:08:10,12,12,7712,1320,6392,11.77%,17.11%
2020-01-01 00:08:10,13,1,2040,37,2003,3.11%,1.81%
2020-01-01 00:08:10,13,2,2333,52,2281,3.56%,2.23%
2020-01-01 00:08:10,13,3,1053,3,1050,1.61%,0.28%
2020-01-01 00:08:10,13,4,5049,513,4536,7.70%,10.16%
2020-01-01 00:08:10,13,5,7447,812,6635,11.36%,10.90%
2020-01-01 00:08:10,13,6,5556,553,5003,8.48%,9.95%
2020-01-01 00:08:10,13,7,4471,163,4308,6.82%,3.64%
2020-01-01 00:08:10,13,8,8376,516,7860,12.78%,6.16%
2020-01-01 00:08:10,13,9,7740,848,6892,11.81%,10.95%
2020-01-01 00:08:10,13,10,28315,5857,22458,43.21%,20.68%
2020-01-01 00:08:10,13,11,17315,2399,14916,26.42%,13.85%
2020-01-01 00:08:10,13,12,8641,944,7697,13.19%,10.92%
2020-01-01 00:08:10,14,1,295,0,295,0.45%,0.00%
2020-01-01 00:08:10,14,2,1679,18,1661,2.56%,1.07%
2020-01-01 00:08:10,14,3,1191,11,1180,1.82%,0.92%
2020-01-01 00:08:10,14,4,4386,164,4222,6.69%,3.74%
2020-01-01 00:08:10,14,5,1495,26,1469,2.28%,1.74%
2020-01-01 00:08:10,14,6,4682,189,4493,7.14%,4.04%
2020-01-01 00:08:10,14,7,12911,1187,11724,19.70%,9.19%
2020-01-01 00:08:10,14,8,14458,1452,13006,22.06%,10.04%
2020-01-01 00:08:10,14,9,1729,30,1699,2.64%,1.73%
2020-01-01 00:08:10,14,10,4174,134,4040,6.37%,3.21%
2020-01-01 00:08:10,14,11,29469,5627,23842,44.97%,19.09%
2020-01-01 00:08:10,14,12,10416,748,9668,15.89%,7.18%
2020-01-01 00:08:10,15,1,562,2,560,0.86%,0.36%
2020-01-01 00:08:10,15,2,102,0,102,0.16%,0.00%
2020-01-01 00:08:10,15,3,3981,134,3847,6.07%,3.37%
2020-01-01 00:08:10,15,4,4728,212,4516,7.21%,4.48%
2020-01-01 00:08:10,15,5,9427,695,8732,14.38%,7.37%
2020-01-01 00:08:10,15,6,4919,222,4697,7.51%,4.51%
2020-01-01 00:08:10,15,7,4039,121,3918,6.16%,3.00%
2020-01-01 00:08:10,15,8,6113,294,5819,9.33%,4.81%
2020-01-01 00:08:10,15,9,9626,717,8909,14.69%,7.45%
2020-01-01 00:08:10,15,10,5268,415,4853,8.04%,7.88%
2020-01-01 00:08:10,15,11,11532,1161,10371,17.60%,10.07%
2020-01-01 00:08:10,15,12,26778,5360,21418,40.86%,20.02%
2020-01-01 00:08:10,16,1,563,0,563,0.86%,0.00%
2020-01-01 00:08:10,16,2,221,0,221,0.34%,0.00%
2020-01-01 00:08:10,16,3,1255,13,1242,1.91%,1.04%
2020-01-01 00:08:10,16,4,4159,109,4050,6.35%,2.62%
2020-01-01 00:08:10,16,5,7733,474,7259,11.80%,6.13%
2020-01-01 00:08:10,16,6,5507,220,5287,8.40%,3.99%
2020-01-01 00:08:10,16,7,3557,93,3464,5.43%,2.61%
2020-01-01 00:08:10,16,8,7151,470,6681,10.91%,6.57%
2020-01-01 00:08:10,16,9,8295,537,7758,12.66%,6.47%
2020-01-01 00:08:10,16,10,2490,48,2442,3.80%,1.93%
2020-01-01 00:08:10,16,11,9965,801,9164,15.21%,8.04%
2020-01-01 00:08:10,16,12,26749,4747,22002,40.82%,17.75%
2020-01-01 00:08:20,1,1,15601,1764,13837,23.81%,11.31%
2020-01-01 00:08:20,1,2,5925,278,5647,9.04%,4.69%
2020-01-01 00:08:20,1,3,494,1,493,0.75%,0.20%
2020-01-01 00:08:20,1,4,9398,659,8739,14.34%,7.01%
2020-01-01 00:08:20,1,5,9313,650,8663,14.21%,6.98%
2020-01-01 00:08:20,1,6,9187,635,8552,14.02%,6.91%
2020-01-01 00:08:20,1,7,5406,238,5168,8.25%,4.40%
2020-01-01 00:08:20,1,8,4446,155,4291,6.78%,3.49%
2020-01-01 00:08:20,1,9,9147,627,8520,13.96%,6.85%
2020-01-01 00:08:20,1,10,3800,94,3706,5.80%,2.47%
2020-01-01 00:08:20,1,11,4014,122,3892,6.12%,3.04%
2020-01-01 00:08:20,1,12,9111,618,8493,13.90%,6.78%
2020-01-01 00:08:20,2,1,555,2,553,0.85%,0.36%
2020-01-01 00:08:20,2,2,26232,4605,21627,40.03%,17.55%
2020-01-01 00:08:20,2,3,20183,2785,17398,30.80%,13.80%
2020-01-01 00:08:20,2,4,444,1,443,0.68%,0.22%
2020-01-01 00:08:20,2,5,9900,734,9166,15.11%,7.41%
2020-01-01 00:08:20,2,6,79,0,79,0.12%,0.00%
2020-01-01 00:08:20,2,7,5472,210,5262,8.35%,3.84%
2020-01-01 00:08:20,2,8,4014,112,3902,6.12%,2.79%
2020-01-01 00:08:20,2,9,9797,720,9077,14.95%,7.35%
2020-01-01 00:08:20,2,10,3141,70,3071,4.79%,2.23%
2020-01-01 00:08:20,2,11,3155,70,3085,4.81%,2.22%
2020-01-01 00:08:20,2,12,9593,697,8896,14.64%,7.26%
2020-01-01 00:08:20,3,1,1429,16,1413,2.18%,1.12%
2020-01-01 00:08:20,3,2,23426,3655,19771,35.75%,15.60%
2020-01-01 00:08:20,3,3,69229,26467,42762,105.64%,38.23%
2020-01-01 00:08:20,3,4,11178,927,10251,17.06%,8.29%
2020-01-01 00:08:20,3,5,44646,12313,32333,68.12%,27.58%
2020-01-01 00:08:20,3,6,12758,1175,11583,19.47%,9.21%
2020-01-01 00:08:20,3,7,19779,2655,17124,30.18%,13.42%
2020-01-01 00:08:20,3,8,16035,1756,14279,24.47%,10.95%
2020-01-01 00:08:20,3,9,31499,6596,24903,48.06%,20.94%
2020-01-01 00:08:20,3,10,4965,183,4782,7.58%,3.69%
2020-01-01 00:08:20,3,11,1727,22,1705,2.64%,1.27%
2020-01-01 00:08:20,3,12,23901,3973,19928,36.47%,16.62%
2020-01-01 00:08:20,4,1,580,0,580,0.89%,0.00%
2020-01-01 00:08:20,4,2,320,0,320,0.49%,0.00%
2020-01-01 00:08:20,4,3,629,3,626,0.96%,0.48%
2020-01-01 00:08:20,4,4,28513,5462,23051,43.51%,19.16%
2020-01-01 00:08:20,4,5,17738,2192,15546,27.07%,12.36%
2020-01-01 00:08:20,4,6,24146,4007,20139,36.84%,16.59%
2020-01-01 00:08:20,4,7,5094,220,4874,7.77%,4.32%
2020-01-01 00:08:20,4,8,3081,77,3004,4.70%,2.50%
2020-01-01 00:08:20,4,9,16060,1807,14253,24.51%,11.25%
2020-01-01 00:08:20,4,10,2143,41,2102,3.27%,1.91%
2020-01-01 00:08:20,4,11,136,0,136,0.21%,0.00%
2020-01-01 00:08:20,4,12,12943,1206,11737,19.75%,9.32%
2020-01-01 00:08:20,5,1,2742,58,2684,4.18%,2.11%
2020-01-01 00:08:20,5,2,1347,17,1330,2.06%,1.26%
2020-01-01 00:08:20,5,3,704,7,697,1.07%,0.99%
2020-01-01 00:08:20,5,4,21944,3267,18677,33.48%,14.89%
2020-01-01 00:08:20,5,5,10248,788,9460,15.64%,7.69%
2020-01-01 00:08:20,5,6,15426,1683,13743,23.54%,10.91%
2020-01-01 00:08:20,5,7,4844,192,4652,7.39%,3.96%
2020-01-01 00:08:20,5,8,3781,120,3661,5.77%,3.17%
2020-01-01 00:08:20,5,9,9386,656,8730,14.32%,6.99%
2020-01-01 00:08:20,5,10,1062,15,1047,1.62%,1.41%
2020-01-01 00:08:20,5,11,809,5,804,1.23%,0.62%
2020-01-01 00:08:20,5,12,8117,487,7630,12.39%,6.00%
2020-01-01 00:08:20,6,1,1005,5,1000,1.53%,0.50%
2020-01-01 00:08:20,6,2,1066,7,1059,1.63%,0.66%
2020-01-01 00:08:20,6,3,1706,16,1690,2.60%,0.94%
2020-01-01 00:08:20,6,4,1773,23,1750,2.71%,1.30%
2020-01-01 00:08:20,6,5,15081,1678,13403,23.01%,11.13%
2020-01-01 00:08:20,6,6,4479,186,4293,6.83%,4.15%
2020-01-01 00:08:20,6,7,2292,77,2215,3.50%,3.36%
2020-01-01 00:08:20,6,8,1888,61,1827,2.88%,3.23%
2020-01-01 00:08:20,6,9,8448,508,7940,12.89%,6.01%
2020-01-01 00:08:20,6,10,2686,52,2634,4.10%,1.94%
2020-01-01 00:08:20,6,11,440,0,440,0.67%,0.00%
2020-01-01 00:08:20,6,12,5717,226,5491,8.72%,3.95%
2020-01-01 00:08:20,7,1,435,3,432,0.66%,0.69%
2020-01-01 00:08:20,7,2,139,0,139,0.21%,0.00%
2020-01-01 00:08:20,7,3,1194,17,1177,1.82%,1.42%
2020-01-01 00:08:20,7,4,1868,24,1844,2.85%,1.28%
2020-01-01 00:08:20,7,5,7854,455,7399,11.98%,5.79%
2020-01-01 00:08:20,7,6,12720,1162,11558,19.41%,9.13%
2020-01-01 00:08:20,7,7,2930,61,2869,4.47%,2.08%
2020-01-01 00:08:20,7,8,1214,7,1207,1.85%,0.58%
2020-01-01 00:08:20,7,9,6453,328,6125,9.85%,5.08%
2020-01-01 00:08:20,7,10,1212,12,1200,1.85%,0.99%
2020-01-01 00:08:20,7,11,85,0,85,0.13%,0.00%
2020-01-01 00:08:20,7,12,5183,218,4965,7.91%,4.21%
2020-01-01 00:08:20,8,1,486,1,485,0.74%,0.21%
2020-01-01 00:08:20,8,2,106,0,106,0.16%,0.00%
2020-01-01 00:08:20,8,3,1557,10,1547,2.38%,0.64%
2020-01-01 00:08:20,8,4,2903,68,2835,4.43%,2.34%
2020-01-01 00:08:20,8,5,8937,596,8341,13.64%,6.67%
2020-01-01 00:08:20,8,6,17205,2088,15117,26.25%,12.14%
2020-01-01 00:08:20,8,7,5313,222,5091,8.11%,4.18%
2020-01-01 00:08:20,8,8,2133,35,2098,3.25%,1.64%
2020-01-01 00:08:20,8,9,6987,378,6609,10.66%,5.41%
2020-01-01 00:08:20,8,10,2681,48,2633,4.09%,1.79%
2020-01-01 00:08:20,8,11,211,0,211,0.32%,0.00%
2020-01-01 00:08:20,8,12,4263,148,4115,6.50%,3.47%
2020-01-01 00:08:20,9,1,485,2,483,0.74%,0.41%
2020-01-01 00:08:20,9,2,1857,18,1839,2.83%,0.97%
2020-01-01 00:08:20,9,3,982,6,976,1.50%,0.61%
2020-01-01 00:08:20,9,4,7155,372,6783,10.92%,5.20%
2020-01-01 00:08:20,9,5,197,1,196,0.30%,0.51%
2020-01-01 00:08:20,9,6,7826,442,7384,11.94%,5.65%
2020-01-01 00:08:20,9,7,29323,5595,23728,44.74%,19.08%
2020-01-01 00:08:20,9,8,10644,800,9844,16.24%,7.52%
2020-01-01 00:08:20,9,9,144,1,143,0.22%,0.69%
2020-01-01 00:08:20,9,10,3492,57,3435,5.33%,1.63%
2020-01-01 00:08:20,9,11,9157,599,8558,13.97%,6.54%
2020-01-01 00:08:20,9,12,5326,222,5104,8.13%,4.17%
2020-01-01 00:08:20,10,1,1186,174,1012,1.81%,14.66%
2020-01-01 00:08:20,10,2,2826,206,2620,4.31%,7.29%
2020-01-01 00:08:20,10,3,1469,12,1457,2.24%,0.82%
2020-01-01 00:08:20,10,4,3724,713,3011,5.68%,19.14%
2020-01-01 00:08:20,10,5,760,5,755,1.16%,0.66%
2020-01-01 00:08:20,10,6,5730,834,4896,8.74%,14.55%
2020-01-01 00:08:20,10,7,10102,1445,8657,15.41%,14.30%
2020-01-01 00:08:20,10,8,30400,7540,22860,46.39%,24.80%
2020-01-01 00:08:20,10,9,930,4,926,1.42%,0.43%
2020-01-01 00:08:20,10,10,2850,65,2785,4.35%,2.28%
2020-01-01 00:08:20,10,11,15741,2190,13551,24.02%,13.91%
2020-01-01 00:08:20,10,12,12315,1592,10723,18.79%,12.93%
2020-01-01 00:08:20,11,1,2214,48,2166,3.38%,2.17%
2020-01-01 00:08:20,11,2,3182,73,3109,4.86%,2.29%
2020-01-01 00:08:20,11,3,825,3,822,1.26%,0.36%
2020-01-01 00:08:20,11,4,6155,319,5836,9.39%,5.18%
2020-01-01 00:08:20,11,5,156,0,156,0.24%,0.00%
2020-01-01 00:08:20,11,6,6909,393,6516,10.54%,5.69%
2020-01-01 00:08:20,11,7,12616,1170,11446,19.25%,9.27%
2020-01-01 00:08:20,11,8,26982,4919,22063,41.17%,18.23%
2020-01-01 00:08:20,11,9,182,0,182,0.28%,0.00%
2020-01-01 00:08:20,11,10,2824,68,2756,4.31%,2.41%
2020-01-01 00:08:20,11,11,9985,733,9252,15.24%,7.34%
2020-01-01 00:08:20,11,12,6662,328,6334,10.17%,4.92%
2020-01-01 00:08:20,12,1,87,0,87,0.13%,0.00%
2020-01-01 00:08:20,12,2,574,224,350,0.88%,38.96%
2020-01-01 00:08:20,12,3,3408,319,3089,5.20%,9.36%
2020-01-01 00:08:20,12,4,3131,107,3024,4.78%,3.42%
2020-01-01 00:08:20,12,5,10399,1000,9399,15.87%,9.62%
2020-01-01 00:08:20,12,6,6104,306,5798,9.31%,5.01%
2020-01-01 00:08:20,12,7,2770,60,2710,4.23%,2.17%
2020-01-01 00:08:20,12,8,1453,278,1175,2.22%,19.12%
2020-01-01 00:08:20,12,9,23471,4889,18582,35.81%,20.83%
2020-01-01 00:08:20,12,10,3877,372,3505,5.92%,9.59%
2020-01-01 00:08:20,12,11,1831,288,1543,2.79%,15.72%
2020-01-01 00:08:20,12,12,8312,1298,7014,12.68%,15.61%
2020-01-01 00:08:20,13,1,2873,73,2800,4.38%,2.54%
2020-01-01 00:08:20,13,2,3203,93,3110,4.89%,2.90%
2020-01-01 00:08:20,13,3,662,3,659,1.01%,0.45%
2020-01-01 00:08:20,13,4,5515,453,5062,8.42%,8.21%
2020-01-01 00:08:20,13,5,7495,710,6785,11.44%,9.47%
2020-01-01 00:08:20,13,6,6123,498,5625,9.34%,8.13%
2020-01-01 00:08:20,13,7,5931,264,5667,9.05%,4.45%
2020-01-01 00:08:20,13,8,7718,454,7264,11.78%,5.88%
2020-01-01 00:08:20,13,9,7845,745,7100,11.97%,9.50%
2020-01-01 00:08:20,13,10,28516,6038,22478,43.51%,21.17%
2020-01-01 00:08:20,13,11,17569,2658,14911,26.81%,15.13%
2020-01-01 00:08:20,13,12,9453,1146,8307,14.42%,12.12%
2020-01-01 00:08:20,14,1,339,2,337,0.52%,0.59%
2020-01-01 00:08:20,14,2,1443,38,1405,2.20%,2.63%
2020-01-01 00:08:20,14,3,905,24,881,1.38%,2.65%
2020-01-01 00:08:20,14,4,8290,540,7750,12.65%,6.51%
2020-01-01 00:08:20,14,5,1389,12,1377,2.12%,0.86%
2020-01-01 00:08:20,14,6,8499,561,7938,12.97%,6.60%
2020-01-01 00:08:20,14,7,16073,1859,14214,24.53%,11.57%
2020-01-01 00:08:20,14,8,17978,2300,15678,27.43%,12.79%
2020-01-01 00:08:20,14,9,1658,19,1639,2.53%,1.15%
2020-01-01 00:08:20,14,10,3906,102,3804,5.96%,2.61%
2020-01-01 00:08:20,14,11,29998,5976,24022,45.77%,19.92%
2020-01-01 00:08:20,14,12,7896,465,7431,12.05%,5.89%
2020-01-01 00:08:20,15,1,657,4,653,1.00%,0.61%
2020-01-01 00:08:20,15,2,192,0,192,0.29%,0.00%
2020-01-01 00:08:20,15,3,5340,227,5113,8.15%,4.25%
2020-01-01 00:08:20,15,4,4859,214,4645,7.41%,4.40%
2020-01-01 00:08:20,15,5,12038,1098,10940,18.37%,9.12%
2020-01-01 00:08:20,15,6,5090,232,4858,7.77%,4.56%
2020-01-01 00:08:20,15,7,3944,127,3817,6.02%,3.22%
2020-01-01 00:08:20,15,8,6706,347,6359,10.23%,5.17%
2020-01-01 00:08:20,15,9,12240,1125,11115,18.68%,9.19%
2020-01-01 00:08:20,15,10,3942,114,3828,6.02%,2.89%
2020-01-01 00:08:20,15,11,10807,863,9944,16.49%,7.98%
2020-01-01 00:08:20,15,12,28577,5666,22911,43.61%,19.83%
2020-01-01 00:08:20,16,1,351,1,350,0.54%,0.28%
2020-01-01 00:08:20,16,2,227,0,227,0.35%,0.00%
2020-01-01 00:08:20,16,3,1409,54,1355,2.15%,3.83%
2020-01-01 00:08:20,16,4,4520,167,4353,6.90%,3.69%
2020-01-01 00:08:20,16,5,8053,569,7484,12.29%,7.06%
2020-01-01 00:08:20,16,6,5184,220,4964,7.91%,4.24%
2020-01-01 00:08:20,16,7,3728,104,3624,5.69%,2.79%
2020-01-01 00:08:20,16,8,8267,592,7675,12.61%,7.16%
2020-01-01 00:08:20,16,9,8476,615,7861,12.93%,7.25%
2020-01-01 00:08:20,16,10,1549,19,1530,2.36%,1.23%
2020-01-01 00:08:20,16,11,10040,791,9249,15.32%,7.88%
2020-01-01 00:08:20,16,12,26209,4774,21435,39.99%,18.21%
2020-01-01 00:08:30,1,1,19131,2616,16515,29.19%,13.67%
2020-01-01 00:08:30,1,2,9161,613,8548,13.98%,6.69%
2020-01-01 00:08:30,1,3,850,5,845,1.30%,0.59%
2020-01-01 00:08:30,1,4,9768,785,8983,14.90%,8.04%
2020-01-01 00:08:30,1,5,9288,722,8566,14.17%,7.77%
2020-01-01 00:08:30,1,6,9241,714,8527,14.10%,7.73%
2020-01-01 00:08:30,1,7,8292,500,7792,12.65%,6.03%
2020-01-01 00:08:30,1,8,6778,331,6447,10.34%,4.88%
2020-01-01 00:08:30,1,9,9197,708,8489,14.03%,7.70%
2020-01-01 00:08:30,1,10,6205,281,5924,9.47%,4.53%
2020-01-01 00:08:30,1,11,6317,291,6026,9.64%,4.61%
2020-01-01 00:08:30,1,12,9137,704,8433,13.94%,7.70%
2020-01-01 00:08:30,2,1,920,3,917,1.40%,0.33%
2020-01-01 00:08:30,2,2,24617,4145,20472,37.56%,16.84%
2020-01-01 00:08:30,2,3,18386,2390,15996,28.05%,13.00%
2020-01-01 00:08:30,2,4,873,3,870,1.33%,0.34%
2020-01-01 00:08:30,2,5,10972,887,10085,16.74%,8.08%
2020-01-01 00:08:30,2,6,55,0,55,0.08%,0.00%
2020-01-01 00:08:30,2,7,5292,200,5092,8.07%,3.78%
2020-01-01 00:08:30,2,8,4150,127,4023,6.33%,3.06%
2020-01-01 00:08:30,2,9,10923,874,10049,16.67%,8.00%
2020-01-01 00:08:30,2,10,3490,87,3403,5.33%,2.49%
2020-01-01 00:08:30,2,11,3505,88,3417,5.35%,2.51%
2020-01-01 00:08:30,2,12,10780,848,9932,16.45%,7.87%
2020-01-01 00:08:30,3,1,1394,16,1378,2.13%,1.15%
2020-01-01 00:08:30,3,2,23568,3797,19771,35.96%,16.11%
2020-01-01 00:08:30,3,3,73329,29137,44192,111.89%,39.73%
2020-01-01 00:08:30,3,4,8062,451,7611,12.30%,5.59%
2020-01-01 00:08:30,3,5,47147,13440,33707,71.94%,28.51%
2020-01-01 00:08:30,3,6,9222,601,8621,14.07%,6.52%
2020-01-01 00:08:30,3,7,20467,2906,17561,31.23%,14.20%
2020-01-01 00:08:30,3,8,15644,1722,13922,23.87%,11.01%
2020-01-01 00:08:30,3,9,37649,8989,28660,57.45%,23.88%
2020-01-01 00:08:30,3,10,5013,163,4850,7.65%,3.25%
2020-01-01 00:08:30,3,11,1184,12,1172,1.81%,1.01%
2020-01-01 00:08:30,3,12,29676,5816,23860,45.28%,19.60%
2020-01-01 00:08:30,4,1,584,4,580,0.89%,0.68%
2020-01-01 00:08:30,4,2,357,2,355,0.54%,0.56%
2020-01-01 00:08:30,4,3,812,6,806,1.24%,0.74%
2020-01-01 00:08:30,4,4,28202,5293,22909,43.03%,18.77%
2020-01-01 00:08:30,4,5,17010,2107,14903,25.96%,12.39%
2020-01-01 00:08:30,4,6,23642,3844,19798,36.07%,16.26%
2020-01-01 00:08:30,4,7,5153,220,4933,7.86%,4.27%
2020-01-01 00:08:30,4,8,2745,67,2678,4.19%,2.44%
2020-01-01 00:08:30,4,9,14859,1637,13222,22.67%,11.02%
2020-01-01 00:08:30,4,10,1858,23,1835,2.84%,1.24%
2020-01-01 00:08:30,4,11,195,0,195,0.30%,0.00%
2020-01-01 00:08:30,4,12,12425,1145,11280,18.96%,9.21%
2020-01-01 00:08:30,5,1,2881,63,2818,4.40%,2.19%
2020-01-01 00:08:30,5,2,1624,22,1602,2.48%,1.35%
2020-01-01 00:08:30,5,3,1939,36,1903,2.96%,1.86%
2020-01-01 00:08:30,5,4,24570,4009,20561,37.49%,16.32%
2020-01-01 00:08:30,5,5,11810,1008,10802,18.02%,8.53%
2020-01-01 00:08:30,5,6,16486,1946,14540,25.16%,11.80%
2020-01-01 00:08:30,5,7,4311,188,4123,6.58%,4.36%
2020-01-01 00:08:30,5,8,3132,92,3040,4.78%,2.94%
2020-01-01 00:08:30,5,9,9752,677,9075,14.88%,6.94%
2020-01-01 00:08:30,5,10,2257,37,2220,3.44%,1.64%
2020-01-01 00:08:30,5,11,594,3,591,0.91%,0.50%
2020-01-01 00:08:30,5,12,7268,368,6900,11.09%,5.06%
2020-01-01 00:08:30,6,1,1098,5,1093,1.68%,0.45%
2020-01-01 00:08:30,6,2,1211,5,1206,1.85%,0.41%
2020-01-01 00:08:30,6,3,1518,11,1507,2.32%,0.72%
2020-01-01 00:08:30,6,4,1209,14,1195,1.84%,1.16%
2020-01-01 00:08:30,6,5,15213,1609,13604,23.21%,10.58%
2020-01-01 00:08:30,6,6,5221,180,5041,7.97%,3.45%
2020-01-01 00:08:30,6,7,3565,88,3477,5.44%,2.47%
2020-01-01 00:08:30,6,8,3014,70,2944,4.60%,2.32%
2020-01-01 00:08:30,6,9,8155,470,7685,12.44%,5.76%
2020-01-01 00:08:30,6,10,2260,35,2225,3.45%,1.55%
2020-01-01 00:08:30,6,11,443,0,443,0.68%,0.00%
2020-01-01 00:08:30,6,12,5840,237,5603,8.91%,4.06%
2020-01-01 00:08:30,7,1,421,1,420,0.64%,0.24%
2020-01-01 00:08:30,7,2,197,0,197,0.30%,0.00%
2020-01-01 00:08:30,7,3,584,3,581,0.89%,0.51%
2020-01-01 00:08:30,7,4,2577,46,2531,3.93%,1.78%
2020-01-01 00:08:30,7,5,6210,309,5901,9.48%,4.98%
2020-01-01 00:08:30,7,6,12404,1158,11246,18.93%,9.33%
2020-01-01 00:08:30,7,7,3580,118,3462,5.46%,3.30%
2020-01-01 00:08:30,7,8,1773,28,1745,2.71%,1.58%
2020-01-01 00:08:30,7,9,5486,246,5240,8.37%,4.48%
2020-01-01 00:08:30,7,10,1002,8,994,1.53%,0.80%
2020-01-01 00:08:30,7,11,74,0,74,0.11%,0.00%
2020-01-01 00:08:30,7,12,4432,169,4263,6.76%,3.81%
2020-01-01 00:08:30,8,1,412,4,408,0.63%,0.97%
2020-01-01 00:08:30,8,2,76,0,76,0.12%,0.00%
2020-01-01 00:08:30,8,3,1784,10,1774,2.72%,0.56%
2020-01-01 00:08:30,8,4,2979,72,2907,4.55%,2.42%
2020-01-01 00:08:30,8,5,8621,521,8100,13.15%,6.04%
2020-01-01 00:08:30,8,6,16673,1916,14757,25.44%,11.49%
2020-01-01 00:08:30,8,7,4984,186,4798,7.60%,3.73%
2020-01-01 00:08:30,8,8,2212,46,2166,3.38%,2.08%
2020-01-01 00:08:30,8,9,6488,292,6196,9.90%,4.50%
2020-01-01 00:08:30,8,10,1737,23,1714,2.65%,1.32%
2020-01-01 00:08:30,8,11,190,1,189,0.29%,0.52%
2020-01-01 00:08:30,8,12,4548,157,4391,6.94%,3.45%
2020-01-01 00:08:30,9,1,384,1,383,0.59%,0.26%
2020-01-01 00:08:30,9,2,1885,27,1858,2.88%,1.43%
2020-01-01 00:08:30,9,3,1107,15,1092,1.69%,1.35%
2020-01-01 00:08:30,9,4,4100,110,3990,6.26%,2.68%
2020-01-01 00:08:30,9,5,919,1,918,1.40%,0.11%
2020-01-01 00:08:30,9,6,6165,264,5901,9.41%,4.28%
2020-01-01 00:08:30,9,7,22012,3282,18730,33.59%,14.91%
2020-01-01 00:08:30,9,8,8513,515,7998,12.99%,6.05%
2020-01-01 00:08:30,9,9,403,0,403,0.61%,0.00%
2020-01-01 00:08:30,9,10,1868,28,1840,2.85%,1.50%
2020-01-01 00:08:30,9,11,7231,381,6850,11.03%,5.27%
2020-01-01 00:08:30,9,12,5038,186,4852,7.69%,3.69%
2020-01-01 00:08:30,10,1,1270,230,1040,1.94%,18.10%
2020-01-01 00:08:30,10,2,3100,309,2791,4.73%,9.96%
2020-01-01 00:08:30,10,3,1670,37,1633,2.55%,2.21%
2020-01-01 00:08:30,10,4,3849,962,2887,5.87%,24.99%
2020-01-01 00:08:30,10,5,1014,61,953,1.55%,6.01%
2020-01-01 00:08:30,10,6,5565,1106,4459,8.49%,19.87%
2020-01-01 00:08:30,10,7,10551,1795,8756,16.10%,17.01%
2020-01-01 00:08:30,10,8,30163,7975,22188,46.03%,26.44%
2020-01-01 00:08:30,10,9,665,2,663,1.01%,0.30%
2020-01-01 00:08:30,10,10,3456,104,3352,5.27%,3.01%
2020-01-01 00:08:30,10,11,14590,1964,12626,22.26%,13.46%
2020-01-01 00:08:30,10,12,10511,1245,9266,16.04%,11.84%
2020-01-01 00:08:30,11,1,2004,31,1973,3.06%,1.55%
2020-01-01 00:08:30,11,2,2788,60,2728,4.25%,2.15%
2020-01-01 00:08:30,11,3,652,4,648,0.99%,0.61%
2020-01-01 00:08:30,11,4,6147,265,5882,9.38%,4.31%
2020-01-01 00:08:30,11,5,289,8,281,0.44%,2.76%
2020-01-01 00:08:30,11,6,6948,344,6604,10.60%,4.95%
2020-01-01 00:08:30,11,7,11542,934,10608,17.61%,8.09%
2020-01-01 00:08:30,11,8,26954,4880,22074,41.13%,18.10%
2020-01-01 00:08:30,11,9,108,0,108,0.16%,0.00%
2020-01-01 00:08:30,11,10,2748,69,2679,4.19%,2.51%
2020-01-01 00:08:30,11,11,10248,772,9476,15.64%,7.53%
2020-01-01 00:08:30,11,12,7051,372,6679,10.76%,5.28%
2020-01-01 00:08:30,12,1,47,1,46,0.07%,2.08%
2020-01-01 00:08:30,12,2,498,159,339,0.76%,31.86%
2020-01-01 00:08:30,12,3,2104,195,1909,3.21%,9.26%
2020-01-01 00:08:30,12,4,3303,73,3230,5.04%,2.21%
2020-01-01 00:08:30,12,5,7587,562,7025,11.58%,7.41%
2020-01-01 00:08:30,12,6,4806,166,4640,7.33%,3.45%
2020-01-01 00:08:30,12,7,1377,14,1363,2.10%,1.02%
2020-01-01 00:08:30,12,8,1643,217,1426,2.51%,13.20%
2020-01-01 00:08:30,12,9,21135,3650,17485,32.25%,17.27%
2020-01-01 00:08:30,12,10,3975,314,3661,6.07%,7.90%
2020-01-01 00:08:30,12,11,1937,228,1709,2.96%,11.76%
2020-01-01 00:08:30,12,12,7587,908,6679,11.58%,11.97%
2020-01-01 00:08:30,13,1,2159,61,2098,3.29%,2.82%
2020-01-01 00:08:30,13,2,2502,74,2428,3.82%,2.96%
2020-01-01 00:08:30,13,3,543,1,542,0.83%,0.18%
2020-01-01 00:08:30,13,4,4947,497,4450,7.55%,10.04%
2020-01-01 00:08:30,13,5,7565,873,6692,11.54%,11.54%
2020-01-01 00:08:30,13,6,5547,544,5003,8.46%,9.81%
2020-01-01 00:08:30,13,7,4772,205,4567,7.28%,4.29%
2020-01-01 00:08:30,13,8,7711,488,7223,11.77%,6.33%
2020-01-01 00:08:30,13,9,7890,911,6979,12.04%,11.54%
2020-01-01 00:08:30,13,10,28272,5852,22420,43.14%,20.70%
2020-01-01 00:08:30,13,11,17954,2467,15487,27.40%,13.74%
2020-01-01 00:08:30,13,12,9763,866,8897,14.90%,8.87%
2020-01-01 00:08:30,14,1,481,3,478,0.73%,0.62%
2020-01-01 00:08:30,14,2,1267,13,1254,1.93%,1.03%
2020-01-01 00:08:30,14,3,600,3,597,0.92%,0.50%
2020-01-01 00:08:30,14,4,4723,162,4561,7.21%,3.43%
2020-01-01 00:08:30,14,5,1657,25,1632,2.53%,1.51%
2020-01-01 00:08:30,14,6,5056,186,4870,7.71%,3.68%
2020-01-01 00:08:30,14,7,11772,1038,10734,17.96%,8.82%
2020-01-01 00:08:30,14,8,13486,1307,12179,20.58%,9.69%
2020-01-01 00:08:30,14,9,1864,32,1832,2.84%,1.72%
2020-01-01 00:08:30,14,10,4004,128,3876,6.11%,3.20%
2020-01-01 00:08:30,14,11,26212,4543,21669,40.00%,17.33%
2020-01-01 00:08:30,14,12,8293,542,7751,12.65%,6.53%
2020-01-01 00:08:30,15,1,650,3,647,0.99%,0.46%
2020-01-01 00:08:30,15,2,125,0,125,0.19%,0.00%
2020-01-01 00:08:30,15,3,6982,307,6675,10.65%,4.40%
2020-01-01 00:08:30,15,4,4376,195,4181,6.68%,4.46%
2020-01-01 00:08:30,15,5,12887,1229,11658,19.66%,9.54%
2020-01-01 00:08:30,15,6,4647,237,4410,7.09%,5.10%
2020-01-01 00:08:30,15,7,3191,88,3103,4.87%,2.76%
2020-01-01 00:08:30,15,8,5523,225,5298,8.43%,4.07%
2020-01-01 00:08:30,15,9,13088,1266,11822,19.97%,9.67%
2020-01-01 00:08:30,15,10,12462,1207,11255,19.02%,9.68%
2020-01-01 00:08:30,15,11,18183,2399,15784,27.75%,13.19%
2020-01-01 00:08:30,15,12,37058,9173,27885,56.55%,24.75%
2020-01-01 00:08:30,16,1,328,0,328,0.50%,0.00%
2020-01-01 00:08:30,16,2,281,2,279,0.43%,0.71%
2020-01-01 00:08:30,16,3,1121,17,1104,1.71%,1.52%
2020-01-01 00:08:30,16,4,4246,95,4151,6.48%,2.24%
2020-01-01 00:08:30,16,5,8165,600,7565,12.46%,7.35%
2020-01-01 00:08:30,16,6,5118,150,4968,7.81%,2.93%
2020-01-01 00:08:30,16,7,2950,65,2885,4.50%,2.20%
2020-01-01 00:08:30,16,8,6246,372,5874,9.53%,5.95%
2020-01-01 00:08:30,16,9,8635,651,7984,13.18%,7.54%
2020-01-01 00:08:30,16,10,1588,27,1561,2.42%,1.70%
2020-01-01 00:08:30,16,11,8024,551,7473,12.24%,6.87%
2020-01-01 00:08:30,16,12,24056,4043,20013,36.71%,16.81%
2020-01-01 00:08:40,1,1,18543,2472,16071,28.29%,13.33%
2020-01-01 00:08:40,1,2,5416,229,5187,8.26%,4.23%
2020-01-01 00:08:40,1,3,435,2,433,0.66%,0.46%
2020-01-01 00:08:40,1,4,12790,1246,11544,19.52%,9.74%
2020-01-01 00:08:40,1,5,12525,1189,11336,19.11%,9.49%
2020-01-01 00:08:40,1,6,12483,1188,11295,19.05%,9.52%
2020-01-01 00:08:40,1,7,4972,196,4776,7.59%,3.94%
2020-01-01 00:08:40,1,8,4050,118,3932,6.18%,2.91%
2020-01-01 00:08:40,1,9,12452,1180,11272,19.00%,9.48%
2020-01-01 00:08:40,1,10,3418,79,3339,5.22%,2.31%
2020-01-01 00:08:40,1,11,3515,88,3427,5.36%,2.50%
2020-01-01 00:08:40,1,12,12380,1172,11208,18.89%,9.47%
2020-01-01 00:08:40,2,1,532,4,528,0.81%,0.75%
2020-01-01 00:08:40,2,2,22875,3570,19305,34.90%,15.61%
2020-01-01 00:08:40,2,3,18236,2366,15870,27.83%,12.97%
2020-01-01 00:08:40,2,4,453,3,450,0.69%,0.66%
2020-01-01 00:08:40,2,5,12119,1046,11073,18.49%,8.63%
2020-01-01 00:08:40,2,6,39,0,39,0.06%,0.00%
2020-01-01 00:08:40,2,7,4101,122,3979,6.26%,2.97%
2020-01-01 00:08:40,2,8,2884,58,2826,4.40%,2.01%
2020-01-01 00:08:40,2,9,11949,1022,10927,18.23%,8.55%
2020-01-01 00:08:40,2,10,2190,34,2156,3.34%,1.55%
2020-01-01 00:08:40,2,11,2242,35,2207,3.42%,1.56%
2020-01-01 00:08:40,2,12,11794,989,10805,18.00%,8.38%
2020-01-01 00:08:40,3,1,1643,19,1624,2.51%,1.16%
2020-01-01 00:08:40,3,2,23956,3853,20103,36.55%,16.08%
2020-01-01 00:08:40,3,3,73120,28970,44150,111.57%,39.62%
2020-01-01 00:08:40,3,4,7827,433,7394,11.94%,5.53%
2020-01-01 00:08:40,3,5,47659,13718,33941,72.72%,28.78%
2020-01-01 00:08:40,3,6,9752,661,9091,14.88%,6.78%
2020-01-01 00:08:40,3,7,20906,3013,17893,31.90%,14.41%
2020-01-01 00:08:40,3,8,17500,2101,15399,26.70%,12.01%
2020-01-01 00:08:40,3,9,37594,8950,28644,57.36%,23.81%
2020-01-01 00:08:40,3,10,5945,280,5665,9.07%,4.71%
2020-01-01 00:08:40,3,11,1845,17,1828,2.82%,0.92%
2020-01-01 00:08:40,3,12,29196,5540,23656,44.55%,18.97%
2020-01-01 00:08:40,4,1,476,1,475,0.73%,0.21%
2020-01-01 00:08:40,4,2,287,0,287,0.44%,0.00%
2020-01-01 00:08:40,4,3,1390,13,1377,2.12%,0.93%
2020-01-01 00:08:40,4,4,28737,5422,23315,43.85%,18.87%
2020-01-01 00:08:40,4,5,18871,2473,16398,28.79%,13.10%
2020-01-01 00:08:40,4,6,25153,4242,20911,38.38%,16.86%
2020-01-01 00:08:40,4,7,5089,229,4860,7.77%,4.50%
2020-01-01 00:08:40,4,8,2977,87,2890,4.54%,2.92%
2020-01-01 00:08:40,4,9,15499,1711,13788,23.65%,11.04%
2020-01-01 00:08:40,4,10,2046,47,1999,3.12%,2.30%
2020-01-01 00:08:40,4,11,189,0,189,0.29%,0.00%
2020-01-01 00:08:40,4,12,12673,1144,11529,19.34%,9.03%
2020-01-01 00:08:40,5,1,2736,48,2688,4.17%,1.75%
2020-01-01 00:08:40,5,2,794,4,790,1.21%,0.50%
2020-01-01 00:08:40,5,3,608,4,604,0.93%,0.66%
2020-01-01 00:08:40,5,4,21631,3239,18392,33.01%,14.97%
2020-01-01 00:08:40,5,5,9896,745,9151,15.10%,7.53%
2020-01-01 00:08:40,5,6,15506,1759,13747,23.66%,11.34%
2020-01-01 00:08:40,5,7,4936,191,4745,7.53%,3.87%
2020-01-01 00:08:40,5,8,3949,116,3833,6.03%,2.94%
2020-01-01 00:08:40,5,9,9146,631,8515,13.96%,6.90%
2020-01-01 00:08:40,5,10,1215,12,1203,1.85%,0.99%
2020-01-01 00:08:40,5,11,882,8,874,1.35%,0.91%
2020-01-01 00:08:40,5,12,7629,439,7190,11.64%,5.75%
2020-01-01 00:08:40,6,1,970,10,960,1.48%,1.03%
2020-01-01 00:08:40,6,2,1080,10,1070,1.65%,0.93%
2020-01-01 00:08:40,6,3,1676,18,1658,2.56%,1.07%
2020-01-01 00:08:40,6,4,1368,16,1352,2.09%,1.17%
2020-01-01 00:08:40,6,5,16774,1989,14785,25.60%,11.86%
2020-01-01 00:08:40,6,6,4174,142,4032,6.37%,3.40%
2020-01-01 00:08:40,6,7,2379,34,2345,3.63%,1.43%
2020-01-01 00:08:40,6,8,1868,22,1846,2.85%,1.18%
2020-01-01 00:08:40,6,9,10539,816,9723,16.08%,7.74%
2020-01-01 00:08:40,6,10,2152,40,2112,3.28%,1.86%
2020-01-01 00:08:40,6,11,422,2,420,0.64%,0.47%
2020-01-01 00:08:40,6,12,8271,520,7751,12.62%,6.29%
2020-01-01 00:08:40,7,1,422,5,417,0.64%,1.18%
2020-01-01 00:08:40,7,2,191,0,191,0.29%,0.00%
2020-01-01 00:08:40,7,3,2491,35,2456,3.80%,1.40%
2020-01-01 00:08:40,7,4,1483,18,1465,2.26%,1.21%
2020-01-01 00:08:40,7,5,8270,497,7773,12.62%,6.01%
2020-01-01 00:08:40,7,6,13456,1287,12169,20.53%,9.56%
2020-01-01 00:08:40,7,7,3615,87,3528,5.52%,2.41%
2020-01-01 00:08:40,7,8,1286,7,1279,1.96%,0.54%
2020-01-01 00:08:40,7,9,5671,255,5416,8.65%,4.50%
2020-01-01 00:08:40,7,10,897,17,880,1.37%,1.89%
2020-01-01 00:08:40,7,11,102,0,102,0.16%,0.00%
2020-01-01 00:08:40,7,12,4753,174,4579,7.25%,3.66%
2020-01-01 00:08:40,8,1,478,2,476,0.73%,0.42%
2020-01-01 00:08:40,8,2,99,1,98,0.15%,1.00%
2020-01-01 00:08:40,8,3,1693,20,1673,2.58%,1.18%
2020-01-01 00:08:40,8,4,2776,49,2727,4.24%,1.76%
2020-01-01 00:08:40,8,5,8756,538,8218,13.36%,6.14%
2020-01-01 00:08:40,8,6,16631,1990,14641,25.38%,11.96%
2020-01-01 00:08:40,8,7,5001,209,4792,7.63%,4.18%
2020-01-01 00:08:40,8,8,1906,37,1869,2.91%,1.94%
2020-01-01 00:08:40,8,9,6911,361,6550,10.55%,5.22%
2020-01-01 00:08:40,8,10,1883,29,1854,2.87%,1.54%
2020-01-01 00:08:40,8,11,171,0,171,0.26%,0.00%
2020-01-01 00:08:40,8,12,4947,186,4761,7.55%,3.76%
2020-01-01 00:08:40,9,1,270,0,270,0.41%,0.00%
2020-01-01 00:08:40,9,2,5559,213,5346,8.48%,3.83%
2020-01-01 00:08:40,9,3,4839,168,4671,7.38%,3.47%
2020-01-01 00:08:40,9,4,10130,778,9352,15.46%,7.68%
2020-01-01 00:08:40,9,5,330,0,330,0.50%,0.00%
2020-01-01 00:08:40,9,6,10987,910,10077,16.76%,8.28%
2020-01-01 00:08:40,9,7,32069,6661,25408,48.93%,20.77%
2020-01-01 00:08:40,9,8,10106,732,9374,15.42%,7.24%
2020-01-01 00:08:40,9,9,174,0,174,0.27%,0.00%
2020-01-01 00:08:40,9,10,2685,41,2644,4.10%,1.53%
2020-01-01 00:08:40,9,11,8886,571,8315,13.56%,6.43%
2020-01-01 00:08:40,9,12,5900,255,5645,9.00%,4.32%
2020-01-01 00:08:40,10,1,1209,287,922,1.84%,23.72%
2020-01-01 00:08:40,10,2,2740,327,2413,4.18%,11.93%
2020-01-01 00:08:40,10,3,1273,11,1262,1.94%,0.86%
2020-01-01 00:08:40,10,4,4160,998,3162,6.35%,23.98%
2020-01-01 00:08:40,10,5,603,4,599,0.92%,0.66%
2020-01-01 00:08:40,10,6,5981,1113,4868,9.13%,18.61%
2020-01-01 00:08:40,10,7,11206,1949,9257,17.10%,17.39%
2020-01-01 00:08:40,10,8,26946,6691,20255,41.12%,24.83%
2020-01-01 00:08:40,10,9,561,3,558,0.86%,0.53%
2020-01-01 00:08:40,10,10,2197,45,2152,3.35%,2.05%
2020-01-01 00:08:40,10,11,11695,1436,10259,17.85%,12.28%
2020-01-01 00:08:40,10,12,8999,1065,7934,13.73%,11.83%
2020-01-01 00:08:40,11,1,2043,36,2007,3.12%,1.76%
2020-01-01 00:08:40,11,2,3279,91,3188,5.00%,2.77%
2020-01-01 00:08:40,11,3,1134,9,1125,1.73%,0.79%
2020-01-01 00:08:40,11,4,4273,141,4132,6.52%,3.30%
2020-01-01 00:08:40,11,5,720,2,718,1.10%,0.28%
2020-01-01 00:08:40,11,6,5586,219,5367,8.52%,3.92%
2020-01-01 00:08:40,11,7,10609,851,9758,16.19%,8.02%
2020-01-01 00:08:40,11,8,23918,4000,19918,36.50%,16.72%
2020-01-01 00:08:40,11,9,252,0,252,0.38%,0.00%
2020-01-01 00:08:40,11,10,3089,73,3016,4.71%,2.36%
2020-01-01 00:08:40,11,11,10264,770,9494,15.66%,7.50%
2020-01-01 00:08:40,11,12,6872,363,6509,10.49%,5.28%
2020-01-01 00:08:40,12,1,53,0,53,0.08%,0.00%
2020-01-01 00:08:40,12,2,689,226,463,1.05%,32.75%
2020-01-01 00:08:40,12,3,3160,303,2857,4.82%,9.59%
2020-01-01 00:08:40,12,4,2625,64,2561,4.01%,2.44%
2020-01-01 00:08:40,12,5,9824,906,8918,14.99%,9.22%
2020-01-01 00:08:40,12,6,5846,276,5570,8.92%,4.72%
2020-01-01 00:08:40,12,7,3115,61,3054,4.75%,1.96%
2020-01-01 00:08:40,12,8,1427,330,1097,2.18%,23.11%
2020-01-01 00:08:40,12,9,22459,4477,17982,34.27%,19.93%
2020-01-01 00:08:40,12,10,4369,458,3911,6.67%,10.48%
2020-01-01 00:08:40,12,11,1636,334,1302,2.50%,20.40%
2020-01-01 00:08:40,12,12,7190,1050,6140,10.97%,14.60%
2020-01-01 00:08:40,13,1,2346,50,2296,3.58%,2.13%
2020-01-01 00:08:40,13,2,2805,70,2735,4.28%,2.49%
2020-01-01 00:08:40,13,3,578,5,573,0.88%,0.86%
2020-01-01 00:08:40,13,4,4548,435,4113,6.94%,9.56%
2020-01-01 00:08:40,13,5,7542,771,6771,11.51%,10.22%
2020-01-01 00:08:40,13,6,6094,548,5546,9.30%,8.99%
2020-01-01 00:08:40,13,7,5574,246,5328,8.51%,4.41%
2020-01-01 00:08:40,13,8,7269,405,6864,11.09%,5.57%
2020-01-01 00:08:40,13,9,7718,786,6932,11.78%,10.18%
2020-01-01 00:08:40,13,10,29308,6117,23191,44.72%,20.87%
2020-01-01 00:08:40,13,11,18855,2740,16115,28.77%,14.53%
2020-01-01 00:08:40,13,12,10997,1223,9774,16.78%,11.12%
2020-01-01 00:08:40,14,1,498,1,497,0.76%,0.20%
2020-01-01 00:08:40,14,2,2086,26,2060,3.18%,1.25%
2020-01-01 00:08:40,14,3,1342,14,1328,2.05%,1.04%
2020-01-01 00:08:40,14,4,4457,155,4302,6.80%,3.48%
2020-01-01 00:08:40,14,5,1244,11,1233,1.90%,0.88%
2020-01-01 00:08:40,14,6,4859,185,4674,7.41%,3.81%
2020-01-01 00:08:40,14,7,12192,1052,11140,18.60%,8.63%
2020-01-01 00:08:40,14,8,13881,1385,12496,21.18%,9.98%
2020-01-01 00:08:40,14,9,1709,23,1686,2.61%,1.35%
2020-01-01 00:08:40,14,10,4120,133,3987,6.29%,3.23%
2020-01-01 00:08:40,14,11,25734,4519,21215,39.27%,17.56%
2020-01-01 00:08:40,14,12,7413,417,6996,11.31%,5.62%
2020-01-01 00:08:40,15,1,483,2,481,0.74%,0.41%
2020-01-01 00:08:40,15,2,165,0,165,0.25%,0.00%
2020-01-01 00:08:40,15,3,4004,127,3877,6.11%,3.17%
2020-01-01 00:08:40,15,4,5321,188,5133,8.12%,3.53%
2020-01-01 00:08:40,15,5,11267,878,10389,17.19%,7.79%
2020-01-01 00:08:40,15,6,5620,205,5415,8.58%,3.65%
2020-01-01 00:08:40,15,7,4048,197,3851,6.18%,4.87%
2020-01-01 00:08:40,15,8,5865,342,5523,8.95%,5.83%
2020-01-01 00:08:40,15,9,11443,912,10531,17.46%,7.97%
2020-01-01 00:08:40,15,10,7215,408,6807,11.01%,5.65%
2020-01-01 00:08:40,15,11,13180,1354,11826,20.11%,10.27%
2020-01-01 00:08:40,15,12,29944,6095,23849,45.69%,20.35%
2020-01-01 00:08:40,16,1,490,6,484,0.75%,1.22%
2020-01-01 00:08:40,16,2,271,0,271,0.41%,0.00%
2020-01-01 00:08:40,16,3,1272,16,1256,1.94%,1.26%
2020-01-01 00:08:40,16,4,4105,121,3984,6.26%,2.95%
2020-01-01 00:08:40,16,5,7441,502,6939,11.35%,6.75%
2020-01-01 00:08:40,16,6,4984,177,4807,7.60%,3.55%
2020-01-01 00:08:40,16,7,3114,79,3035,4.75%,2.54%
2020-01-01 00:08:40,16,8,8281,506,7775,12.64%,6.11%
2020-01-01 00:08:40,16,9,7889,559,7330,12.04%,7.08%
2020-01-01 00:08:40,16,10,2228,29,2199,3.40%,1.30%
2020-01-01 00:08:40,16,11,10856,968,9888,16.56%,8.92%
2020-01-01 00:08:40,16,12,27856,5342,22514,42.50%,19.18%
2020-01-01 00:08:50,1,1,18653,2401,16252,28.46%,12.87%
2020-01-01 00:08:50,1,2,7463,399,7064,11.39%,5.35%
2020-01-01 00:08:50,1,3,568,1,567,0.87%,0.18%
2020-01-01 00:08:50,1,4,10855,917,9938,16.56%,8.45%
2020-01-01 00:08:50,1,5,10259,822,9437,15.65%,8.01%
2020-01-01 00:08:50,1,6,10275,826,9449,15.68%,8.04%
2020-01-01 00:08:50,1,7,6865,343,6522,10.48%,5.00%
2020-01-01 00:08:50,1,8,5192,171,5021,7.92%,3.29%
2020-01-01 00:08:50,1,9,10117,799,9318,15.44%,7.90%
2020-01-01 00:08:50,1,10,4242,107,4135,6.47%,2.52%
2020-01-01 00:08:50,1,11,4337,112,4225,6.62%,2.58%
2020-01-01 00:08:50,1,12,10094,795,9299,15.40%,7.88%
2020-01-01 00:08:50,2,1,800,2,798,1.22%,0.25%
2020-01-01 00:08:50,2,2,30545,6098,24447,46.61%,19.96%
2020-01-01 00:08:50,2,3,25341,4299,21042,38.67%,16.96%
2020-01-01 00:08:50,2,4,711,2,709,1.08%,0.28%
2020-01-01 00:08:50,2,5,16520,1863,14657,25.21%,11.28%
2020-01-01 00:08:50,2,6,21,0,21,0.03%,0.00%
2020-01-01 00:08:50,2,7,4382,139,4243,6.69%,3.17%
2020-01-01 00:08:50,2,8,3314,76,3238,5.06%,2.29%
2020-01-01 00:08:50,2,9,16455,1843,14612,25.11%,11.20%
2020-01-01 00:08:50,2,10,2522,42,2480,3.85%,1.66%
2020-01-01 00:08:50,2,11,2555,42,2513,3.90%,1.64%
2020-01-01 00:08:50,2,12,16254,1794,14460,24.80%,11.04%
2020-01-01 00:08:50,3,1,1835,20,1815,2.80%,1.09%
2020-01-01 00:08:50,3,2,22146,3335,18811,33.79%,15.06%
2020-01-01 00:08:50,3,3,70209,27164,43045,107.13%,38.69%
2020-01-01 00:08:50,3,4,9817,705,9112,14.98%,7.18%
2020-01-01 00:08:50,3,5,45392,12713,32679,69.26%,28.01%
2020-01-01 00:08:50,3,6,11236,928,10308,17.14%,8.26%
2020-01-01 00:08:50,3,7,18210,2340,15870,27.79%,12.85%
2020-01-01 00:08:50,3,8,15254,1691,13563,23.28%,11.08%
2020-01-01 00:08:50,3,9,33725,7478,26247,51.46%,22.17%
2020-01-01 00:08:50,3,10,4773,148,4625,7.28%,3.10%
2020-01-01 00:08:50,3,11,1712,31,1681,2.61%,1.81%
2020-01-01 00:08:50,3,12,27044,4936,22108,41.27%,18.25%
2020-01-01 00:08:50,4,1,485,1,484,0.74%,0.21%
2020-01-01 00:08:50,4,2,348,1,347,0.53%,0.29%
2020-01-01 00:08:50,4,3,991,6,985,1.51%,0.60%
2020-01-01 00:08:50,4,4,29421,5770,23651,44.89%,19.61%
2020-01-01 00:08:50,4,5,19771,2726,17045,30.17%,13.79%
2020-01-01 00:08:50,4,6,25962,4549,21413,39.61%,17.52%
2020-01-01 00:08:50,4,7,4783,169,4614,7.30%,3.53%
2020-01-01 00:08:50,4,8,3187,76,3111,4.86%,2.38%
2020-01-01 00:08:50,4,9,17548,2217,15331,26.78%,12.63%
2020-01-01 00:08:50,4,10,1942,20,1922,2.96%,1.03%
2020-01-01 00:08:50,4,11,164,0,164,0.25%,0.00%
2020-01-01 00:08:50,4,12,14873,1656,13217,22.69%,11.13%
2020-01-01 00:08:50,5,1,2297,35,2262,3.50%,1.52%
2020-01-01 00:08:50,5,2,643,2,641,0.98%,0.31%
2020-01-01 00:08:50,5,3,1575,18,1557,2.40%,1.14%
2020-01-01 00:08:50,5,4,25704,4474,21230,39.22%,17.41%
2020-01-01 00:08:50,5,5,9921,749,9172,15.14%,7.55%
2020-01-01 00:08:50,5,6,20223,2881,17342,30.86%,14.25%
2020-01-01 00:08:50,5,7,9635,721,8914,14.70%,7.48%
2020-01-01 00:08:50,5,8,3464,98,3366,5.29%,2.83%
2020-01-01 00:08:50,5,9,8163,515,7648,12.46%,6.31%
2020-01-01 00:08:50,5,10,1436,15,1421,2.19%,1.04%
2020-01-01 00:08:50,5,11,1047,9,1038,1.60%,0.86%
2020-01-01 00:08:50,5,12,6417,311,6106,9.79%,4.85%
2020-01-01 00:08:50,6,1,797,7,790,1.22%,0.88%
2020-01-01 00:08:50,6,2,935,11,924,1.43%,1.18%
2020-01-01 00:08:50,6,3,1678,22,1656,2.56%,1.31%
2020-01-01 00:08:50,6,4,1517,15,1502,2.31%,0.99%
2020-01-01 00:08:50,6,5,15898,1776,14122,24.26%,11.17%
2020-01-01 00:08:50,6,6,4268,151,4117,6.51%,3.54%
2020-01-01 00:08:50,6,7,2403,47,2356,3.67%,1.96%
2020-01-01 00:08:50,6,8,1842,24,1818,2.81%,1.30%
2020-01-01 00:08:50,6,9,9676,657,9019,14.76%,6.79%
2020-01-01 00:08:50,6,10,2045,29,2016,3.12%,1.42%
2020-01-01 00:08:50,6,11,428,1,427,0.65%,0.23%
2020-01-01 00:08:50,6,12,7584,418,7166,11.57%,5.51%
2020-01-01 00:08:50,7,1,395,2,393,0.60%,0.51%
2020-01-01 00:08:50,7,2,215,0,215,0.33%,0.00%
2020-01-01 00:08:50,7,3,1238,6,1232,1.89%,0.48%
2020-01-01 00:08:50,7,4,1410,23,1387,2.15%,1.63%
2020-01-01 00:08:50,7,5,7155,382,6773,10.92%,5.34%
2020-01-01 00:08:50,7,6,12373,1133,11240,18.88%,9.16%
2020-01-01 00:08:50,7,7,3754,132,3622,5.73%,3.52%
2020-01-01 00:08:50,7,8,1271,15,1256,1.94%,1.18%
2020-01-01 00:08:50,7,9,5845,266,5579,8.92%,4.55%
2020-01-01 00:08:50,7,10,1306,15,1291,1.99%,1.15%
2020-01-01 00:08:50,7,11,73,0,73,0.11%,0.00%
2020-01-01 00:08:50,7,12,4510,157,4353,6.88%,3.48%
2020-01-01 00:08:50,8,1,450,1,449,0.69%,0.22%
2020-01-01 00:08:50,8,2,186,0,186,0.28%,0.00%
2020-01-01 00:08:50,8,3,1540,12,1528,2.35%,0.78%
2020-01-01 00:08:50,8,4,2580,45,2535,3.94%,1.74%
2020-01-01 00:08:50,8,5,7671,430,7241,11.71%,5.60%
2020-01-01 00:08:50,8,6,15541,1736,13805,23.71%,11.17%
2020-01-01 00:08:50,8,7,5186,223,4963,7.91%,4.30%
2020-01-01 00:08:50,8,8,2147,43,2104,3.28%,2.00%
2020-01-01 00:08:50,8,9,5960,256,5704,9.09%,4.29%
2020-01-01 00:08:50,8,10,1892,14,1878,2.89%,0.74%
2020-01-01 00:08:50,8,11,207,0,207,0.32%,0.00%
2020-01-01 00:08:50,8,12,3873,123,3750,5.91%,3.18%
2020-01-01 00:08:50,9,1,1050,6,1044,1.60%,0.57%
2020-01-01 00:08:50,9,2,2948,67,2881,4.50%,2.27%
2020-01-01 00:08:50,9,3,1320,18,1302,2.01%,1.36%
2020-01-01 00:08:50,9,4,8137,470,7667,12.42%,5.78%
2020-01-01 00:08:50,9,5,170,2,168,0.26%,1.17%
2020-01-01 00:08:50,9,6,8892,572,8320,13.57%,6.43%
2020-01-01 00:08:50,9,7,29440,5628,23812,44.92%,19.12%
2020-01-01 00:08:50,9,8,11676,965,10711,17.82%,8.26%
2020-01-01 00:08:50,9,9,134,1,133,0.20%,0.74%
2020-01-01 00:08:50,9,10,4969,194,4775,7.58%,3.90%
2020-01-01 00:08:50,9,11,10516,779,9737,16.05%,7.41%
2020-01-01 00:08:50,9,12,5210,197,5013,7.95%,3.78%
2020-01-01 00:08:50,10,1,1113,276,837,1.70%,24.78%
2020-01-01 00:08:50,10,2,3143,350,2793,4.80%,11.13%
2020-01-01 00:08:50,10,3,1803,46,1757,2.75%,2.55%
2020-01-01 00:08:50,10,4,4724,1057,3667,7.21%,22.37%
2020-01-01 00:08:50,10,5,607,3,604,0.93%,0.49%
2020-01-01 00:08:50,10,6,6661,1203,5458,10.16%,18.06%
2020-01-01 00:08:50,10,7,11632,2049,9583,17.75%,17.61%
2020-01-01 00:08:50,10,8,28265,7176,21089,43.13%,25.39%
2020-01-01 00:08:50,10,9,758,4,754,1.16%,0.53%
2020-01-01 00:08:50,10,10,2287,41,2246,3.49%,1.79%
2020-01-01 00:08:50,10,11,12378,1491,10887,18.89%,12.04%
2020-01-01 00:08:50,10,12,9554,1086,8468,14.58%,11.37%
2020-01-01 00:08:50,11,1,2328,35,2293,3.55%,1.50%
2020-01-01 00:08:50,11,2,3905,111,3794,5.96%,2.84%
2020-01-01 00:08:50,11,3,1423,11,1412,2.17%,0.77%
2020-01-01 00:08:50,11,4,3154,67,3087,4.81%,2.12%
2020-01-01 00:08:50,11,5,328,4,324,0.50%,1.22%
2020-01-01 00:08:50,11,6,4050,123,3927,6.18%,3.04%
2020-01-01 00:08:50,11,7,9553,709,8844,14.58%,7.42%
2020-01-01 00:08:50,11,8,27018,4978,22040,41.23%,18.42%
2020-01-01 00:08:50,11,9,213,0,213,0.33%,0.00%
2020-01-01 00:08:50,11,10,3019,65,2954,4.61%,2.15%
2020-01-01 00:08:50,11,11,13925,1368,12557,21.25%,9.82%
2020-01-01 00:08:50,11,12,10655,782,9873,16.26%,7.34%
2020-01-01 00:08:50,12,1,45,0,45,0.07%,0.00%
2020-01-01 00:08:50,12,2,751,267,484,1.15%,35.51%
2020-01-01 00:08:50,12,3,2699,313,2386,4.12%,11.59%
2020-01-01 00:08:50,12,4,2147,44,2103,3.28%,2.05%
2020-01-01 00:08:50,12,5,8185,704,7481,12.49%,8.60%
2020-01-01 00:08:50,12,6,4635,167,4468,7.07%,3.60%
2020-01-01 00:08:50,12,7,2398,42,2356,3.66%,1.75%
2020-01-01 00:08:50,12,8,1066,254,812,1.63%,23.81%
2020-01-01 00:08:50,12,9,20327,3953,16374,31.02%,19.45%
2020-01-01 00:08:50,12,10,3773,364,3409,5.76%,9.64%
2020-01-01 00:08:50,12,11,1251,256,995,1.91%,20.45%
2020-01-01 00:08:50,12,12,6939,1062,5877,10.59%,15.30%
2020-01-01 00:08:50,13,1,2461,54,2407,3.76%,2.19%
2020-01-01 00:08:50,13,2,2832,69,2763,4.32%,2.44%
2020-01-01 00:08:50,13,3,912,7,905,1.39%,0.77%
2020-01-01 00:08:50,13,4,4864,460,4404,7.42%,9.46%
2020-01-01 00:08:50,13,5,7137,744,6393,10.89%,10.42%
2020-01-01 00:08:50,13,6,5560,505,5055,8.48%,9.08%
2020-01-01 00:08:50,13,7,5395,214,5181,8.23%,3.97%
2020-01-01 00:08:50,13,8,8187,520,7667,12.49%,6.35%
2020-01-01 00:08:50,13,9,7526,776,6750,11.48%,10.31%
2020-01-01 00:08:50,13,10,28827,6034,22793,43.99%,20.93%
2020-01-01 00:08:50,13,11,18832,2711,16121,28.74%,14.39%
2020-01-01 00:08:50,13,12,10096,1015,9081,15.41%,10.05%
2020-01-01 00:08:50,14,1,490,2,488,0.75%,0.41%
2020-01-01 00:08:50,14,2,1724,30,1694,2.63%,1.74%
2020-01-01 00:08:50,14,3,948,6,942,1.45%,0.63%
2020-01-01 00:08:50,14,4,4171,116,4055,6.36%,2.78%
2020-01-01 00:08:50,14,5,1496,18,1478,2.28%,1.20%
2020-01-01 00:08:50,14,6,4721,148,4573,7.20%,3.13%
2020-01-01 00:08:50,14,7,11732,989,10743,17.90%,8.43%
2020-01-01 00:08:50,14,8,13305,1268,12037,20.30%,9.53%
2020-01-01 00:08:50,14,9,1822,25,1797,2.78%,1.37%
2020-01-01 00:08:50,14,10,4320,142,4178,6.59%,3.29%
2020-01-01 00:08:50,14,11,25071,4288,20783,38.26%,17.10%
2020-01-01 00:08:50,14,12,7160,373,6787,10.93%,5.21%
2020-01-01 00:08:50,15,1,512,1,511,0.78%,0.19%
2020-01-01 00:08:50,15,2,127,0,127,0.19%,0.00%
2020-01-01 00:08:50,15,3,3824,118,3706,5.83%,3.08%
2020-01-01 00:08:50,15,4,5051,305,4746,7.71%,6.04%
2020-01-01 00:08:50,15,5,10809,929,9880,16.49%,8.59%
2020-01-01 00:08:50,15,6,5297,315,4982,8.08%,5.95%
2020-01-01 00:08:50,15,7,3444,115,3329,5.26%,3.34%
2020-01-01 00:08:50,15,8,5434,252,5182,8.29%,4.64%
2020-01-01 00:08:50,15,9,10961,949,10012,16.73%,8.66%
2020-01-01 00:08:50,15,10,4370,122,4248,6.67%,2.79%
2020-01-01 00:08:50,15,11,9913,718,9195,15.13%,7.24%
2020-01-01 00:08:50,15,12,26738,5223,21515,40.80%,19.53%
2020-01-01 00:08:50,16,1,480,0,480,0.73%,0.00%
2020-01-01 00:08:50,16,2,224,0,224,0.34%,0.00%
2020-01-01 00:08:50,16,3,1348,13,1335,2.06%,0.96%
2020-01-01 00:08:50,16,4,3754,82,3672,5.73%,2.18%
2020-01-01 00:08:50,16,5,7554,496,7058,11.53%,6.57%
2020-01-01 00:08:50,16,6,4538,134,4404,6.92%,2.95%
2020-01-01 00:08:50,16,7,3618,103,3515,5.52%,2.85%
2020-01-01 00:08:50,16,8,7817,472,7345,11.93%,6.04%
2020-01-01 00:08:50,16,9,8050,562,7488,12.28%,6.98%
2020-01-01 00:08:50,16,10,1840,31,1809,2.81%,1.68%
2020-01-01 00:08:50,16,11,9855,701,9154,15.04%,7.11%
2020-01-01 00:08:50,16,12,25971,4588,21383,39.63%,17.67%
2020-01-01 00:09:00,1,1,17379,2224,15155,26.52%,12.80%
2020-01-01 00:09:00,1,2,6430,325,6105,9.81%,5.05%
2020-01-01 00:09:00,1,3,569,16,553,0.87%,2.81%
2020-01-01 00:09:00,1,4,10339,870,9469,15.78%,8.41%
2020-01-01 00:09:00,1,5,10028,819,9209,15.30%,8.17%
2020-01-01 00:09:00,1,6,9956,808,9148,15.19%,8.11%
2020-01-01 00:09:00,1,7,5839,261,5578,8.91%,4.47%
2020-01-01 00:09:00,1,8,4131,127,4004,6.30%,3.07%
2020-01-01 00:09:00,1,9,9888,800,9088,15.09%,8.09%
2020-01-01 00:09:00,1,10,3642,100,3542,5.56%,2.74%
2020-01-01 00:09:00,1,11,3726,104,3622,5.69%,2.79%
2020-01-01 00:09:00,1,12,9854,794,9060,15.04%,8.06%
2020-01-01 00:09:00,2,1,487,3,484,0.74%,0.61%
2020-01-01 00:09:00,2,2,26741,4740,22001,40.80%,17.72%
2020-01-01 00:09:00,2,3,22413,3423,18990,34.20%,15.27%
2020-01-01 00:09:00,2,4,353,2,351,0.54%,0.56%
2020-01-01 00:09:00,2,5,15520,1726,13794,23.68%,11.12%
2020-01-01 00:09:00,2,6,33,0,33,0.05%,0.00%
2020-01-01 00:09:00,2,7,3819,103,3716,5.83%,2.70%
2020-01-01 00:09:00,2,8,2709,51,2658,4.13%,1.88%
2020-01-01 00:09:00,2,9,15457,1713,13744,23.59%,11.08%
2020-01-01 00:09:00,2,10,1971,32,1939,3.01%,1.62%
2020-01-01 00:09:00,2,11,1987,32,1955,3.03%,1.61%
2020-01-01 00:09:00,2,12,15244,1669,13575,23.26%,10.95%
2020-01-01 00:09:00,3,1,1520,23,1497,2.32%,1.51%
2020-01-01 00:09:00,3,2,23832,3859,19973,36.36%,16.19%
2020-01-01 00:09:00,3,3,73074,29198,43876,111.50%,39.96%
2020-01-01 00:09:00,3,4,12720,1194,11526,19.41%,9.39%
2020-01-01 00:09:00,3,5,48024,14114,33910,73.28%,29.39%
2020-01-01 00:09:00,3,6,14180,1464,12716,21.64%,10.32%
2020-01-01 00:09:00,3,7,20097,2803,17294,30.67%,13.95%
2020-01-01 00:09:00,3,8,16781,1995,14786,25.61%,11.89%
2020-01-01 00:09:00,3,9,33433,7239,26194,51.01%,21.65%
2020-01-01 00:09:00,3,10,8079,473,7606,12.33%,5.85%
2020-01-01 00:09:00,3,11,2050,43,2007,3.13%,2.10%
2020-01-01 00:09:00,3,12,22491,3437,19054,34.32%,15.28%
2020-01-01 00:09:00,4,1,576,1,575,0.88%,0.17%
2020-01-01 00:09:00,4,2,361,1,360,0.55%,0.28%
2020-01-01 00:09:00,4,3,583,4,579,0.89%,0.68%
2020-01-01 00:09:00,4,4,29942,5854,24088,45.69%,19.55%
2020-01-01 00:09:00,4,5,19369,2614,16755,29.55%,13.50%
2020-01-01 00:09:00,4,6,25714,4409,21305,39.24%,17.15%
2020-01-01 00:09:00,4,7,5082,167,4915,7.75%,3.29%
2020-01-01 00:09:00,4,8,2869,61,2808,4.38%,2.13%
2020-01-01 00:09:00,4,9,17525,2153,15372,26.74%,12.28%
2020-01-01 00:09:00,4,10,2284,34,2250,3.49%,1.49%
2020-01-01 00:09:00,4,11,235,0,235,0.36%,0.00%
2020-01-01 00:09:00,4,12,14430,1526,12904,22.02%,10.57%
2020-01-01 00:09:00,5,1,2608,66,2542,3.98%,2.53%
2020-01-01 00:09:00,5,2,729,7,722,1.11%,0.96%
2020-01-01 00:09:00,5,3,476,0,476,0.73%,0.00%
2020-01-01 00:09:00,5,4,25465,4460,21005,38.86%,17.51%
2020-01-01 00:09:00,5,5,8963,611,8352,13.68%,6.82%
2020-01-01 00:09:00,5,6,19047,2610,16437,29.06%,13.70%
2020-01-01 00:09:00,5,7,9465,717,8748,14.44%,7.57%
2020-01-01 00:09:00,5,8,3535,98,3437,5.39%,2.77%
2020-01-01 00:09:00,5,9,8337,519,7818,12.72%,6.22%
2020-01-01 00:09:00,5,10,949,16,933,1.45%,1.68%
2020-01-01 00:09:00,5,11,590,3,587,0.90%,0.51%
2020-01-01 00:09:00,5,12,6921,363,6558,10.56%,5.24%
2020-01-01 00:09:00,6,1,1245,11,1234,1.90%,0.88%
2020-01-01 00:09:00,6,2,1367,14,1353,2.09%,1.02%
2020-01-01 00:09:00,6,3,1854,23,1831,2.83%,1.24%
2020-01-01 00:09:00,6,4,997,12,985,1.52%,1.20%
2020-01-01 00:09:00,6,5,15267,1675,13592,23.30%,10.97%
2020-01-01 00:09:00,6,6,5487,252,5235,8.37%,4.59%
2020-01-01 00:09:00,6,7,4190,160,4030,6.39%,3.82%
2020-01-01 00:09:00,6,8,3102,103,2999,4.73%,3.32%
2020-01-01 00:09:00,6,9,7626,444,7182,11.64%,5.82%
2020-01-01 00:09:00,6,10,2710,55,2655,4.14%,2.03%
2020-01-01 00:09:00,6,11,537,2,535,0.82%,0.37%
2020-01-01 00:09:00,6,12,4858,172,4686,7.41%,3.54%
2020-01-01 00:09:00,7,1,665,10,655,1.01%,1.50%
2020-01-01 00:09:00,7,2,137,0,137,0.21%,0.00%
2020-01-01 00:09:00,7,3,831,3,828,1.27%,0.36%
2020-01-01 00:09:00,7,4,2636,51,2585,4.02%,1.93%
2020-01-01 00:09:00,7,5,7364,383,6981,11.24%,5.20%
2020-01-01 00:09:00,7,6,14421,1536,12885,22.00%,10.65%
2020-01-01 00:09:00,7,7,4369,145,4224,6.67%,3.32%
2020-01-01 00:09:00,7,8,1729,15,1714,2.64%,0.87%
2020-01-01 00:09:00,7,9,6443,291,6152,9.83%,4.52%
2020-01-01 00:09:00,7,10,1120,8,1112,1.71%,0.71%
2020-01-01 00:09:00,7,11,112,1,111,0.17%,0.88%
2020-01-01 00:09:00,7,12,5275,211,5064,8.05%,4.00%
2020-01-01 00:09:00,8,1,468,1,467,0.71%,0.21%
2020-01-01 00:09:00,8,2,88,0,88,0.13%,0.00%
2020-01-01 00:09:00,8,3,1973,21,1952,3.01%,1.06%
2020-01-01 00:09:00,8,4,2523,41,2482,3.85%,1.62%
2020-01-01 00:09:00,8,5,8305,468,7837,12.67%,5.63%
2020-01-01 00:09:00,8,6,15782,1717,14065,24.08%,10.88%
2020-01-01 00:09:00,8,7,4791,191,4600,7.31%,3.99%
2020-01-01 00:09:00,8,8,1924,47,1877,2.94%,2.44%
2020-01-01 00:09:00,8,9,6112,289,5823,9.33%,4.73%
2020-01-01 00:09:00,8,10,1857,21,1836,2.83%,1.13%
2020-01-01 00:09:00,8,11,112,0,112,0.17%,0.00%
2020-01-01 00:09:00,8,12,4197,154,4043,6.40%,3.67%
2020-01-01 00:09:00,9,1,474,0,474,0.72%,0.00%
2020-01-01 00:09:00,9,2,2460,40,2420,3.75%,1.63%
2020-01-01 00:09:00,9,3,1456,10,1446,2.22%,0.69%
2020-01-01 00:09:00,9,4,3237,79,3158,4.94%,2.44%
2020-01-01 00:09:00,9,5,351,2,349,0.54%,0.57%
2020-01-01 00:09:00,9,6,4102,130,3972,6.26%,3.17%
2020-01-01 00:09:00,9,7,27608,4990,22618,42.13%,18.07%
2020-01-01 00:09:00,9,8,13829,1389,12440,21.10%,10.04%
2020-01-01 00:09:00,9,9,209,0,209,0.32%,0.00%
2020-01-01 00:09:00,9,10,4432,99,4333,6.76%,2.23%
2020-01-01 00:09:00,9,11,11860,990,10870,18.10%,8.35%
2020-01-01 00:09:00,9,12,7054,381,6673,10.76%,5.40%
2020-01-01 00:09:00,10,1,1940,300,1640,2.96%,15.46%
2020-01-01 00:09:00,10,2,3766,355,3411,5.75%,9.42%
2020-01-01 00:09:00,10,3,1680,17,1663,2.56%,1.01%
2020-01-01 00:09:00,10,4,3685,1156,2529,5.62%,31.36%
2020-01-01 00:09:00,10,5,840,52,788,1.28%,6.18%
2020-01-01 00:09:00,10,6,6153,1337,4816,9.39%,21.73%
2020-01-01 00:09:00,10,7,11477,2175,9302,17.51%,18.95%
2020-01-01 00:09:00,10,8,29443,7728,21715,44.93%,26.25%
2020-01-01 00:09:00,10,9,620,1,619,0.95%,0.16%
2020-01-01 00:09:00,10,10,2444,36,2408,3.73%,1.47%
2020-01-01 00:09:00,10,11,14217,1905,12312,21.69%,13.40%
2020-01-01 00:09:00,10,12,10996,1334,9662,16.78%,12.13%
2020-01-01 00:09:00,11,1,3158,85,3073,4.82%,2.69%
2020-01-01 00:09:00,11,2,4142,145,3997,6.32%,3.50%
2020-01-01 00:09:00,11,3,691,8,683,1.05%,1.16%
2020-01-01 00:09:00,11,4,5367,226,5141,8.19%,4.21%
2020-01-01 00:09:00,11,5,218,1,217,0.33%,0.46%
2020-01-01 00:09:00,11,6,6309,309,6000,9.63%,4.90%
2020-01-01 00:09:00,11,7,12222,1078,11144,18.65%,8.82%
2020-01-01 00:09:00,11,8,28429,5397,23032,43.38%,18.98%
2020-01-01 00:09:00,11,9,236,1,235,0.36%,0.42%
2020-01-01 00:09:00,11,10,3252,187,3065,4.96%,5.75%
2020-01-01 00:09:00,11,11,12042,1113,10929,18.37%,9.24%
2020-01-01 00:09:00,11,12,8317,478,7839,12.69%,5.75%
2020-01-01 00:09:00,12,1,47,0,47,0.07%,0.00%
2020-01-01 00:09:00,12,2,613,176,437,0.94%,28.66%
2020-01-01 00:09:00,12,3,3080,234,2846,4.70%,7.59%
2020-01-01 00:09:00,12,4,2845,70,2775,4.34%,2.46%
2020-01-01 00:09:00,12,5,8465,666,7799,12.92%,7.87%
2020-01-01 00:09:00,12,6,4706,171,4535,7.18%,3.63%
2020-01-01 00:09:00,12,7,1678,25,1653,2.56%,1.49%
2020-01-01 00:09:00,12,8,1374,292,1082,2.10%,21.24%
2020-01-01 00:09:00,12,9,21746,4289,17457,33.18%,19.72%
2020-01-01 00:09:00,12,10,5160,468,4692,7.87%,9.07%
2020-01-01 00:09:00,12,11,2148,308,1840,3.28%,14.33%
2020-01-01 00:09:00,12,12,7527,1255,6272,11.49%,16.67%
2020-01-01 00:09:00,13,1,2300,55,2245,3.51%,2.39%
2020-01-01 00:09:00,13,2,2560,71,2489,3.91%,2.77%
2020-01-01 00:09:00,13,3,959,17,942,1.46%,1.77%
2020-01-01 00:09:00,13,4,4688,452,4236,7.15%,9.64%
2020-01-01 00:09:00,13,5,7304,759,6545,11.15%,10.39%
2020-01-01 00:09:00,13,6,5439,492,4947,8.30%,9.04%
2020-01-01 00:09:00,13,7,4578,164,4414,6.99%,3.58%
2020-01-01 00:09:00,13,8,6892,319,6573,10.52%,4.63%
2020-01-01 00:09:00,13,9,7590,789,6801,11.58%,10.39%
2020-01-01 00:09:00,13,10,26572,5228,21344,40.55%,19.67%
2020-01-01 00:09:00,13,11,15418,2033,13385,23.53%,13.19%
2020-01-01 00:09:00,13,12,8049,881,7168,12.28%,10.94%
2020-01-01 00:09:00,14,1,177,0,177,0.27%,0.00%
2020-01-01 00:09:00,14,2,1408,13,1395,2.15%,0.92%
2020-01-01 00:09:00,14,3,1073,7,1066,1.64%,0.65%
2020-01-01 00:09:00,14,4,3948,120,3828,6.02%,3.04%
2020-01-01 00:09:00,14,5,1530,19,1511,2.33%,1.24%
2020-01-01 00:09:00,14,6,4218,139,4079,6.44%,3.29%
2020-01-01 00:09:00,14,7,11951,1028,10923,18.24%,8.60%
2020-01-01 00:09:00,14,8,13566,1320,12246,20.70%,9.73%
2020-01-01 00:09:00,14,9,1837,31,1806,2.80%,1.69%
2020-01-01 00:09:00,14,10,4270,136,4134,6.52%,3.18%
2020-01-01 00:09:00,14,11,25969,4600,21369,39.63%,17.71%
2020-01-01 00:09:00,14,12,7850,490,7360,11.98%,6.24%
2020-01-01 00:09:00,15,1,521,1,520,0.79%,0.19%
2020-01-01 00:09:00,15,2,148,0,148,0.23%,0.00%
2020-01-01 00:09:00,15,3,3820,99,3721,5.83%,2.59%
2020-01-01 00:09:00,15,4,4780,192,4588,7.29%,4.02%
2020-01-01 00:09:00,15,5,9661,673,8988,14.74%,6.97%
2020-01-01 00:09:00,15,6,5039,206,4833,7.69%,4.09%
2020-01-01 00:09:00,15,7,3684,144,3540,5.62%,3.91%
2020-01-01 00:09:00,15,8,5418,263,5155,8.27%,4.85%
2020-01-01 00:09:00,15,9,9871,700,9171,15.06%,7.09%
2020-01-01 00:09:00,15,10,4178,444,3734,6.38%,10.62%
2020-01-01 00:09:00,15,11,9801,1038,8763,14.96%,10.59%
2020-01-01 00:09:00,15,12,25384,4954,20430,38.73%,19.52%
2020-01-01 00:09:00,16,1,565,0,565,0.86%,0.00%
2020-01-01 00:09:00,16,2,204,0,204,0.31%,0.00%
2020-01-01 00:09:00,16,3,1550,20,1530,2.37%,1.29%
2020-01-01 00:09:00,16,4,4337,203,4134,6.62%,4.68%
2020-01-01 00:09:00,16,5,7792,611,7181,11.89%,7.84%
2020-01-01 00:09:00,16,6,5278,268,5010,8.05%,5.08%
2020-01-01 00:09:00,16,7,3307,86,3221,5.05%,2.60%
2020-01-01 00:09:00,16,8,7352,416,6936,11.22%,5.66%
2020-01-01 00:09:00,16,9,8347,669,7678,12.74%,8.01%
2020-01-01 00:09:00,16,10,2131,34,2097,3.25%,1.59%
2020-01-01 00:09:00,16,11,9780,725,9055,14.92%,7.41%
2020-01-01 00:09:00,16,12,26779,4966,21813,40.86%,18.54%
2020-01-01 00:09:10,1,1,15271,1678,13593,23.30%,10.99%
2020-01-01 00:09:10,1,2,7351,375,6976,11.22%,5.10%
2020-01-01 00:09:10,1,3,559,3,556,0.85%,0.54%
2020-01-01 00:09:10,1,4,7405,443,6962,11.30%,5.98%
2020-01-01 00:09:10,1,5,7177,420,6757,10.95%,5.85%
2020-01-01 00:09:10,1,6,7081,414,6667,10.80%,5.85%
2020-01-01 00:09:10,1,7,6780,327,6453,10.35%,4.82%
2020-01-01 00:09:10,1,8,4463,137,4326,6.81%,3.07%
2020-01-01 00:09:10,1,9,7057,411,6646,10.77%,5.82%
2020-01-01 00:09:10,1,10,3663,91,3572,5.59%,2.48%
2020-01-01 00:09:10,1,11,3784,98,3686,5.77%,2.59%
2020-01-01 00:09:10,1,12,7002,405,6597,10.68%,5.78%
2020-01-01 00:09:10,2,1,529,0,529,0.81%,0.00%
2020-01-01 00:09:10,2,2,28779,5458,23321,43.91%,18.96%
2020-01-01 00:09:10,2,3,24399,3999,20400,37.23%,16.39%
2020-01-01 00:09:10,2,4,459,0,459,0.70%,0.00%
2020-01-01 00:09:10,2,5,14746,1516,13230,22.50%,10.28%
2020-01-01 00:09:10,2,6,53,0,53,0.08%,0.00%
2020-01-01 00:09:10,2,7,3829,92,3737,5.84%,2.40%
2020-01-01 00:09:10,2,8,2514,44,2470,3.84%,1.75%
2020-01-01 00:09:10,2,9,14572,1475,13097,22.24%,10.12%
2020-01-01 00:09:10,2,10,1601,21,1580,2.44%,1.31%
2020-01-01 00:09:10,2,11,1630,21,1609,2.49%,1.29%
2020-01-01 00:09:10,2,12,14433,1453,12980,22.02%,10.07%
2020-01-01 00:09:10,3,1,1444,31,1413,2.20%,2.15%
2020-01-01 00:09:10,3,2,22586,3488,19098,34.46%,15.44%
2020-01-01 00:09:10,3,3,76483,31343,45140,116.70%,40.98%
2020-01-01 00:09:10,3,4,14285,1471,12814,21.80%,10.30%
2020-01-01 00:09:10,3,5,53254,16783,36471,81.26%,31.51%
2020-01-01 00:09:10,3,6,15501,1737,13764,23.65%,11.21%
2020-01-01 00:09:10,3,7,19208,2567,16641,29.31%,13.36%
2020-01-01 00:09:10,3,8,16633,1931,14702,25.38%,11.61%
2020-01-01 00:09:10,3,9,37154,8723,28431,56.69%,23.48%
2020-01-01 00:09:10,3,10,7440,396,7044,11.35%,5.32%
2020-01-01 00:09:10,3,11,1768,27,1741,2.70%,1.53%
2020-01-01 00:09:10,3,12,27241,4918,22323,41.57%,18.05%
2020-01-01 00:09:10,4,1,657,3,654,1.00%,0.46%
2020-01-01 00:09:10,4,2,432,2,430,0.66%,0.46%
2020-01-01 00:09:10,4,3,757,4,753,1.16%,0.53%
2020-01-01 00:09:10,4,4,27355,4957,22398,41.74%,18.12%
2020-01-01 00:09:10,4,5,17087,2061,15026,26.07%,12.06%
2020-01-01 00:09:10,4,6,23003,3627,19376,35.10%,15.77%
2020-01-01 00:09:10,4,7,4704,146,4558,7.18%,3.10%
2020-01-01 00:09:10,4,8,2609,43,2566,3.98%,1.65%
2020-01-01 00:09:10,4,9,15197,1627,13570,23.19%,10.71%
2020-01-01 00:09:10,4,10,2016,36,1980,3.08%,1.78%
2020-01-01 00:09:10,4,11,191,1,190,0.29%,0.52%
2020-01-01 00:09:10,4,12,12531,1155,11376,19.12%,9.22%
2020-01-01 00:09:10,5,1,3262,80,3182,4.98%,2.45%
2020-01-01 00:09:10,5,2,775,4,771,1.18%,0.52%
2020-01-01 00:09:10,5,3,485,0,485,0.74%,0.00%
2020-01-01 00:09:10,5,4,21326,3081,18245,32.54%,14.45%
2020-01-01 00:09:10,5,5,9555,640,8915,14.58%,6.70%
2020-01-01 00:09:10,5,6,14522,1457,13065,22.16%,10.03%
2020-01-01 00:09:10,5,7,4536,155,4381,6.92%,3.42%
2020-01-01 00:09:10,5,8,3535,99,3436,5.39%,2.80%
2020-01-01 00:09:10,5,9,8950,572,8378,13.66%,6.39%
2020-01-01 00:09:10,5,10,892,6,886,1.36%,0.67%
2020-01-01 00:09:10,5,11,558,4,554,0.85%,0.72%
2020-01-01 00:09:10,5,12,7860,446,7414,11.99%,5.67%
2020-01-01 00:09:10,6,1,1175,25,1150,1.79%,2.13%
2020-01-01 00:09:10,6,2,1271,29,1242,1.94%,2.28%
2020-01-01 00:09:10,6,3,1911,46,1865,2.92%,2.41%
2020-01-01 00:09:10,6,4,1002,5,997,1.53%,0.50%
2020-01-01 00:09:10,6,5,12103,1026,11077,18.47%,8.48%
2020-01-01 00:09:10,6,6,3728,96,3632,5.69%,2.57%
2020-01-01 00:09:10,6,7,2316,37,2279,3.53%,1.60%
2020-01-01 00:09:10,6,8,1818,26,1792,2.77%,1.43%
2020-01-01 00:09:10,6,9,6158,272,5886,9.40%,4.42%
2020-01-01 00:09:10,6,10,1793,27,1766,2.74%,1.51%
2020-01-01 00:09:10,6,11,469,4,465,0.72%,0.85%
2020-01-01 00:09:10,6,12,4293,120,4173,6.55%,2.79%
2020-01-01 00:09:10,7,1,478,2,476,0.73%,0.42%
2020-01-01 00:09:10,7,2,353,1,352,0.54%,0.28%
2020-01-01 00:09:10,7,3,483,2,481,0.74%,0.41%
2020-01-01 00:09:10,7,4,2289,23,2266,3.49%,1.00%
2020-01-01 00:09:10,7,5,7407,399,7008,11.30%,5.39%
2020-01-01 00:09:10,7,6,13947,1385,12562,21.28%,9.93%
2020-01-01 00:09:10,7,7,4187,152,4035,6.39%,3.63%
2020-01-01 00:09:10,7,8,2214,48,2166,3.38%,2.17%
2020-01-01 00:09:10,7,9,6527,309,6218,9.96%,4.73%
2020-01-01 00:09:10,7,10,1502,12,1490,2.29%,0.80%
2020-01-01 00:09:10,7,11,85,1,84,0.13%,1.16%
2020-01-01 00:09:10,7,12,5002,188,4814,7.63%,3.76%
2020-01-01 00:09:10,8,1,483,1,482,0.74%,0.21%
2020-01-01 00:09:10,8,2,106,3,103,0.16%,2.80%
2020-01-01 00:09:10,8,3,1853,29,1824,2.83%,1.56%
2020-01-01 00:09:10,8,4,3221,76,3145,4.91%,2.36%
2020-01-01 00:09:10,8,5,8810,586,8224,13.44%,6.65%
2020-01-01 00:09:10,8,6,16362,1942,14420,24.97%,11.87%
2020-01-01 00:09:10,8,7,4208,130,4078,6.42%,3.09%
2020-01-01 00:09:10,8,8,1424,26,1398,2.17%,1.82%
2020-01-01 00:09:10,8,9,6761,328,6433,10.32%,4.85%
2020-01-01 00:09:10,8,10,1999,22,1977,3.05%,1.10%
2020-01-01 00:09:10,8,11,133,0,133,0.20%,0.00%
2020-01-01 00:09:10,8,12,4722,163,4559,7.21%,3.45%
2020-01-01 00:09:10,9,1,255,0,255,0.39%,0.00%
2020-01-01 00:09:10,9,2,2325,36,2289,3.55%,1.55%
2020-01-01 00:09:10,9,3,1642,21,1621,2.51%,1.28%
2020-01-01 00:09:10,9,4,5405,246,5159,8.25%,4.55%
2020-01-01 00:09:10,9,5,677,4,673,1.03%,0.59%
2020-01-01 00:09:10,9,6,6588,358,6230,10.05%,5.43%
2020-01-01 00:09:10,9,7,27271,4967,22304,41.61%,18.21%
2020-01-01 00:09:10,9,8,11735,933,10802,17.91%,7.95%
2020-01-01 00:09:10,9,9,269,1,268,0.41%,0.37%
2020-01-01 00:09:10,9,10,3820,66,3754,5.83%,1.73%
2020-01-01 00:09:10,9,11,10746,790,9956,16.40%,7.35%
2020-01-01 00:09:10,9,12,6612,325,6287,10.09%,4.91%
2020-01-01 00:09:10,10,1,1504,234,1270,2.29%,15.55%
2020-01-01 00:09:10,10,2,3466,306,3160,5.29%,8.83%
2020-01-01 00:09:10,10,3,1825,23,1802,2.78%,1.26%
2020-01-01 00:09:10,10,4,3852,1137,2715,5.88%,29.51%
2020-01-01 00:09:10,10,5,1062,116,946,1.62%,10.91%
2020-01-01 00:09:10,10,6,6124,1371,4753,9.34%,22.38%
2020-01-01 00:09:10,10,7,10990,2125,8865,16.77%,19.33%
2020-01-01 00:09:10,10,8,29232,7488,21744,44.60%,25.61%
2020-01-01 00:09:10,10,9,559,4,555,0.85%,0.71%
2020-01-01 00:09:10,10,10,1799,32,1767,2.75%,1.78%
2020-01-01 00:09:10,10,11,13090,1495,11595,19.97%,11.42%
2020-01-01 00:09:10,10,12,10195,1044,9151,15.56%,10.24%
2020-01-01 00:09:10,11,1,2327,44,2283,3.55%,1.89%
2020-01-01 00:09:10,11,2,3832,111,3721,5.85%,2.90%
2020-01-01 00:09:10,11,3,1242,15,1227,1.90%,1.21%
2020-01-01 00:09:10,11,4,3561,92,3469,5.43%,2.58%
2020-01-01 00:09:10,11,5,217,2,215,0.33%,0.92%
2020-01-01 00:09:10,11,6,4335,140,4195,6.61%,3.23%
2020-01-01 00:09:10,11,7,9723,710,9013,14.84%,7.30%
2020-01-01 00:09:10,11,8,24570,4083,20487,37.49%,16.62%
2020-01-01 00:09:10,11,9,186,0,186,0.28%,0.00%
2020-01-01 00:09:10,11,10,3123,80,3043,4.77%,2.56%
2020-01-01 00:09:10,11,11,10553,822,9731,16.10%,7.79%
2020-01-01 00:09:10,11,12,6876,375,6501,10.49%,5.45%
2020-01-01 00:09:10,12,1,37,0,37,0.06%,0.00%
2020-01-01 00:09:10,12,2,473,118,355,0.72%,24.89%
2020-01-01 00:09:10,12,3,2907,177,2730,4.44%,6.09%
2020-01-01 00:09:10,12,4,2962,60,2902,4.52%,2.02%
2020-01-01 00:09:10,12,5,9572,788,8784,14.61%,8.23%
2020-01-01 00:09:10,12,6,5427,268,5159,8.28%,4.94%
2020-01-01 00:09:10,12,7,2330,73,2257,3.56%,3.13%
2020-01-01 00:09:10,12,8,2025,278,1747,3.09%,13.72%
2020-01-01 00:09:10,12,9,22434,4478,17956,34.23%,19.96%
2020-01-01 00:09:10,12,10,4775,380,4395,7.29%,7.96%
2020-01-01 00:09:10,12,11,2485,292,2193,3.79%,11.75%
2020-01-01 00:09:10,12,12,7423,1263,6160,11.33%,17.01%
2020-01-01 00:09:10,13,1,1673,23,1650,2.55%,1.37%
2020-01-01 00:09:10,13,2,2124,31,2093,3.24%,1.46%
2020-01-01 00:09:10,13,3,922,27,895,1.41%,2.93%
2020-01-01 00:09:10,13,4,4689,859,3830,7.15%,18.32%
2020-01-01 00:09:10,13,5,7187,1200,5987,10.97%,16.69%
2020-01-01 00:09:10,13,6,5197,898,4299,7.93%,17.28%
2020-01-01 00:09:10,13,7,4104,122,3982,6.26%,2.97%
2020-01-01 00:09:10,13,8,6264,289,5975,9.56%,4.61%
2020-01-01 00:09:10,13,9,7461,1228,6233,11.38%,16.46%
2020-01-01 00:09:10,13,10,27021,5582,21439,41.23%,20.66%
2020-01-01 00:09:10,13,11,16655,2039,14616,25.41%,12.24%
2020-01-01 00:09:10,13,12,10020,858,9162,15.29%,8.56%
2020-01-01 00:09:10,14,1,278,1,277,0.42%,0.36%
2020-01-01 00:09:10,14,2,1615,21,1594,2.46%,1.30%
2020-01-01 00:09:10,14,3,1044,8,1036,1.59%,0.77%
2020-01-01 00:09:10,14,4,3501,82,3419,5.34%,2.34%
2020-01-01 00:09:10,14,5,1158,8,1150,1.77%,0.69%
2020-01-01 00:09:10,14,6,4034,105,3929,6.16%,2.60%
2020-01-01 00:09:10,14,7,12135,995,11140,18.52%,8.20%
2020-01-01 00:09:10,14,8,13604,1258,12346,20.76%,9.25%
2020-01-01 00:09:10,14,9,1496,12,1484,2.28%,0.80%
2020-01-01 00:09:10,14,10,4449,146,4303,6.79%,3.28%
2020-01-01 00:09:10,14,11,29208,5554,23654,44.57%,19.01%
2020-01-01 00:09:10,14,12,10759,844,9915,16.42%,7.84%
2020-01-01 00:09:10,15,1,497,2,495,0.76%,0.40%
2020-01-01 00:09:10,15,2,128,0,128,0.20%,0.00%
2020-01-01 00:09:10,15,3,8653,554,8099,13.20%,6.40%
2020-01-01 00:09:10,15,4,5321,231,5090,8.12%,4.34%
2020-01-01 00:09:10,15,5,14955,1699,13256,22.82%,11.36%
2020-01-01 00:09:10,15,6,5592,275,5317,8.53%,4.92%
2020-01-01 00:09:10,15,7,3352,93,3259,5.11%,2.77%
2020-01-01 00:09:10,15,8,5180,229,4951,7.90%,4.42%
2020-01-01 00:09:10,15,9,15147,1740,13407,23.11%,11.49%
2020-01-01 00:09:10,15,10,5575,455,5120,8.51%,8.16%
2020-01-01 00:09:10,15,11,10997,1103,9894,16.78%,10.03%
2020-01-01 00:09:10,15,12,31474,6952,24522,48.03%,22.09%
2020-01-01 00:09:10,16,1,597,2,595,0.91%,0.33%
2020-01-01 00:09:10,16,2,294,0,294,0.45%,0.00%
2020-01-01 00:09:10,16,3,1559,22,1537,2.38%,1.41%
2020-01-01 00:09:10,16,4,4282,129,4153,6.53%,3.01%
2020-01-01 00:09:10,16,5,8737,626,8111,13.33%,7.16%
2020-01-01 00:09:10,16,6,5308,201,5107,8.10%,3.79%
2020-01-01 00:09:10,16,7,3411,99,3312,5.20%,2.90%
2020-01-01 00:09:10,16,8,7617,434,7183,11.62%,5.70%
2020-01-01 00:09:10,16,9,9180,683,8497,14.01%,7.44%
2020-01-01 00:09:10,16,10,1630,25,1605,2.49%,1.53%
2020-01-01 00:09:10,16,11,9464,669,8795,14.44%,7.07%
2020-01-01 00:09:10,16,12,27165,4959,22206,41.45%,18.25%
2020-01-01 00:09:20,1,1,13984,1407,12577,21.34%,10.06%
2020-01-01 00:09:20,1,2,4510,136,4374,6.88%,3.01%
2020-01-01 00:09:20,1,3,454,1,453,0.69%,0.22%
2020-01-01 00:09:20,1,4,9078,634,8444,13.85%,6.98%
2020-01-01 00:09:20,1,5,8609,586,8023,13.14%,6.81%
2020-01-01 00:09:20,1,6,8482,576,7906,12.94%,6.79%
2020-01-01 00:09:20,1,7,4035,109,3926,6.16%,2.70%
2020-01-01 00:09:20,1,8,3338,66,3272,5.09%,1.98%
2020-01-01 00:09:20,1,9,8461,573,7888,12.91%,6.77%
2020-01-01 00:09:20,1,10,2657,47,2610,4.05%,1.77%
2020-01-01 00:09:20,1,11,2703,47,2656,4.12%,1.74%
2020-01-01 00:09:20,1,12,8235,546,7689,12.57%,6.63%
2020-01-01 00:09:20,2,1,781,0,781,1.19%,0.00%
2020-01-01 00:09:20,2,2,28910,5450,23460,44.11%,18.85%
2020-01-01 00:09:20,2,3,24228,3861,20367,36.97%,15.94%
2020-01-01 00:09:20,2,4,710,0,710,1.08%,0.00%
2020-01-01 00:09:20,2,5,16123,1742,14381,24.60%,10.80%
2020-01-01 00:09:20,2,6,21,0,21,0.03%,0.00%
2020-01-01 00:09:20,2,7,3883,102,3781,5.92%,2.63%
2020-01-01 00:09:20,2,8,3037,60,2977,4.63%,1.97%
2020-01-01 00:09:20,2,9,16039,1719,14320,24.47%,10.72%
2020-01-01 00:09:20,2,10,2224,37,2187,3.39%,1.66%
2020-01-01 00:09:20,2,11,2230,37,2193,3.40%,1.66%
2020-01-01 00:09:20,2,12,15823,1669,14154,24.14%,10.55%
2020-01-01 00:09:20,3,1,1752,34,1718,2.67%,1.94%
2020-01-01 00:09:20,3,2,23587,3896,19691,35.99%,16.52%
2020-01-01 00:09:20,3,3,62690,22463,40227,95.66%,35.83%
2020-01-01 00:09:20,3,4,5399,217,5182,8.24%,4.02%
2020-01-01 00:09:20,3,5,37746,9147,28599,57.60%,24.23%
2020-01-01 00:09:20,3,6,7016,356,6660,10.71%,5.07%
2020-01-01 00:09:20,3,7,19872,2834,17038,30.32%,14.26%
2020-01-01 00:09:20,3,8,16135,1853,14282,24.62%,11.48%
2020-01-01 00:09:20,3,9,30162,6094,24068,46.02%,20.20%
2020-01-01 00:09:20,3,10,4150,127,4023,6.33%,3.06%
2020-01-01 00:09:20,3,11,1947,32,1915,2.97%,1.64%
2020-01-01 00:09:20,3,12,22676,3600,19076,34.60%,15.88%
2020-01-01 00:09:20,4,1,433,1,432,0.66%,0.23%
2020-01-01 00:09:20,4,2,254,1,253,0.39%,0.39%
2020-01-01 00:09:20,4,3,815,4,811,1.24%,0.49%
2020-01-01 00:09:20,4,4,27567,5121,22446,42.06%,18.58%
2020-01-01 00:09:20,4,5,17063,2031,15032,26.04%,11.90%
2020-01-01 00:09:20,4,6,23921,3923,19998,36.50%,16.40%
2020-01-01 00:09:20,4,7,5461,276,5185,8.33%,5.05%
2020-01-01 00:09:20,4,8,3070,74,2996,4.68%,2.41%
2020-01-01 00:09:20,4,9,14998,1637,13361,22.89%,10.91%
2020-01-01 00:09:20,4,10,2050,44,2006,3.13%,2.15%
2020-01-01 00:09:20,4,11,148,0,148,0.23%,0.00%
2020-01-01 00:09:20,4,12,12308,1110,11198,18.78%,9.02%
2020-01-01 00:09:20,5,1,3180,77,3103,4.85%,2.42%
2020-01-01 00:09:20,5,2,705,1,704,1.08%,0.14%
2020-01-01 00:09:20,5,3,576,0,576,0.88%,0.00%
2020-01-01 00:09:20,5,4,27384,5013,22371,41.78%,18.31%
2020-01-01 00:09:20,5,5,9753,713,9040,14.88%,7.31%
2020-01-01 00:09:20,5,6,16242,1908,14334,24.78%,11.75%
2020-01-01 00:09:20,5,7,5915,281,5634,9.03%,4.75%
2020-01-01 00:09:20,5,8,4564,172,4392,6.96%,3.77%
2020-01-01 00:09:20,5,9,9017,622,8395,13.76%,6.90%
2020-01-01 00:09:20,5,10,854,6,848,1.30%,0.70%
2020-01-01 00:09:20,5,11,614,2,612,0.94%,0.33%
2020-01-01 00:09:20,5,12,7860,491,7369,11.99%,6.25%
2020-01-01 00:09:20,6,1,1135,13,1122,1.73%,1.14%
2020-01-01 00:09:20,6,2,1266,14,1252,1.93%,1.10%
2020-01-01 00:09:20,6,3,1767,26,1741,2.70%,1.47%
2020-01-01 00:09:20,6,4,1297,8,1289,1.98%,0.62%
2020-01-01 00:09:20,6,5,18275,2366,15909,27.89%,12.95%
2020-01-01 00:09:20,6,6,6126,297,5829,9.35%,4.85%
2020-01-01 00:09:20,6,7,4392,146,4246,6.70%,3.32%
2020-01-01 00:09:20,6,8,3834,108,3726,5.85%,2.82%
2020-01-01 00:09:20,6,9,10056,768,9288,15.34%,7.64%
2020-01-01 00:09:20,6,10,2876,63,2813,4.39%,2.19%
2020-01-01 00:09:20,6,11,387,0,387,0.59%,0.00%
2020-01-01 00:09:20,6,12,7091,400,6691,10.82%,5.64%
2020-01-01 00:09:20,7,1,503,1,502,0.77%,0.20%
2020-01-01 00:09:20,7,2,140,0,140,0.21%,0.00%
2020-01-01 00:09:20,7,3,661,4,657,1.01%,0.60%
2020-01-01 00:09:20,7,4,2068,38,2030,3.16%,1.84%
2020-01-01 00:09:20,7,5,7543,430,7113,11.51%,5.70%
2020-01-01 00:09:20,7,6,12803,1193,11610,19.54%,9.32%
2020-01-01 00:09:20,7,7,3099,114,2985,4.73%,3.68%
2020-01-01 00:09:20,7,8,1325,24,1301,2.02%,1.81%
2020-01-01 00:09:20,7,9,6736,329,6407,10.28%,4.88%
2020-01-01 00:09:20,7,10,1631,12,1619,2.49%,0.74%
2020-01-01 00:09:20,7,11,90,0,90,0.14%,0.00%
2020-01-01 00:09:20,7,12,5080,208,4872,7.75%,4.09%
2020-01-01 00:09:20,8,1,508,5,503,0.78%,0.98%
2020-01-01 00:09:20,8,2,124,3,121,0.19%,2.40%
2020-01-01 00:09:20,8,3,1676,15,1661,2.56%,0.89%
2020-01-01 00:09:20,8,4,2756,63,2693,4.21%,2.29%
2020-01-01 00:09:20,8,5,7993,484,7509,12.20%,6.05%
2020-01-01 00:09:20,8,6,16840,1973,14867,25.70%,11.72%
2020-01-01 00:09:20,8,7,5993,261,5732,9.14%,4.35%
2020-01-01 00:09:20,8,8,2572,61,2511,3.92%,2.37%
2020-01-01 00:09:20,8,9,6065,274,5791,9.25%,4.52%
2020-01-01 00:09:20,8,10,1821,24,1797,2.78%,1.32%
2020-01-01 00:09:20,8,11,227,0,227,0.35%,0.00%
2020-01-01 00:09:20,8,12,4164,129,4035,6.35%,3.10%
2020-01-01 00:09:20,9,1,1115,3,1112,1.70%,0.27%
2020-01-01 00:09:20,9,2,3366,84,3282,5.14%,2.49%
2020-01-01 00:09:20,9,3,1847,23,1824,2.82%,1.24%
2020-01-01 00:09:20,9,4,4143,153,3990,6.32%,3.69%
2020-01-01 00:09:20,9,5,378,1,377,0.58%,0.26%
2020-01-01 00:09:20,9,6,5410,237,5173,8.26%,4.38%
2020-01-01 00:09:20,9,7,24959,4287,20672,38.08%,17.18%
2020-01-01 00:09:20,9,8,9567,741,8826,14.60%,7.74%
2020-01-01 00:09:20,9,9,237,1,236,0.36%,0.42%
2020-01-01 00:09:20,9,10,2619,126,2493,4.00%,4.81%
2020-01-01 00:09:20,9,11,8286,571,7715,12.64%,6.89%
2020-01-01 00:09:20,9,12,5303,209,5094,8.09%,3.94%
2020-01-01 00:09:20,10,1,1187,276,911,1.81%,23.23%
2020-01-01 00:09:20,10,2,4243,392,3851,6.47%,9.24%
2020-01-01 00:09:20,10,3,2874,64,2810,4.39%,2.23%
2020-01-01 00:09:20,10,4,4427,1102,3325,6.76%,24.89%
2020-01-01 00:09:20,10,5,646,24,622,0.99%,3.71%
2020-01-01 00:09:20,10,6,6861,1289,5572,10.47%,18.78%
2020-01-01 00:09:20,10,7,12627,2225,10402,19.27%,17.62%
2020-01-01 00:09:20,10,8,29936,7631,22305,45.68%,25.49%
2020-01-01 00:09:20,10,9,727,7,720,1.11%,0.96%
2020-01-01 00:09:20,10,10,2610,61,2549,3.98%,2.34%
2020-01-01 00:09:20,10,11,12895,1617,11278,19.68%,12.54%
2020-01-01 00:09:20,10,12,9492,1089,8403,14.48%,11.47%
2020-01-01 00:09:20,11,1,2955,70,2885,4.51%,2.37%
2020-01-01 00:09:20,11,2,4555,179,4376,6.95%,3.93%
2020-01-01 00:09:20,11,3,1448,23,1425,2.21%,1.59%
2020-01-01 00:09:20,11,4,5466,220,5246,8.34%,4.02%
2020-01-01 00:09:20,11,5,247,1,246,0.38%,0.40%
2020-01-01 00:09:20,11,6,6434,297,6137,9.82%,4.62%
2020-01-01 00:09:20,11,7,12710,1155,11555,19.39%,9.09%
2020-01-01 00:09:20,11,8,27391,4957,22434,41.80%,18.10%
2020-01-01 00:09:20,11,9,302,0,302,0.46%,0.00%
2020-01-01 00:09:20,11,10,3433,104,3329,5.24%,3.03%
2020-01-01 00:09:20,11,11,10242,773,9469,15.63%,7.55%
2020-01-01 00:09:20,11,12,6448,319,6129,9.84%,4.95%
2020-01-01 00:09:20,12,1,27,0,27,0.04%,0.00%
2020-01-01 00:09:20,12,2,676,201,475,1.03%,29.69%
2020-01-01 00:09:20,12,3,2691,243,2448,4.11%,9.03%
2020-01-01 00:09:20,12,4,2810,56,2754,4.29%,1.99%
2020-01-01 00:09:20,12,5,8600,705,7895,13.12%,8.20%
2020-01-01 00:09:20,12,6,4920,188,4732,7.51%,3.82%
2020-01-01 00:09:20,12,7,1989,52,1937,3.03%,2.61%
2020-01-01 00:09:20,12,8,1120,182,938,1.71%,16.24%
2020-01-01 00:09:20,12,9,26949,5679,21270,41.12%,21.07%
2020-01-01 00:09:20,12,10,4270,289,3981,6.52%,6.77%
2020-01-01 00:09:20,12,11,1344,186,1158,2.05%,13.83%
2020-01-01 00:09:20,12,12,12583,1808,10775,19.20%,14.37%
2020-01-01 00:09:20,13,1,2381,39,2342,3.63%,1.64%
2020-01-01 00:09:20,13,2,2745,52,2693,4.19%,1.89%
2020-01-01 00:09:20,13,3,611,7,604,0.93%,1.14%
2020-01-01 00:09:20,13,4,5988,707,5281,9.14%,11.80%
2020-01-01 00:09:20,13,5,8050,1056,6994,12.28%,13.12%
2020-01-01 00:09:20,13,6,6586,767,5819,10.05%,11.64%
2020-01-01 00:09:20,13,7,5484,235,5249,8.37%,4.28%
2020-01-01 00:09:20,13,8,7641,432,7209,11.66%,5.65%
2020-01-01 00:09:20,13,9,8341,1084,7257,12.73%,12.99%
2020-01-01 00:09:20,13,10,29177,6262,22915,44.52%,21.46%
2020-01-01 00:09:20,13,11,18309,2649,15660,27.94%,14.47%
2020-01-01 00:09:20,13,12,10219,1109,9110,15.59%,10.85%
2020-01-01 00:09:20,14,1,399,0,399,0.61%,0.00%
2020-01-01 00:09:20,14,2,1817,28,1789,2.77%,1.54%
2020-01-01 00:09:20,14,3,1043,13,1030,1.59%,1.25%
2020-01-01 00:09:20,14,4,4502,134,4368,6.87%,2.98%
2020-01-01 00:09:20,14,5,1797,24,1773,2.74%,1.33%
2020-01-01 00:09:20,14,6,4829,156,4673,7.37%,3.23%
2020-01-01 00:09:20,14,7,12732,1106,11626,19.43%,8.69%
2020-01-01 00:09:20,14,8,14568,1467,13101,22.23%,10.07%
2020-01-01 00:09:20,14,9,2135,34,2101,3.26%,1.59%
2020-01-01 00:09:20,14,10,4813,194,4619,7.34%,4.03%
2020-01-01 00:09:20,14,11,26992,4868,22124,41.19%,18.03%
2020-01-01 00:09:20,14,12,7363,393,6970,11.24%,5.34%
2020-01-01 00:09:20,15,1,550,1,549,0.84%,0.18%
2020-01-01 00:09:20,15,2,166,2,164,0.25%,1.20%
2020-01-01 00:09:20,15,3,5441,213,5228,8.30%,3.91%
2020-01-01 00:09:20,15,4,7226,392,6834,11.03%,5.42%
2020-01-01 00:09:20,15,5,13380,1348,12032,20.42%,10.07%
2020-01-01 00:09:20,15,6,7440,419,7021,11.35%,5.63%
2020-01-01 00:09:20,15,7,3934,117,3817,6.00%,2.97%
2020-01-01 00:09:20,15,8,5356,221,5135,8.17%,4.13%
2020-01-01 00:09:20,15,9,13637,1392,12245,20.81%,10.21%
2020-01-01 00:09:20,15,10,4217,173,4044,6.43%,4.10%
2020-01-01 00:09:20,15,11,9735,715,9020,14.85%,7.34%
2020-01-01 00:09:20,15,12,29105,5901,23204,44.41%,20.27%
2020-01-01 00:09:20,16,1,529,3,526,0.81%,0.57%
2020-01-01 00:09:20,16,2,269,1,268,0.41%,0.37%
2020-01-01 00:09:20,16,3,1068,18,1050,1.63%,1.68%
2020-01-01 00:09:20,16,4,4672,184,4488,7.13%,3.94%
2020-01-01 00:09:20,16,5,7786,496,7290,11.88%,6.37%
2020-01-01 00:09:20,16,6,5615,248,5367,8.57%,4.42%
2020-01-01 00:09:20,16,7,3458,99,3359,5.28%,2.86%
2020-01-01 00:09:20,16,8,8096,503,7593,12.35%,6.21%
2020-01-01 00:09:20,16,9,8187,541,7646,12.49%,6.61%
2020-01-01 00:09:20,16,10,1495,22,1473,2.28%,1.47%
2020-01-01 00:09:20,16,11,9738,709,9029,14.86%,7.28%
2020-01-01 00:09:20,16,12,27039,4939,22100,41.26%,18.27%
2020-01-01 00:09:30,1,1,19950,2798,17152,30.44%,14.02%
2020-01-01 00:09:30,1,2,8575,516,8059,13.08%,6.02%
2020-01-01 00:09:30,1,3,333,0,333,0.51%,0.00%
2020-01-01 00:09:30,1,4,10994,963,10031,16.78%,8.76%
2020-01-01 00:09:30,1,5,10820,919,9901,16.51%,8.49%
2020-01-01 00:09:30,1,6,10763,913,9850,16.42%,8.48%
2020-01-01 00:09:30,1,7,8237,479,7758,12.57%,5.81%
2020-01-01 00:09:30,1,8,7321,372,6949,11.17%,5.08%
2020-01-01 00:09:30,1,9,10720,907,9813,16.36%,8.46%
2020-01-01 00:09:30,1,10,6880,330,6550,10.50%,4.80%
2020-01-01 00:09:30,1,11,6946,337,6609,10.60%,4.85%
2020-01-01 00:09:30,1,12,10688,901,9787,16.31%,8.43%
2020-01-01 00:09:30,2,1,393,2,391,0.60%,0.51%
2020-01-01 00:09:30,2,2,25687,4466,21221,39.20%,17.39%
2020-01-01 00:09:30,2,3,21231,3132,18099,32.40%,14.75%
2020-01-01 00:09:30,2,4,292,1,291,0.45%,0.34%
2020-01-01 00:09:30,2,5,12817,1165,11652,19.56%,9.09%
2020-01-01 00:09:30,2,6,55,0,55,0.08%,0.00%
2020-01-01 00:09:30,2,7,4056,131,3925,6.19%,3.23%
2020-01-01 00:09:30,2,8,3084,74,3010,4.71%,2.40%
2020-01-01 00:09:30,2,9,12765,1157,11608,19.48%,9.06%
2020-01-01 00:09:30,2,10,2455,47,2408,3.75%,1.91%
2020-01-01 00:09:30,2,11,2469,47,2422,3.77%,1.90%
2020-01-01 00:09:30,2,12,12602,1127,11475,19.23%,8.94%
2020-01-01 00:09:30,3,1,1928,41,1887,2.94%,2.13%
2020-01-01 00:09:30,3,2,23811,3923,19888,36.33%,16.47%
2020-01-01 00:09:30,3,3,75402,30681,44721,115.05%,40.69%
2020-01-01 00:09:30,3,4,7690,390,7300,11.73%,5.07%
2020-01-01 00:09:30,3,5,50124,14985,35139,76.48%,29.90%
2020-01-01 00:09:30,3,6,8976,547,8429,13.70%,6.09%
2020-01-01 00:09:30,3,7,19743,2766,16977,30.13%,14.01%
2020-01-01 00:09:30,3,8,15280,1718,13562,23.32%,11.24%
2020-01-01 00:09:30,3,9,40734,10277,30457,62.16%,25.23%
2020-01-01 00:09:30,3,10,9682,687,8995,14.77%,7.09%
2020-01-01 00:09:30,3,11,1951,29,1922,2.98%,1.49%
2020-01-01 00:09:30,3,12,27180,4821,22359,41.47%,17.74%
2020-01-01 00:09:30,4,1,430,5,425,0.66%,1.16%
2020-01-01 00:09:30,4,2,245,1,244,0.37%,0.41%
2020-01-01 00:09:30,4,3,799,7,792,1.22%,0.88%
2020-01-01 00:09:30,4,4,29338,5663,23675,44.77%,19.30%
2020-01-01 00:09:30,4,5,17249,2064,15185,26.32%,11.97%
2020-01-01 00:09:30,4,6,24173,3938,20235,36.89%,16.29%
2020-01-01 00:09:30,4,7,5625,225,5400,8.58%,4.00%
2020-01-01 00:09:30,4,8,2951,53,2898,4.50%,1.80%
2020-01-01 00:09:30,4,9,15212,1626,13586,23.21%,10.69%
2020-01-01 00:09:30,4,10,2227,33,2194,3.40%,1.48%
2020-01-01 00:09:30,4,11,147,0,147,0.22%,0.00%
2020-01-01 00:09:30,4,12,12275,1085,11190,18.73%,8.84%
2020-01-01 00:09:30,5,1,2823,60,2763,4.31%,2.12%
2020-01-01 00:09:30,5,2,732,6,726,1.12%,0.82%
2020-01-01 00:09:30,5,3,1212,4,1208,1.85%,0.33%
2020-01-01 00:09:30,5,4,23452,3830,19622,35.78%,16.33%
2020-01-01 00:09:30,5,5,10660,802,9858,16.27%,7.52%
2020-01-01 00:09:30,5,6,15782,1800,13982,24.08%,11.40%
2020-01-01 00:09:30,5,7,4661,177,4484,7.11%,3.80%
2020-01-01 00:09:30,5,8,3721,107,3614,5.68%,2.87%
2020-01-01 00:09:30,5,9,8983,569,8414,13.71%,6.33%
2020-01-01 00:09:30,5,10,1174,10,1164,1.79%,0.85%
2020-01-01 00:09:30,5,11,828,8,820,1.26%,0.97%
2020-01-01 00:09:30,5,12,7537,389,7148,11.50%,5.16%
2020-01-01 00:09:30,6,1,1064,9,1055,1.62%,0.85%
2020-01-01 00:09:30,6,2,1175,13,1162,1.79%,1.11%
2020-01-01 00:09:30,6,3,1601,24,1577,2.44%,1.50%
2020-01-01 00:09:30,6,4,1630,18,1612,2.49%,1.10%
2020-01-01 00:09:30,6,5,13776,1407,12369,21.02%,10.21%
2020-01-01 00:09:30,6,6,4507,187,4320,6.88%,4.15%
2020-01-01 00:09:30,6,7,2395,44,2351,3.65%,1.84%
2020-01-01 00:09:30,6,8,1879,31,1848,2.87%,1.65%
2020-01-01 00:09:30,6,9,7254,391,6863,11.07%,5.39%
2020-01-01 00:09:30,6,10,2048,31,2017,3.12%,1.51%
2020-01-01 00:09:30,6,11,408,2,406,0.62%,0.49%
2020-01-01 00:09:30,6,12,5141,214,4927,7.84%,4.16%
2020-01-01 00:09:30,7,1,561,6,555,0.86%,1.07%
2020-01-01 00:09:30,7,2,81,0,81,0.12%,0.00%
2020-01-01 00:09:30,7,3,1419,6,1413,2.17%,0.42%
2020-01-01 00:09:30,7,4,1901,29,1872,2.90%,1.52%
2020-01-01 00:09:30,7,5,8346,520,7826,12.73%,6.23%
2020-01-01 00:09:30,7,6,13124,1251,11873,20.03%,9.53%
2020-01-01 00:09:30,7,7,2838,69,2769,4.33%,2.43%
2020-01-01 00:09:30,7,8,1049,8,1041,1.60%,0.76%
2020-01-01 00:09:30,7,9,6763,364,6399,10.32%,5.38%
2020-01-01 00:09:30,7,10,1267,16,1251,1.93%,1.26%
2020-01-01 00:09:30,7,11,90,0,90,0.14%,0.00%
2020-01-01 00:09:30,7,12,5478,238,5240,8.36%,4.34%
2020-01-01 00:09:30,8,1,403,3,400,0.61%,0.74%
2020-01-01 00:09:30,8,2,96,0,96,0.15%,0.00%
2020-01-01 00:09:30,8,3,1296,11,1285,1.98%,0.85%
2020-01-01 00:09:30,8,4,2672,55,2617,4.08%,2.06%
2020-01-01 00:09:30,8,5,7272,395,6877,11.10%,5.43%
2020-01-01 00:09:30,8,6,15944,1769,14175,24.33%,11.09%
2020-01-01 00:09:30,8,7,5919,242,5677,9.03%,4.09%
2020-01-01 00:09:30,8,8,2602,56,2546,3.97%,2.15%
2020-01-01 00:09:30,8,9,5693,239,5454,8.69%,4.20%
2020-01-01 00:09:30,8,10,1570,17,1553,2.40%,1.08%
2020-01-01 00:09:30,8,11,220,0,220,0.34%,0.00%
2020-01-01 00:09:30,8,12,4060,125,3935,6.20%,3.08%
2020-01-01 00:09:30,9,1,1457,15,1442,2.22%,1.03%
2020-01-01 00:09:30,9,2,4614,148,4466,7.04%,3.21%
2020-01-01 00:09:30,9,3,2747,61,2686,4.19%,2.22%
2020-01-01 00:09:30,9,4,5123,173,4950,7.82%,3.38%
2020-01-01 00:09:30,9,5,488,3,485,0.74%,0.61%
2020-01-01 00:09:30,9,6,6096,249,5847,9.30%,4.08%
2020-01-01 00:09:30,9,7,28957,5520,23437,44.18%,19.06%
2020-01-01 00:09:30,9,8,9692,650,9042,14.79%,6.71%
2020-01-01 00:09:30,9,9,359,0,359,0.55%,0.00%
2020-01-01 00:09:30,9,10,3242,63,3179,4.95%,1.94%
2020-01-01 00:09:30,9,11,8507,504,8003,12.98%,5.92%
2020-01-01 00:09:30,9,12,4856,172,4684,7.41%,3.54%
2020-01-01 00:09:30,10,1,1096,197,899,1.67%,17.96%
2020-01-01 00:09:30,10,2,3685,286,3399,5.62%,7.76%
2020-01-01 00:09:30,10,3,2402,46,2356,3.67%,1.91%
2020-01-01 00:09:30,10,4,3823,890,2933,5.83%,23.27%
2020-01-01 00:09:30,10,5,710,4,706,1.08%,0.56%
2020-01-01 00:09:30,10,6,5886,1026,4860,8.98%,17.43%
2020-01-01 00:09:30,10,7,11236,1784,9452,17.14%,15.88%
2020-01-01 00:09:30,10,8,29051,7211,21840,44.33%,24.82%
2020-01-01 00:09:30,10,9,804,5,799,1.23%,0.62%
2020-01-01 00:09:30,10,10,2434,42,2392,3.71%,1.72%
2020-01-01 00:09:30,10,11,13644,1915,11729,20.82%,14.03%
2020-01-01 00:09:30,10,12,10635,1416,9219,16.23%,13.31%
2020-01-01 00:09:30,11,1,2620,77,2543,4.00%,2.94%
2020-01-01 00:09:30,11,2,4304,165,4139,6.57%,3.83%
2020-01-01 00:09:30,11,3,1543,18,1525,2.35%,1.17%
2020-01-01 00:09:30,11,4,5650,239,5411,8.62%,4.23%
2020-01-01 00:09:30,11,5,418,0,418,0.64%,0.00%
2020-01-01 00:09:30,11,6,6668,332,6336,10.17%,4.98%
2020-01-01 00:09:30,11,7,12754,1187,11567,19.46%,9.31%
2020-01-01 00:09:30,11,8,26515,4840,21675,40.46%,18.25%
2020-01-01 00:09:30,11,9,215,0,215,0.33%,0.00%
2020-01-01 00:09:30,11,10,3101,94,3007,4.73%,3.03%
2020-01-01 00:09:30,11,11,9851,767,9084,15.03%,7.79%
2020-01-01 00:09:30,11,12,6451,335,6116,9.84%,5.19%
2020-01-01 00:09:30,12,1,82,0,82,0.13%,0.00%
2020-01-01 00:09:30,12,2,699,215,484,1.07%,30.71%
2020-01-01 00:09:30,12,3,2525,251,2274,3.85%,9.94%
2020-01-01 00:09:30,12,4,2624,51,2573,4.00%,1.94%
2020-01-01 00:09:30,12,5,8439,709,7730,12.88%,8.40%
2020-01-01 00:09:30,12,6,5160,206,4954,7.87%,3.99%
2020-01-01 00:09:30,12,7,2384,63,2321,3.64%,2.64%
2020-01-01 00:09:30,12,8,1477,349,1128,2.25%,23.61%
2020-01-01 00:09:30,12,9,23240,4745,18495,35.46%,20.42%
2020-01-01 00:09:30,12,10,4272,496,3776,6.52%,11.61%
2020-01-01 00:09:30,12,11,1670,351,1319,2.55%,21.01%
2020-01-01 00:09:30,12,12,9675,1331,8344,14.76%,13.76%
2020-01-01 00:09:30,13,1,2291,40,2251,3.50%,1.75%
2020-01-01 00:09:30,13,2,2623,54,2569,4.00%,2.06%
2020-01-01 00:09:30,13,3,542,0,542,0.83%,0.00%
2020-01-01 00:09:30,13,4,5196,518,4678,7.93%,9.97%
2020-01-01 00:09:30,13,5,7108,821,6287,10.85%,11.55%
2020-01-01 00:09:30,13,6,5830,575,5255,8.90%,9.86%
2020-01-01 00:09:30,13,7,5248,203,5045,8.01%,3.87%
2020-01-01 00:09:30,13,8,7416,402,7014,11.32%,5.42%
2020-01-01 00:09:30,13,9,7382,846,6536,11.26%,11.46%
2020-01-01 00:09:30,13,10,27213,5693,21520,41.52%,20.92%
2020-01-01 00:09:30,13,11,17203,2511,14692,26.25%,14.60%
2020-01-01 00:09:30,13,12,9343,1144,8199,14.26%,12.24%
2020-01-01 00:09:30,14,1,360,0,360,0.55%,0.00%
2020-01-01 00:09:30,14,2,1568,18,1550,2.39%,1.15%
2020-01-01 00:09:30,14,3,894,1,893,1.36%,0.11%
2020-01-01 00:09:30,14,4,4375,137,4238,6.68%,3.13%
2020-01-01 00:09:30,14,5,1108,13,1095,1.69%,1.17%
2020-01-01 00:09:30,14,6,4595,150,4445,7.01%,3.26%
2020-01-01 00:09:30,14,7,11811,1014,10797,18.02%,8.58%
2020-01-01 00:09:30,14,8,13279,1250,12029,20.26%,9.41%
2020-01-01 00:09:30,14,9,1446,19,1427,2.21%,1.31%
2020-01-01 00:09:30,14,10,4008,115,3893,6.12%,2.87%
2020-01-01 00:09:30,14,11,26615,4664,21951,40.61%,17.52%
2020-01-01 00:09:30,14,12,9169,627,8542,13.99%,6.84%
2020-01-01 00:09:30,15,1,530,3,527,0.81%,0.56%
2020-01-01 00:09:30,15,2,185,0,185,0.28%,0.00%
2020-01-01 00:09:30,15,3,3723,133,3590,5.68%,3.57%
2020-01-01 00:09:30,15,4,4778,213,4565,7.29%,4.46%
2020-01-01 00:09:30,15,5,9639,725,8914,14.71%,7.52%
2020-01-01 00:09:30,15,6,5022,232,4790,7.66%,4.62%
2020-01-01 00:09:30,15,7,4121,162,3959,6.29%,3.93%
2020-01-01 00:09:30,15,8,6492,322,6170,9.91%,4.96%
2020-01-01 00:09:30,15,9,9835,746,9089,15.01%,7.58%
2020-01-01 00:09:30,15,10,3556,180,3376,5.43%,5.06%
2020-01-01 00:09:30,15,11,10192,865,9327,15.55%,8.49%
2020-01-01 00:09:30,15,12,26086,5064,21022,39.80%,19.41%
2020-01-01 00:09:30,16,1,467,3,464,0.71%,0.64%
2020-01-01 00:09:30,16,2,162,0,162,0.25%,0.00%
2020-01-01 00:09:30,16,3,1637,23,1614,2.50%,1.40%
2020-01-01 00:09:30,16,4,4536,170,4366,6.92%,3.75%
2020-01-01 00:09:30,16,5,7924,492,7432,12.09%,6.21%
2020-01-01 00:09:30,16,6,5247,219,5028,8.01%,4.17%
2020-01-01 00:09:30,16,7,3572,104,3468,5.45%,2.91%
2020-01-01 00:09:30,16,8,7699,511,7188,11.75%,6.64%
2020-01-01 00:09:30,16,9,8308,534,7774,12.68%,6.43%
2020-01-01 00:09:30,16,10,1662,14,1648,2.54%,0.84%
2020-01-01 00:09:30,16,11,9505,741,8764,14.50%,7.80%
2020-01-01 00:09:30,16,12,25651,4438,21213,39.14%,17.30%
2020-01-01 00:09:40,1,1,19978,2823,17155,30.48%,14.13%
2020-01-01 00:09:40,1,2,10066,728,9338,15.36%,7.23%
2020-01-01 00:09:40,1,3,436,2,434,0.67%,0.46%
2020-01-01 00:09:40,1,4,9450,708,8742,14.42%,7.49%
2020-01-01 00:09:40,1,5,8853,628,8225,13.51%,7.09%
2020-01-01 00:09:40,1,6,8788,620,8168,13.41%,7.05%
2020-01-01 00:09:40,1,7,9618,660,8958,14.68%,6.86%
2020-01-01 00:09:40,1,8,3739,110,3629,5.71%,2.94%
2020-01-01 00:09:40,1,9,8754,613,8141,13.36%,7.00%
2020-01-01 00:09:40,1,10,3252,85,3167,4.96%,2.61%
2020-01-01 00:09:40,1,11,3300,87,3213,5.04%,2.64%
2020-01-01 00:09:40,1,12,8725,610,8115,13.31%,6.99%
2020-01-01 00:09:40,2,1,2044,50,1994,3.12%,2.44%
2020-01-01 00:09:40,2,2,32209,6790,25419,49.15%,21.08%
2020-01-01 00:09:40,2,3,25137,4246,20891,38.36%,16.89%
2020-01-01 00:09:40,2,4,1970,45,1925,3.01%,2.28%
2020-01-01 00:09:40,2,5,15042,1610,13432,22.95%,10.70%
2020-01-01 00:09:40,2,6,27,0,27,0.04%,0.00%
2020-01-01 00:09:40,2,7,5013,190,4823,7.65%,3.79%
2020-01-01 00:09:40,2,8,3554,105,3449,5.42%,2.95%
2020-01-01 00:09:40,2,9,14999,1605,13394,22.89%,10.70%
2020-01-01 00:09:40,2,10,2881,66,2815,4.40%,2.29%
2020-01-01 00:09:40,2,11,2894,66,2828,4.42%,2.28%
2020-01-01 00:09:40,2,12,14843,1575,13268,22.65%,10.61%
2020-01-01 00:09:40,3,1,2325,43,2282,3.55%,1.85%
2020-01-01 00:09:40,3,2,22411,3435,18976,34.20%,15.33%
2020-01-01 00:09:40,3,3,70876,27440,43436,108.15%,38.71%
2020-01-01 00:09:40,3,4,13026,1235,11791,19.88%,9.48%
2020-01-01 00:09:40,3,5,47381,13592,33789,72.30%,28.69%
2020-01-01 00:09:40,3,6,14443,1488,12955,22.04%,10.30%
2020-01-01 00:09:40,3,7,18283,2308,15975,27.90%,12.62%
2020-01-01 00:09:40,3,8,15785,1740,14045,24.09%,11.02%
2020-01-01 00:09:40,3,9,32167,6765,25402,49.08%,21.03%
2020-01-01 00:09:40,3,10,5896,244,5652,9.00%,4.14%
2020-01-01 00:09:40,3,11,2262,58,2204,3.45%,2.56%
2020-01-01 00:09:40,3,12,23977,3883,20094,36.59%,16.19%
2020-01-01 00:09:40,4,1,589,6,583,0.90%,1.02%
2020-01-01 00:09:40,4,2,383,4,379,0.58%,1.04%
2020-01-01 00:09:40,4,3,847,6,841,1.29%,0.71%
2020-01-01 00:09:40,4,4,27504,4966,22538,41.97%,18.05%
2020-01-01 00:09:40,4,5,16455,1870,14585,25.11%,11.36%
2020-01-01 00:09:40,4,6,23069,3549,19520,35.20%,15.38%
2020-01-01 00:09:40,4,7,5377,224,5153,8.20%,4.17%
2020-01-01 00:09:40,4,8,2936,67,2869,4.48%,2.28%
2020-01-01 00:09:40,4,9,14405,1420,12985,21.98%,9.86%
2020-01-01 00:09:40,4,10,1996,25,1971,3.05%,1.25%
2020-01-01 00:09:40,4,11,164,1,163,0.25%,0.61%
2020-01-01 00:09:40,4,12,11702,933,10769,17.86%,7.97%
2020-01-01 00:09:40,5,1,2154,42,2112,3.29%,1.95%
2020-01-01 00:09:40,5,2,624,6,618,0.95%,0.96%
2020-01-01 00:09:40,5,3,514,5,509,0.78%,0.97%
2020-01-01 00:09:40,5,4,21966,3429,18537,33.52%,15.61%
2020-01-01 00:09:40,5,5,9136,634,8502,13.94%,6.94%
2020-01-01 00:09:40,5,6,13505,1360,12145,20.61%,10.07%
2020-01-01 00:09:40,5,7,3907,142,3765,5.96%,3.63%
2020-01-01 00:09:40,5,8,2878,64,2814,4.39%,2.22%
2020-01-01 00:09:40,5,9,8137,511,7626,12.42%,6.28%
2020-01-01 00:09:40,5,10,1091,13,1078,1.66%,1.19%
2020-01-01 00:09:40,5,11,449,2,447,0.69%,0.44%
2020-01-01 00:09:40,5,12,6753,337,6416,10.30%,4.99%
2020-01-01 00:09:40,6,1,956,7,949,1.46%,0.73%
2020-01-01 00:09:40,6,2,1057,7,1050,1.61%,0.66%
2020-01-01 00:09:40,6,3,1660,18,1642,2.53%,1.08%
2020-01-01 00:09:40,6,4,1030,7,1023,1.57%,0.68%
2020-01-01 00:09:40,6,5,11909,1071,10838,18.17%,8.99%
2020-01-01 00:09:40,6,6,3971,131,3840,6.06%,3.30%
2020-01-01 00:09:40,6,7,2549,63,2486,3.89%,2.47%
2020-01-01 00:09:40,6,8,2113,42,2071,3.22%,1.99%
2020-01-01 00:09:40,6,9,5942,286,5656,9.07%,4.81%
2020-01-01 00:09:40,6,10,1740,24,1716,2.66%,1.38%
2020-01-01 00:09:40,6,11,427,2,425,0.65%,0.47%
2020-01-01 00:09:40,6,12,4157,148,4009,6.34%,3.56%
2020-01-01 00:09:40,7,1,537,0,537,0.82%,0.00%
2020-01-01 00:09:40,7,2,161,0,161,0.25%,0.00%
2020-01-01 00:09:40,7,3,703,2,701,1.07%,0.28%
2020-01-01 00:09:40,7,4,2522,47,2475,3.85%,1.86%
2020-01-01 00:09:40,7,5,7552,416,7136,11.52%,5.51%
2020-01-01 00:09:40,7,6,13721,1335,12386,20.94%,9.73%
2020-01-01 00:09:40,7,7,3529,92,3437,5.38%,2.61%
2020-01-01 00:09:40,7,8,1340,18,1322,2.04%,1.34%
2020-01-01 00:09:40,7,9,6439,305,6134,9.83%,4.74%
2020-01-01 00:09:40,7,10,1075,7,1068,1.64%,0.65%
2020-01-01 00:09:40,7,11,82,0,82,0.13%,0.00%
2020-01-01 00:09:40,7,12,5341,207,5134,8.15%,3.87%
2020-01-01 00:09:40,8,1,539,3,536,0.82%,0.56%
2020-01-01 00:09:40,8,2,73,0,73,0.11%,0.00%
2020-01-01 00:09:40,8,3,1556,36,1520,2.37%,2.31%
2020-01-01 00:09:40,8,4,2561,54,2507,3.91%,2.11%
2020-01-01 00:09:40,8,5,7798,448,7350,11.90%,5.74%
2020-01-01 00:09:40,8,6,16570,1942,14628,25.28%,11.72%
2020-01-01 00:09:40,8,7,6111,306,5805,9.32%,5.01%
2020-01-01 00:09:40,8,8,2086,44,2042,3.18%,2.11%
2020-01-01 00:09:40,8,9,5784,246,5538,8.83%,4.25%
2020-01-01 00:09:40,8,10,1752,28,1724,2.67%,1.60%
2020-01-01 00:09:40,8,11,146,0,146,0.22%,0.00%
2020-01-01 00:09:40,8,12,3990,119,3871,6.09%,2.98%
2020-01-01 00:09:40,9,1,825,2,823,1.26%,0.24%
2020-01-01 00:09:40,9,2,2114,33,2081,3.23%,1.56%
2020-01-01 00:09:40,9,3,985,7,978,1.50%,0.71%
2020-01-01 00:09:40,9,4,2730,71,2659,4.17%,2.60%
2020-01-01 00:09:40,9,5,600,1,599,0.92%,0.17%
2020-01-01 00:09:40,9,6,3853,119,3734,5.88%,3.09%
2020-01-01 00:09:40,9,7,23602,3810,19792,36.01%,16.14%
2020-01-01 00:09:40,9,8,9999,690,9309,15.26%,6.90%
2020-01-01 00:09:40,9,9,371,0,371,0.57%,0.00%
2020-01-01 00:09:40,9,10,3383,81,3302,5.16%,2.39%
2020-01-01 00:09:40,9,11,9024,566,8458,13.77%,6.27%
2020-01-01 00:09:40,9,12,5339,212,5127,8.15%,3.97%
2020-01-01 00:09:40,10,1,1462,243,1219,2.23%,16.61%
2020-01-01 00:09:40,10,2,3045,297,2748,4.65%,9.75%
2020-01-01 00:09:40,10,3,1453,17,1436,2.22%,1.17%
2020-01-01 00:09:40,10,4,3604,842,2762,5.50%,23.36%
2020-01-01 00:09:40,10,5,873,80,793,1.33%,9.15%
2020-01-01 00:09:40,10,6,5652,1033,4619,8.62%,18.27%
2020-01-01 00:09:40,10,7,10436,1752,8684,15.92%,16.79%
2020-01-01 00:09:40,10,8,29192,7272,21920,44.54%,24.91%
2020-01-01 00:09:40,10,9,567,3,564,0.87%,0.53%
2020-01-01 00:09:40,10,10,2257,34,2223,3.44%,1.51%
2020-01-01 00:09:40,10,11,13069,1532,11537,19.94%,11.72%
2020-01-01 00:09:40,10,12,9968,1049,8919,15.21%,10.52%
2020-01-01 00:09:40,11,1,2358,36,2322,3.60%,1.53%
2020-01-01 00:09:40,11,2,3564,97,3467,5.44%,2.72%
2020-01-01 00:09:40,11,3,1094,6,1088,1.67%,0.55%
2020-01-01 00:09:40,11,4,2963,73,2890,4.52%,2.46%
2020-01-01 00:09:40,11,5,211,0,211,0.32%,0.00%
2020-01-01 00:09:40,11,6,3688,102,3586,5.63%,2.76%
2020-01-01 00:09:40,11,7,8853,583,8270,13.51%,6.58%
2020-01-01 00:09:40,11,8,23135,3697,19438,35.30%,15.98%
2020-01-01 00:09:40,11,9,124,3,121,0.19%,2.40%
2020-01-01 00:09:40,11,10,3395,82,3313,5.18%,2.41%
2020-01-01 00:09:40,11,11,10345,768,9577,15.79%,7.42%
2020-01-01 00:09:40,11,12,6583,319,6264,10.04%,4.85%
2020-01-01 00:09:40,12,1,55,0,55,0.08%,0.00%
2020-01-01 00:09:40,12,2,557,132,425,0.85%,23.66%
2020-01-01 00:09:40,12,3,2521,169,2352,3.85%,6.70%
2020-01-01 00:09:40,12,4,3377,112,3265,5.15%,3.32%
2020-01-01 00:09:40,12,5,8363,638,7725,12.76%,7.63%
2020-01-01 00:09:40,12,6,5237,233,5004,7.99%,4.45%
2020-01-01 00:09:40,12,7,1739,26,1713,2.65%,1.49%
2020-01-01 00:09:40,12,8,1471,324,1147,2.24%,22.01%
2020-01-01 00:09:40,12,9,21320,4181,17139,32.53%,19.61%
2020-01-01 00:09:40,12,10,4810,495,4315,7.34%,10.29%
2020-01-01 00:09:40,12,11,1921,332,1589,2.93%,17.27%
2020-01-01 00:09:40,12,12,7711,1245,6466,11.77%,16.14%
2020-01-01 00:09:40,13,1,2036,38,1998,3.11%,1.87%
2020-01-01 00:09:40,13,2,2422,50,2372,3.70%,2.06%
2020-01-01 00:09:40,13,3,805,3,802,1.23%,0.37%
2020-01-01 00:09:40,13,4,4349,660,3689,6.64%,15.17%
2020-01-01 00:09:40,13,5,6525,991,5534,9.96%,15.19%
2020-01-01 00:09:40,13,6,4860,695,4165,7.42%,14.30%
2020-01-01 00:09:40,13,7,4437,172,4265,6.77%,3.88%
2020-01-01 00:09:40,13,8,17619,2188,15431,26.88%,12.42%
2020-01-01 00:09:40,13,9,6978,1029,5949,10.65%,14.74%
2020-01-01 00:09:40,13,10,37992,9819,28173,57.97%,25.84%
2020-01-01 00:09:40,13,11,28059,5518,22541,42.81%,19.67%
2020-01-01 00:09:40,13,12,10038,1116,8922,15.32%,11.12%
2020-01-01 00:09:40,14,1,170,0,170,0.26%,0.00%
2020-01-01 00:09:40,14,2,1526,16,1510,2.33%,1.05%
2020-01-01 00:09:40,14,3,1131,5,1126,1.73%,0.44%
2020-01-01 00:09:40,14,4,3729,112,3617,5.69%,3.00%
2020-01-01 00:09:40,14,5,957,11,946,1.46%,1.15%
2020-01-01 00:09:40,14,6,3887,119,3768,5.93%,3.06%
2020-01-01 00:09:40,14,7,11161,865,10296,17.03%,7.75%
2020-01-01 00:09:40,14,8,13499,1255,12244,20.60%,9.30%
2020-01-01 00:09:40,14,9,1141,13,1128,1.74%,1.14%
2020-01-01 00:09:40,14,10,3815,120,3695,5.82%,3.14%
2020-01-01 00:09:40,14,11,26975,4869,22106,41.16%,18.05%
2020-01-01 00:09:40,14,12,9265,630,8635,14.14%,6.80%
2020-01-01 00:09:40,15,1,475,4,471,0.72%,0.84%
2020-01-01 00:09:40,15,2,153,0,153,0.23%,0.00%
2020-01-01 00:09:40,15,3,3557,116,3441,5.43%,3.26%
2020-01-01 00:09:40,15,4,3843,162,3681,5.86%,4.21%
2020-01-01 00:09:40,15,5,9132,710,8422,13.93%,7.77%
2020-01-01 00:09:40,15,6,4088,196,3892,6.24%,4.79%
2020-01-01 00:09:40,15,7,3734,95,3639,5.70%,2.54%
2020-01-01 00:09:40,15,8,6012,275,5737,9.17%,4.57%
2020-01-01 00:09:40,15,9,9344,742,8602,14.26%,7.94%
2020-01-01 00:09:40,15,10,4339,382,3957,6.62%,8.80%
2020-01-01 00:09:40,15,11,10460,1021,9439,15.96%,9.76%
2020-01-01 00:09:40,15,12,25399,5006,20393,38.76%,19.71%
2020-01-01 00:09:40,16,1,398,0,398,0.61%,0.00%
2020-01-01 00:09:40,16,2,259,1,258,0.40%,0.38%
2020-01-01 00:09:40,16,3,1426,15,1411,2.18%,1.05%
2020-01-01 00:09:40,16,4,4661,165,4496,7.11%,3.54%
2020-01-01 00:09:40,16,5,8475,575,7900,12.93%,6.78%
2020-01-01 00:09:40,16,6,5466,223,5243,8.34%,4.08%
2020-01-01 00:09:40,16,7,3457,106,3351,5.27%,3.07%
2020-01-01 00:09:40,16,8,7398,547,6851,11.29%,7.39%
2020-01-01 00:09:40,16,9,8984,636,8348,13.71%,7.08%
2020-01-01 00:09:40,16,10,3731,147,3584,5.69%,3.94%
2020-01-01 00:09:40,16,11,11356,1077,10279,17.33%,9.48%
2020-01-01 00:09:40,16,12,27653,5394,22259,42.20%,19.51%
2020-01-01 00:09:50,1,1,17501,2179,15322,26.70%,12.45%
2020-01-01 00:09:50,1,2,8558,556,8002,13.06%,6.50%
2020-01-01 00:09:50,1,3,581,2,579,0.89%,0.34%
2020-01-01 00:09:50,1,4,8540,618,7922,13.03%,7.24%
2020-01-01 00:09:50,1,5,8265,584,7681,12.61%,7.07%
2020-01-01 00:09:50,1,6,8187,576,7611,12.49%,7.03%
2020-01-01 00:09:50,1,7,7968,480,7488,12.16%,6.02%
2020-01-01 00:09:50,1,8,4994,176,4818,7.62%,3.52%
2020-01-01 00:09:50,1,9,8164,575,7589,12.46%,7.04%
2020-01-01 00:09:50,1,10,4472,141,4331,6.82%,3.15%
2020-01-01 00:09:50,1,11,4526,142,4384,6.91%,3.14%
2020-01-01 00:09:50,1,12,8148,573,7575,12.43%,7.03%
2020-01-01 00:09:50,2,1,2561,49,2512,3.91%,1.91%
2020-01-01 00:09:50,2,2,52043,16276,35767,79.41%,31.27%
2020-01-01 00:09:50,2,3,34710,7835,26875,52.96%,22.57%
2020-01-01 00:09:50,2,4,2473,47,2426,3.77%,1.90%
2020-01-01 00:09:50,2,5,25461,4427,21034,38.85%,17.39%
2020-01-01 00:09:50,2,6,46,0,46,0.07%,0.00%
2020-01-01 00:09:50,2,7,14749,1600,13149,22.51%,10.85%
2020-01-01 00:09:50,2,8,4563,158,4405,6.96%,3.46%
2020-01-01 00:09:50,2,9,25419,4410,21009,38.79%,17.35%
2020-01-01 00:09:50,2,10,3787,106,3681,5.78%,2.80%
2020-01-01 00:09:50,2,11,3806,107,3699,5.81%,2.81%
2020-01-01 00:09:50,2,12,25267,4370,20897,38.55%,17.29%
2020-01-01 00:09:50,3,1,1647,23,1624,2.51%,1.40%
2020-01-01 00:09:50,3,2,20924,2995,17929,31.93%,14.31%
2020-01-01 00:09:50,3,3,67889,25564,42325,103.59%,37.66%
2020-01-01 00:09:50,3,4,12596,1157,11439,19.22%,9.18%
2020-01-01 00:09:50,3,5,45575,12757,32818,69.54%,27.99%
2020-01-01 00:09:50,3,6,14781,1547,13234,22.55%,10.47%
2020-01-01 00:09:50,3,7,17209,2070,15139,26.26%,12.03%
2020-01-01 00:09:50,3,8,13299,1279,12020,20.29%,9.62%
2020-01-01 00:09:50,3,9,30242,6066,24176,46.15%,20.06%
2020-01-01 00:09:50,3,10,3935,111,3824,6.00%,2.82%
2020-01-01 00:09:50,3,11,1570,12,1558,2.40%,0.76%
2020-01-01 00:09:50,3,12,23908,3911,19997,36.48%,16.36%
2020-01-01 00:09:50,4,1,501,1,500,0.76%,0.20%
2020-01-01 00:09:50,4,2,306,0,306,0.47%,0.00%
2020-01-01 00:09:50,4,3,743,21,722,1.13%,2.82%
2020-01-01 00:09:50,4,4,25707,4442,21265,39.23%,17.28%
2020-01-01 00:09:50,4,5,16022,1782,14240,24.45%,11.12%
2020-01-01 00:09:50,4,6,22084,3310,18774,33.70%,14.99%
2020-01-01 00:09:50,4,7,4905,176,4729,7.48%,3.59%
2020-01-01 00:09:50,4,8,2625,45,2580,4.01%,1.71%
2020-01-01 00:09:50,4,9,14141,1385,12756,21.58%,9.79%
2020-01-01 00:09:50,4,10,1729,32,1697,2.64%,1.85%
2020-01-01 00:09:50,4,11,205,1,204,0.31%,0.49%
2020-01-01 00:09:50,4,12,11078,827,10251,16.90%,7.46%
2020-01-01 00:09:50,5,1,2660,44,2616,4.06%,1.65%
2020-01-01 00:09:50,5,2,576,1,575,0.88%,0.17%
2020-01-01 00:09:50,5,3,463,3,460,0.71%,0.65%
2020-01-01 00:09:50,5,4,19122,2512,16610,29.18%,13.14%
2020-01-01 00:09:50,5,5,8228,516,7712,12.55%,6.27%
2020-01-01 00:09:50,5,6,12616,1167,11449,19.25%,9.25%
2020-01-01 00:09:50,5,7,3899,118,3781,5.95%,3.03%
2020-01-01 00:09:50,5,8,3148,81,3067,4.80%,2.57%
2020-01-01 00:09:50,5,9,7589,445,7144,11.58%,5.86%
2020-01-01 00:09:50,5,10,1644,14,1630,2.51%,0.85%
2020-01-01 00:09:50,5,11,438,1,437,0.67%,0.23%
2020-01-01 00:09:50,5,12,5695,262,5433,8.69%,4.60%
2020-01-01 00:09:50,6,1,917,7,910,1.40%,0.76%
2020-01-01 00:09:50,6,2,980,9,971,1.50%,0.92%
2020-01-01 00:09:50,6,3,1617,23,1594,2.47%,1.42%
2020-01-01 00:09:50,6,4,1505,144,1361,2.30%,9.56%
2020-01-01 00:09:50,6,5,11597,1076,10521,17.70%,9.28%
2020-01-01 00:09:50,6,6,4638,298,4340,7.08%,6.42%
2020-01-01 00:09:50,6,7,2675,57,2618,4.08%,2.13%
2020-01-01 00:09:50,6,8,1936,39,1897,2.95%,2.01%
2020-01-01 00:09:50,6,9,5149,183,4966,7.86%,3.55%
2020-01-01 00:09:50,6,10,1544,18,1526,2.36%,1.17%
2020-01-01 00:09:50,6,11,450,2,448,0.69%,0.44%
2020-01-01 00:09:50,6,12,3555,92,3463,5.42%,2.59%
2020-01-01 00:09:50,7,1,460,6,454,0.70%,1.30%
2020-01-01 00:09:50,7,2,246,2,244,0.38%,0.81%
2020-01-01 00:09:50,7,3,1487,12,1475,2.27%,0.81%
2020-01-01 00:09:50,7,4,1549,28,1521,2.36%,1.81%
2020-01-01 00:09:50,7,5,7715,407,7308,11.77%,5.27%
2020-01-01 00:09:50,7,6,12569,1119,11450,19.18%,8.90%
2020-01-01 00:09:50,7,7,3241,87,3154,4.95%,2.68%
2020-01-01 00:09:50,7,8,1403,17,1386,2.14%,1.21%
2020-01-01 00:09:50,7,9,6055,252,5803,9.24%,4.16%
2020-01-01 00:09:50,7,10,1032,8,1024,1.57%,0.77%
2020-01-01 00:09:50,7,11,85,0,85,0.13%,0.00%
2020-01-01 00:09:50,7,12,4950,171,4779,7.55%,3.45%
2020-01-01 00:09:50,8,1,513,0,513,0.78%,0.00%
2020-01-01 00:09:50,8,2,86,0,86,0.13%,0.00%
2020-01-01 00:09:50,8,3,1561,12,1549,2.38%,0.77%
2020-01-01 00:09:50,8,4,2558,42,2516,3.90%,1.64%
2020-01-01 00:09:50,8,5,7530,432,7098,11.49%,5.74%
2020-01-01 00:09:50,8,6,15260,1638,13622,23.28%,10.73%
2020-01-01 00:09:50,8,7,5071,204,4867,7.74%,4.02%
2020-01-01 00:09:50,8,8,1696,27,1669,2.59%,1.59%
2020-01-01 00:09:50,8,9,5634,242,5392,8.60%,4.29%
2020-01-01 00:09:50,8,10,1589,23,1566,2.42%,1.45%
2020-01-01 00:09:50,8,11,77,0,77,0.12%,0.00%
2020-01-01 00:09:50,8,12,4007,121,3886,6.11%,3.02%
2020-01-01 00:09:50,9,1,993,8,985,1.52%,0.80%
2020-01-01 00:09:50,9,2,3665,104,3561,5.59%,2.84%
2020-01-01 00:09:50,9,3,2346,43,2303,3.58%,1.83%
2020-01-01 00:09:50,9,4,18858,2512,16346,28.78%,13.32%
2020-01-01 00:09:50,9,5,395,1,394,0.60%,0.25%
2020-01-01 00:09:50,9,6,19931,2802,17129,30.41%,14.06%
2020-01-01 00:09:50,9,7,38968,9502,29466,59.46%,24.38%
2020-01-01 00:09:50,9,8,9655,632,9023,14.73%,6.55%
2020-01-01 00:09:50,9,9,203,0,203,0.31%,0.00%
2020-01-01 00:09:50,9,10,3057,59,2998,4.66%,1.93%
2020-01-01 00:09:50,9,11,8770,508,8262,13.38%,5.79%
2020-01-01 00:09:50,9,12,5450,196,5254,8.32%,3.60%
2020-01-01 00:09:50,10,1,1379,193,1186,2.10%,13.99%
2020-01-01 00:09:50,10,2,3034,251,2783,4.63%,8.27%
2020-01-01 00:09:50,10,3,1533,17,1516,2.34%,1.11%
2020-01-01 00:09:50,10,4,3542,700,2842,5.40%,19.76%
2020-01-01 00:09:50,10,5,843,40,803,1.29%,4.74%
2020-01-01 00:09:50,10,6,5198,820,4378,7.93%,15.77%
2020-01-01 00:09:50,10,7,10135,1500,8635,15.46%,14.80%
2020-01-01 00:09:50,10,8,26313,6068,20245,40.15%,23.06%
2020-01-01 00:09:50,10,9,670,2,668,1.02%,0.30%
2020-01-01 00:09:50,10,10,1851,14,1837,2.82%,0.76%
2020-01-01 00:09:50,10,11,12233,1419,10814,18.67%,11.60%
2020-01-01 00:09:50,10,12,9420,1008,8412,14.37%,10.70%
2020-01-01 00:09:50,11,1,2312,51,2261,3.53%,2.20%
2020-01-01 00:09:50,11,2,3335,114,3221,5.09%,3.42%
2020-01-01 00:09:50,11,3,850,8,842,1.30%,0.94%
2020-01-01 00:09:50,11,4,2792,35,2757,4.26%,1.25%
2020-01-01 00:09:50,11,5,206,4,202,0.31%,1.93%
2020-01-01 00:09:50,11,6,3553,66,3487,5.42%,1.86%
2020-01-01 00:09:50,11,7,8530,623,7907,13.02%,7.30%
2020-01-01 00:09:50,11,8,20989,3149,17840,32.03%,15.00%
2020-01-01 00:09:50,11,9,110,0,110,0.17%,0.00%
2020-01-01 00:09:50,11,10,2471,45,2426,3.77%,1.82%
2020-01-01 00:09:50,11,11,8766,557,8209,13.38%,6.35%
2020-01-01 00:09:50,11,12,6020,277,5743,9.19%,4.60%
2020-01-01 00:09:50,12,1,43,0,43,0.07%,0.00%
2020-01-01 00:09:50,12,2,456,130,326,0.70%,28.45%
2020-01-01 00:09:50,12,3,2637,166,2471,4.02%,6.29%
2020-01-01 00:09:50,12,4,2694,50,2644,4.11%,1.86%
2020-01-01 00:09:50,12,5,8336,606,7730,12.72%,7.27%
2020-01-01 00:09:50,12,6,4935,151,4784,7.53%,3.06%
2020-01-01 00:09:50,12,7,2077,32,2045,3.17%,1.54%
2020-01-01 00:09:50,12,8,1187,241,946,1.81%,20.29%
2020-01-01 00:09:50,12,9,19848,3547,16301,30.29%,17.87%
2020-01-01 00:09:50,12,10,3554,322,3232,5.42%,9.06%
2020-01-01 00:09:50,12,11,1386,244,1142,2.11%,17.59%
2020-01-01 00:09:50,12,12,7608,1016,6592,11.61%,13.35%
2020-01-01 00:09:50,13,1,1864,32,1832,2.84%,1.72%
2020-01-01 00:09:50,13,2,2163,45,2118,3.30%,2.08%
2020-01-01 00:09:50,13,3,657,4,653,1.00%,0.61%
2020-01-01 00:09:50,13,4,4660,562,4098,7.11%,12.06%
2020-01-01 00:09:50,13,5,6437,771,5666,9.82%,11.98%
2020-01-01 00:09:50,13,6,5220,595,4625,7.97%,11.40%
2020-01-01 00:09:50,13,7,3826,112,3714,5.84%,2.93%
2020-01-01 00:09:50,13,8,10330,812,9518,15.76%,7.86%
2020-01-01 00:09:50,13,9,6768,803,5965,10.33%,11.86%
2020-01-01 00:09:50,13,10,28839,6124,22715,44.00%,21.23%
2020-01-01 00:09:50,13,11,19454,2935,16519,29.68%,15.09%
2020-01-01 00:09:50,13,12,8743,803,7940,13.34%,9.18%
2020-01-01 00:09:50,14,1,338,0,338,0.52%,0.00%
2020-01-01 00:09:50,14,2,1292,16,1276,1.97%,1.24%
2020-01-01 00:09:50,14,3,704,5,699,1.07%,0.71%
2020-01-01 00:09:50,14,4,4458,140,4318,6.80%,3.14%
2020-01-01 00:09:50,14,5,1397,23,1374,2.13%,1.65%
2020-01-01 00:09:50,14,6,4725,156,4569,7.21%,3.30%
2020-01-01 00:09:50,14,7,11802,940,10862,18.01%,7.96%
2020-01-01 00:09:50,14,8,13257,1202,12055,20.23%,9.07%
2020-01-01 00:09:50,14,9,1493,25,1468,2.28%,1.67%
2020-01-01 00:09:50,14,10,3767,112,3655,5.75%,2.97%
2020-01-01 00:09:50,14,11,23800,3806,19994,36.32%,15.99%
2020-01-01 00:09:50,14,12,6503,327,6176,9.92%,5.03%
2020-01-01 00:09:50,15,1,564,3,561,0.86%,0.53%
2020-01-01 00:09:50,15,2,110,1,109,0.17%,0.90%
2020-01-01 00:09:50,15,3,3517,97,3420,5.37%,2.76%
2020-01-01 00:09:50,15,4,4042,137,3905,6.17%,3.39%
2020-01-01 00:09:50,15,5,8266,508,7758,12.61%,6.14%
2020-01-01 00:09:50,15,6,4273,151,4122,6.52%,3.53%
2020-01-01 00:09:50,15,7,3368,79,3289,5.14%,2.34%
2020-01-01 00:09:50,15,8,5269,204,5065,8.04%,3.87%
2020-01-01 00:09:50,15,9,8450,534,7916,12.89%,6.32%
2020-01-01 00:09:50,15,10,5696,321,5375,8.69%,5.63%
2020-01-01 00:09:50,15,11,11100,933,10167,16.94%,8.40%
2020-01-01 00:09:50,15,12,24779,4549,20230,37.81%,18.36%
2020-01-01 00:09:50,16,1,369,2,367,0.56%,0.54%
2020-01-01 00:09:50,16,2,236,0,236,0.36%,0.00%
2020-01-01 00:09:50,16,3,1433,12,1421,2.19%,0.84%
2020-01-01 00:09:50,16,4,4165,144,4021,6.36%,3.46%
2020-01-01 00:09:50,16,5,7892,483,7409,12.04%,6.12%
2020-01-01 00:09:50,16,6,4932,191,4741,7.53%,3.87%
2020-01-01 00:09:50,16,7,3804,124,3680,5.80%,3.26%
2020-01-01 00:09:50,16,8,7310,503,6807,11.15%,6.88%
2020-01-01 00:09:50,16,9,8324,524,7800,12.70%,6.29%
2020-01-01 00:09:50,16,10,1842,23,1819,2.81%,1.25%
2020-01-01 00:09:50,16,11,9378,736,8642,14.31%,7.85%
2020-01-01 00:09:50,16,12,24777,4201,20576,37.81%,16.95%
2020-01-01 00:10:00,1,1,17518,2190,15328,26.73%,12.50%
2020-01-01 00:10:00,1,2,7616,456,7160,11.62%,5.99%
2020-01-01 00:10:00,1,3,243,0,243,0.37%,0.00%
2020-01-01 00:10:00,1,4,9630,720,8910,14.69%,7.48%
2020-01-01 00:10:00,1,5,9410,684,8726,14.36%,7.27%
2020-01-01 00:10:00,1,6,9342,677,8665,14.25%,7.25%
2020-01-01 00:10:00,1,7,7363,430,6933,11.24%,5.84%
2020-01-01 00:10:00,1,8,5830,254,5576,8.90%,4.36%
2020-01-01 00:10:00,1,9,9307,672,8635,14.20%,7.22%
2020-01-01 00:10:00,1,10,5111,184,4927,7.80%,3.60%
2020-01-01 00:10:00,1,11,5177,191,4986,7.90%,3.69%
2020-01-01 00:10:00,1,12,9285,671,8614,14.17%,7.23%
2020-01-01 00:10:00,2,1,1381,14,1367,2.11%,1.01%
2020-01-01 00:10:00,2,2,36896,8702,28194,56.30%,23.58%
2020-01-01 00:10:00,2,3,24173,3884,20289,36.89%,16.07%
2020-01-01 00:10:00,2,4,1188,12,1176,1.81%,1.01%
2020-01-01 00:10:00,2,5,15718,1736,13982,23.98%,11.04%
2020-01-01 00:10:00,2,6,36,0,36,0.05%,0.00%
2020-01-01 00:10:00,2,7,11328,926,10402,17.29%,8.17%
2020-01-01 00:10:00,2,8,4323,124,4199,6.60%,2.87%
2020-01-01 00:10:00,2,9,15628,1718,13910,23.85%,10.99%
2020-01-01 00:10:00,2,10,3380,76,3304,5.16%,2.25%
2020-01-01 00:10:00,2,11,3390,77,3313,5.17%,2.27%
2020-01-01 00:10:00,2,12,15474,1681,13793,23.61%,10.86%
2020-01-01 00:10:00,3,1,1534,12,1522,2.34%,0.78%
2020-01-01 00:10:00,3,2,26371,4684,21687,40.24%,17.76%
2020-01-01 00:10:00,3,3,65657,24259,41398,100.18%,36.95%
2020-01-01 00:10:00,3,4,5548,246,5302,8.47%,4.43%
2020-01-01 00:10:00,3,5,38252,9240,29012,58.37%,24.15%
2020-01-01 00:10:00,3,6,6479,327,6152,9.89%,5.05%
2020-01-01 00:10:00,3,7,22405,3457,18948,34.19%,15.43%
2020-01-01 00:10:00,3,8,17090,2063,15027,26.08%,12.07%
2020-01-01 00:10:00,3,9,31453,6367,25086,47.99%,20.24%
2020-01-01 00:10:00,3,10,4718,153,4565,7.20%,3.24%
2020-01-01 00:10:00,3,11,2287,51,2236,3.49%,2.23%
2020-01-01 00:10:00,3,12,23721,3770,19951,36.20%,15.89%
2020-01-01 00:10:00,4,1,500,3,497,0.76%,0.60%
2020-01-01 00:10:00,4,2,284,1,283,0.43%,0.35%
2020-01-01 00:10:00,4,3,783,7,776,1.19%,0.89%
2020-01-01 00:10:00,4,4,29443,5751,23692,44.93%,19.53%
2020-01-01 00:10:00,4,5,18381,2354,16027,28.05%,12.81%
2020-01-01 00:10:00,4,6,25778,4480,21298,39.33%,17.38%
2020-01-01 00:10:00,4,7,6081,275,5806,9.28%,4.52%
2020-01-01 00:10:00,4,8,2852,55,2797,4.35%,1.93%
2020-01-01 00:10:00,4,9,16345,1897,14448,24.94%,11.61%
2020-01-01 00:10:00,4,10,1956,24,1932,2.98%,1.23%
2020-01-01 00:10:00,4,11,153,0,153,0.23%,0.00%
2020-01-01 00:10:00,4,12,12945,1212,11733,19.75%,9.36%
2020-01-01 00:10:00,5,1,3142,86,3056,4.79%,2.74%
2020-01-01 00:10:00,5,2,674,2,672,1.03%,0.30%
2020-01-01 00:10:00,5,3,432,0,432,0.66%,0.00%
2020-01-01 00:10:00,5,4,27952,5236,22716,42.65%,18.73%
2020-01-01 00:10:00,5,5,9411,648,8763,14.36%,6.88%
2020-01-01 00:10:00,5,6,15154,1650,13504,23.12%,10.89%
2020-01-01 00:10:00,5,7,5229,281,4948,7.98%,5.37%
2020-01-01 00:10:00,5,8,3691,117,3574,5.63%,3.17%
2020-01-01 00:10:00,5,9,8853,592,8261,13.51%,6.69%
2020-01-01 00:10:00,5,10,1097,12,1085,1.67%,1.09%
2020-01-01 00:10:00,5,11,540,2,538,0.82%,0.37%
2020-01-01 00:10:00,5,12,7418,432,6986,11.32%,5.82%
2020-01-01 00:10:00,6,1,1227,13,1214,1.87%,1.06%
2020-01-01 00:10:00,6,2,1289,13,1276,1.97%,1.01%
2020-01-01 00:10:00,6,3,1878,38,1840,2.87%,2.02%
2020-01-01 00:10:00,6,4,1559,29,1530,2.38%,1.86%
2020-01-01 00:10:00,6,5,13556,1333,12223,20.68%,9.83%
2020-01-01 00:10:00,6,6,4714,174,4540,7.19%,3.69%
2020-01-01 00:10:00,6,7,2638,47,2591,4.03%,1.78%
2020-01-01 00:10:00,6,8,2068,30,2038,3.16%,1.45%
2020-01-01 00:10:00,6,9,6572,321,6251,10.03%,4.88%
2020-01-01 00:10:00,6,10,1776,21,1755,2.71%,1.18%
2020-01-01 00:10:00,6,11,429,1,428,0.65%,0.23%
2020-01-01 00:10:00,6,12,4732,160,4572,7.22%,3.38%
2020-01-01 00:10:00,7,1,396,3,393,0.60%,0.76%
2020-01-01 00:10:00,7,2,270,0,270,0.41%,0.00%
2020-01-01 00:10:00,7,3,1379,26,1353,2.10%,1.88%
2020-01-01 00:10:00,7,4,1192,15,1177,1.82%,1.26%
2020-01-01 00:10:00,7,5,7814,504,7310,11.92%,6.45%
2020-01-01 00:10:00,7,6,12082,1126,10956,18.44%,9.32%
2020-01-01 00:10:00,7,7,2965,74,2891,4.52%,2.49%
2020-01-01 00:10:00,7,8,1067,7,1060,1.63%,0.66%
2020-01-01 00:10:00,7,9,6377,338,6039,9.73%,5.30%
2020-01-01 00:10:00,7,10,1108,11,1097,1.69%,0.99%
2020-01-01 00:10:00,7,11,91,0,91,0.14%,0.00%
2020-01-01 00:10:00,7,12,5218,229,4989,7.96%,4.39%
2020-01-01 00:10:00,8,1,412,0,412,0.63%,0.00%
2020-01-01 00:10:00,8,2,133,0,133,0.20%,0.00%
2020-01-01 00:10:00,8,3,1432,10,1422,2.19%,0.70%
2020-01-01 00:10:00,8,4,2531,59,2472,3.86%,2.33%
2020-01-01 00:10:00,8,5,7983,476,7507,12.18%,5.96%
2020-01-01 00:10:00,8,6,15838,1834,14004,24.17%,11.58%
2020-01-01 00:10:00,8,7,5244,228,5016,8.00%,4.35%
2020-01-01 00:10:00,8,8,1912,24,1888,2.92%,1.25%
2020-01-01 00:10:00,8,9,6312,303,6009,9.63%,4.80%
2020-01-01 00:10:00,8,10,1970,24,1946,3.01%,1.22%
2020-01-01 00:10:00,8,11,231,0,231,0.35%,0.00%
2020-01-01 00:10:00,8,12,4254,153,4101,6.49%,3.60%
2020-01-01 00:10:00,9,1,589,1,588,0.90%,0.17%
2020-01-01 00:10:00,9,2,3113,61,3052,4.75%,1.96%
2020-01-01 00:10:00,9,3,2111,27,2084,3.22%,1.28%
2020-01-01 00:10:00,9,4,10203,741,9462,15.57%,7.26%
2020-01-01 00:10:00,9,5,251,0,251,0.38%,0.00%
2020-01-01 00:10:00,9,6,11040,866,10174,16.85%,7.84%
2020-01-01 00:10:00,9,7,31238,6274,24964,47.67%,20.08%
2020-01-01 00:10:00,9,8,10529,842,9687,16.07%,8.00%
2020-01-01 00:10:00,9,9,196,0,196,0.30%,0.00%
2020-01-01 00:10:00,9,10,2171,45,2126,3.31%,2.07%
2020-01-01 00:10:00,9,11,9446,671,8775,14.41%,7.10%
2020-01-01 00:10:00,9,12,6887,368,6519,10.51%,5.34%
2020-01-01 00:10:00,10,1,1237,207,1030,1.89%,16.72%
2020-01-01 00:10:00,10,2,2908,246,2662,4.44%,8.46%
2020-01-01 00:10:00,10,3,1378,12,1366,2.10%,0.87%
2020-01-01 00:10:00,10,4,4065,681,3384,6.20%,16.75%
2020-01-01 00:10:00,10,5,783,3,780,1.19%,0.38%
2020-01-01 00:10:00,10,6,5932,789,5143,9.05%,13.30%
2020-01-01 00:10:00,10,7,10885,1472,9413,16.61%,13.52%
2020-01-01 00:10:00,10,8,27209,6271,20938,41.52%,23.05%
2020-01-01 00:10:00,10,9,657,4,653,1.00%,0.61%
2020-01-01 00:10:00,10,10,2365,44,2321,3.61%,1.86%
2020-01-01 00:10:00,10,11,12540,1606,10934,19.13%,12.81%
2020-01-01 00:10:00,10,12,9487,1137,8350,14.48%,11.98%
2020-01-01 00:10:00,11,1,2163,24,2139,3.30%,1.11%
2020-01-01 00:10:00,11,2,3293,63,3230,5.02%,1.91%
2020-01-01 00:10:00,11,3,967,6,961,1.48%,0.62%
2020-01-01 00:10:00,11,4,3749,102,3647,5.72%,2.72%
2020-01-01 00:10:00,11,5,153,1,152,0.23%,0.65%
2020-01-01 00:10:00,11,6,4661,156,4505,7.11%,3.35%
2020-01-01 00:10:00,11,7,9990,679,9311,15.24%,6.80%
2020-01-01 00:10:00,11,8,23660,3711,19949,36.10%,15.68%
2020-01-01 00:10:00,11,9,263,1,262,0.40%,0.38%
2020-01-01 00:10:00,11,10,3032,72,2960,4.63%,2.37%
2020-01-01 00:10:00,11,11,10185,745,9440,15.54%,7.31%
2020-01-01 00:10:00,11,12,6887,346,6541,10.51%,5.02%
2020-01-01 00:10:00,12,1,99,0,99,0.15%,0.00%
2020-01-01 00:10:00,12,2,627,202,425,0.96%,32.17%
2020-01-01 00:10:00,12,3,3620,295,3325,5.52%,8.15%
2020-01-01 00:10:00,12,4,2455,40,2415,3.75%,1.63%
2020-01-01 00:10:00,12,5,9423,863,8560,14.38%,9.16%
2020-01-01 00:10:00,12,6,5024,204,4820,7.67%,4.06%
2020-01-01 00:10:00,12,7,2442,46,2396,3.73%,1.88%
2020-01-01 00:10:00,12,8,1372,350,1022,2.09%,25.49%
2020-01-01 00:10:00,12,9,21882,4415,17467,33.39%,20.18%
2020-01-01 00:10:00,12,10,3784,437,3347,5.77%,11.55%
2020-01-01 00:10:00,12,11,1550,357,1193,2.37%,23.02%
2020-01-01 00:10:00,12,12,8169,1195,6974,12.46%,14.63%
2020-01-01 00:10:00,13,1,2195,34,2161,3.35%,1.55%
2020-01-01 00:10:00,13,2,2565,48,2517,3.91%,1.87%
2020-01-01 00:10:00,13,3,525,2,523,0.80%,0.38%
2020-01-01 00:10:00,13,4,5494,560,4934,8.38%,10.19%
2020-01-01 00:10:00,13,5,7644,832,6812,11.66%,10.88%
2020-01-01 00:10:00,13,6,6273,622,5651,9.57%,9.91%
2020-01-01 00:10:00,13,7,4891,167,4724,7.46%,3.41%
2020-01-01 00:10:00,13,8,6792,341,6451,10.36%,5.02%
2020-01-01 00:10:00,13,9,7930,863,7067,12.10%,10.88%
2020-01-01 00:10:00,13,10,26858,5366,21492,40.98%,19.98%
2020-01-01 00:10:00,13,11,15755,2054,13701,24.04%,13.04%
2020-01-01 00:10:00,13,12,8311,846,7465,12.68%,10.18%
2020-01-01 00:10:00,14,1,359,2,357,0.55%,0.56%
2020-01-01 00:10:00,14,2,1733,18,1715,2.64%,1.04%
2020-01-01 00:10:00,14,3,1104,10,1094,1.68%,0.90%
2020-01-01 00:10:00,14,4,4095,124,3971,6.25%,3.03%
2020-01-01 00:10:00,14,5,1678,29,1649,2.56%,1.73%
2020-01-01 00:10:00,14,6,4313,136,4177,6.58%,3.15%
2020-01-01 00:10:00,14,7,12451,1053,11398,19.00%,8.46%
2020-01-01 00:10:00,14,8,14216,1396,12820,21.69%,9.82%
2020-01-01 00:10:00,14,9,1819,34,1785,2.78%,1.87%
2020-01-01 00:10:00,14,10,4375,164,4211,6.68%,3.75%
2020-01-01 00:10:00,14,11,27704,5127,22577,42.27%,18.51%
2020-01-01 00:10:00,14,12,8876,586,8290,13.54%,6.60%
2020-01-01 00:10:00,15,1,551,3,548,0.84%,0.54%
2020-01-01 00:10:00,15,2,180,0,180,0.27%,0.00%
2020-01-01 00:10:00,15,3,3982,105,3877,6.08%,2.64%
2020-01-01 00:10:00,15,4,4922,307,4615,7.51%,6.24%
2020-01-01 00:10:00,15,5,9703,751,8952,14.81%,7.74%
2020-01-01 00:10:00,15,6,5219,327,4892,7.96%,6.26%
2020-01-01 00:10:00,15,7,3752,112,3640,5.73%,2.98%
2020-01-01 00:10:00,15,8,5569,242,5327,8.50%,4.34%
2020-01-01 00:10:00,15,9,9967,789,9178,15.21%,7.92%
2020-01-01 00:10:00,15,10,4154,176,3978,6.34%,4.24%
2020-01-01 00:10:00,15,11,9870,722,9148,15.06%,7.31%
2020-01-01 00:10:00,15,12,25442,4707,20735,38.82%,18.50%
2020-01-01 00:10:00,16,1,555,1,554,0.85%,0.18%
2020-01-01 00:10:00,16,2,290,1,289,0.44%,0.34%
2020-01-01 00:10:00,16,3,1599,21,1578,2.44%,1.31%
2020-01-01 00:10:00,16,4,4408,143,4265,6.73%,3.24%
2020-01-01 00:10:00,16,5,8051,550,7501,12.28%,6.83%
2020-01-01 00:10:00,16,6,5204,206,4998,7.94%,3.96%
2020-01-01 00:10:00,16,7,3693,86,3607,5.64%,2.33%
2020-01-01 00:10:00,16,8,7441,450,6991,11.35%,6.05%
2020-01-01 00:10:00,16,9,9432,721,8711,14.39%,7.64%
2020-01-01 00:10:00,16,10,2076,34,2042,3.17%,1.64%
2020-01-01 00:10:00,16,11,9780,759,9021,14.92%,7.76%
2020-01-01 00:10:00,16,12,27066,5109,21957,41.30%,18.88%
2020-01-01 00:10:10,1,1,17788,2297,15491,27.14%,12.91%
2020-01-01 00:10:10,1,2,6246,298,5948,9.53%,4.77%
2020-01-01 00:10:10,1,3,404,2,402,0.62%,0.49%
2020-01-01 00:10:10,1,4,11155,943,10212,17.02%,8.45%
2020-01-01 00:10:10,1,5,10998,896,10102,16.78%,8.15%
2020-01-01 00:10:10,1,6,10859,885,9974,16.57%,8.15%
2020-01-01 00:10:10,1,7,5830,262,5568,8.90%,4.49%
2020-01-01 00:10:10,1,8,4870,179,4691,7.43%,3.67%
2020-01-01 00:10:10,1,9,10833,879,9954,16.53%,8.11%
2020-01-01 00:10:10,1,10,4031,128,3903,6.15%,3.17%
2020-01-01 00:10:10,1,11,4120,136,3984,6.29%,3.30%
2020-01-01 00:10:10,1,12,10808,875,9933,16.49%,8.10%
2020-01-01 00:10:10,2,1,318,5,313,0.49%,1.57%
2020-01-01 00:10:10,2,2,27399,4942,22457,41.81%,18.04%
2020-01-01 00:10:10,2,3,22741,3468,19273,34.70%,15.25%
2020-01-01 00:10:10,2,4,254,4,250,0.39%,1.57%
2020-01-01 00:10:10,2,5,14331,1444,12887,21.87%,10.08%
2020-01-01 00:10:10,2,6,50,0,50,0.08%,0.00%
2020-01-01 00:10:10,2,7,4322,128,4194,6.59%,2.96%
2020-01-01 00:10:10,2,8,3119,61,3058,4.76%,1.96%
2020-01-01 00:10:10,2,9,14208,1411,12797,21.68%,9.93%
2020-01-01 00:10:10,2,10,2303,37,2266,3.51%,1.61%
2020-01-01 00:10:10,2,11,2318,37,2281,3.54%,1.60%
2020-01-01 00:10:10,2,12,14005,1371,12634,21.37%,9.79%
2020-01-01 00:10:10,3,1,1489,17,1472,2.27%,1.14%
2020-01-01 00:10:10,3,2,28409,5329,23080,43.35%,18.76%
2020-01-01 00:10:10,3,3,77909,32297,45612,118.88%,41.45%
2020-01-01 00:10:10,3,4,7710,450,7260,11.76%,5.84%
2020-01-01 00:10:10,3,5,48446,14239,34207,73.92%,29.39%
2020-01-01 00:10:10,3,6,8915,611,8304,13.60%,6.85%
2020-01-01 00:10:10,3,7,25144,4247,20897,38.37%,16.89%
2020-01-01 00:10:10,3,8,20110,2779,17331,30.69%,13.82%
2020-01-01 00:10:10,3,9,39224,9727,29497,59.85%,24.80%
2020-01-01 00:10:10,3,10,6694,316,6378,10.21%,4.72%
2020-01-01 00:10:10,3,11,2072,30,2042,3.16%,1.45%
2020-01-01 00:10:10,3,12,29868,5879,23989,45.57%,19.68%
2020-01-01 00:10:10,4,1,462,0,462,0.70%,0.00%
2020-01-01 00:10:10,4,2,250,0,250,0.38%,0.00%
2020-01-01 00:10:10,4,3,896,7,889,1.37%,0.78%
2020-01-01 00:10:10,4,4,30419,6171,24248,46.42%,20.29%
2020-01-01 00:10:10,4,5,18517,2414,16103,28.25%,13.04%
2020-01-01 00:10:10,4,6,26235,4715,21520,40.03%,17.97%
2020-01-01 00:10:10,4,7,6250,312,5938,9.54%,4.99%
2020-01-01 00:10:10,4,8,2934,64,2870,4.48%,2.18%
2020-01-01 00:10:10,4,9,16057,1829,14228,24.50%,11.39%
2020-01-01 00:10:10,4,10,2076,32,2044,3.17%,1.54%
2020-01-01 00:10:10,4,11,178,0,178,0.27%,0.00%
2020-01-01 00:10:10,4,12,12935,1207,11728,19.74%,9.33%
2020-01-01 00:10:10,5,1,2688,54,2634,4.10%,2.01%
2020-01-01 00:10:10,5,2,677,2,675,1.03%,0.29%
2020-01-01 00:10:10,5,3,422,1,421,0.64%,0.24%
2020-01-01 00:10:10,5,4,24069,3933,20136,36.73%,16.34%
2020-01-01 00:10:10,5,5,9889,693,9196,15.09%,7.01%
2020-01-01 00:10:10,5,6,15628,1725,13903,23.85%,11.04%
2020-01-01 00:10:10,5,7,5320,218,5102,8.12%,4.10%
2020-01-01 00:10:10,5,8,3671,104,3567,5.60%,2.83%
2020-01-01 00:10:10,5,9,9327,618,8709,14.23%,6.63%
2020-01-01 00:10:10,5,10,1176,11,1165,1.79%,0.93%
2020-01-01 00:10:10,5,11,755,6,749,1.15%,0.79%
2020-01-01 00:10:10,5,12,7885,440,7445,12.03%,5.58%
2020-01-01 00:10:10,6,1,1094,11,1083,1.67%,1.00%
2020-01-01 00:10:10,6,2,1165,12,1153,1.78%,1.03%
2020-01-01 00:10:10,6,3,1793,29,1764,2.74%,1.62%
2020-01-01 00:10:10,6,4,1463,14,1449,2.23%,0.96%
2020-01-01 00:10:10,6,5,15488,1632,13856,23.63%,10.54%
2020-01-01 00:10:10,6,6,5131,180,4951,7.83%,3.51%
2020-01-01 00:10:10,6,7,3203,82,3121,4.89%,2.56%
2020-01-01 00:10:10,6,8,2657,64,2593,4.05%,2.41%
2020-01-01 00:10:10,6,9,8222,506,7716,12.55%,6.15%
2020-01-01 00:10:10,6,10,1971,34,1937,3.01%,1.72%
2020-01-01 00:10:10,6,11,356,0,356,0.54%,0.00%
2020-01-01 00:10:10,6,12,6154,284,5870,9.39%,4.61%
2020-01-01 00:10:10,7,1,481,1,480,0.73%,0.21%
2020-01-01 00:10:10,7,2,187,1,186,0.29%,0.53%
2020-01-01 00:10:10,7,3,1043,9,1034,1.59%,0.86%
2020-01-01 00:10:10,7,4,1286,19,1267,1.96%,1.48%
2020-01-01 00:10:10,7,5,8668,578,8090,13.23%,6.67%
2020-01-01 00:10:10,7,6,13251,1265,11986,20.22%,9.55%
2020-01-01 00:10:10,7,7,3237,81,3156,4.94%,2.50%
2020-01-01 00:10:10,7,8,1139,16,1123,1.74%,1.40%
2020-01-01 00:10:10,7,9,6460,326,6134,9.86%,5.05%
2020-01-01 00:10:10,7,10,1136,7,1129,1.73%,0.62%
2020-01-01 00:10:10,7,11,127,1,126,0.19%,0.78%
2020-01-01 00:10:10,7,12,5284,216,5068,8.06%,4.09%
2020-01-01 00:10:10,8,1,340,2,338,0.52%,0.59%
2020-01-01 00:10:10,8,2,79,0,79,0.12%,0.00%
2020-01-01 00:10:10,8,3,1516,11,1505,2.31%,0.73%
2020-01-01 00:10:10,8,4,2463,47,2416,3.76%,1.91%
2020-01-01 00:10:10,8,5,8687,565,8122,13.26%,6.50%
2020-01-01 00:10:10,8,6,16290,1875,14415,24.86%,11.51%
2020-01-01 00:10:10,8,7,5016,206,4810,7.65%,4.11%
2020-01-01 00:10:10,8,8,2021,34,1987,3.08%,1.68%
2020-01-01 00:10:10,8,9,6865,369,6496,10.48%,5.37%
2020-01-01 00:10:10,8,10,1831,23,1808,2.79%,1.26%
2020-01-01 00:10:10,8,11,246,0,246,0.38%,0.00%
2020-01-01 00:10:10,8,12,4917,194,4723,7.50%,3.94%
2020-01-01 00:10:10,9,1,414,1,413,0.63%,0.24%
2020-01-01 00:10:10,9,2,2058,57,2001,3.14%,2.77%
2020-01-01 00:10:10,9,3,1191,37,1154,1.82%,3.10%
2020-01-01 00:10:10,9,4,7205,385,6820,10.99%,5.34%
2020-01-01 00:10:10,9,5,245,0,245,0.37%,0.00%
2020-01-01 00:10:10,9,6,7777,435,7342,11.87%,5.59%
2020-01-01 00:10:10,9,7,26906,4821,22085,41.06%,17.92%
2020-01-01 00:10:10,9,8,11103,902,10201,16.94%,8.12%
2020-01-01 00:10:10,9,9,177,0,177,0.27%,0.00%
2020-01-01 00:10:10,9,10,4238,123,4115,6.47%,2.90%
2020-01-01 00:10:10,9,11,9750,690,9060,14.88%,7.08%
2020-01-01 00:10:10,9,12,5219,185,5034,7.96%,3.54%
2020-01-01 00:10:10,10,1,1154,266,888,1.76%,23.03%
2020-01-01 00:10:10,10,2,2796,320,2476,4.27%,11.44%
2020-01-01 00:10:10,10,3,1409,22,1387,2.15%,1.56%
2020-01-01 00:10:10,10,4,5573,973,4600,8.50%,17.46%
2020-01-01 00:10:10,10,5,685,7,678,1.05%,1.02%
2020-01-01 00:10:10,10,6,7333,1108,6225,11.19%,15.11%
2020-01-01 00:10:10,10,7,12065,1903,10162,18.41%,15.77%
2020-01-01 00:10:10,10,8,29040,7290,21750,44.31%,25.10%
2020-01-01 00:10:10,10,9,543,2,541,0.83%,0.37%
2020-01-01 00:10:10,10,10,2242,46,2196,3.42%,2.05%
2020-01-01 00:10:10,10,11,12492,1651,10841,19.06%,13.22%
2020-01-01 00:10:10,10,12,9681,1209,8472,14.77%,12.49%
2020-01-01 00:10:10,11,1,2238,42,2196,3.41%,1.88%
2020-01-01 00:10:10,11,2,3485,89,3396,5.32%,2.55%
2020-01-01 00:10:10,11,3,1099,7,1092,1.68%,0.64%
2020-01-01 00:10:10,11,4,3007,69,2938,4.59%,2.29%
2020-01-01 00:10:10,11,5,535,2,533,0.82%,0.37%
2020-01-01 00:10:10,11,6,4210,122,4088,6.42%,2.90%
2020-01-01 00:10:10,11,7,9516,668,8848,14.52%,7.02%
2020-01-01 00:10:10,11,8,23125,3669,19456,35.29%,15.87%
2020-01-01 00:10:10,11,9,245,1,244,0.37%,0.41%
2020-01-01 00:10:10,11,10,2953,65,2888,4.51%,2.20%
2020-01-01 00:10:10,11,11,10249,744,9505,15.64%,7.26%
2020-01-01 00:10:10,11,12,7026,371,6655,10.72%,5.28%
2020-01-01 00:10:10,12,1,74,0,74,0.11%,0.00%
2020-01-01 00:10:10,12,2,657,224,433,1.00%,34.04%
2020-01-01 00:10:10,12,3,2563,263,2300,3.91%,10.26%
2020-01-01 00:10:10,12,4,2635,61,2574,4.02%,2.31%
2020-01-01 00:10:10,12,5,8433,706,7727,12.87%,8.37%
2020-01-01 00:10:10,12,6,5051,175,4876,7.71%,3.46%
2020-01-01 00:10:10,12,7,2296,28,2268,3.50%,1.22%
2020-01-01 00:10:10,12,8,1261,303,958,1.92%,24.01%
2020-01-01 00:10:10,12,9,21395,4252,17143,32.65%,19.87%
2020-01-01 00:10:10,12,10,3735,387,3348,5.70%,10.36%
2020-01-01 00:10:10,12,11,1454,305,1149,2.22%,20.96%
2020-01-01 00:10:10,12,12,7713,1178,6535,11.77%,15.27%
2020-01-01 00:10:10,13,1,2316,44,2272,3.53%,1.90%
2020-01-01 00:10:10,13,2,2695,59,2636,4.11%,2.19%
2020-01-01 00:10:10,13,3,604,2,602,0.92%,0.33%
2020-01-01 00:10:10,13,4,4865,447,4418,7.42%,9.19%
2020-01-01 00:10:10,13,5,7389,738,6651,11.27%,9.99%
2020-01-01 00:10:10,13,6,5829,510,5319,8.89%,8.75%
2020-01-01 00:10:10,13,7,5080,190,4890,7.75%,3.74%
2020-01-01 00:10:10,13,8,6844,348,6496,10.44%,5.08%
2020-01-01 00:10:10,13,9,7708,773,6935,11.76%,10.03%
2020-01-01 00:10:10,13,10,28679,6010,22669,43.76%,20.96%
2020-01-01 00:10:10,13,11,17928,2619,15309,27.36%,14.61%
2020-01-01 00:10:10,13,12,10357,1172,9185,15.80%,11.31%
2020-01-01 00:10:10,14,1,493,6,487,0.75%,1.21%
2020-01-01 00:10:10,14,2,1948,24,1924,2.97%,1.23%
2020-01-01 00:10:10,14,3,1241,4,1237,1.89%,0.32%
2020-01-01 00:10:10,14,4,4095,125,3970,6.25%,3.05%
2020-01-01 00:10:10,14,5,1455,21,1434,2.22%,1.44%
2020-01-01 00:10:10,14,6,4377,143,4234,6.68%,3.27%
2020-01-01 00:10:10,14,7,12130,1037,11093,18.51%,8.55%
2020-01-01 00:10:10,14,8,13689,1343,12346,20.89%,9.81%
2020-01-01 00:10:10,14,9,1747,30,1717,2.67%,1.72%
2020-01-01 00:10:10,14,10,4101,129,3972,6.26%,3.14%
2020-01-01 00:10:10,14,11,25932,4529,21403,39.57%,17.46%
2020-01-01 00:10:10,14,12,7730,435,7295,11.80%,5.63%
2020-01-01 00:10:10,15,1,493,0,493,0.75%,0.00%
2020-01-01 00:10:10,15,2,190,0,190,0.29%,0.00%
2020-01-01 00:10:10,15,3,3734,130,3604,5.70%,3.48%
2020-01-01 00:10:10,15,4,5584,256,5328,8.52%,4.58%
2020-01-01 00:10:10,15,5,10763,860,9903,16.42%,7.99%
2020-01-01 00:10:10,15,6,5899,284,5615,9.00%,4.81%
2020-01-01 00:10:10,15,7,3723,119,3604,5.68%,3.20%
2020-01-01 00:10:10,15,8,5521,243,5278,8.42%,4.40%
2020-01-01 00:10:10,15,9,10961,878,10083,16.73%,8.01%
2020-01-01 00:10:10,15,10,4491,266,4225,6.85%,5.92%
2020-01-01 00:10:10,15,11,10140,857,9283,15.47%,8.45%
2020-01-01 00:10:10,15,12,26508,5167,21341,40.45%,19.49%
2020-01-01 00:10:10,16,1,448,0,448,0.68%,0.00%
2020-01-01 00:10:10,16,2,280,0,280,0.43%,0.00%
2020-01-01 00:10:10,16,3,1008,12,996,1.54%,1.19%
2020-01-01 00:10:10,16,4,4475,147,4328,6.83%,3.28%
2020-01-01 00:10:10,16,5,7335,455,6880,11.19%,6.20%
2020-01-01 00:10:10,16,6,5243,195,5048,8.00%,3.72%
2020-01-01 00:10:10,16,7,3537,111,3426,5.40%,3.14%
2020-01-01 00:10:10,16,8,7778,441,7337,11.87%,5.67%
2020-01-01 00:10:10,16,9,7723,495,7228,11.78%,6.41%
2020-01-01 00:10:10,16,10,1605,22,1583,2.45%,1.37%
2020-01-01 00:10:10,16,11,9625,673,8952,14.69%,6.99%
2020-01-01 00:10:10,16,12,25803,4605,21198,39.37%,17.85%
2020-01-01 00:10:20,1,1,15675,1848,13827,23.92%,11.79%
2020-01-01 00:10:20,1,2,5631,262,5369,8.59%,4.65%
2020-01-01 00:10:20,1,3,557,2,555,0.85%,0.36%
2020-01-01 00:10:20,1,4,9798,770,9028,14.95%,7.86%
2020-01-01 00:10:20,1,5,9566,745,8821,14.60%,7.79%
2020-01-01 00:10:20,1,6,9490,726,8764,14.48%,7.65%
2020-01-01 00:10:20,1,7,5047,198,4849,7.70%,3.92%
2020-01-01 00:10:20,1,8,4201,135,4066,6.41%,3.21%
2020-01-01 00:10:20,1,9,9450,722,8728,14.42%,7.64%
2020-01-01 00:10:20,1,10,3440,91,3349,5.25%,2.64%
2020-01-01 00:10:20,1,11,3566,99,3467,5.44%,2.78%
2020-01-01 00:10:20,1,12,9290,704,8586,14.18%,7.58%
2020-01-01 00:10:20,2,1,1221,15,1206,1.86%,1.23%
2020-01-01 00:10:20,2,2,26899,4835,22064,41.04%,17.97%
2020-01-01 00:10:20,2,3,20121,2818,17303,30.70%,14.00%
2020-01-01 00:10:20,2,4,1188,15,1173,1.81%,1.26%
2020-01-01 00:10:20,2,5,11797,1002,10795,18.00%,8.49%
2020-01-01 00:10:20,2,6,58,0,58,0.09%,0.00%
2020-01-01 00:10:20,2,7,5538,218,5320,8.45%,3.94%
2020-01-01 00:10:20,2,8,4637,154,4483,7.08%,3.32%
2020-01-01 00:10:20,2,9,11693,992,10701,17.84%,8.48%
2020-01-01 00:10:20,2,10,3809,106,3703,5.81%,2.78%
2020-01-01 00:10:20,2,11,3820,106,3714,5.83%,2.77%
2020-01-01 00:10:20,2,12,11495,956,10539,17.54%,8.32%
2020-01-01 00:10:20,3,1,1542,10,1532,2.35%,0.65%
2020-01-01 00:10:20,3,2,23301,3684,19617,35.55%,15.81%
2020-01-01 00:10:20,3,3,73259,29083,44176,111.78%,39.70%
2020-01-01 00:10:20,3,4,7318,461,6857,11.17%,6.30%
2020-01-01 00:10:20,3,5,48280,14204,34076,73.67%,29.42%
2020-01-01 00:10:20,3,6,8532,595,7937,13.02%,6.97%
2020-01-01 00:10:20,3,7,19926,2747,17179,30.40%,13.79%
2020-01-01 00:10:20,3,8,17175,2006,15169,26.21%,11.68%
2020-01-01 00:10:20,3,9,39369,9853,29516,60.07%,25.03%
2020-01-01 00:10:20,3,10,7097,378,6719,10.83%,5.33%
2020-01-01 00:10:20,3,11,1841,32,1809,2.81%,1.74%
2020-01-01 00:10:20,3,12,28761,5528,23233,43.89%,19.22%
2020-01-01 00:10:20,4,1,710,4,706,1.08%,0.56%
2020-01-01 00:10:20,4,2,373,1,372,0.57%,0.27%
2020-01-01 00:10:20,4,3,752,26,726,1.15%,3.45%
2020-01-01 00:10:20,4,4,28649,5320,23329,43.71%,18.57%
2020-01-01 00:10:20,4,5,17263,2050,15213,26.34%,11.87%
2020-01-01 00:10:20,4,6,24250,3911,20339,37.00%,16.13%
2020-01-01 00:10:20,4,7,5467,217,5250,8.34%,3.97%
2020-01-01 00:10:20,4,8,2959,67,2892,4.52%,2.26%
2020-01-01 00:10:20,4,9,15280,1638,13642,23.32%,10.72%
2020-01-01 00:10:20,4,10,1983,32,1951,3.03%,1.61%
2020-01-01 00:10:20,4,11,164,0,164,0.25%,0.00%
2020-01-01 00:10:20,4,12,12540,1146,11394,19.13%,9.14%
2020-01-01 00:10:20,5,1,2915,68,2847,4.45%,2.33%
2020-01-01 00:10:20,5,2,1159,7,1152,1.77%,0.60%
2020-01-01 00:10:20,5,3,2295,42,2253,3.50%,1.83%
2020-01-01 00:10:20,5,4,23241,3732,19509,35.46%,16.06%
2020-01-01 00:10:20,5,5,11081,865,10216,16.91%,7.81%
2020-01-01 00:10:20,5,6,16358,1871,14487,24.96%,11.44%
2020-01-01 00:10:20,5,7,4898,161,4737,7.47%,3.29%
2020-01-01 00:10:20,5,8,3784,105,3679,5.77%,2.77%
2020-01-01 00:10:20,5,9,8475,507,7968,12.93%,5.98%
2020-01-01 00:10:20,5,10,1297,13,1284,1.98%,1.00%
2020-01-01 00:10:20,5,11,578,3,575,0.88%,0.52%
2020-01-01 00:10:20,5,12,6855,343,6512,10.46%,5.00%
2020-01-01 00:10:20,6,1,1079,10,1069,1.65%,0.93%
2020-01-01 00:10:20,6,2,1205,10,1195,1.84%,0.83%
2020-01-01 00:10:20,6,3,1685,15,1670,2.57%,0.89%
2020-01-01 00:10:20,6,4,1569,15,1554,2.39%,0.96%
2020-01-01 00:10:20,6,5,15561,1722,13839,23.74%,11.07%
2020-01-01 00:10:20,6,6,5246,171,5075,8.00%,3.26%
2020-01-01 00:10:20,6,7,3223,75,3148,4.92%,2.33%
2020-01-01 00:10:20,6,8,2738,54,2684,4.18%,1.97%
2020-01-01 00:10:20,6,9,8413,543,7870,12.84%,6.45%
2020-01-01 00:10:20,6,10,2067,29,2038,3.15%,1.40%
2020-01-01 00:10:20,6,11,345,1,344,0.53%,0.29%
2020-01-01 00:10:20,6,12,6276,305,5971,9.58%,4.86%
2020-01-01 00:10:20,7,1,446,2,444,0.68%,0.45%
2020-01-01 00:10:20,7,2,181,0,181,0.28%,0.00%
2020-01-01 00:10:20,7,3,1196,7,1189,1.82%,0.58%
2020-01-01 00:10:20,7,4,2108,26,2082,3.22%,1.23%
2020-01-01 00:10:20,7,5,8303,521,7782,12.67%,6.27%
2020-01-01 00:10:20,7,6,14011,1380,12631,21.38%,9.85%
2020-01-01 00:10:20,7,7,3543,93,3450,5.41%,2.62%
2020-01-01 00:10:20,7,8,1488,12,1476,2.27%,0.81%
2020-01-01 00:10:20,7,9,6167,297,5870,9.41%,4.82%
2020-01-01 00:10:20,7,10,1030,7,1023,1.57%,0.68%
2020-01-01 00:10:20,7,11,86,0,86,0.13%,0.00%
2020-01-01 00:10:20,7,12,5116,226,4890,7.81%,4.42%
2020-01-01 00:10:20,8,1,490,2,488,0.75%,0.41%
2020-01-01 00:10:20,8,2,90,0,90,0.14%,0.00%
2020-01-01 00:10:20,8,3,1918,34,1884,2.93%,1.77%
2020-01-01 00:10:20,8,4,2928,72,2856,4.47%,2.46%
2020-01-01 00:10:20,8,5,9057,616,8441,13.82%,6.80%
2020-01-01 00:10:20,8,6,17513,2162,15351,26.72%,12.34%
2020-01-01 00:10:20,8,7,5411,214,5197,8.26%,3.95%
2020-01-01 00:10:20,8,8,2457,55,2402,3.75%,2.24%
2020-01-01 00:10:20,8,9,6882,355,6527,10.50%,5.16%
2020-01-01 00:10:20,8,10,1795,28,1767,2.74%,1.56%
2020-01-01 00:10:20,8,11,218,0,218,0.33%,0.00%
2020-01-01 00:10:20,8,12,4988,185,4803,7.61%,3.71%
2020-01-01 00:10:20,9,1,596,0,596,0.91%,0.00%
2020-01-01 00:10:20,9,2,2224,42,2182,3.39%,1.89%
2020-01-01 00:10:20,9,3,1105,10,1095,1.69%,0.90%
2020-01-01 00:10:20,9,4,8325,485,7840,12.70%,5.83%
2020-01-01 00:10:20,9,5,430,4,426,0.66%,0.93%
2020-01-01 00:10:20,9,6,9532,646,8886,14.54%,6.78%
2020-01-01 00:10:20,9,7,30169,6185,23984,46.03%,20.50%
2020-01-01 00:10:20,9,8,9462,709,8753,14.44%,7.49%
2020-01-01 00:10:20,9,9,227,1,226,0.35%,0.44%
2020-01-01 00:10:20,9,10,3229,88,3141,4.93%,2.72%
2020-01-01 00:10:20,9,11,8302,521,7781,12.67%,6.27%
2020-01-01 00:10:20,9,12,4809,161,4648,7.34%,3.35%
2020-01-01 00:10:20,10,1,1252,334,918,1.91%,26.66%
2020-01-01 00:10:20,10,2,3212,391,2821,4.90%,12.17%
2020-01-01 00:10:20,10,3,1784,34,1750,2.72%,1.90%
2020-01-01 00:10:20,10,4,4634,1061,3573,7.07%,22.89%
2020-01-01 00:10:20,10,5,851,39,812,1.30%,4.58%
2020-01-01 00:10:20,10,6,6770,1231,5539,10.33%,18.18%
2020-01-01 00:10:20,10,7,12005,2133,9872,18.32%,17.77%
2020-01-01 00:10:20,10,8,28785,7405,21380,43.92%,25.72%
2020-01-01 00:10:20,10,9,556,2,554,0.85%,0.36%
2020-01-01 00:10:20,10,10,2659,47,2612,4.06%,1.77%
2020-01-01 00:10:20,10,11,12582,1642,10940,19.20%,13.05%
2020-01-01 00:10:20,10,12,9356,1172,8184,14.28%,12.53%
2020-01-01 00:10:20,11,1,2246,39,2207,3.43%,1.74%
2020-01-01 00:10:20,11,2,3220,90,3130,4.91%,2.79%
2020-01-01 00:10:20,11,3,827,10,817,1.26%,1.21%
2020-01-01 00:10:20,11,4,3118,62,3056,4.76%,1.99%
2020-01-01 00:10:20,11,5,243,0,243,0.37%,0.00%
2020-01-01 00:10:20,11,6,3941,117,3824,6.01%,2.97%
2020-01-01 00:10:20,11,7,8945,620,8325,13.65%,6.93%
2020-01-01 00:10:20,11,8,23471,3800,19671,35.81%,16.19%
2020-01-01 00:10:20,11,9,191,0,191,0.29%,0.00%
2020-01-01 00:10:20,11,10,3264,80,3184,4.98%,2.45%
2020-01-01 00:10:20,11,11,10514,786,9728,16.04%,7.48%
2020-01-01 00:10:20,11,12,6779,334,6445,10.34%,4.93%
2020-01-01 00:10:20,12,1,47,0,47,0.07%,0.00%
2020-01-01 00:10:20,12,2,536,186,350,0.82%,34.64%
2020-01-01 00:10:20,12,3,2501,225,2276,3.82%,8.99%
2020-01-01 00:10:20,12,4,2506,50,2456,3.82%,1.99%
2020-01-01 00:10:20,12,5,7741,614,7127,11.81%,7.93%
2020-01-01 00:10:20,12,6,4484,164,4320,6.84%,3.66%
2020-01-01 00:10:20,12,7,1807,31,1776,2.76%,1.71%
2020-01-01 00:10:20,12,8,978,198,780,1.49%,20.22%
2020-01-01 00:10:20,12,9,20749,3673,17076,31.66%,17.70%
2020-01-01 00:10:20,12,10,3612,274,3338,5.51%,7.58%
2020-01-01 00:10:20,12,11,1385,207,1178,2.11%,14.94%
2020-01-01 00:10:20,12,12,8418,1056,7362,12.84%,12.54%
2020-01-01 00:10:20,13,1,1898,28,1870,2.90%,1.47%
2020-01-01 00:10:20,13,2,2265,43,2222,3.46%,1.90%
2020-01-01 00:10:20,13,3,616,3,613,0.94%,0.49%
2020-01-01 00:10:20,13,4,4753,589,4164,7.25%,12.39%
2020-01-01 00:10:20,13,5,7016,843,6173,10.71%,12.01%
2020-01-01 00:10:20,13,6,5476,637,4839,8.36%,11.63%
2020-01-01 00:10:20,13,7,4715,170,4545,7.19%,3.60%
2020-01-01 00:10:20,13,8,6855,366,6489,10.46%,5.34%
2020-01-01 00:10:20,13,9,7275,875,6400,11.10%,12.03%
2020-01-01 00:10:20,13,10,27454,5712,21742,41.89%,20.80%
2020-01-01 00:10:20,13,11,17073,2432,14641,26.05%,14.24%
2020-01-01 00:10:20,13,12,9670,1092,8578,14.76%,11.29%
2020-01-01 00:10:20,14,1,449,1,448,0.69%,0.22%
2020-01-01 00:10:20,14,2,2630,64,2566,4.01%,2.43%
2020-01-01 00:10:20,14,3,1958,29,1929,2.99%,1.48%
2020-01-01 00:10:20,14,4,4037,114,3923,6.16%,2.82%
2020-01-01 00:10:20,14,5,1349,16,1333,2.06%,1.19%
2020-01-01 00:10:20,14,6,4285,129,4156,6.54%,3.01%
2020-01-01 00:10:20,14,7,12462,1112,11350,19.02%,8.92%
2020-01-01 00:10:20,14,8,14063,1398,12665,21.46%,9.94%
2020-01-01 00:10:20,14,9,1690,26,1664,2.58%,1.54%
2020-01-01 00:10:20,14,10,3885,118,3767,5.93%,3.04%
2020-01-01 00:10:20,14,11,28416,5367,23049,43.36%,18.89%
2020-01-01 00:10:20,14,12,10004,726,9278,15.26%,7.26%
2020-01-01 00:10:20,15,1,503,1,502,0.77%,0.20%
2020-01-01 00:10:20,15,2,199,0,199,0.30%,0.00%
2020-01-01 00:10:20,15,3,9086,620,8466,13.86%,6.82%
2020-01-01 00:10:20,15,4,4769,181,4588,7.28%,3.79%
2020-01-01 00:10:20,15,5,15413,1748,13665,23.52%,11.34%
2020-01-01 00:10:20,15,6,5047,231,4816,7.70%,4.58%
2020-01-01 00:10:20,15,7,3123,71,3052,4.77%,2.27%
2020-01-01 00:10:20,15,8,4935,179,4756,7.53%,3.63%
2020-01-01 00:10:20,15,9,15566,1779,13787,23.75%,11.43%
2020-01-01 00:10:20,15,10,5405,319,5086,8.25%,5.90%
2020-01-01 00:10:20,15,11,10465,913,9552,15.97%,8.72%
2020-01-01 00:10:20,15,12,31851,7069,24782,48.60%,22.19%
2020-01-01 00:10:20,16,1,425,0,425,0.65%,0.00%
2020-01-01 00:10:20,16,2,275,2,273,0.42%,0.72%
2020-01-01 00:10:20,16,3,1135,8,1127,1.73%,0.70%
2020-01-01 00:10:20,16,4,3566,95,3471,5.44%,2.66%
2020-01-01 00:10:20,16,5,6868,330,6538,10.48%,4.80%
2020-01-01 00:10:20,16,6,4341,120,4221,6.62%,2.76%
2020-01-01 00:10:20,16,7,3430,86,3344,5.23%,2.51%
2020-01-01 00:10:20,16,8,7232,476,6756,11.04%,6.58%
2020-01-01 00:10:20,16,9,7278,377,6901,11.11%,5.18%
2020-01-01 00:10:20,16,10,1789,20,1769,2.73%,1.12%
2020-01-01 00:10:20,16,11,9235,707,8528,14.09%,7.65%
2020-01-01 00:10:20,16,12,24298,4000,20298,37.08%,16.46%
2020-01-01 00:10:30,1,1,19979,2827,17152,30.49%,14.15%
2020-01-01 00:10:30,1,2,6367,301,6066,9.72%,4.73%
2020-01-01 00:10:30,1,3,494,2,492,0.75%,0.40%
2020-01-01 00:10:30,1,4,13318,1301,12017,20.32%,9.77%
2020-01-01 00:10:30,1,5,13055,1254,11801,19.92%,9.60%
2020-01-01 00:10:30,1,6,13000,1243,11757,19.84%,9.56%
2020-01-01 00:10:30,1,7,5853,249,5604,8.93%,4.25%
2020-01-01 00:10:30,1,8,4902,166,4736,7.48%,3.39%
2020-01-01 00:10:30,1,9,12964,1236,11728,19.78%,9.53%
2020-01-01 00:10:30,1,10,4338,132,4206,6.62%,3.04%
2020-01-01 00:10:30,1,11,4441,135,4306,6.78%,3.04%
2020-01-01 00:10:30,1,12,12865,1220,11645,19.63%,9.48%
2020-01-01 00:10:30,2,1,2221,44,2177,3.39%,1.98%
2020-01-01 00:10:30,2,2,28260,5390,22870,43.12%,19.07%
2020-01-01 00:10:30,2,3,21153,3148,18005,32.28%,14.88%
2020-01-01 00:10:30,2,4,2118,40,2078,3.23%,1.89%
2020-01-01 00:10:30,2,5,13563,1320,12243,20.70%,9.73%
2020-01-01 00:10:30,2,6,35,0,35,0.05%,0.00%
2020-01-01 00:10:30,2,7,4863,164,4699,7.42%,3.37%
2020-01-01 00:10:30,2,8,3522,83,3439,5.37%,2.36%
2020-01-01 00:10:30,2,9,13443,1304,12139,20.51%,9.70%
2020-01-01 00:10:30,2,10,2779,45,2734,4.24%,1.62%
2020-01-01 00:10:30,2,11,2795,47,2748,4.26%,1.68%
2020-01-01 00:10:30,2,12,13288,1267,12021,20.28%,9.53%
2020-01-01 00:10:30,3,1,1480,14,1466,2.26%,0.95%
2020-01-01 00:10:30,3,2,22598,3457,19141,34.48%,15.30%
2020-01-01 00:10:30,3,3,67350,25126,42224,102.77%,37.31%
2020-01-01 00:10:30,3,4,7886,458,7428,12.03%,5.81%
2020-01-01 00:10:30,3,5,43330,11564,31766,66.12%,26.69%
2020-01-01 00:10:30,3,6,9096,592,8504,13.88%,6.51%
2020-01-01 00:10:30,3,7,19424,2558,16866,29.64%,13.17%
2020-01-01 00:10:30,3,8,15400,1627,13773,23.50%,10.56%
2020-01-01 00:10:30,3,9,33903,7386,26517,51.73%,21.79%
2020-01-01 00:10:30,3,10,5245,195,5050,8.00%,3.72%
2020-01-01 00:10:30,3,11,1629,32,1597,2.49%,1.96%
2020-01-01 00:10:30,3,12,24489,4062,20427,37.37%,16.59%
2020-01-01 00:10:30,4,1,487,0,487,0.74%,0.00%
2020-01-01 00:10:30,4,2,293,0,293,0.45%,0.00%
2020-01-01 00:10:30,4,3,684,4,680,1.04%,0.58%
2020-01-01 00:10:30,4,4,27826,5160,22666,42.46%,18.54%
2020-01-01 00:10:30,4,5,17011,2057,14954,25.96%,12.09%
2020-01-01 00:10:30,4,6,23536,3761,19775,35.91%,15.98%
2020-01-01 00:10:30,4,7,5151,189,4962,7.86%,3.67%
2020-01-01 00:10:30,4,8,2766,68,2698,4.22%,2.46%
2020-01-01 00:10:30,4,9,15236,1707,13529,23.25%,11.20%
2020-01-01 00:10:30,4,10,1978,49,1929,3.02%,2.48%
2020-01-01 00:10:30,4,11,170,1,169,0.26%,0.58%
2020-01-01 00:10:30,4,12,12398,1100,11298,18.92%,8.87%
2020-01-01 00:10:30,5,1,2858,69,2789,4.36%,2.41%
2020-01-01 00:10:30,5,2,967,13,954,1.48%,1.34%
2020-01-01 00:10:30,5,3,584,1,583,0.89%,0.17%
2020-01-01 00:10:30,5,4,24154,3917,20237,36.86%,16.22%
2020-01-01 00:10:30,5,5,9679,671,9008,14.77%,6.93%
2020-01-01 00:10:30,5,6,14714,1535,13179,22.45%,10.43%
2020-01-01 00:10:30,5,7,4632,163,4469,7.07%,3.52%
2020-01-01 00:10:30,5,8,3713,103,3610,5.67%,2.77%
2020-01-01 00:10:30,5,9,8961,575,8386,13.67%,6.42%
2020-01-01 00:10:30,5,10,1306,18,1288,1.99%,1.38%
2020-01-01 00:10:30,5,11,711,3,708,1.08%,0.42%
2020-01-01 00:10:30,5,12,7290,382,6908,11.12%,5.24%
2020-01-01 00:10:30,6,1,1013,7,1006,1.55%,0.69%
2020-01-01 00:10:30,6,2,1140,11,1129,1.74%,0.96%
2020-01-01 00:10:30,6,3,1691,27,1664,2.58%,1.60%
2020-01-01 00:10:30,6,4,1022,17,1005,1.56%,1.66%
2020-01-01 00:10:30,6,5,14006,1441,12565,21.37%,10.29%
2020-01-01 00:10:30,6,6,4848,201,4647,7.40%,4.15%
2020-01-01 00:10:30,6,7,3430,106,3324,5.23%,3.09%
2020-01-01 00:10:30,6,8,2939,88,2851,4.48%,2.99%
2020-01-01 00:10:30,6,9,7105,368,6737,10.84%,5.18%
2020-01-01 00:10:30,6,10,2161,32,2129,3.30%,1.48%
2020-01-01 00:10:30,6,11,407,0,407,0.62%,0.00%
2020-01-01 00:10:30,6,12,4879,190,4689,7.44%,3.89%
2020-01-01 00:10:30,7,1,394,2,392,0.60%,0.51%
2020-01-01 00:10:30,7,2,190,1,189,0.29%,0.52%
2020-01-01 00:10:30,7,3,853,6,847,1.30%,0.70%
2020-01-01 00:10:30,7,4,2093,32,2061,3.19%,1.53%
2020-01-01 00:10:30,7,5,7516,413,7103,11.47%,5.49%
2020-01-01 00:10:30,7,6,13299,1252,12047,20.29%,9.41%
2020-01-01 00:10:30,7,7,3576,89,3487,5.46%,2.49%
2020-01-01 00:10:30,7,8,1464,21,1443,2.23%,1.43%
2020-01-01 00:10:30,7,9,6462,310,6152,9.86%,4.80%
2020-01-01 00:10:30,7,10,1172,12,1160,1.79%,1.02%
2020-01-01 00:10:30,7,11,72,0,72,0.11%,0.00%
2020-01-01 00:10:30,7,12,5273,194,5079,8.05%,3.68%
2020-01-01 00:10:30,8,1,415,0,415,0.63%,0.00%
2020-01-01 00:10:30,8,2,78,3,75,0.12%,3.80%
2020-01-01 00:10:30,8,3,1728,17,1711,2.64%,0.98%
2020-01-01 00:10:30,8,4,2783,69,2714,4.25%,2.48%
2020-01-01 00:10:30,8,5,8640,492,8148,13.18%,5.69%
2020-01-01 00:10:30,8,6,17069,2031,15038,26.05%,11.90%
2020-01-01 00:10:30,8,7,5565,234,5331,8.49%,4.20%
2020-01-01 00:10:30,8,8,2718,60,2658,4.15%,2.21%
2020-01-01 00:10:30,8,9,6464,281,6183,9.86%,4.35%
2020-01-01 00:10:30,8,10,1970,27,1943,3.01%,1.37%
2020-01-01 00:10:30,8,11,168,0,168,0.26%,0.00%
2020-01-01 00:10:30,8,12,4361,122,4239,6.65%,2.80%
2020-01-01 00:10:30,9,1,890,4,886,1.36%,0.45%
2020-01-01 00:10:30,9,2,2084,37,2047,3.18%,1.77%
2020-01-01 00:10:30,9,3,852,7,845,1.30%,0.82%
2020-01-01 00:10:30,9,4,12199,1072,11127,18.61%,8.79%
2020-01-01 00:10:30,9,5,487,4,483,0.74%,0.82%
2020-01-01 00:10:30,9,6,13571,1325,12246,20.71%,9.76%
2020-01-01 00:10:30,9,7,39007,9656,29351,59.52%,24.75%
2020-01-01 00:10:30,9,8,14561,1480,13081,22.22%,10.16%
2020-01-01 00:10:30,9,9,323,1,322,0.49%,0.31%
2020-01-01 00:10:30,9,10,7942,429,7513,12.12%,5.40%
2020-01-01 00:10:30,9,11,13403,1234,12169,20.45%,9.21%
2020-01-01 00:10:30,9,12,5129,185,4944,7.83%,3.61%
2020-01-01 00:10:30,10,1,1160,276,884,1.77%,23.77%
2020-01-01 00:10:30,10,2,3308,343,2965,5.05%,10.37%
2020-01-01 00:10:30,10,3,1617,26,1591,2.47%,1.61%
2020-01-01 00:10:30,10,4,4139,807,3332,6.32%,19.49%
2020-01-01 00:10:30,10,5,751,31,720,1.15%,4.12%
2020-01-01 00:10:30,10,6,6051,958,5093,9.23%,15.83%
2020-01-01 00:10:30,10,7,11663,1804,9859,17.80%,15.47%
2020-01-01 00:10:30,10,8,28577,7059,21518,43.61%,24.70%
2020-01-01 00:10:30,10,9,465,2,463,0.71%,0.43%
2020-01-01 00:10:30,10,10,2526,40,2486,3.85%,1.58%
2020-01-01 00:10:30,10,11,12695,1578,11117,19.37%,12.43%
2020-01-01 00:10:30,10,12,9664,1126,8538,14.75%,11.65%
2020-01-01 00:10:30,11,1,2037,32,2005,3.11%,1.57%
2020-01-01 00:10:30,11,2,4056,136,3920,6.19%,3.35%
2020-01-01 00:10:30,11,3,1895,33,1862,2.89%,1.74%
2020-01-01 00:10:30,11,4,4682,194,4488,7.14%,4.14%
2020-01-01 00:10:30,11,5,243,4,239,0.37%,1.64%
2020-01-01 00:10:30,11,6,5682,285,5397,8.67%,5.01%
2020-01-01 00:10:30,11,7,11667,1006,10661,17.80%,8.62%
2020-01-01 00:10:30,11,8,26630,4858,21772,40.63%,18.24%
2020-01-01 00:10:30,11,9,419,2,417,0.64%,0.48%
2020-01-01 00:10:30,11,10,3911,132,3779,5.97%,3.37%
2020-01-01 00:10:30,11,11,10729,894,9835,16.37%,8.33%
2020-01-01 00:10:30,11,12,6428,314,6114,9.81%,4.88%
2020-01-01 00:10:30,12,1,39,0,39,0.06%,0.00%
2020-01-01 00:10:30,12,2,508,183,325,0.78%,35.95%
2020-01-01 00:10:30,12,3,2433,215,2218,3.71%,8.83%
2020-01-01 00:10:30,12,4,2741,57,2684,4.18%,2.08%
2020-01-01 00:10:30,12,5,8470,710,7760,12.92%,8.38%
2020-01-01 00:10:30,12,6,5245,216,5029,8.00%,4.12%
2020-01-01 00:10:30,12,7,2303,31,2272,3.51%,1.35%
2020-01-01 00:10:30,12,8,1507,238,1269,2.30%,15.78%
2020-01-01 00:10:30,12,9,21327,4079,17248,32.54%,19.13%
2020-01-01 00:10:30,12,10,4072,333,3739,6.21%,8.18%
2020-01-01 00:10:30,12,11,1827,244,1583,2.79%,13.35%
2020-01-01 00:10:30,12,12,8211,1142,7069,12.53%,13.91%
2020-01-01 00:10:30,13,1,1713,21,1692,2.61%,1.23%
2020-01-01 00:10:30,13,2,2027,28,1999,3.09%,1.38%
2020-01-01 00:10:30,13,3,457,0,457,0.70%,0.00%
2020-01-01 00:10:30,13,4,4294,520,3774,6.55%,12.11%
2020-01-01 00:10:30,13,5,6305,756,5549,9.62%,11.99%
2020-01-01 00:10:30,13,6,5060,576,4484,7.72%,11.38%
2020-01-01 00:10:30,13,7,4370,143,4227,6.67%,3.27%
2020-01-01 00:10:30,13,8,6674,338,6336,10.18%,5.06%
2020-01-01 00:10:30,13,9,6601,778,5823,10.07%,11.78%
2020-01-01 00:10:30,13,10,25621,5090,20531,39.09%,19.87%
2020-01-01 00:10:30,13,11,16074,2200,13874,24.53%,13.69%
2020-01-01 00:10:30,13,12,8933,1018,7915,13.63%,11.39%
2020-01-01 00:10:30,14,1,338,0,338,0.52%,0.00%
2020-01-01 00:10:30,14,2,1894,25,1869,2.89%,1.32%
2020-01-01 00:10:30,14,3,1349,14,1335,2.06%,1.04%
2020-01-01 00:10:30,14,4,3569,107,3462,5.45%,3.00%
2020-01-01 00:10:30,14,5,1287,18,1269,1.96%,1.40%
2020-01-01 00:10:30,14,6,3863,119,3744,5.89%,3.08%
2020-01-01 00:10:30,14,7,11049,868,10181,16.86%,7.86%
2020-01-01 00:10:30,14,8,12720,1152,11568,19.41%,9.06%
2020-01-01 00:10:30,14,9,1458,20,1438,2.22%,1.37%
2020-01-01 00:10:30,14,10,3832,125,3707,5.85%,3.26%
2020-01-01 00:10:30,14,11,24150,3889,20261,36.85%,16.10%
2020-01-01 00:10:30,14,12,7347,369,6978,11.21%,5.02%
2020-01-01 00:10:30,15,1,474,2,472,0.72%,0.42%
2020-01-01 00:10:30,15,2,149,0,149,0.23%,0.00%
2020-01-01 00:10:30,15,3,6742,313,6429,10.29%,4.64%
2020-01-01 00:10:30,15,4,4669,184,4485,7.12%,3.94%
2020-01-01 00:10:30,15,5,12331,1116,11215,18.82%,9.05%
2020-01-01 00:10:30,15,6,4985,231,4754,7.61%,4.63%
2020-01-01 00:10:30,15,7,3262,88,3174,4.98%,2.70%
2020-01-01 00:10:30,15,8,5333,214,5119,8.14%,4.01%
2020-01-01 00:10:30,15,9,12578,1163,11415,19.19%,9.25%
2020-01-01 00:10:30,15,10,4782,219,4563,7.30%,4.58%
2020-01-01 00:10:30,15,11,10239,786,9453,15.62%,7.68%
2020-01-01 00:10:30,15,12,28300,5699,22601,43.18%,20.14%
2020-01-01 00:10:30,16,1,392,0,392,0.60%,0.00%
2020-01-01 00:10:30,16,2,249,1,248,0.38%,0.40%
2020-01-01 00:10:30,16,3,1064,12,1052,1.62%,1.13%
2020-01-01 00:10:30,16,4,4174,121,4053,6.37%,2.90%
2020-01-01 00:10:30,16,5,7519,434,7085,11.47%,5.77%
2020-01-01 00:10:30,16,6,5018,174,4844,7.66%,3.47%
2020-01-01 00:10:30,16,7,3259,80,3179,4.97%,2.45%
2020-01-01 00:10:30,16,8,6938,384,6554,10.59%,5.53%
2020-01-01 00:10:30,16,9,7943,482,7461,12.12%,6.07%
2020-01-01 00:10:30,16,10,1702,23,1679,2.60%,1.35%
2020-01-01 00:10:30,16,11,8850,598,8252,13.50%,6.76%
2020-01-01 00:10:30,16,12,24446,4080,20366,37.30%,16.69%
2020-01-01 00:10:40,1,1,19773,2723,17050,30.17%,13.77%
2020-01-01 00:10:40,1,2,7353,431,6922,11.22%,5.86%
2020-01-01 00:10:40,1,3,450,0,450,0.69%,0.00%
2020-01-01 00:10:40,1,4,12027,1095,10932,18.35%,9.10%
2020-01-01 00:10:40,1,5,11458,1007,10451,17.48%,8.79%
2020-01-01 00:10:40,1,6,11382,996,10386,17.37%,8.75%
2020-01-01 00:10:40,1,7,6889,373,6516,10.51%,5.41%
2020-01-01 00:10:40,1,8,6097,296,5801,9.30%,4.85%
2020-01-01 00:10:40,1,9,11358,993,10365,17.33%,8.74%
2020-01-01 00:10:40,1,10,5318,222,5096,8.11%,4.17%
2020-01-01 00:10:40,1,11,5368,223,5145,8.19%,4.15%
2020-01-01 00:10:40,1,12,11334,989,10345,17.29%,8.73%
2020-01-01 00:10:40,2,1,1170,12,1158,1.79%,1.02%
2020-01-01 00:10:40,2,2,32419,6717,25702,49.47%,20.72%
2020-01-01 00:10:40,2,3,23619,3672,19947,36.04%,15.55%
2020-01-01 00:10:40,2,4,1079,11,1068,1.65%,1.02%
2020-01-01 00:10:40,2,5,14898,1528,13370,22.73%,10.26%
2020-01-01 00:10:40,2,6,47,0,47,0.07%,0.00%
2020-01-01 00:10:40,2,7,7617,410,7207,11.62%,5.38%
2020-01-01 00:10:40,2,8,6207,277,5930,9.47%,4.46%
2020-01-01 00:10:40,2,9,14833,1517,13316,22.63%,10.23%
2020-01-01 00:10:40,2,10,5500,217,5283,8.39%,3.94%
2020-01-01 00:10:40,2,11,5515,219,5296,8.42%,3.97%
2020-01-01 00:10:40,2,12,14653,1473,13180,22.36%,10.05%
2020-01-01 00:10:40,3,1,1831,26,1805,2.79%,1.42%
2020-01-01 00:10:40,3,2,25259,4290,20969,38.54%,16.98%
2020-01-01 00:10:40,3,3,77182,31802,45380,117.77%,41.20%
2020-01-01 00:10:40,3,4,11687,970,10717,17.83%,8.30%
2020-01-01 00:10:40,3,5,50854,15532,35322,77.60%,30.54%
2020-01-01 00:10:40,3,6,12755,1159,11596,19.46%,9.09%
2020-01-01 00:10:40,3,7,21672,3211,18461,33.07%,14.82%
2020-01-01 00:10:40,3,8,17534,2168,15366,26.75%,12.36%
2020-01-01 00:10:40,3,9,37033,8767,28266,56.51%,23.67%
2020-01-01 00:10:40,3,10,4193,131,4062,6.40%,3.12%
2020-01-01 00:10:40,3,11,1475,12,1463,2.25%,0.81%
2020-01-01 00:10:40,3,12,29135,5573,23562,44.46%,19.13%
2020-01-01 00:10:40,4,1,470,1,469,0.72%,0.21%
2020-01-01 00:10:40,4,2,273,1,272,0.42%,0.36%
2020-01-01 00:10:40,4,3,1044,7,1037,1.59%,0.67%
2020-01-01 00:10:40,4,4,28550,5408,23142,43.56%,18.94%
2020-01-01 00:10:40,4,5,18104,2269,15835,27.62%,12.53%
2020-01-01 00:10:40,4,6,24735,4119,20616,37.74%,16.65%
2020-01-01 00:10:40,4,7,5373,226,5147,8.20%,4.21%
2020-01-01 00:10:40,4,8,2798,75,2723,4.27%,2.68%
2020-01-01 00:10:40,4,9,16050,1823,14227,24.49%,11.36%
2020-01-01 00:10:40,4,10,2063,24,2039,3.15%,1.16%
2020-01-01 00:10:40,4,11,128,0,128,0.20%,0.00%
2020-01-01 00:10:40,4,12,12692,1159,11533,19.37%,9.13%
2020-01-01 00:10:40,5,1,2779,58,2721,4.24%,2.09%
2020-01-01 00:10:40,5,2,603,0,603,0.92%,0.00%
2020-01-01 00:10:40,5,3,1180,10,1170,1.80%,0.85%
2020-01-01 00:10:40,5,4,22339,3532,18807,34.09%,15.81%
2020-01-01 00:10:40,5,5,9510,672,8838,14.51%,7.07%
2020-01-01 00:10:40,5,6,13759,1390,12369,20.99%,10.10%
2020-01-01 00:10:40,5,7,3764,126,3638,5.74%,3.35%
2020-01-01 00:10:40,5,8,2684,50,2634,4.10%,1.86%
2020-01-01 00:10:40,5,9,8225,521,7704,12.55%,6.33%
2020-01-01 00:10:40,5,10,1127,11,1116,1.72%,0.98%
2020-01-01 00:10:40,5,11,784,8,776,1.20%,1.02%
2020-01-01 00:10:40,5,12,6903,373,6530,10.53%,5.40%
2020-01-01 00:10:40,6,1,1175,8,1167,1.79%,0.68%
2020-01-01 00:10:40,6,2,1237,9,1228,1.89%,0.73%
2020-01-01 00:10:40,6,3,1730,20,1710,2.64%,1.16%
2020-01-01 00:10:40,6,4,1168,14,1154,1.78%,1.20%
2020-01-01 00:10:40,6,5,14971,1554,13417,22.84%,10.38%
2020-01-01 00:10:40,6,6,5261,238,5023,8.03%,4.52%
2020-01-01 00:10:40,6,7,3537,98,3439,5.40%,2.77%
2020-01-01 00:10:40,6,8,2320,66,2254,3.54%,2.84%
2020-01-01 00:10:40,6,9,7627,397,7230,11.64%,5.20%
2020-01-01 00:10:40,6,10,2472,46,2426,3.77%,1.86%
2020-01-01 00:10:40,6,11,463,3,460,0.71%,0.65%
2020-01-01 00:10:40,6,12,5072,183,4889,7.74%,3.61%
2020-01-01 00:10:40,7,1,384,1,383,0.59%,0.26%
2020-01-01 00:10:40,7,2,234,0,234,0.36%,0.00%
2020-01-01 00:10:40,7,3,612,5,607,0.93%,0.82%
2020-01-01 00:10:40,7,4,1304,17,1287,1.99%,1.30%
2020-01-01 00:10:40,7,5,7812,414,7398,11.92%,5.30%
2020-01-01 00:10:40,7,6,12507,1128,11379,19.08%,9.02%
2020-01-01 00:10:40,7,7,3332,82,3250,5.08%,2.46%
2020-01-01 00:10:40,7,8,1387,14,1373,2.12%,1.01%
2020-01-01 00:10:40,7,9,7174,348,6826,10.95%,4.85%
2020-01-01 00:10:40,7,10,1289,7,1282,1.97%,0.54%
2020-01-01 00:10:40,7,11,83,0,83,0.13%,0.00%
2020-01-01 00:10:40,7,12,5828,213,5615,8.89%,3.65%
2020-01-01 00:10:40,8,1,316,0,316,0.48%,0.00%
2020-01-01 00:10:40,8,2,64,0,64,0.10%,0.00%
2020-01-01 00:10:40,8,3,1470,26,1444,2.24%,1.77%
2020-01-01 00:10:40,8,4,2604,47,2557,3.97%,1.80%
2020-01-01 00:10:40,8,5,7359,384,6975,11.23%,5.22%
2020-01-01 00:10:40,8,6,14978,1543,13435,22.85%,10.30%
2020-01-01 00:10:40,8,7,4891,192,4699,7.46%,3.92%
2020-01-01 00:10:40,8,8,2049,39,2010,3.13%,1.90%
2020-01-01 00:10:40,8,9,5536,202,5334,8.45%,3.65%
2020-01-01 00:10:40,8,10,1452,18,1434,2.22%,1.24%
2020-01-01 00:10:40,8,11,169,0,169,0.26%,0.00%
2020-01-01 00:10:40,8,12,3986,112,3874,6.08%,2.81%
2020-01-01 00:10:40,9,1,474,1,473,0.72%,0.21%
2020-01-01 00:10:40,9,2,2562,55,2507,3.91%,2.15%
2020-01-01 00:10:40,9,3,1626,16,1610,2.48%,0.98%
2020-01-01 00:10:40,9,4,7917,484,7433,12.08%,6.11%
2020-01-01 00:10:40,9,5,273,0,273,0.42%,0.00%
2020-01-01 00:10:40,9,6,8739,598,8141,13.33%,6.84%
2020-01-01 00:10:40,9,7,28590,5366,23224,43.62%,18.77%
2020-01-01 00:10:40,9,8,9557,654,8903,14.58%,6.84%
2020-01-01 00:10:40,9,9,244,0,244,0.37%,0.00%
2020-01-01 00:10:40,9,10,2483,43,2440,3.79%,1.73%
2020-01-01 00:10:40,9,11,8109,483,7626,12.37%,5.96%
2020-01-01 00:10:40,9,12,5427,218,5209,8.28%,4.02%
2020-01-01 00:10:40,10,1,1065,178,887,1.63%,16.70%
2020-01-01 00:10:40,10,2,3307,250,3057,5.05%,7.56%
2020-01-01 00:10:40,10,3,1947,36,1911,2.97%,1.85%
2020-01-01 00:10:40,10,4,3986,871,3115,6.08%,21.85%
2020-01-01 00:10:40,10,5,736,1,735,1.12%,0.14%
2020-01-01 00:10:40,10,6,6066,985,5081,9.26%,16.24%
2020-01-01 00:10:40,10,7,11593,1797,9796,17.69%,15.50%
2020-01-01 00:10:40,10,8,29475,7159,22316,44.98%,24.29%
2020-01-01 00:10:40,10,9,735,5,730,1.12%,0.68%
2020-01-01 00:10:40,10,10,2270,42,2228,3.46%,1.85%
2020-01-01 00:10:40,10,11,13576,1657,11919,20.72%,12.20%
2020-01-01 00:10:40,10,12,10323,1148,9175,15.75%,11.12%
2020-01-01 00:10:40,11,1,2138,52,2086,3.26%,2.43%
2020-01-01 00:10:40,11,2,4948,187,4761,7.55%,3.78%
2020-01-01 00:10:40,11,3,2605,40,2565,3.97%,1.53%
2020-01-01 00:10:40,11,4,4445,141,4304,6.78%,3.17%
2020-01-01 00:10:40,11,5,144,0,144,0.22%,0.00%
2020-01-01 00:10:40,11,6,5137,192,4945,7.84%,3.74%
2020-01-01 00:10:40,11,7,12276,1048,11228,18.73%,8.54%
2020-01-01 00:10:40,11,8,25944,4504,21440,39.59%,17.36%
2020-01-01 00:10:40,11,9,202,2,200,0.31%,0.99%
2020-01-01 00:10:40,11,10,2941,65,2876,4.49%,2.21%
2020-01-01 00:10:40,11,11,9944,718,9226,15.17%,7.22%
2020-01-01 00:10:40,11,12,6545,346,6199,9.99%,5.29%
2020-01-01 00:10:40,12,1,70,0,70,0.11%,0.00%
2020-01-01 00:10:40,12,2,475,169,306,0.72%,35.50%
2020-01-01 00:10:40,12,3,2524,207,2317,3.85%,8.20%
2020-01-01 00:10:40,12,4,2795,68,2727,4.26%,2.43%
2020-01-01 00:10:40,12,5,8688,687,8001,13.26%,7.91%
2020-01-01 00:10:40,12,6,5126,198,4928,7.82%,3.86%
2020-01-01 00:10:40,12,7,2154,39,2115,3.29%,1.81%
2020-01-01 00:10:40,12,8,1300,261,1039,1.98%,20.06%
2020-01-01 00:10:40,12,9,20759,3839,16920,31.68%,18.49%
2020-01-01 00:10:40,12,10,3681,355,3326,5.62%,9.64%
2020-01-01 00:10:40,12,11,1511,265,1246,2.31%,17.53%
2020-01-01 00:10:40,12,12,7908,1033,6875,12.07%,13.06%
2020-01-01 00:10:40,13,1,2416,59,2357,3.69%,2.44%
2020-01-01 00:10:40,13,2,2711,68,2643,4.14%,2.51%
2020-01-01 00:10:40,13,3,512,3,509,0.78%,0.58%
2020-01-01 00:10:40,13,4,4520,550,3970,6.90%,12.17%
2020-01-01 00:10:40,13,5,6508,750,5758,9.93%,11.52%
2020-01-01 00:10:40,13,6,5320,599,4721,8.12%,11.26%
2020-01-01 00:10:40,13,7,5092,215,4877,7.77%,4.22%
2020-01-01 00:10:40,13,8,7105,379,6726,10.84%,5.33%
2020-01-01 00:10:40,13,9,6903,779,6124,10.53%,11.28%
2020-01-01 00:10:40,13,10,25779,4969,20810,39.34%,19.27%
2020-01-01 00:10:40,13,11,15891,2032,13859,24.25%,12.79%
2020-01-01 00:10:40,13,12,8251,850,7401,12.59%,10.30%
2020-01-01 00:10:40,14,1,234,1,233,0.36%,0.43%
2020-01-01 00:10:40,14,2,1454,12,1442,2.22%,0.82%
2020-01-01 00:10:40,14,3,1053,7,1046,1.61%,0.66%
2020-01-01 00:10:40,14,4,4503,161,4342,6.87%,3.57%
2020-01-01 00:10:40,14,5,1253,13,1240,1.91%,1.04%
2020-01-01 00:10:40,14,6,4736,178,4558,7.23%,3.76%
2020-01-01 00:10:40,14,7,13093,1262,11831,19.98%,9.64%
2020-01-01 00:10:40,14,8,14838,1596,13242,22.64%,10.76%
2020-01-01 00:10:40,14,9,1424,13,1411,2.17%,0.91%
2020-01-01 00:10:40,14,10,4459,173,4286,6.80%,3.88%
2020-01-01 00:10:40,14,11,26581,4763,21818,40.56%,17.92%
2020-01-01 00:10:40,14,12,7121,388,6733,10.87%,5.45%
2020-01-01 00:10:40,15,1,610,2,608,0.93%,0.33%
2020-01-01 00:10:40,15,2,170,0,170,0.26%,0.00%
2020-01-01 00:10:40,15,3,4104,159,3945,6.26%,3.87%
2020-01-01 00:10:40,15,4,4927,174,4753,7.52%,3.53%
2020-01-01 00:10:40,15,5,9688,721,8967,14.78%,7.44%
2020-01-01 00:10:40,15,6,5164,196,4968,7.88%,3.79%
2020-01-01 00:10:40,15,7,3574,126,3448,5.45%,3.52%
2020-01-01 00:10:40,15,8,5796,324,5472,8.84%,5.59%
2020-01-01 00:10:40,15,9,9948,757,9191,15.18%,7.61%
2020-01-01 00:10:40,15,10,4559,173,4386,6.96%,3.79%
2020-01-01 00:10:40,15,11,10498,881,9617,16.02%,8.39%
2020-01-01 00:10:40,15,12,25717,4801,20916,39.24%,18.67%
2020-01-01 00:10:40,16,1,355,0,355,0.54%,0.00%
2020-01-01 00:10:40,16,2,186,0,186,0.28%,0.00%
2020-01-01 00:10:40,16,3,1190,11,1179,1.82%,0.92%
2020-01-01 00:10:40,16,4,4024,126,3898,6.14%,3.13%
2020-01-01 00:10:40,16,5,7266,414,6852,11.09%,5.70%
2020-01-01 00:10:40,16,6,4744,172,4572,7.24%,3.62%
2020-01-01 00:10:40,16,7,3418,87,3331,5.22%,2.54%
2020-01-01 00:10:40,16,8,7384,545,6839,11.27%,7.38%
2020-01-01 00:10:40,16,9,7647,458,7189,11.67%,5.99%
2020-01-01 00:10:40,16,10,1560,20,1540,2.38%,1.28%
2020-01-01 00:10:40,16,11,9232,770,8462,14.09%,8.34%
2020-01-01 00:10:40,16,12,24437,4173,20264,37.29%,17.08%
2020-01-01 00:10:50,1,1,19550,2667,16883,29.83%,13.64%
2020-01-01 00:10:50,1,2,6986,356,6630,10.66%,5.10%
2020-01-01 00:10:50,1,3,768,3,765,1.17%,0.39%
2020-01-01 00:10:50,1,4,12189,1099,11090,18.60%,9.02%
2020-01-01 00:10:50,1,5,11994,1055,10939,18.30%,8.80%
2020-01-01 00:10:50,1,6,11855,1038,10817,18.09%,8.76%
2020-01-01 00:10:50,1,7,6207,287,5920,9.47%,4.62%
2020-01-01 00:10:50,1,8,4704,154,4550,7.18%,3.27%
2020-01-01 00:10:50,1,9,11825,1031,10794,18.04%,8.72%
2020-01-01 00:10:50,1,10,4072,118,3954,6.21%,2.90%
2020-01-01 00:10:50,1,11,4171,124,4047,6.36%,2.97%
2020-01-01 00:10:50,1,12,11807,1029,10778,18.02%,8.71%
2020-01-01 00:10:50,2,1,1065,7,1058,1.63%,0.66%
2020-01-01 00:10:50,2,2,26016,4650,21366,39.70%,17.87%
2020-01-01 00:10:50,2,3,20412,2974,17438,31.15%,14.57%
2020-01-01 00:10:50,2,4,1017,6,1011,1.55%,0.59%
2020-01-01 00:10:50,2,5,13881,1397,12484,21.18%,10.06%
2020-01-01 00:10:50,2,6,23,0,23,0.04%,0.00%
2020-01-01 00:10:50,2,7,4513,161,4352,6.89%,3.57%
2020-01-01 00:10:50,2,8,3265,76,3189,4.98%,2.33%
2020-01-01 00:10:50,2,9,13750,1368,12382,20.98%,9.95%
2020-01-01 00:10:50,2,10,2664,49,2615,4.06%,1.84%
2020-01-01 00:10:50,2,11,2670,49,2621,4.07%,1.83%
2020-01-01 00:10:50,2,12,13571,1342,12229,20.71%,9.89%
2020-01-01 00:10:50,3,1,2028,26,2002,3.09%,1.28%
2020-01-01 00:10:50,3,2,22124,3386,18738,33.76%,15.30%
2020-01-01 00:10:50,3,3,69809,26897,42912,106.52%,38.53%
2020-01-01 00:10:50,3,4,9963,742,9221,15.20%,7.45%
2020-01-01 00:10:50,3,5,46694,13282,33412,71.25%,28.44%
2020-01-01 00:10:50,3,6,11211,928,10283,17.11%,8.28%
2020-01-01 00:10:50,3,7,18473,2419,16054,28.19%,13.09%
2020-01-01 00:10:50,3,8,15267,1684,13583,23.30%,11.03%
2020-01-01 00:10:50,3,9,35008,7841,27167,53.42%,22.40%
2020-01-01 00:10:50,3,10,6748,333,6415,10.30%,4.93%
2020-01-01 00:10:50,3,11,1450,17,1433,2.21%,1.17%
2020-01-01 00:10:50,3,12,26672,4693,21979,40.70%,17.59%
2020-01-01 00:10:50,4,1,494,5,489,0.75%,1.01%
2020-01-01 00:10:50,4,2,307,4,303,0.47%,1.30%
2020-01-01 00:10:50,4,3,1001,7,994,1.53%,0.70%
2020-01-01 00:10:50,4,4,27508,5030,22478,41.97%,18.28%
2020-01-01 00:10:50,4,5,17779,2230,15549,27.13%,12.54%
2020-01-01 00:10:50,4,6,24100,3918,20182,36.77%,16.26%
2020-01-01 00:10:50,4,7,5086,176,4910,7.76%,3.46%
2020-01-01 00:10:50,4,8,2953,71,2882,4.51%,2.40%
2020-01-01 00:10:50,4,9,15643,1704,13939,23.87%,10.89%
2020-01-01 00:10:50,4,10,1776,27,1749,2.71%,1.52%
2020-01-01 00:10:50,4,11,169,0,169,0.26%,0.00%
2020-01-01 00:10:50,4,12,12959,1196,11763,19.77%,9.23%
2020-01-01 00:10:50,5,1,2947,59,2888,4.50%,2.00%
2020-01-01 00:10:50,5,2,940,5,935,1.43%,0.53%
2020-01-01 00:10:50,5,3,1103,12,1091,1.68%,1.09%
2020-01-01 00:10:50,5,4,26947,4802,22145,41.12%,17.82%
2020-01-01 00:10:50,5,5,11292,938,10354,17.23%,8.31%
2020-01-01 00:10:50,5,6,17079,2068,15011,26.06%,12.11%
2020-01-01 00:10:50,5,7,5271,232,5039,8.04%,4.40%
2020-01-01 00:10:50,5,8,3537,112,3425,5.40%,3.17%
2020-01-01 00:10:50,5,9,10026,738,9288,15.30%,7.36%
2020-01-01 00:10:50,5,10,1530,19,1511,2.33%,1.24%
2020-01-01 00:10:50,5,11,950,6,944,1.45%,0.63%
2020-01-01 00:10:50,5,12,8003,475,7528,12.21%,5.93%
2020-01-01 00:10:50,6,1,1067,17,1050,1.63%,1.59%
2020-01-01 00:10:50,6,2,1193,24,1169,1.82%,2.01%
2020-01-01 00:10:50,6,3,1433,27,1406,2.19%,1.88%
2020-01-01 00:10:50,6,4,1503,17,1486,2.29%,1.13%
2020-01-01 00:10:50,6,5,16517,1905,14612,25.20%,11.53%
2020-01-01 00:10:50,6,6,5722,284,5438,8.73%,4.96%
2020-01-01 00:10:50,6,7,3637,131,3506,5.55%,3.60%
2020-01-01 00:10:50,6,8,3003,88,2915,4.58%,2.93%
2020-01-01 00:10:50,6,9,9063,588,8475,13.83%,6.49%
2020-01-01 00:10:50,6,10,2278,34,2244,3.48%,1.49%
2020-01-01 00:10:50,6,11,434,0,434,0.66%,0.00%
2020-01-01 00:10:50,6,12,6726,337,6389,10.26%,5.01%
2020-01-01 00:10:50,7,1,418,4,414,0.64%,0.95%
2020-01-01 00:10:50,7,2,195,0,195,0.30%,0.00%
2020-01-01 00:10:50,7,3,1315,11,1304,2.01%,0.84%
2020-01-01 00:10:50,7,4,2047,31,2016,3.12%,1.51%
2020-01-01 00:10:50,7,5,7407,371,7036,11.30%,5.01%
2020-01-01 00:10:50,7,6,13392,1235,12157,20.43%,9.22%
2020-01-01 00:10:50,7,7,3856,132,3724,5.88%,3.42%
2020-01-01 00:10:50,7,8,1342,14,1328,2.05%,1.04%
2020-01-01 00:10:50,7,9,6015,255,5760,9.18%,4.24%
2020-01-01 00:10:50,7,10,1500,15,1485,2.29%,1.00%
2020-01-01 00:10:50,7,11,76,0,76,0.12%,0.00%
2020-01-01 00:10:50,7,12,4495,148,4347,6.86%,3.29%
2020-01-01 00:10:50,8,1,272,0,272,0.42%,0.00%
2020-01-01 00:10:50,8,2,95,0,95,0.14%,0.00%
2020-01-01 00:10:50,8,3,1362,15,1347,2.08%,1.10%
2020-01-01 00:10:50,8,4,2886,65,2821,4.40%,2.25%
2020-01-01 00:10:50,8,5,7821,446,7375,11.93%,5.70%
2020-01-01 00:10:50,8,6,15872,1845,14027,24.22%,11.62%
2020-01-01 00:10:50,8,7,5003,212,4791,7.63%,4.24%
2020-01-01 00:10:50,8,8,1918,38,1880,2.93%,1.98%
2020-01-01 00:10:50,8,9,6043,287,5756,9.22%,4.75%
2020-01-01 00:10:50,8,10,1865,25,1840,2.85%,1.34%
2020-01-01 00:10:50,8,11,356,1,355,0.54%,0.28%
2020-01-01 00:10:50,8,12,4064,127,3937,6.20%,3.12%
2020-01-01 00:10:50,9,1,791,6,785,1.21%,0.76%
2020-01-01 00:10:50,9,2,2986,75,2911,4.56%,2.51%
2020-01-01 00:10:50,9,3,1675,24,1651,2.56%,1.43%
2020-01-01 00:10:50,9,4,6396,261,6135,9.76%,4.08%
2020-01-01 00:10:50,9,5,196,1,195,0.30%,0.51%
2020-01-01 00:10:50,9,6,6987,318,6669,10.66%,4.55%
2020-01-01 00:10:50,9,7,28114,5165,22949,42.90%,18.37%
2020-01-01 00:10:50,9,8,9653,673,8980,14.73%,6.97%
2020-01-01 00:10:50,9,9,170,1,169,0.26%,0.58%
2020-01-01 00:10:50,9,10,2921,57,2864,4.46%,1.95%
2020-01-01 00:10:50,9,11,8846,560,8286,13.50%,6.33%
2020-01-01 00:10:50,9,12,5625,235,5390,8.58%,4.18%
2020-01-01 00:10:50,10,1,1579,353,1226,2.41%,22.34%
2020-01-01 00:10:50,10,2,3333,415,2918,5.09%,12.45%
2020-01-01 00:10:50,10,3,1578,23,1555,2.41%,1.46%
2020-01-01 00:10:50,10,4,4032,978,3054,6.15%,24.25%
2020-01-01 00:10:50,10,5,867,7,860,1.32%,0.81%
2020-01-01 00:10:50,10,6,6201,1108,5093,9.46%,17.87%
2020-01-01 00:10:50,10,7,11413,2035,9378,17.41%,17.83%
2020-01-01 00:10:50,10,8,29632,7300,22332,45.21%,24.63%
2020-01-01 00:10:50,10,9,957,3,954,1.46%,0.31%
2020-01-01 00:10:50,10,10,2640,46,2594,4.03%,1.74%
2020-01-01 00:10:50,10,11,13375,1662,11713,20.41%,12.43%
2020-01-01 00:10:50,10,12,10257,1158,9099,15.65%,11.29%
2020-01-01 00:10:50,11,1,2274,39,2235,3.47%,1.71%
2020-01-01 00:10:50,11,2,3629,108,3521,5.54%,2.98%
2020-01-01 00:10:50,11,3,1220,9,1211,1.86%,0.74%
2020-01-01 00:10:50,11,4,4802,168,4634,7.33%,3.50%
2020-01-01 00:10:50,11,5,287,2,285,0.44%,0.69%
2020-01-01 00:10:50,11,6,5809,247,5562,8.86%,4.25%
2020-01-01 00:10:50,11,7,11515,938,10577,17.57%,8.15%
2020-01-01 00:10:50,11,8,25717,4502,21215,39.24%,17.51%
2020-01-01 00:10:50,11,9,190,0,190,0.29%,0.00%
2020-01-01 00:10:50,11,10,3200,102,3098,4.88%,3.19%
2020-01-01 00:10:50,11,11,9987,735,9252,15.24%,7.36%
2020-01-01 00:10:50,11,12,6505,326,6179,9.93%,5.01%
2020-01-01 00:10:50,12,1,107,0,107,0.16%,0.00%
2020-01-01 00:10:50,12,2,783,257,526,1.19%,32.78%
2020-01-01 00:10:50,12,3,3442,324,3118,5.25%,9.41%
2020-01-01 00:10:50,12,4,3253,89,3164,4.96%,2.74%
2020-01-01 00:10:50,12,5,10028,975,9053,15.30%,9.72%
2020-01-01 00:10:50,12,6,5860,332,5528,8.94%,5.66%
2020-01-01 00:10:50,12,7,2460,60,2400,3.75%,2.44%
2020-01-01 00:10:50,12,8,1186,248,938,1.81%,20.89%
2020-01-01 00:10:50,12,9,22196,4457,17739,33.87%,20.08%
2020-01-01 00:10:50,12,10,3857,348,3509,5.89%,9.02%
2020-01-01 00:10:50,12,11,1497,253,1244,2.28%,16.89%
2020-01-01 00:10:50,12,12,7331,1030,6301,11.19%,14.05%
2020-01-01 00:10:50,13,1,2294,40,2254,3.50%,1.74%
2020-01-01 00:10:50,13,2,2758,58,2700,4.21%,2.10%
2020-01-01 00:10:50,13,3,890,5,885,1.36%,0.56%
2020-01-01 00:10:50,13,4,4735,536,4199,7.23%,11.32%
2020-01-01 00:10:50,13,5,7531,911,6620,11.49%,12.10%
2020-01-01 00:10:50,13,6,5914,622,5292,9.02%,10.52%
2020-01-01 00:10:50,13,7,5231,212,5019,7.98%,4.05%
2020-01-01 00:10:50,13,8,6953,364,6589,10.61%,5.23%
2020-01-01 00:10:50,13,9,7763,946,6817,11.85%,12.18%
2020-01-01 00:10:50,13,10,29702,6365,23337,45.32%,21.43%
2020-01-01 00:10:50,13,11,18657,2714,15943,28.47%,14.55%
2020-01-01 00:10:50,13,12,11243,1257,9986,17.16%,11.18%
2020-01-01 00:10:50,14,1,502,2,500,0.77%,0.40%
2020-01-01 00:10:50,14,2,1775,25,1750,2.71%,1.41%
2020-01-01 00:10:50,14,3,1116,12,1104,1.70%,1.07%
2020-01-01 00:10:50,14,4,4883,180,4703,7.45%,3.69%
2020-01-01 00:10:50,14,5,1168,9,1159,1.78%,0.77%
2020-01-01 00:10:50,14,6,5415,221,5194,8.26%,4.08%
2020-01-01 00:10:50,14,7,12944,1184,11760,19.75%,9.15%
2020-01-01 00:10:50,14,8,14502,1492,13010,22.13%,10.29%
2020-01-01 00:10:50,14,9,1391,13,1378,2.12%,0.93%
2020-01-01 00:10:50,14,10,4065,118,3947,6.20%,2.90%
2020-01-01 00:10:50,14,11,25460,4400,21060,38.85%,17.28%
2020-01-01 00:10:50,14,12,6655,317,6338,10.15%,4.76%
2020-01-01 00:10:50,15,1,440,1,439,0.67%,0.23%
2020-01-01 00:10:50,15,2,170,0,170,0.26%,0.00%
2020-01-01 00:10:50,15,3,3762,114,3648,5.74%,3.03%
2020-01-01 00:10:50,15,4,6145,253,5892,9.38%,4.12%
2020-01-01 00:10:50,15,5,10686,841,9845,16.31%,7.87%
2020-01-01 00:10:50,15,6,6347,280,6067,9.68%,4.41%
2020-01-01 00:10:50,15,7,3506,86,3420,5.35%,2.45%
2020-01-01 00:10:50,15,8,5275,208,5067,8.05%,3.94%
2020-01-01 00:10:50,15,9,10854,869,9985,16.56%,8.01%
2020-01-01 00:10:50,15,10,4083,127,3956,6.23%,3.11%
2020-01-01 00:10:50,15,11,9549,655,8894,14.57%,6.86%
2020-01-01 00:10:50,15,12,25760,4805,20955,39.31%,18.65%
2020-01-01 00:10:50,16,1,417,3,414,0.64%,0.72%
2020-01-01 00:10:50,16,2,264,0,264,0.40%,0.00%
2020-01-01 00:10:50,16,3,1551,30,1521,2.37%,1.93%
2020-01-01 00:10:50,16,4,4189,179,4010,6.39%,4.27%
2020-01-01 00:10:50,16,5,8051,602,7449,12.28%,7.48%
2020-01-01 00:10:50,16,6,5082,237,4845,7.75%,4.66%
2020-01-01 00:10:50,16,7,3125,77,3048,4.77%,2.46%
2020-01-01 00:10:50,16,8,8963,560,8403,13.68%,6.25%
2020-01-01 00:10:50,16,9,8473,645,7828,12.93%,7.61%
2020-01-01 00:10:50,16,10,1435,29,1406,2.19%,2.02%
2020-01-01 00:10:50,16,11,10761,823,9938,16.42%,7.65%
2020-01-01 00:10:50,16,12,27809,5270,22539,42.43%,18.95%
2020-01-01 00:11:00,1,1,25728,4580,21148,39.26%,17.80%
2020-01-01 00:11:00,1,2,5111,223,4888,7.80%,4.36%
2020-01-01 00:11:00,1,3,665,2,663,1.01%,0.30%
2020-01-01 00:11:00,1,4,20239,2882,17357,30.88%,14.24%
2020-01-01 00:11:00,1,5,20084,2836,17248,30.65%,14.12%
2020-01-01 00:11:00,1,6,19968,2813,17155,30.47%,14.09%
2020-01-01 00:11:00,1,7,4433,176,4257,6.76%,3.97%
2020-01-01 00:11:00,1,8,3255,90,3165,4.97%,2.76%
2020-01-01 00:11:00,1,9,19951,2807,17144,30.44%,14.07%
2020-01-01 00:11:00,1,10,2727,66,2661,4.16%,2.42%
2020-01-01 00:11:00,1,11,2794,72,2722,4.26%,2.58%
2020-01-01 00:11:00,1,12,19924,2800,17124,30.40%,14.05%
2020-01-01 00:11:00,2,1,625,2,623,0.95%,0.32%
2020-01-01 00:11:00,2,2,31333,6447,24886,47.81%,20.58%
2020-01-01 00:11:00,2,3,25647,4425,21222,39.13%,17.25%
2020-01-01 00:11:00,2,4,571,2,569,0.87%,0.35%
2020-01-01 00:11:00,2,5,18051,2301,15750,27.54%,12.75%
2020-01-01 00:11:00,2,6,41,0,41,0.06%,0.00%
2020-01-01 00:11:00,2,7,5049,196,4853,7.70%,3.88%
2020-01-01 00:11:00,2,8,3680,104,3576,5.62%,2.83%
2020-01-01 00:11:00,2,9,17947,2278,15669,27.38%,12.69%
2020-01-01 00:11:00,2,10,2991,72,2919,4.56%,2.41%
2020-01-01 00:11:00,2,11,2994,72,2922,4.57%,2.40%
2020-01-01 00:11:00,2,12,17760,2230,15530,27.10%,12.56%
2020-01-01 00:11:00,3,1,1718,24,1694,2.62%,1.40%
2020-01-01 00:11:00,3,2,24219,3927,20292,36.96%,16.21%
2020-01-01 00:11:00,3,3,76744,31542,45202,117.10%,41.10%
2020-01-01 00:11:00,3,4,9865,687,9178,15.05%,6.96%
2020-01-01 00:11:00,3,5,51537,15981,35556,78.64%,31.01%
2020-01-01 00:11:00,3,6,11522,946,10576,17.58%,8.21%
2020-01-01 00:11:00,3,7,20973,2999,17974,32.00%,14.30%
2020-01-01 00:11:00,3,8,16044,1735,14309,24.48%,10.81%
2020-01-01 00:11:00,3,9,39656,10048,29608,60.51%,25.34%
2020-01-01 00:11:00,3,10,4358,139,4219,6.65%,3.19%
2020-01-01 00:11:00,3,11,1820,26,1794,2.78%,1.43%
2020-01-01 00:11:00,3,12,31394,6534,24860,47.90%,20.81%
2020-01-01 00:11:00,4,1,432,0,432,0.66%,0.00%
2020-01-01 00:11:00,4,2,212,0,212,0.32%,0.00%
2020-01-01 00:11:00,4,3,835,6,829,1.27%,0.72%
2020-01-01 00:11:00,4,4,28433,5251,23182,43.39%,18.47%
2020-01-01 00:11:00,4,5,17619,2197,15422,26.88%,12.47%
2020-01-01 00:11:00,4,6,24651,4013,20638,37.61%,16.28%
2020-01-01 00:11:00,4,7,5752,238,5514,8.78%,4.14%
2020-01-01 00:11:00,4,8,2754,64,2690,4.20%,2.32%
2020-01-01 00:11:00,4,9,15568,1760,13808,23.75%,11.30%
2020-01-01 00:11:00,4,10,1832,27,1805,2.80%,1.47%
2020-01-01 00:11:00,4,11,135,0,135,0.21%,0.00%
2020-01-01 00:11:00,4,12,12848,1227,11621,19.60%,9.55%
2020-01-01 00:11:00,5,1,2787,56,2731,4.25%,2.01%
2020-01-01 00:11:00,5,2,677,4,673,1.03%,0.59%
2020-01-01 00:11:00,5,3,639,2,637,0.98%,0.31%
2020-01-01 00:11:00,5,4,25489,4495,20994,38.89%,17.63%
2020-01-01 00:11:00,5,5,10276,761,9515,15.68%,7.40%
2020-01-01 00:11:00,5,6,17328,2132,15196,26.44%,12.30%
2020-01-01 00:11:00,5,7,6540,311,6229,9.98%,4.75%
2020-01-01 00:11:00,5,8,5505,231,5274,8.40%,4.20%
2020-01-01 00:11:00,5,9,9550,653,8897,14.57%,6.84%
2020-01-01 00:11:00,5,10,1115,11,1104,1.70%,0.99%
2020-01-01 00:11:00,5,11,846,6,840,1.29%,0.71%
2020-01-01 00:11:00,5,12,8073,478,7595,12.32%,5.92%
2020-01-01 00:11:00,6,1,1065,8,1057,1.63%,0.75%
2020-01-01 00:11:00,6,2,1157,12,1145,1.77%,1.04%
2020-01-01 00:11:00,6,3,1567,22,1545,2.39%,1.40%
2020-01-01 00:11:00,6,4,1002,7,995,1.53%,0.70%
2020-01-01 00:11:00,6,5,13281,1255,12026,20.27%,9.45%
2020-01-01 00:11:00,6,6,3553,100,3453,5.42%,2.81%
2020-01-01 00:11:00,6,7,2176,48,2128,3.32%,2.20%
2020-01-01 00:11:00,6,8,1620,34,1586,2.47%,2.10%
2020-01-01 00:11:00,6,9,7707,418,7289,11.76%,5.42%
2020-01-01 00:11:00,6,10,2332,32,2300,3.56%,1.37%
2020-01-01 00:11:00,6,11,373,0,373,0.57%,0.00%
2020-01-01 00:11:00,6,12,5330,208,5122,8.13%,3.90%
2020-01-01 00:11:00,7,1,410,0,410,0.63%,0.00%
2020-01-01 00:11:00,7,2,183,0,183,0.28%,0.00%
2020-01-01 00:11:00,7,3,928,8,920,1.42%,0.86%
2020-01-01 00:11:00,7,4,1170,11,1159,1.79%,0.94%
2020-01-01 00:11:00,7,5,7371,401,6970,11.25%,5.44%
2020-01-01 00:11:00,7,6,11897,982,10915,18.15%,8.25%
2020-01-01 00:11:00,7,7,3261,80,3181,4.98%,2.45%
2020-01-01 00:11:00,7,8,1142,15,1127,1.74%,1.31%
2020-01-01 00:11:00,7,9,6363,303,6060,9.71%,4.76%
2020-01-01 00:11:00,7,10,1274,16,1258,1.94%,1.25%
2020-01-01 00:11:00,7,11,76,1,75,0.12%,1.30%
2020-01-01 00:11:00,7,12,5076,186,4890,7.75%,3.66%
2020-01-01 00:11:00,8,1,311,0,311,0.47%,0.00%
2020-01-01 00:11:00,8,2,110,0,110,0.17%,0.00%
2020-01-01 00:11:00,8,3,1135,15,1120,1.73%,1.32%
2020-01-01 00:11:00,8,4,3239,89,3150,4.94%,2.75%
2020-01-01 00:11:00,8,5,7547,421,7126,11.52%,5.58%
2020-01-01 00:11:00,8,6,15498,1704,13794,23.65%,10.99%
2020-01-01 00:11:00,8,7,4599,171,4428,7.02%,3.72%
2020-01-01 00:11:00,8,8,1526,22,1504,2.33%,1.44%
2020-01-01 00:11:00,8,9,6073,282,5791,9.27%,4.64%
2020-01-01 00:11:00,8,10,1818,28,1790,2.77%,1.54%
2020-01-01 00:11:00,8,11,200,0,200,0.31%,0.00%
2020-01-01 00:11:00,8,12,4166,141,4025,6.36%,3.38%
2020-01-01 00:11:00,9,1,1768,2,1766,2.70%,0.11%
2020-01-01 00:11:00,9,2,6279,270,6009,9.58%,4.30%
2020-01-01 00:11:00,9,3,4184,143,4041,6.38%,3.42%
2020-01-01 00:11:00,9,4,3379,109,3270,5.16%,3.22%
2020-01-01 00:11:00,9,5,279,1,278,0.43%,0.36%
2020-01-01 00:11:00,9,6,4226,152,4074,6.45%,3.60%
2020-01-01 00:11:00,9,7,25238,4284,20954,38.51%,16.97%
2020-01-01 00:11:00,9,8,9423,642,8781,14.38%,6.81%
2020-01-01 00:11:00,9,9,188,0,188,0.29%,0.00%
2020-01-01 00:11:00,9,10,3258,79,3179,4.97%,2.42%
2020-01-01 00:11:00,9,11,8269,518,7751,12.62%,6.26%
2020-01-01 00:11:00,9,12,4640,168,4472,7.08%,3.62%
2020-01-01 00:11:00,10,1,1050,213,837,1.60%,20.27%
2020-01-01 00:11:00,10,2,2521,249,2272,3.85%,9.87%
2020-01-01 00:11:00,10,3,1288,14,1274,1.97%,1.09%
2020-01-01 00:11:00,10,4,3931,710,3221,6.00%,18.06%
2020-01-01 00:11:00,10,5,584,2,582,0.89%,0.34%
2020-01-01 00:11:00,10,6,5501,787,4714,8.39%,14.30%
2020-01-01 00:11:00,10,7,10762,1535,9227,16.42%,14.26%
2020-01-01 00:11:00,10,8,27996,6728,21268,42.72%,24.03%
2020-01-01 00:11:00,10,9,700,4,696,1.07%,0.57%
2020-01-01 00:11:00,10,10,2629,67,2562,4.01%,2.55%
2020-01-01 00:11:00,10,11,12809,1717,11092,19.54%,13.40%
2020-01-01 00:11:00,10,12,9657,1205,8452,14.74%,12.48%
2020-01-01 00:11:00,11,1,2062,32,2030,3.15%,1.55%
2020-01-01 00:11:00,11,2,3884,118,3766,5.93%,3.04%
2020-01-01 00:11:00,11,3,1659,20,1639,2.53%,1.20%
2020-01-01 00:11:00,11,4,3399,77,3322,5.19%,2.26%
2020-01-01 00:11:00,11,5,193,1,192,0.29%,0.52%
2020-01-01 00:11:00,11,6,4248,119,4129,6.48%,2.80%
2020-01-01 00:11:00,11,7,10079,720,9359,15.38%,7.14%
2020-01-01 00:11:00,11,8,22543,3470,19073,34.40%,15.39%
2020-01-01 00:11:00,11,9,352,2,350,0.54%,0.57%
2020-01-01 00:11:00,11,10,2965,81,2884,4.52%,2.73%
2020-01-01 00:11:00,11,11,9444,688,8756,14.41%,7.28%
2020-01-01 00:11:00,11,12,6318,302,6016,9.64%,4.78%
2020-01-01 00:11:00,12,1,86,0,86,0.13%,0.00%
2020-01-01 00:11:00,12,2,675,223,452,1.03%,32.99%
2020-01-01 00:11:00,12,3,3006,274,2732,4.59%,9.11%
2020-01-01 00:11:00,12,4,2693,48,2645,4.11%,1.78%
2020-01-01 00:11:00,12,5,9434,808,8626,14.40%,8.56%
2020-01-01 00:11:00,12,6,5787,213,5574,8.83%,3.68%
2020-01-01 00:11:00,12,7,2987,68,2919,4.56%,2.28%
2020-01-01 00:11:00,12,8,1583,316,1267,2.42%,19.95%
2020-01-01 00:11:00,12,9,22018,4475,17543,33.60%,20.32%
2020-01-01 00:11:00,12,10,4004,405,3599,6.11%,10.11%
2020-01-01 00:11:00,12,11,1797,317,1480,2.74%,17.63%
2020-01-01 00:11:00,12,12,7953,1294,6659,12.14%,16.27%
2020-01-01 00:11:00,13,1,2247,38,2209,3.43%,1.69%
2020-01-01 00:11:00,13,2,2557,50,2507,3.90%,1.95%
2020-01-01 00:11:00,13,3,570,1,569,0.87%,0.18%
2020-01-01 00:11:00,13,4,4445,356,4089,6.78%,8.01%
2020-01-01 00:11:00,13,5,6529,597,5932,9.96%,9.14%
2020-01-01 00:11:00,13,6,5194,399,4795,7.93%,7.68%
2020-01-01 00:11:00,13,7,4696,163,4533,7.17%,3.47%
2020-01-01 00:11:00,13,8,6621,325,6296,10.10%,4.91%
2020-01-01 00:11:00,13,9,6771,616,6155,10.33%,9.10%
2020-01-01 00:11:00,13,10,26840,5310,21530,40.95%,19.78%
2020-01-01 00:11:00,13,11,17186,2368,14818,26.22%,13.78%
2020-01-01 00:11:00,13,12,9870,1050,8820,15.06%,10.64%
2020-01-01 00:11:00,14,1,645,6,639,0.98%,0.93%
2020-01-01 00:11:00,14,2,1609,27,1582,2.46%,1.68%
2020-01-01 00:11:00,14,3,731,6,725,1.12%,0.82%
2020-01-01 00:11:00,14,4,5384,196,5188,8.22%,3.64%
2020-01-01 00:11:00,14,5,2087,34,2053,3.18%,1.63%
2020-01-01 00:11:00,14,6,5568,207,5361,8.50%,3.72%
2020-01-01 00:11:00,14,7,12960,1234,11726,19.78%,9.52%
2020-01-01 00:11:00,14,8,14310,1515,12795,21.84%,10.59%
2020-01-01 00:11:00,14,9,2371,41,2330,3.62%,1.73%
2020-01-01 00:11:00,14,10,5063,171,4892,7.73%,3.38%
2020-01-01 00:11:00,14,11,26820,4876,21944,40.92%,18.18%
2020-01-01 00:11:00,14,12,7173,394,6779,10.95%,5.49%
2020-01-01 00:11:00,15,1,468,1,467,0.71%,0.21%
2020-01-01 00:11:00,15,2,194,1,193,0.30%,0.51%
2020-01-01 00:11:00,15,3,3658,101,3557,5.58%,2.76%
2020-01-01 00:11:00,15,4,5470,311,5159,8.35%,5.68%
2020-01-01 00:11:00,15,5,9846,764,9082,15.02%,7.76%
2020-01-01 00:11:00,15,6,5736,337,5399,8.75%,5.87%
2020-01-01 00:11:00,15,7,3562,91,3471,5.44%,2.55%
2020-01-01 00:11:00,15,8,5638,231,5407,8.60%,4.10%
2020-01-01 00:11:00,15,9,10098,806,9292,15.41%,7.98%
2020-01-01 00:11:00,15,10,3398,103,3295,5.18%,3.03%
2020-01-01 00:11:00,15,11,9127,608,8519,13.93%,6.66%
2020-01-01 00:11:00,15,12,24608,4632,19976,37.55%,18.82%
2020-01-01 00:11:00,16,1,374,3,371,0.57%,0.80%
2020-01-01 00:11:00,16,2,266,2,264,0.41%,0.75%
2020-01-01 00:11:00,16,3,1792,29,1763,2.73%,1.62%
2020-01-01 00:11:00,16,4,4447,169,4278,6.79%,3.80%
2020-01-01 00:11:00,16,5,8196,581,7615,12.51%,7.09%
2020-01-01 00:11:00,16,6,5200,224,4976,7.93%,4.31%
2020-01-01 00:11:00,16,7,3293,79,3214,5.02%,2.40%
2020-01-01 00:11:00,16,8,8031,503,7528,12.25%,6.26%
2020-01-01 00:11:00,16,9,8574,625,7949,13.08%,7.29%
2020-01-01 00:11:00,16,10,1497,14,1483,2.28%,0.93%
2020-01-01 00:11:00,16,11,9677,716,8961,14.77%,7.40%
2020-01-01 00:11:00,16,12,25535,4442,21093,38.96%,17.40%
2020-01-01 00:11:10,1,1,23319,3768,19551,35.58%,16.16%
2020-01-01 00:11:10,1,2,6205,297,5908,9.47%,4.79%
2020-01-01 00:11:10,1,3,579,1,578,0.88%,0.17%
2020-01-01 00:11:10,1,4,16672,2003,14669,25.44%,12.01%
2020-01-01 00:11:10,1,5,16186,1899,14287,24.70%,11.73%
2020-01-01 00:11:10,1,6,16143,1886,14257,24.63%,11.68%
2020-01-01 00:11:10,1,7,5610,261,5349,8.56%,4.65%
2020-01-01 00:11:10,1,8,4255,148,4107,6.49%,3.48%
2020-01-01 00:11:10,1,9,16094,1878,14216,24.56%,11.67%
2020-01-01 00:11:10,1,10,3596,107,3489,5.49%,2.97%
2020-01-01 00:11:10,1,11,3727,117,3610,5.69%,3.14%
2020-01-01 00:11:10,1,12,16067,1875,14192,24.52%,11.67%
2020-01-01 00:11:10,2,1,409,2,407,0.62%,0.49%
2020-01-01 00:11:10,2,2,29335,5685,23650,44.76%,19.38%
2020-01-01 00:11:10,2,3,24387,4033,20354,37.21%,16.54%
2020-01-01 00:11:10,2,4,377,2,375,0.58%,0.53%
2020-01-01 00:11:10,2,5,16552,1868,14684,25.26%,11.28%
2020-01-01 00:11:10,2,6,45,0,45,0.07%,0.00%
2020-01-01 00:11:10,2,7,4505,148,4357,6.87%,3.28%
2020-01-01 00:11:10,2,8,3164,76,3088,4.83%,2.40%
2020-01-01 00:11:10,2,9,16445,1842,14603,25.09%,11.20%
2020-01-01 00:11:10,2,10,2396,37,2359,3.66%,1.54%
2020-01-01 00:11:10,2,11,2414,38,2376,3.68%,1.57%
2020-01-01 00:11:10,2,12,16264,1806,14458,24.82%,11.10%
2020-01-01 00:11:10,3,1,1210,14,1196,1.85%,1.16%
2020-01-01 00:11:10,3,2,23592,3815,19777,36.00%,16.17%
2020-01-01 00:11:10,3,3,70088,27066,43022,106.95%,38.62%
2020-01-01 00:11:10,3,4,7040,361,6679,10.74%,5.13%
2020-01-01 00:11:10,3,5,45511,12719,32792,69.44%,27.95%
2020-01-01 00:11:10,3,6,8007,470,7537,12.22%,5.87%
2020-01-01 00:11:10,3,7,20386,2846,17540,31.11%,13.96%
2020-01-01 00:11:10,3,8,17261,2048,15213,26.34%,11.86%
2020-01-01 00:11:10,3,9,37165,8724,28441,56.71%,23.47%
2020-01-01 00:11:10,3,10,6888,353,6535,10.51%,5.12%
2020-01-01 00:11:10,3,11,1873,17,1856,2.86%,0.91%
2020-01-01 00:11:10,3,12,26366,4580,21786,40.23%,17.37%
2020-01-01 00:11:10,4,1,493,2,491,0.75%,0.40%
2020-01-01 00:11:10,4,2,308,2,306,0.47%,0.65%
2020-01-01 00:11:10,4,3,862,3,859,1.32%,0.35%
2020-01-01 00:11:10,4,4,28347,5317,23030,43.25%,18.76%
2020-01-01 00:11:10,4,5,17660,2237,15423,26.95%,12.67%
2020-01-01 00:11:10,4,6,24277,3998,20279,37.04%,16.47%
2020-01-01 00:11:10,4,7,5350,230,5120,8.16%,4.30%
2020-01-01 00:11:10,4,8,2932,80,2852,4.47%,2.73%
2020-01-01 00:11:10,4,9,15684,1789,13895,23.93%,11.41%
2020-01-01 00:11:10,4,10,1761,33,1728,2.69%,1.87%
2020-01-01 00:11:10,4,11,121,0,121,0.18%,0.00%
2020-01-01 00:11:10,4,12,12412,1161,11251,18.94%,9.35%
2020-01-01 00:11:10,5,1,2674,63,2611,4.08%,2.36%
2020-01-01 00:11:10,5,2,682,6,676,1.04%,0.88%
2020-01-01 00:11:10,5,3,448,2,446,0.68%,0.45%
2020-01-01 00:11:10,5,4,24637,4129,20508,37.59%,16.76%
2020-01-01 00:11:10,5,5,8749,550,8199,13.35%,6.29%
2020-01-01 00:11:10,5,6,13101,1235,11866,19.99%,9.43%
2020-01-01 00:11:10,5,7,3869,107,3762,5.90%,2.76%
2020-01-01 00:11:10,5,8,3113,69,3044,4.75%,2.22%
2020-01-01 00:11:10,5,9,8120,489,7631,12.39%,6.02%
2020-01-01 00:11:10,5,10,980,13,967,1.50%,1.33%
2020-01-01 00:11:10,5,11,627,8,619,0.96%,1.27%
2020-01-01 00:11:10,5,12,6849,346,6503,10.45%,5.05%
2020-01-01 00:11:10,6,1,1158,9,1149,1.77%,0.78%
2020-01-01 00:11:10,6,2,1222,10,1212,1.86%,0.82%
2020-01-01 00:11:10,6,3,1640,23,1617,2.50%,1.40%
2020-01-01 00:11:10,6,4,1136,6,1130,1.73%,0.53%
2020-01-01 00:11:10,6,5,11183,893,10290,17.06%,7.98%
2020-01-01 00:11:10,6,6,3427,90,3337,5.23%,2.63%
2020-01-01 00:11:10,6,7,1894,31,1863,2.89%,1.64%
2020-01-01 00:11:10,6,8,1290,21,1269,1.97%,1.63%
2020-01-01 00:11:10,6,9,5870,267,5603,8.96%,4.55%
2020-01-01 00:11:10,6,10,1782,26,1756,2.72%,1.46%
2020-01-01 00:11:10,6,11,434,0,434,0.66%,0.00%
2020-01-01 00:11:10,6,12,4037,128,3909,6.16%,3.17%
2020-01-01 00:11:10,7,1,426,2,424,0.65%,0.47%
2020-01-01 00:11:10,7,2,203,1,202,0.31%,0.49%
2020-01-01 00:11:10,7,3,1340,8,1332,2.04%,0.60%
2020-01-01 00:11:10,7,4,1738,31,1707,2.65%,1.78%
2020-01-01 00:11:10,7,5,7774,432,7342,11.86%,5.56%
2020-01-01 00:11:10,7,6,13232,1271,11961,20.19%,9.60%
2020-01-01 00:11:10,7,7,3606,112,3494,5.50%,3.11%
2020-01-01 00:11:10,7,8,1562,28,1534,2.38%,1.79%
2020-01-01 00:11:10,7,9,6380,302,6078,9.74%,4.73%
2020-01-01 00:11:10,7,10,1289,10,1279,1.97%,0.78%
2020-01-01 00:11:10,7,11,135,0,135,0.21%,0.00%
2020-01-01 00:11:10,7,12,5063,182,4881,7.73%,3.59%
2020-01-01 00:11:10,8,1,368,4,364,0.56%,1.08%
2020-01-01 00:11:10,8,2,74,0,74,0.11%,0.00%
2020-01-01 00:11:10,8,3,1777,20,1757,2.71%,1.12%
2020-01-01 00:11:10,8,4,2745,74,2671,4.19%,2.69%
2020-01-01 00:11:10,8,5,9035,578,8457,13.79%,6.40%
2020-01-01 00:11:10,8,6,16708,1965,14743,25.49%,11.76%
2020-01-01 00:11:10,8,7,4740,181,4559,7.23%,3.82%
2020-01-01 00:11:10,8,8,1822,29,1793,2.78%,1.59%
2020-01-01 00:11:10,8,9,6103,271,5832,9.31%,4.44%
2020-01-01 00:11:10,8,10,1775,18,1757,2.71%,1.01%
2020-01-01 00:11:10,8,11,169,0,169,0.26%,0.00%
2020-01-01 00:11:10,8,12,4287,128,4159,6.54%,2.99%
2020-01-01 00:11:10,9,1,1218,9,1209,1.86%,0.74%
2020-01-01 00:11:10,9,2,2618,44,2574,3.99%,1.68%
2020-01-01 00:11:10,9,3,1051,4,1047,1.60%,0.38%
2020-01-01 00:11:10,9,4,8874,598,8276,13.54%,6.74%
2020-01-01 00:11:10,9,5,235,2,233,0.36%,0.85%
2020-01-01 00:11:10,9,6,10236,791,9445,15.62%,7.73%
2020-01-01 00:11:10,9,7,31631,6516,25115,48.27%,20.60%
2020-01-01 00:11:10,9,8,11713,939,10774,17.87%,8.02%
2020-01-01 00:11:10,9,9,136,2,134,0.21%,1.46%
2020-01-01 00:11:10,9,10,5878,251,5627,8.97%,4.27%
2020-01-01 00:11:10,9,11,10762,797,9965,16.42%,7.40%
2020-01-01 00:11:10,9,12,4519,145,4374,6.90%,3.21%
2020-01-01 00:11:10,10,1,1225,170,1055,1.87%,13.87%
2020-01-01 00:11:10,10,2,4978,343,4635,7.60%,6.89%
2020-01-01 00:11:10,10,3,3616,114,3502,5.52%,3.15%
2020-01-01 00:11:10,10,4,4050,902,3148,6.18%,22.27%
2020-01-01 00:11:10,10,5,624,38,586,0.95%,6.08%
2020-01-01 00:11:10,10,6,5700,1037,4663,8.70%,18.19%
2020-01-01 00:11:10,10,7,12684,1999,10685,19.35%,15.76%
2020-01-01 00:11:10,10,8,29281,7234,22047,44.68%,24.70%
2020-01-01 00:11:10,10,9,923,6,917,1.41%,0.65%
2020-01-01 00:11:10,10,10,2391,61,2330,3.65%,2.55%
2020-01-01 00:11:10,10,11,12866,1699,11167,19.63%,13.20%
2020-01-01 00:11:10,10,12,9781,1176,8605,14.92%,12.02%
2020-01-01 00:11:10,11,1,2479,56,2423,3.78%,2.26%
2020-01-01 00:11:10,11,2,3817,114,3703,5.82%,2.99%
2020-01-01 00:11:10,11,3,1128,11,1117,1.72%,0.97%
2020-01-01 00:11:10,11,4,3232,81,3151,4.93%,2.51%
2020-01-01 00:11:10,11,5,187,0,187,0.29%,0.00%
2020-01-01 00:11:10,11,6,4077,137,3940,6.22%,3.36%
2020-01-01 00:11:10,11,7,9398,655,8743,14.34%,6.97%
2020-01-01 00:11:10,11,8,23310,3720,19590,35.57%,15.96%
2020-01-01 00:11:10,11,9,337,0,337,0.51%,0.00%
2020-01-01 00:11:10,11,10,2720,50,2670,4.15%,1.84%
2020-01-01 00:11:10,11,11,9571,696,8875,14.60%,7.27%
2020-01-01 00:11:10,11,12,6517,346,6171,9.94%,5.31%
2020-01-01 00:11:10,12,1,80,0,80,0.12%,0.00%
2020-01-01 00:11:10,12,2,656,172,484,1.00%,26.18%
2020-01-01 00:11:10,12,3,3234,233,3001,4.93%,7.20%
2020-01-01 00:11:10,12,4,3259,92,3167,4.97%,2.82%
2020-01-01 00:11:10,12,5,9820,865,8955,14.98%,8.81%
2020-01-01 00:11:10,12,6,5792,257,5535,8.84%,4.44%
2020-01-01 00:11:10,12,7,2359,31,2328,3.60%,1.31%
2020-01-01 00:11:10,12,8,1665,305,1360,2.54%,18.31%
2020-01-01 00:11:10,12,9,22418,4253,18165,34.21%,18.97%
2020-01-01 00:11:10,12,10,4314,398,3916,6.58%,9.22%
2020-01-01 00:11:10,12,11,1827,307,1520,2.79%,16.79%
2020-01-01 00:11:10,12,12,7596,1023,6573,11.59%,13.47%
2020-01-01 00:11:10,13,1,2085,40,2045,3.18%,1.92%
2020-01-01 00:11:10,13,2,2353,51,2302,3.59%,2.17%
2020-01-01 00:11:10,13,3,820,2,818,1.25%,0.24%
2020-01-01 00:11:10,13,4,5036,544,4492,7.68%,10.80%
2020-01-01 00:11:10,13,5,7391,815,6576,11.28%,11.03%
2020-01-01 00:11:10,13,6,5735,587,5148,8.75%,10.23%
2020-01-01 00:11:10,13,7,4694,178,4516,7.16%,3.79%
2020-01-01 00:11:10,13,8,7028,372,6656,10.72%,5.29%
2020-01-01 00:11:10,13,9,7796,862,6934,11.90%,11.06%
2020-01-01 00:11:10,13,10,28621,6270,22351,43.67%,21.91%
2020-01-01 00:11:10,13,11,18045,2798,15247,27.53%,15.50%
2020-01-01 00:11:10,13,12,10519,1388,9131,16.05%,13.19%
2020-01-01 00:11:10,14,1,273,0,273,0.42%,0.00%
2020-01-01 00:11:10,14,2,1257,10,1247,1.92%,0.79%
2020-01-01 00:11:10,14,3,769,4,765,1.17%,0.52%
2020-01-01 00:11:10,14,4,4367,143,4224,6.66%,3.27%
2020-01-01 00:11:10,14,5,1481,23,1458,2.26%,1.55%
2020-01-01 00:11:10,14,6,4657,173,4484,7.11%,3.71%
2020-01-01 00:11:10,14,7,11807,976,10831,18.02%,8.27%
2020-01-01 00:11:10,14,8,13434,1278,12156,20.50%,9.51%
2020-01-01 00:11:10,14,9,1659,31,1628,2.53%,1.87%
2020-01-01 00:11:10,14,10,3922,115,3807,5.98%,2.93%
2020-01-01 00:11:10,14,11,25451,4345,21106,38.84%,17.07%
2020-01-01 00:11:10,14,12,7777,422,7355,11.87%,5.43%
2020-01-01 00:11:10,15,1,435,2,433,0.66%,0.46%
2020-01-01 00:11:10,15,2,195,0,195,0.30%,0.00%
2020-01-01 00:11:10,15,3,3685,98,3587,5.62%,2.66%
2020-01-01 00:11:10,15,4,6020,260,5760,9.19%,4.32%
2020-01-01 00:11:10,15,5,10612,821,9791,16.19%,7.74%
2020-01-01 00:11:10,15,6,6272,286,5986,9.57%,4.56%
2020-01-01 00:11:10,15,7,3359,89,3270,5.13%,2.65%
2020-01-01 00:11:10,15,8,5560,225,5335,8.48%,4.05%
2020-01-01 00:11:10,15,9,10818,865,9953,16.51%,8.00%
2020-01-01 00:11:10,15,10,5670,240,5430,8.65%,4.23%
2020-01-01 00:11:10,15,11,11489,941,10548,17.53%,8.19%
2020-01-01 00:11:10,15,12,27564,5370,22194,42.06%,19.48%
2020-01-01 00:11:10,16,1,494,1,493,0.75%,0.20%
2020-01-01 00:11:10,16,2,239,0,239,0.36%,0.00%
2020-01-01 00:11:10,16,3,1829,32,1797,2.79%,1.75%
2020-01-01 00:11:10,16,4,4374,148,4226,6.67%,3.38%
2020-01-01 00:11:10,16,5,8126,518,7608,12.40%,6.37%
2020-01-01 00:11:10,16,6,5188,194,4994,7.92%,3.74%
2020-01-01 00:11:10,16,7,3823,121,3702,5.83%,3.16%
2020-01-01 00:11:10,16,8,7416,457,6959,11.32%,6.16%
2020-01-01 00:11:10,16,9,8473,563,7910,12.93%,6.64%
2020-01-01 00:11:10,16,10,1423,16,1407,2.17%,1.12%
2020-01-01 00:11:10,16,11,9086,667,8419,13.86%,7.34%
2020-01-01 00:11:10,16,12,24876,4322,20554,37.96%,17.37%
2020-01-01 00:11:20,1,1,23216,3752,19464,35.42%,16.16%
2020-01-01 00:11:20,1,2,12040,1075,10965,18.37%,8.93%
2020-01-01 00:11:20,1,3,733,4,729,1.12%,0.54%
2020-01-01 00:11:20,1,4,10746,878,9868,16.40%,8.17%
2020-01-01 00:11:20,1,5,10428,823,9605,15.91%,7.89%
2020-01-01 00:11:20,1,6,10353,818,9535,15.80%,7.90%
2020-01-01 00:11:20,1,7,11293,936,10357,17.23%,8.29%
2020-01-01 00:11:20,1,8,7391,386,7005,11.28%,5.22%
2020-01-01 00:11:20,1,9,10320,816,9504,15.75%,7.91%
2020-01-01 00:11:20,1,10,6576,316,6260,10.03%,4.80%
2020-01-01 00:11:20,1,11,6696,326,6370,10.22%,4.87%
2020-01-01 00:11:20,1,12,10278,807,9471,15.68%,7.85%
2020-01-01 00:11:20,2,1,475,3,472,0.72%,0.63%
2020-01-01 00:11:20,2,2,27000,4797,22203,41.20%,17.77%
2020-01-01 00:11:20,2,3,21792,3158,18634,33.25%,14.49%
2020-01-01 00:11:20,2,4,397,3,394,0.61%,0.75%
2020-01-01 00:11:20,2,5,14136,1373,12763,21.57%,9.71%
2020-01-01 00:11:20,2,6,40,0,40,0.06%,0.00%
2020-01-01 00:11:20,2,7,4713,169,4544,7.19%,3.59%
2020-01-01 00:11:20,2,8,3707,112,3595,5.66%,3.02%
2020-01-01 00:11:20,2,9,14032,1354,12678,21.41%,9.65%
2020-01-01 00:11:20,2,10,2830,68,2762,4.32%,2.40%
2020-01-01 00:11:20,2,11,2838,68,2770,4.33%,2.40%
2020-01-01 00:11:20,2,12,13848,1309,12539,21.13%,9.45%
2020-01-01 00:11:20,3,1,1358,11,1347,2.07%,0.81%
2020-01-01 00:11:20,3,2,24870,4238,20632,37.95%,17.04%
2020-01-01 00:11:20,3,3,72330,28569,43761,110.37%,39.50%
2020-01-01 00:11:20,3,4,8466,537,7929,12.92%,6.34%
2020-01-01 00:11:20,3,5,45010,12594,32416,68.68%,27.98%
2020-01-01 00:11:20,3,6,9662,689,8973,14.74%,7.13%
2020-01-01 00:11:20,3,7,21561,3252,18309,32.90%,15.08%
2020-01-01 00:11:20,3,8,15944,1814,14130,24.33%,11.38%
2020-01-01 00:11:20,3,9,34922,7908,27014,53.29%,22.64%
2020-01-01 00:11:20,3,10,6834,313,6521,10.43%,4.58%
2020-01-01 00:11:20,3,11,2175,38,2137,3.32%,1.75%
2020-01-01 00:11:20,3,12,25464,4320,21144,38.85%,16.96%
2020-01-01 00:11:20,4,1,507,1,506,0.77%,0.20%
2020-01-01 00:11:20,4,2,317,0,317,0.48%,0.00%
2020-01-01 00:11:20,4,3,675,1,674,1.03%,0.15%
2020-01-01 00:11:20,4,4,27872,5200,22672,42.53%,18.66%
2020-01-01 00:11:20,4,5,17425,2093,15332,26.59%,12.01%
2020-01-01 00:11:20,4,6,24095,3980,20115,36.77%,16.52%
2020-01-01 00:11:20,4,7,5294,217,5077,8.08%,4.10%
2020-01-01 00:11:20,4,8,2752,60,2692,4.20%,2.18%
2020-01-01 00:11:20,4,9,15625,1694,13931,23.84%,10.84%
2020-01-01 00:11:20,4,10,1951,33,1918,2.98%,1.69%
2020-01-01 00:11:20,4,11,129,0,129,0.20%,0.00%
2020-01-01 00:11:20,4,12,12681,1139,11542,19.35%,8.98%
2020-01-01 00:11:20,5,1,2980,67,2913,4.55%,2.25%
2020-01-01 00:11:20,5,2,692,3,689,1.06%,0.43%
2020-01-01 00:11:20,5,3,477,1,476,0.73%,0.21%
2020-01-01 00:11:20,5,4,26127,4562,21565,39.87%,17.46%
2020-01-01 00:11:20,5,5,8771,596,8175,13.38%,6.79%
2020-01-01 00:11:20,5,6,15064,1606,13458,22.99%,10.66%
2020-01-01 00:11:20,5,7,5652,242,5410,8.62%,4.28%
2020-01-01 00:11:20,5,8,3587,108,3479,5.47%,3.01%
2020-01-01 00:11:20,5,9,8105,513,7592,12.37%,6.33%
2020-01-01 00:11:20,5,10,703,12,691,1.07%,1.70%
2020-01-01 00:11:20,5,11,768,8,760,1.17%,1.04%
2020-01-01 00:11:20,5,12,6967,378,6589,10.63%,5.42%
2020-01-01 00:11:20,6,1,867,11,856,1.32%,1.27%
2020-01-01 00:11:20,6,2,996,15,981,1.52%,1.50%
2020-01-01 00:11:20,6,3,1655,24,1631,2.53%,1.45%
2020-01-01 00:11:20,6,4,1328,10,1318,2.03%,0.75%
2020-01-01 00:11:20,6,5,16347,1887,14460,24.94%,11.54%
2020-01-01 00:11:20,6,6,5504,248,5256,8.40%,4.50%
2020-01-01 00:11:20,6,7,3613,102,3511,5.51%,2.82%
2020-01-01 00:11:20,6,8,2399,51,2348,3.66%,2.12%
2020-01-01 00:11:20,6,9,8828,587,8241,13.47%,6.65%
2020-01-01 00:11:20,6,10,2037,23,2014,3.11%,1.13%
2020-01-01 00:11:20,6,11,468,0,468,0.71%,0.00%
2020-01-01 00:11:20,6,12,6734,349,6385,10.28%,5.18%
2020-01-01 00:11:20,7,1,462,1,461,0.70%,0.22%
2020-01-01 00:11:20,7,2,201,1,200,0.31%,0.50%
2020-01-01 00:11:20,7,3,1173,9,1164,1.79%,0.77%
2020-01-01 00:11:20,7,4,1548,33,1515,2.36%,2.13%
2020-01-01 00:11:20,7,5,7215,352,6863,11.01%,4.88%
2020-01-01 00:11:20,7,6,12391,1011,11380,18.91%,8.16%
2020-01-01 00:11:20,7,7,3529,80,3449,5.38%,2.27%
2020-01-01 00:11:20,7,8,1413,15,1398,2.16%,1.06%
2020-01-01 00:11:20,7,9,6007,244,5763,9.17%,4.06%
2020-01-01 00:11:20,7,10,1106,8,1098,1.69%,0.72%
2020-01-01 00:11:20,7,11,94,0,94,0.14%,0.00%
2020-01-01 00:11:20,7,12,4852,169,4683,7.40%,3.48%
2020-01-01 00:11:20,8,1,436,4,432,0.67%,0.92%
2020-01-01 00:11:20,8,2,89,0,89,0.14%,0.00%
2020-01-01 00:11:20,8,3,1334,7,1327,2.04%,0.52%
2020-01-01 00:11:20,8,4,2623,55,2568,4.00%,2.10%
2020-01-01 00:11:20,8,5,8469,568,7901,12.92%,6.71%
2020-01-01 00:11:20,8,6,16339,1882,14457,24.93%,11.52%
2020-01-01 00:11:20,8,7,5128,196,4932,7.82%,3.82%
2020-01-01 00:11:20,8,8,2096,30,2066,3.20%,1.43%
2020-01-01 00:11:20,8,9,6456,333,6123,9.85%,5.16%
2020-01-01 00:11:20,8,10,1849,23,1826,2.82%,1.24%
2020-01-01 00:11:20,8,11,214,1,213,0.33%,0.47%
2020-01-01 00:11:20,8,12,4526,157,4369,6.91%,3.47%
2020-01-01 00:11:20,9,1,323,0,323,0.49%,0.00%
2020-01-01 00:11:20,9,2,2759,48,2711,4.21%,1.74%
2020-01-01 00:11:20,9,3,1980,27,1953,3.02%,1.36%
2020-01-01 00:11:20,9,4,8132,446,7686,12.41%,5.48%
2020-01-01 00:11:20,9,5,243,0,243,0.37%,0.00%
2020-01-01 00:11:20,9,6,9194,573,8621,14.03%,6.23%
2020-01-01 00:11:20,9,7,27507,4904,22603,41.97%,17.83%
2020-01-01 00:11:20,9,8,9049,622,8427,13.81%,6.87%
2020-01-01 00:11:20,9,9,180,0,180,0.27%,0.00%
2020-01-01 00:11:20,9,10,2237,87,2150,3.41%,3.89%
2020-01-01 00:11:20,9,11,7560,445,7115,11.54%,5.89%
2020-01-01 00:11:20,9,12,4951,181,4770,7.55%,3.66%
2020-01-01 00:11:20,10,1,1218,208,1010,1.86%,17.06%
2020-01-01 00:11:20,10,2,5241,391,4850,8.00%,7.46%
2020-01-01 00:11:20,10,3,3841,106,3735,5.86%,2.76%
2020-01-01 00:11:20,10,4,4222,907,3315,6.44%,21.48%
2020-01-01 00:11:20,10,5,549,18,531,0.84%,3.27%
2020-01-01 00:11:20,10,6,5803,1032,4771,8.85%,17.78%
2020-01-01 00:11:20,10,7,13213,2094,11119,20.16%,15.85%
2020-01-01 00:11:20,10,8,30358,7794,22564,46.32%,25.67%
2020-01-01 00:11:20,10,9,723,2,721,1.10%,0.28%
2020-01-01 00:11:20,10,10,2427,44,2383,3.70%,1.81%
2020-01-01 00:11:20,10,11,13414,1831,11583,20.47%,13.65%
2020-01-01 00:11:20,10,12,10269,1308,8961,15.67%,12.74%
2020-01-01 00:11:20,11,1,2484,44,2440,3.79%,1.77%
2020-01-01 00:11:20,11,2,3654,85,3569,5.58%,2.33%
2020-01-01 00:11:20,11,3,1017,9,1008,1.55%,0.88%
2020-01-01 00:11:20,11,4,3167,81,3086,4.83%,2.56%
2020-01-01 00:11:20,11,5,219,0,219,0.33%,0.00%
2020-01-01 00:11:20,11,6,4120,127,3993,6.29%,3.08%
2020-01-01 00:11:20,11,7,9691,675,9016,14.79%,6.96%
2020-01-01 00:11:20,11,8,23691,3922,19769,36.15%,16.55%
2020-01-01 00:11:20,11,9,249,0,249,0.38%,0.00%
2020-01-01 00:11:20,11,10,3253,87,3166,4.96%,2.67%
2020-01-01 00:11:20,11,11,10156,810,9346,15.50%,7.97%
2020-01-01 00:11:20,11,12,6521,364,6157,9.95%,5.58%
2020-01-01 00:11:20,12,1,38,0,38,0.06%,0.00%
2020-01-01 00:11:20,12,2,612,203,409,0.93%,33.12%
2020-01-01 00:11:20,12,3,2409,237,2172,3.68%,9.83%
2020-01-01 00:11:20,12,4,2837,48,2789,4.33%,1.69%
2020-01-01 00:11:20,12,5,7956,689,7267,12.14%,8.66%
2020-01-01 00:11:20,12,6,4735,178,4557,7.23%,3.76%
2020-01-01 00:11:20,12,7,1751,44,1707,2.67%,2.51%
2020-01-01 00:11:20,12,8,1307,255,1052,1.99%,19.50%
2020-01-01 00:11:20,12,9,21217,4032,17185,32.37%,19.00%
2020-01-01 00:11:20,12,10,3985,377,3608,6.08%,9.46%
2020-01-01 00:11:20,12,11,1628,264,1364,2.48%,16.21%
2020-01-01 00:11:20,12,12,8748,1142,7606,13.35%,13.05%
2020-01-01 00:11:20,13,1,2690,51,2639,4.10%,1.90%
2020-01-01 00:11:20,13,2,3009,68,2941,4.59%,2.26%
2020-01-01 00:11:20,13,3,617,2,615,0.94%,0.32%
2020-01-01 00:11:20,13,4,4399,436,3963,6.71%,9.91%
2020-01-01 00:11:20,13,5,7683,810,6873,11.72%,10.54%
2020-01-01 00:11:20,13,6,5377,503,4874,8.20%,9.35%
2020-01-01 00:11:20,13,7,5350,215,5135,8.16%,4.02%
2020-01-01 00:11:20,13,8,7287,394,6893,11.12%,5.41%
2020-01-01 00:11:20,13,9,8053,851,7202,12.29%,10.57%
2020-01-01 00:11:20,13,10,27769,5793,21976,42.37%,20.86%
2020-01-01 00:11:20,13,11,17474,2492,14982,26.66%,14.26%
2020-01-01 00:11:20,13,12,9735,1060,8675,14.85%,10.89%
2020-01-01 00:11:20,14,1,439,1,438,0.67%,0.23%
2020-01-01 00:11:20,14,2,1426,21,1405,2.18%,1.47%
2020-01-01 00:11:20,14,3,791,2,789,1.21%,0.25%
2020-01-01 00:11:20,14,4,3825,122,3703,5.84%,3.19%
2020-01-01 00:11:20,14,5,1348,12,1336,2.06%,0.89%
2020-01-01 00:11:20,14,6,4170,138,4032,6.36%,3.31%
2020-01-01 00:11:20,14,7,11339,953,10386,17.30%,8.40%
2020-01-01 00:11:20,14,8,12700,1175,11525,19.38%,9.25%
2020-01-01 00:11:20,14,9,1542,18,1524,2.35%,1.17%
2020-01-01 00:11:20,14,10,3791,113,3678,5.78%,2.98%
2020-01-01 00:11:20,14,11,24822,4174,20648,37.88%,16.82%
2020-01-01 00:11:20,14,12,8055,483,7572,12.29%,6.00%
2020-01-01 00:11:20,15,1,390,1,389,0.60%,0.26%
2020-01-01 00:11:20,15,2,247,1,246,0.38%,0.40%
2020-01-01 00:11:20,15,3,3666,95,3571,5.59%,2.59%
2020-01-01 00:11:20,15,4,5323,234,5089,8.12%,4.40%
2020-01-01 00:11:20,15,5,9594,692,8902,14.64%,7.21%
2020-01-01 00:11:20,15,6,5532,251,5281,8.44%,4.54%
2020-01-01 00:11:20,15,7,3703,118,3585,5.65%,3.19%
2020-01-01 00:11:20,15,8,5511,237,5274,8.41%,4.30%
2020-01-01 00:11:20,15,9,9838,733,9105,15.01%,7.45%
2020-01-01 00:11:20,15,10,4528,161,4367,6.91%,3.55%
2020-01-01 00:11:20,15,11,10345,823,9522,15.79%,7.95%
2020-01-01 00:11:20,15,12,25099,4698,20401,38.30%,18.72%
2020-01-01 00:11:20,16,1,515,1,514,0.79%,0.19%
2020-01-01 00:11:20,16,2,218,0,218,0.33%,0.00%
2020-01-01 00:11:20,16,3,1456,13,1443,2.22%,0.89%
2020-01-01 00:11:20,16,4,6749,306,6443,10.30%,4.53%
2020-01-01 00:11:20,16,5,10095,821,9274,15.40%,8.13%
2020-01-01 00:11:20,16,6,7553,395,7158,11.52%,5.23%
2020-01-01 00:11:20,16,7,3811,110,3701,5.82%,2.89%
2020-01-01 00:11:20,16,8,7665,429,7236,11.70%,5.60%
2020-01-01 00:11:20,16,9,10529,887,9642,16.07%,8.42%
2020-01-01 00:11:20,16,10,1581,20,1561,2.41%,1.26%
2020-01-01 00:11:20,16,11,9479,674,8805,14.46%,7.11%
2020-01-01 00:11:20,16,12,27916,5257,22659,42.60%,18.83%
2020-01-01 00:11:30,1,1,16270,1848,14422,24.83%,11.36%
2020-01-01 00:11:30,1,2,7386,374,7012,11.27%,5.06%
2020-01-01 00:11:30,1,3,758,2,756,1.16%,0.26%
2020-01-01 00:11:30,1,4,8523,534,7989,13.01%,6.26%
2020-01-01 00:11:30,1,5,8296,513,7783,12.66%,6.18%
2020-01-01 00:11:30,1,6,8036,485,7551,12.26%,6.03%
2020-01-01 00:11:30,1,7,6610,302,6308,10.09%,4.57%
2020-01-01 00:11:30,1,8,5760,226,5534,8.79%,3.92%
2020-01-01 00:11:30,1,9,8016,482,7534,12.23%,6.01%
2020-01-01 00:11:30,1,10,5023,163,4860,7.66%,3.24%
2020-01-01 00:11:30,1,11,5142,170,4972,7.85%,3.31%
2020-01-01 00:11:30,1,12,7915,468,7447,12.08%,5.91%
2020-01-01 00:11:30,2,1,511,6,505,0.78%,1.17%
2020-01-01 00:11:30,2,2,20958,3120,17838,31.98%,14.89%
2020-01-01 00:11:30,2,3,15468,1751,13717,23.60%,11.32%
2020-01-01 00:11:30,2,4,428,6,422,0.65%,1.40%
2020-01-01 00:11:30,2,5,9903,711,9192,15.11%,7.18%
2020-01-01 00:11:30,2,6,67,0,67,0.10%,0.00%
2020-01-01 00:11:30,2,7,4957,196,4761,7.56%,3.95%
2020-01-01 00:11:30,2,8,3694,119,3575,5.64%,3.22%
2020-01-01 00:11:30,2,9,9839,700,9139,15.01%,7.11%
2020-01-01 00:11:30,2,10,2976,74,2902,4.54%,2.49%
2020-01-01 00:11:30,2,11,2989,75,2914,4.56%,2.51%
2020-01-01 00:11:30,2,12,9666,676,8990,14.75%,6.99%
2020-01-01 00:11:30,3,1,1640,14,1626,2.50%,0.85%
2020-01-01 00:11:30,3,2,20856,3027,17829,31.82%,14.51%
2020-01-01 00:11:30,3,3,78858,33016,45842,120.33%,41.87%
2020-01-01 00:11:30,3,4,13913,1370,12543,21.23%,9.85%
2020-01-01 00:11:30,3,5,56419,18577,37842,86.09%,32.93%
2020-01-01 00:11:30,3,6,15231,1635,13596,23.24%,10.73%
2020-01-01 00:11:30,3,7,17636,2200,15436,26.91%,12.47%
2020-01-01 00:11:30,3,8,13813,1395,12418,21.08%,10.10%
2020-01-01 00:11:30,3,9,40861,10420,30441,62.35%,25.50%
2020-01-01 00:11:30,3,10,7492,397,7095,11.43%,5.30%
2020-01-01 00:11:30,3,11,1472,17,1455,2.25%,1.15%
2020-01-01 00:11:30,3,12,30453,6055,24398,46.47%,19.88%
2020-01-01 00:11:30,4,1,537,0,537,0.82%,0.00%
2020-01-01 00:11:30,4,2,313,0,313,0.48%,0.00%
2020-01-01 00:11:30,4,3,746,6,740,1.14%,0.80%
2020-01-01 00:11:30,4,4,28276,5370,22906,43.15%,18.99%
2020-01-01 00:11:30,4,5,17257,2096,15161,26.33%,12.15%
2020-01-01 00:11:30,4,6,24176,4007,20169,36.89%,16.57%
2020-01-01 00:11:30,4,7,5598,243,5355,8.54%,4.34%
2020-01-01 00:11:30,4,8,3003,71,2932,4.58%,2.36%
2020-01-01 00:11:30,4,9,15195,1651,13544,23.19%,10.86%
2020-01-01 00:11:30,4,10,1982,30,1952,3.02%,1.51%
2020-01-01 00:11:30,4,11,182,2,180,0.28%,1.09%
2020-01-01 00:11:30,4,12,12251,1118,11133,18.69%,9.13%
2020-01-01 00:11:30,5,1,3131,68,3063,4.78%,2.17%
2020-01-01 00:11:30,5,2,1427,12,1415,2.18%,0.84%
2020-01-01 00:11:30,5,3,1913,33,1880,2.92%,1.72%
2020-01-01 00:11:30,5,4,24658,4126,20532,37.63%,16.73%
2020-01-01 00:11:30,5,5,11763,995,10768,17.95%,8.46%
2020-01-01 00:11:30,5,6,17055,2051,15004,26.02%,12.03%
2020-01-01 00:11:30,5,7,4610,162,4448,7.03%,3.51%
2020-01-01 00:11:30,5,8,3198,88,3110,4.88%,2.75%
2020-01-01 00:11:30,5,9,9674,664,9010,14.76%,6.86%
2020-01-01 00:11:30,5,10,1986,32,1954,3.03%,1.61%
2020-01-01 00:11:30,5,11,600,5,595,0.92%,0.83%
2020-01-01 00:11:30,5,12,7369,407,6962,11.24%,5.52%
2020-01-01 00:11:30,6,1,991,7,984,1.51%,0.71%
2020-01-01 00:11:30,6,2,1135,12,1123,1.73%,1.06%
2020-01-01 00:11:30,6,3,1570,35,1535,2.40%,2.23%
2020-01-01 00:11:30,6,4,1824,27,1797,2.78%,1.48%
2020-01-01 00:11:30,6,5,15211,1676,13535,23.21%,11.02%
2020-01-01 00:11:30,6,6,5656,256,5400,8.63%,4.53%
2020-01-01 00:11:30,6,7,3265,82,3183,4.98%,2.51%
2020-01-01 00:11:30,6,8,2815,66,2749,4.30%,2.34%
2020-01-01 00:11:30,6,9,7652,437,7215,11.68%,5.71%
2020-01-01 00:11:30,6,10,1912,30,1882,2.92%,1.57%
2020-01-01 00:11:30,6,11,483,4,479,0.74%,0.83%
2020-01-01 00:11:30,6,12,5659,241,5418,8.63%,4.26%
2020-01-01 00:11:30,7,1,411,1,410,0.63%,0.24%
2020-01-01 00:11:30,7,2,196,0,196,0.30%,0.00%
2020-01-01 00:11:30,7,3,754,4,750,1.15%,0.53%
2020-01-01 00:11:30,7,4,2219,33,2186,3.39%,1.49%
2020-01-01 00:11:30,7,5,6704,342,6362,10.23%,5.10%
2020-01-01 00:11:30,7,6,12340,1158,11182,18.83%,9.38%
2020-01-01 00:11:30,7,7,3353,86,3267,5.12%,2.56%
2020-01-01 00:11:30,7,8,1453,16,1437,2.22%,1.10%
2020-01-01 00:11:30,7,9,5744,269,5475,8.76%,4.68%
2020-01-01 00:11:30,7,10,1271,16,1255,1.94%,1.26%
2020-01-01 00:11:30,7,11,78,0,78,0.12%,0.00%
2020-01-01 00:11:30,7,12,4446,170,4276,6.78%,3.82%
2020-01-01 00:11:30,8,1,452,2,450,0.69%,0.44%
2020-01-01 00:11:30,8,2,126,0,126,0.19%,0.00%
2020-01-01 00:11:30,8,3,1466,19,1447,2.24%,1.30%
2020-01-01 00:11:30,8,4,2909,67,2842,4.44%,2.30%
2020-01-01 00:11:30,8,5,8220,522,7698,12.54%,6.35%
2020-01-01 00:11:30,8,6,16315,1949,14366,24.89%,11.95%
2020-01-01 00:11:30,8,7,5108,199,4909,7.79%,3.90%
2020-01-01 00:11:30,8,8,2283,35,2248,3.48%,1.53%
2020-01-01 00:11:30,8,9,6400,312,6088,9.77%,4.87%
2020-01-01 00:11:30,8,10,1792,30,1762,2.73%,1.67%
2020-01-01 00:11:30,8,11,209,0,209,0.32%,0.00%
2020-01-01 00:11:30,8,12,4398,147,4251,6.71%,3.34%
2020-01-01 00:11:30,9,1,500,0,500,0.76%,0.00%
2020-01-01 00:11:30,9,2,5173,193,4980,7.89%,3.73%
2020-01-01 00:11:30,9,3,4324,140,4184,6.60%,3.24%
2020-01-01 00:11:30,9,4,5834,235,5599,8.90%,4.03%
2020-01-01 00:11:30,9,5,712,4,708,1.09%,0.56%
2020-01-01 00:11:30,9,6,7440,381,7059,11.35%,5.12%
2020-01-01 00:11:30,9,7,29177,5610,23567,44.52%,19.23%
2020-01-01 00:11:30,9,8,8518,543,7975,13.00%,6.37%
2020-01-01 00:11:30,9,9,344,0,344,0.52%,0.00%
2020-01-01 00:11:30,9,10,2233,53,2180,3.41%,2.37%
2020-01-01 00:11:30,9,11,7303,398,6905,11.14%,5.45%
2020-01-01 00:11:30,9,12,4770,175,4595,7.28%,3.67%
2020-01-01 00:11:30,10,1,1000,209,791,1.53%,20.88%
2020-01-01 00:11:30,10,2,2749,266,2483,4.19%,9.67%
2020-01-01 00:11:30,10,3,1644,37,1607,2.51%,2.25%
2020-01-01 00:11:30,10,4,4106,883,3223,6.27%,21.50%
2020-01-01 00:11:30,10,5,711,38,673,1.08%,5.34%
2020-01-01 00:11:30,10,6,5839,1008,4831,8.91%,17.26%
2020-01-01 00:11:30,10,7,10705,1691,9014,16.33%,15.79%
2020-01-01 00:11:30,10,8,28098,7034,21064,42.87%,25.03%
2020-01-01 00:11:30,10,9,627,2,625,0.96%,0.32%
2020-01-01 00:11:30,10,10,2569,52,2517,3.92%,2.02%
2020-01-01 00:11:30,10,11,12849,1657,11192,19.61%,12.89%
2020-01-01 00:11:30,10,12,9756,1185,8571,14.89%,12.15%
2020-01-01 00:11:30,11,1,1965,32,1933,3.00%,1.63%
2020-01-01 00:11:30,11,2,2970,62,2908,4.53%,2.09%
2020-01-01 00:11:30,11,3,763,2,761,1.16%,0.26%
2020-01-01 00:11:30,11,4,2987,92,2895,4.56%,3.08%
2020-01-01 00:11:30,11,5,209,0,209,0.32%,0.00%
2020-01-01 00:11:30,11,6,3740,122,3618,5.71%,3.26%
2020-01-01 00:11:30,11,7,8514,535,7979,12.99%,6.28%
2020-01-01 00:11:30,11,8,22904,3491,19413,34.95%,15.24%
2020-01-01 00:11:30,11,9,220,1,219,0.34%,0.45%
2020-01-01 00:11:30,11,10,2877,67,2810,4.39%,2.33%
2020-01-01 00:11:30,11,11,10198,740,9458,15.56%,7.26%
2020-01-01 00:11:30,11,12,6815,350,6465,10.40%,5.13%
2020-01-01 00:11:30,12,1,29,0,29,0.04%,0.00%
2020-01-01 00:11:30,12,2,548,179,369,0.84%,32.60%
2020-01-01 00:11:30,12,3,2139,211,1928,3.26%,9.86%
2020-01-01 00:11:30,12,4,2684,76,2608,4.10%,2.83%
2020-01-01 00:11:30,12,5,7222,593,6629,11.02%,8.21%
2020-01-01 00:11:30,12,6,4425,179,4246,6.75%,4.04%
2020-01-01 00:11:30,12,7,1578,19,1559,2.41%,1.20%
2020-01-01 00:11:30,12,8,1265,240,1025,1.93%,18.96%
2020-01-01 00:11:30,12,9,20357,3747,16610,31.06%,18.41%
2020-01-01 00:11:30,12,10,3950,345,3605,6.03%,8.73%
2020-01-01 00:11:30,12,11,1537,246,1291,2.35%,15.99%
2020-01-01 00:11:30,12,12,7814,1024,6790,11.92%,13.10%
2020-01-01 00:11:30,13,1,1953,38,1915,2.98%,1.94%
2020-01-01 00:11:30,13,2,2305,46,2259,3.52%,1.99%
2020-01-01 00:11:30,13,3,469,1,468,0.72%,0.21%
2020-01-01 00:11:30,13,4,5448,449,4999,8.31%,8.24%
2020-01-01 00:11:30,13,5,8192,843,7349,12.50%,10.29%
2020-01-01 00:11:30,13,6,6026,504,5522,9.19%,8.36%
2020-01-01 00:11:30,13,7,4832,197,4635,7.37%,4.08%
2020-01-01 00:11:30,13,8,7076,416,6660,10.80%,5.88%
2020-01-01 00:11:30,13,9,8484,871,7613,12.95%,10.27%
2020-01-01 00:11:30,13,10,26783,5227,21556,40.87%,19.52%
2020-01-01 00:11:30,13,11,16056,2004,14052,24.50%,12.48%
2020-01-01 00:11:30,13,12,8512,699,7813,12.99%,8.21%
2020-01-01 00:11:30,14,1,392,4,388,0.60%,1.02%
2020-01-01 00:11:30,14,2,1282,18,1264,1.96%,1.40%
2020-01-01 00:11:30,14,3,678,1,677,1.03%,0.15%
2020-01-01 00:11:30,14,4,3518,91,3427,5.37%,2.59%
2020-01-01 00:11:30,14,5,1183,8,1175,1.81%,0.68%
2020-01-01 00:11:30,14,6,3852,105,3747,5.88%,2.73%
2020-01-01 00:11:30,14,7,10721,851,9870,16.36%,7.94%
2020-01-01 00:11:30,14,8,12203,1104,11099,18.62%,9.05%
2020-01-01 00:11:30,14,9,1404,13,1391,2.14%,0.93%
2020-01-01 00:11:30,14,10,3645,93,3552,5.56%,2.55%
2020-01-01 00:11:30,14,11,24072,3914,20158,36.73%,16.26%
2020-01-01 00:11:30,14,12,7841,444,7397,11.96%,5.66%
2020-01-01 00:11:30,15,1,513,5,508,0.78%,0.97%
2020-01-01 00:11:30,15,2,164,0,164,0.25%,0.00%
2020-01-01 00:11:30,15,3,15100,1607,13493,23.04%,10.64%
2020-01-01 00:11:30,15,4,4693,236,4457,7.16%,5.03%
2020-01-01 00:11:30,15,5,20411,2953,17458,31.14%,14.47%
2020-01-01 00:11:30,15,6,4910,264,4646,7.49%,5.38%
2020-01-01 00:11:30,15,7,3301,84,3217,5.04%,2.54%
2020-01-01 00:11:30,15,8,5154,222,4932,7.86%,4.31%
2020-01-01 00:11:30,15,9,20622,3008,17614,31.47%,14.59%
2020-01-01 00:11:30,15,10,8391,582,7809,12.80%,6.94%
2020-01-01 00:11:30,15,11,13797,1472,12325,21.05%,10.67%
2020-01-01 00:11:30,15,12,39745,10385,29360,60.65%,26.13%
2020-01-01 00:11:30,16,1,483,1,482,0.74%,0.21%
2020-01-01 00:11:30,16,2,252,0,252,0.38%,0.00%
2020-01-01 00:11:30,16,3,1279,20,1259,1.95%,1.56%
2020-01-01 00:11:30,16,4,5247,194,5053,8.01%,3.70%
2020-01-01 00:11:30,16,5,8863,640,8223,13.52%,7.22%
2020-01-01 00:11:30,16,6,6078,271,5807,9.27%,4.46%
2020-01-01 00:11:30,16,7,3247,76,3171,4.95%,2.34%
2020-01-01 00:11:30,16,8,6879,350,6529,10.50%,5.09%
2020-01-01 00:11:30,16,9,9356,704,8652,14.28%,7.52%
2020-01-01 00:11:30,16,10,1943,28,1915,2.96%,1.44%
2020-01-01 00:11:30,16,11,9006,613,8393,13.74%,6.81%
2020-01-01 00:11:30,16,12,25979,4587,21392,39.64%,17.66%
2020-01-01 00:11:40,1,1,15934,1815,14119,24.31%,11.39%
2020-01-01 00:11:40,1,2,5468,239,5229,8.34%,4.37%
2020-01-01 00:11:40,1,3,477,2,475,0.73%,0.42%
2020-01-01 00:11:40,1,4,10045,777,9268,15.33%,7.73%
2020-01-01 00:11:40,1,5,9675,714,8961,14.76%,7.38%
2020-01-01 00:11:40,1,6,9589,708,8881,14.63%,7.38%
2020-01-01 00:11:40,1,7,4982,208,4774,7.60%,4.17%
2020-01-01 00:11:40,1,8,3209,91,3118,4.90%,2.83%
2020-01-01 00:11:40,1,9,9542,692,8850,14.56%,7.25%
2020-01-01 00:11:40,1,10,2493,56,2437,3.80%,2.25%
2020-01-01 00:11:40,1,11,2613,63,2550,3.99%,2.41%
2020-01-01 00:11:40,1,12,9502,690,8812,14.50%,7.26%
2020-01-01 00:11:40,2,1,636,0,636,0.97%,0.00%
2020-01-01 00:11:40,2,2,22899,3553,19346,34.94%,15.52%
2020-01-01 00:11:40,2,3,18106,2268,15838,27.63%,12.53%
2020-01-01 00:11:40,2,4,520,0,520,0.79%,0.00%
2020-01-01 00:11:40,2,5,10328,789,9539,15.76%,7.64%
2020-01-01 00:11:40,2,6,66,0,66,0.10%,0.00%
2020-01-01 00:11:40,2,7,4130,146,3984,6.30%,3.53%
2020-01-01 00:11:40,2,8,2883,87,2796,4.40%,3.02%
2020-01-01 00:11:40,2,9,10207,775,9432,15.57%,7.59%
2020-01-01 00:11:40,2,10,2176,46,2130,3.32%,2.11%
2020-01-01 00:11:40,2,11,2192,46,2146,3.34%,2.10%
2020-01-01 00:11:40,2,12,10052,753,9299,15.34%,7.49%
2020-01-01 00:11:40,3,1,1691,32,1659,2.58%,1.89%
2020-01-01 00:11:40,3,2,24646,4167,20479,37.61%,16.91%
2020-01-01 00:11:40,3,3,75054,30414,44640,114.52%,40.52%
2020-01-01 00:11:40,3,4,9938,737,9201,15.16%,7.42%
2020-01-01 00:11:40,3,5,49622,14829,34793,75.72%,29.88%
2020-01-01 00:11:40,3,6,10738,856,9882,16.38%,7.97%
2020-01-01 00:11:40,3,7,21423,3201,18222,32.69%,14.94%
2020-01-01 00:11:40,3,8,18704,2463,16241,28.54%,13.17%
2020-01-01 00:11:40,3,9,38402,9330,29072,58.60%,24.29%
2020-01-01 00:11:40,3,10,6375,303,6072,9.73%,4.75%
2020-01-01 00:11:40,3,11,2056,21,2035,3.14%,1.02%
2020-01-01 00:11:40,3,12,29686,5847,23839,45.30%,19.70%
2020-01-01 00:11:40,4,1,703,4,699,1.07%,0.57%
2020-01-01 00:11:40,4,2,463,3,460,0.71%,0.65%
2020-01-01 00:11:40,4,3,728,3,725,1.11%,0.41%
2020-01-01 00:11:40,4,4,28709,5522,23187,43.81%,19.23%
2020-01-01 00:11:40,4,5,16990,2058,14932,25.92%,12.11%
2020-01-01 00:11:40,4,6,23875,3872,20003,36.43%,16.22%
2020-01-01 00:11:40,4,7,5514,228,5286,8.41%,4.13%
2020-01-01 00:11:40,4,8,3144,68,3076,4.80%,2.16%
2020-01-01 00:11:40,4,9,14985,1633,13352,22.87%,10.90%
2020-01-01 00:11:40,4,10,1913,25,1888,2.92%,1.31%
2020-01-01 00:11:40,4,11,243,0,243,0.37%,0.00%
2020-01-01 00:11:40,4,12,12439,1115,11324,18.98%,8.96%
2020-01-01 00:11:40,5,1,3137,78,3059,4.79%,2.49%
2020-01-01 00:11:40,5,2,1210,10,1200,1.85%,0.83%
2020-01-01 00:11:40,5,3,455,2,453,0.69%,0.44%
2020-01-01 00:11:40,5,4,19702,2676,17026,30.06%,13.58%
2020-01-01 00:11:40,5,5,8683,593,8090,13.25%,6.83%
2020-01-01 00:11:40,5,6,13408,1287,12121,20.46%,9.60%
2020-01-01 00:11:40,5,7,4110,133,3977,6.27%,3.24%
2020-01-01 00:11:40,5,8,3030,65,2965,4.62%,2.14%
2020-01-01 00:11:40,5,9,8072,513,7559,12.32%,6.35%
2020-01-01 00:11:40,5,10,1048,11,1037,1.60%,1.05%
2020-01-01 00:11:40,5,11,456,3,453,0.70%,0.66%
2020-01-01 00:11:40,5,12,6681,347,6334,10.19%,5.19%
2020-01-01 00:11:40,6,1,1159,8,1151,1.77%,0.69%
2020-01-01 00:11:40,6,2,1304,12,1292,1.99%,0.92%
2020-01-01 00:11:40,6,3,1800,17,1783,2.75%,0.94%
2020-01-01 00:11:40,6,4,2324,31,2293,3.55%,1.33%
2020-01-01 00:11:40,6,5,14641,1540,13101,22.34%,10.52%
2020-01-01 00:11:40,6,6,6353,317,6036,9.69%,4.99%
2020-01-01 00:11:40,6,7,3546,87,3459,5.41%,2.45%
2020-01-01 00:11:40,6,8,3115,68,3047,4.75%,2.18%
2020-01-01 00:11:40,6,9,6190,288,5902,9.45%,4.65%
2020-01-01 00:11:40,6,10,1854,26,1828,2.83%,1.40%
2020-01-01 00:11:40,6,11,435,0,435,0.66%,0.00%
2020-01-01 00:11:40,6,12,4300,138,4162,6.56%,3.21%
2020-01-01 00:11:40,7,1,318,2,316,0.49%,0.63%
2020-01-01 00:11:40,7,2,260,1,259,0.40%,0.38%
2020-01-01 00:11:40,7,3,512,1,511,0.78%,0.19%
2020-01-01 00:11:40,7,4,2629,52,2577,4.01%,1.98%
2020-01-01 00:11:40,7,5,7208,358,6850,11.00%,4.97%
2020-01-01 00:11:40,7,6,13524,1285,12239,20.64%,9.50%
2020-01-01 00:11:40,7,7,3634,119,3515,5.55%,3.27%
2020-01-01 00:11:40,7,8,1542,27,1515,2.35%,1.75%
2020-01-01 00:11:40,7,9,5884,248,5636,8.98%,4.21%
2020-01-01 00:11:40,7,10,1015,5,1010,1.55%,0.49%
2020-01-01 00:11:40,7,11,70,0,70,0.11%,0.00%
2020-01-01 00:11:40,7,12,4843,169,4674,7.39%,3.49%
2020-01-01 00:11:40,8,1,526,2,524,0.80%,0.38%
2020-01-01 00:11:40,8,2,121,0,121,0.18%,0.00%
2020-01-01 00:11:40,8,3,1668,16,1652,2.55%,0.96%
2020-01-01 00:11:40,8,4,3103,59,3044,4.73%,1.90%
2020-01-01 00:11:40,8,5,8778,550,8228,13.39%,6.26%
2020-01-01 00:11:40,8,6,16633,1898,14735,25.38%,11.41%
2020-01-01 00:11:40,8,7,4614,159,4455,7.04%,3.45%
2020-01-01 00:11:40,8,8,1915,25,1890,2.92%,1.30%
2020-01-01 00:11:40,8,9,6757,341,6416,10.31%,5.05%
2020-01-01 00:11:40,8,10,1762,28,1734,2.69%,1.59%
2020-01-01 00:11:40,8,11,200,0,200,0.31%,0.00%
2020-01-01 00:11:40,8,12,4944,196,4748,7.54%,3.96%
2020-01-01 00:11:40,9,1,393,2,391,0.60%,0.51%
2020-01-01 00:11:40,9,2,2559,50,2509,3.90%,1.95%
2020-01-01 00:11:40,9,3,1666,21,1645,2.54%,1.26%
2020-01-01 00:11:40,9,4,4813,167,4646,7.34%,3.47%
2020-01-01 00:11:40,9,5,679,1,678,1.04%,0.15%
2020-01-01 00:11:40,9,6,6647,313,6334,10.14%,4.71%
2020-01-01 00:11:40,9,7,23135,3633,19502,35.30%,15.70%
2020-01-01 00:11:40,9,8,8789,592,8197,13.41%,6.73%
2020-01-01 00:11:40,9,9,304,0,304,0.46%,0.00%
2020-01-01 00:11:40,9,10,2010,33,1977,3.07%,1.64%
2020-01-01 00:11:40,9,11,7873,476,7397,12.01%,6.05%
2020-01-01 00:11:40,9,12,5569,251,5318,8.50%,4.51%
2020-01-01 00:11:40,10,1,1372,265,1107,2.09%,19.30%
2020-01-01 00:11:40,10,2,3196,319,2877,4.88%,9.98%
2020-01-01 00:11:40,10,3,1715,19,1696,2.62%,1.11%
2020-01-01 00:11:40,10,4,5521,1124,4397,8.42%,20.35%
2020-01-01 00:11:40,10,5,1054,58,996,1.61%,5.50%
2020-01-01 00:11:40,10,6,7251,1294,5957,11.06%,17.84%
2020-01-01 00:11:40,10,7,12328,2151,10177,18.81%,17.45%
2020-01-01 00:11:40,10,8,30146,7919,22227,46.00%,26.27%
2020-01-01 00:11:40,10,9,603,3,600,0.92%,0.50%
2020-01-01 00:11:40,10,10,2038,29,2009,3.11%,1.42%
2020-01-01 00:11:40,10,11,13633,1643,11990,20.80%,12.05%
2020-01-01 00:11:40,10,12,10899,1195,9704,16.63%,10.96%
2020-01-01 00:11:40,11,1,2175,55,2120,3.32%,2.53%
2020-01-01 00:11:40,11,2,3163,100,3063,4.83%,3.16%
2020-01-01 00:11:40,11,3,815,5,810,1.24%,0.61%
2020-01-01 00:11:40,11,4,5132,191,4941,7.83%,3.72%
2020-01-01 00:11:40,11,5,181,0,181,0.28%,0.00%
2020-01-01 00:11:40,11,6,5918,258,5660,9.03%,4.36%
2020-01-01 00:11:40,11,7,10907,874,10033,16.64%,8.01%
2020-01-01 00:11:40,11,8,26000,4534,21466,39.67%,17.44%
2020-01-01 00:11:40,11,9,168,0,168,0.26%,0.00%
2020-01-01 00:11:40,11,10,3091,81,3010,4.72%,2.62%
2020-01-01 00:11:40,11,11,10279,787,9492,15.68%,7.66%
2020-01-01 00:11:40,11,12,6633,323,6310,10.12%,4.87%
2020-01-01 00:11:40,12,1,43,0,43,0.07%,0.00%
2020-01-01 00:11:40,12,2,554,129,425,0.85%,23.24%
2020-01-01 00:11:40,12,3,2605,170,2435,3.97%,6.52%
2020-01-01 00:11:40,12,4,3251,87,3164,4.96%,2.68%
2020-01-01 00:11:40,12,5,8080,598,7482,12.33%,7.40%
2020-01-01 00:11:40,12,6,4801,195,4606,7.33%,4.06%
2020-01-01 00:11:40,12,7,1378,13,1365,2.10%,0.94%
2020-01-01 00:11:40,12,8,1573,310,1263,2.40%,19.70%
2020-01-01 00:11:40,12,9,21601,4156,17445,32.96%,19.24%
2020-01-01 00:11:40,12,10,4339,434,3905,6.62%,10.00%
2020-01-01 00:11:40,12,11,1801,315,1486,2.75%,17.48%
2020-01-01 00:11:40,12,12,7879,1229,6650,12.02%,15.60%
2020-01-01 00:11:40,13,1,1664,32,1632,2.54%,1.92%
2020-01-01 00:11:40,13,2,2083,41,2042,3.18%,1.97%
2020-01-01 00:11:40,13,3,669,3,666,1.02%,0.45%
2020-01-01 00:11:40,13,4,4922,634,4288,7.51%,12.88%
2020-01-01 00:11:40,13,5,7353,991,6362,11.22%,13.48%
2020-01-01 00:11:40,13,6,5494,677,4817,8.38%,12.32%
2020-01-01 00:11:40,13,7,4299,150,4149,6.56%,3.49%
2020-01-01 00:11:40,13,8,6903,362,6541,10.53%,5.24%
2020-01-01 00:11:40,13,9,7679,1024,6655,11.72%,13.33%
2020-01-01 00:11:40,13,10,29477,6409,23068,44.98%,21.74%
2020-01-01 00:11:40,13,11,18141,2542,15599,27.68%,14.01%
2020-01-01 00:11:40,13,12,10815,1063,9752,16.50%,9.83%
2020-01-01 00:11:40,14,1,277,0,277,0.42%,0.00%
2020-01-01 00:11:40,14,2,1406,15,1391,2.15%,1.07%
2020-01-01 00:11:40,14,3,887,7,880,1.35%,0.79%
2020-01-01 00:11:40,14,4,4912,178,4734,7.50%,3.62%
2020-01-01 00:11:40,14,5,1208,11,1197,1.84%,0.91%
2020-01-01 00:11:40,14,6,5247,204,5043,8.01%,3.89%
2020-01-01 00:11:40,14,7,12593,1140,11453,19.22%,9.05%
2020-01-01 00:11:40,14,8,14167,1442,12725,21.62%,10.18%
2020-01-01 00:11:40,14,9,1405,20,1385,2.14%,1.42%
2020-01-01 00:11:40,14,10,4319,155,4164,6.59%,3.59%
2020-01-01 00:11:40,14,11,27593,5051,22542,42.10%,18.30%
2020-01-01 00:11:40,14,12,8757,556,8201,13.36%,6.35%
2020-01-01 00:11:40,15,1,520,2,518,0.79%,0.38%
2020-01-01 00:11:40,15,2,145,0,145,0.22%,0.00%
2020-01-01 00:11:40,15,3,13282,1245,12037,20.27%,9.37%
2020-01-01 00:11:40,15,4,4679,274,4405,7.14%,5.85%
2020-01-01 00:11:40,15,5,19338,2900,16438,29.51%,15.00%
2020-01-01 00:11:40,15,6,5007,339,4668,7.64%,6.77%
2020-01-01 00:11:40,15,7,3038,75,2963,4.64%,2.47%
2020-01-01 00:11:40,15,8,5625,251,5374,8.58%,4.46%
2020-01-01 00:11:40,15,9,19523,2949,16574,29.79%,15.10%
2020-01-01 00:11:40,15,10,8093,638,7455,12.35%,7.88%
2020-01-01 00:11:40,15,11,13898,1538,12360,21.21%,11.07%
2020-01-01 00:11:40,15,12,39034,10171,28863,59.56%,26.06%
2020-01-01 00:11:40,16,1,414,1,413,0.63%,0.24%
2020-01-01 00:11:40,16,2,282,2,280,0.43%,0.71%
2020-01-01 00:11:40,16,3,1412,14,1398,2.15%,0.99%
2020-01-01 00:11:40,16,4,4565,119,4446,6.97%,2.61%
2020-01-01 00:11:40,16,5,8852,595,8257,13.51%,6.72%
2020-01-01 00:11:40,16,6,5599,199,5400,8.54%,3.55%
2020-01-01 00:11:40,16,7,2954,64,2890,4.51%,2.17%
2020-01-01 00:11:40,16,8,6986,399,6587,10.66%,5.71%
2020-01-01 00:11:40,16,9,9260,641,8619,14.13%,6.92%
2020-01-01 00:11:40,16,10,1495,19,1476,2.28%,1.27%
2020-01-01 00:11:40,16,11,8646,599,8047,13.19%,6.93%
2020-01-01 00:11:40,16,12,25919,4696,21223,39.55%,18.12%
2020-01-01 00:11:50,1,1,16204,1920,14284,24.73%,11.85%
2020-01-01 00:11:50,1,2,6843,380,6463,10.44%,5.55%
2020-01-01 00:11:50,1,3,716,3,713,1.09%,0.42%
2020-01-01 00:11:50,1,4,8943,636,8307,13.65%,7.11%
2020-01-01 00:11:50,1,5,8551,593,7958,13.05%,6.93%
2020-01-01 00:11:50,1,6,8528,591,7937,13.01%,6.93%
2020-01-01 00:11:50,1,7,6104,312,5792,9.31%,5.11%
2020-01-01 00:11:50,1,8,5118,216,4902,7.81%,4.22%
2020-01-01 00:11:50,1,9,8463,584,7879,12.91%,6.90%
2020-01-01 00:11:50,1,10,4331,163,4168,6.61%,3.76%
2020-01-01 00:11:50,1,11,4402,171,4231,6.72%,3.88%
2020-01-01 00:11:50,1,12,8434,584,7850,12.87%,6.92%
2020-01-01 00:11:50,2,1,706,3,703,1.08%,0.42%
2020-01-01 00:11:50,2,2,26395,4615,21780,40.28%,17.48%
2020-01-01 00:11:50,2,3,20013,2738,17275,30.54%,13.68%
2020-01-01 00:11:50,2,4,428,1,427,0.65%,0.23%
2020-01-01 00:11:50,2,5,10942,857,10085,16.70%,7.83%
2020-01-01 00:11:50,2,6,48,0,48,0.07%,0.00%
2020-01-01 00:11:50,2,7,5647,232,5415,8.62%,4.11%
2020-01-01 00:11:50,2,8,4616,163,4453,7.04%,3.53%
2020-01-01 00:11:50,2,9,10797,832,9965,16.47%,7.71%
2020-01-01 00:11:50,2,10,3771,111,3660,5.75%,2.94%
2020-01-01 00:11:50,2,11,3785,111,3674,5.78%,2.93%
2020-01-01 00:11:50,2,12,10600,808,9792,16.17%,7.62%
2020-01-01 00:11:50,3,1,2680,58,2622,4.09%,2.16%
2020-01-01 00:11:50,3,2,23101,3648,19453,35.25%,15.79%
2020-01-01 00:11:50,3,3,72403,28527,43876,110.48%,39.40%
2020-01-01 00:11:50,3,4,9656,683,8973,14.73%,7.07%
2020-01-01 00:11:50,3,5,48134,14048,34086,73.45%,29.18%
2020-01-01 00:11:50,3,6,10551,820,9731,16.10%,7.77%
2020-01-01 00:11:50,3,7,19038,2538,16500,29.05%,13.33%
2020-01-01 00:11:50,3,8,15331,1695,13636,23.39%,11.06%
2020-01-01 00:11:50,3,9,37222,8853,28369,56.80%,23.78%
2020-01-01 00:11:50,3,10,8359,544,7815,12.75%,6.51%
2020-01-01 00:11:50,3,11,2124,39,2085,3.24%,1.84%
2020-01-01 00:11:50,3,12,26478,4692,21786,40.40%,17.72%
2020-01-01 00:11:50,4,1,583,5,578,0.89%,0.86%
2020-01-01 00:11:50,4,2,385,2,383,0.59%,0.52%
2020-01-01 00:11:50,4,3,873,6,867,1.33%,0.69%
2020-01-01 00:11:50,4,4,29599,5778,23821,45.16%,19.52%
2020-01-01 00:11:50,4,5,17681,2227,15454,26.98%,12.59%
2020-01-01 00:11:50,4,6,25443,4377,21066,38.82%,17.20%
2020-01-01 00:11:50,4,7,6302,341,5961,9.62%,5.41%
2020-01-01 00:11:50,4,8,2909,64,2845,4.44%,2.20%
2020-01-01 00:11:50,4,9,15799,1816,13983,24.11%,11.49%
2020-01-01 00:11:50,4,10,1897,45,1852,2.89%,2.37%
2020-01-01 00:11:50,4,11,191,0,191,0.29%,0.00%
2020-01-01 00:11:50,4,12,13266,1285,11981,20.24%,9.69%
2020-01-01 00:11:50,5,1,3144,80,3064,4.80%,2.54%
2020-01-01 00:11:50,5,2,731,6,725,1.12%,0.82%
2020-01-01 00:11:50,5,3,418,2,416,0.64%,0.48%
2020-01-01 00:11:50,5,4,22243,3312,18931,33.94%,14.89%
2020-01-01 00:11:50,5,5,9235,642,8593,14.09%,6.95%
2020-01-01 00:11:50,5,6,15033,1612,13421,22.94%,10.72%
2020-01-01 00:11:50,5,7,5294,215,5079,8.08%,4.06%
2020-01-01 00:11:50,5,8,4445,154,4291,6.78%,3.46%
2020-01-01 00:11:50,5,9,8281,532,7749,12.64%,6.42%
2020-01-01 00:11:50,5,10,1082,12,1070,1.65%,1.11%
2020-01-01 00:11:50,5,11,755,6,749,1.15%,0.79%
2020-01-01 00:11:50,5,12,6943,374,6569,10.59%,5.39%
2020-01-01 00:11:50,6,1,1172,13,1159,1.79%,1.11%
2020-01-01 00:11:50,6,2,1318,17,1301,2.01%,1.29%
2020-01-01 00:11:50,6,3,1805,21,1784,2.75%,1.16%
2020-01-01 00:11:50,6,4,1327,22,1305,2.02%,1.66%
2020-01-01 00:11:50,6,5,15537,1704,13833,23.71%,10.97%
2020-01-01 00:11:50,6,6,6183,294,5889,9.43%,4.75%
2020-01-01 00:11:50,6,7,4310,157,4153,6.58%,3.64%
2020-01-01 00:11:50,6,8,3643,113,3530,5.56%,3.10%
2020-01-01 00:11:50,6,9,7267,406,6861,11.09%,5.59%
2020-01-01 00:11:50,6,10,2507,37,2470,3.83%,1.48%
2020-01-01 00:11:50,6,11,405,1,404,0.62%,0.25%
2020-01-01 00:11:50,6,12,4646,175,4471,7.09%,3.77%
2020-01-01 00:11:50,7,1,460,6,454,0.70%,1.30%
2020-01-01 00:11:50,7,2,211,0,211,0.32%,0.00%
2020-01-01 00:11:50,7,3,1222,10,1212,1.86%,0.82%
2020-01-01 00:11:50,7,4,1928,41,1887,2.94%,2.13%
2020-01-01 00:11:50,7,5,7611,487,7124,11.61%,6.40%
2020-01-01 00:11:50,7,6,13117,1389,11728,20.01%,10.59%
2020-01-01 00:11:50,7,7,3478,89,3389,5.31%,2.56%
2020-01-01 00:11:50,7,8,1204,8,1196,1.84%,0.66%
2020-01-01 00:11:50,7,9,6226,322,5904,9.50%,5.17%
2020-01-01 00:11:50,7,10,866,10,856,1.32%,1.15%
2020-01-01 00:11:50,7,11,77,0,77,0.12%,0.00%
2020-01-01 00:11:50,7,12,5343,239,5104,8.15%,4.47%
2020-01-01 00:11:50,8,1,491,3,488,0.75%,0.61%
2020-01-01 00:11:50,8,2,91,0,91,0.14%,0.00%
2020-01-01 00:11:50,8,3,1448,15,1433,2.21%,1.04%
2020-01-01 00:11:50,8,4,2716,67,2649,4.14%,2.47%
2020-01-01 00:11:50,8,5,8567,496,8071,13.07%,5.79%
2020-01-01 00:11:50,8,6,16368,1827,14541,24.98%,11.16%
2020-01-01 00:11:50,8,7,5004,193,4811,7.64%,3.86%
2020-01-01 00:11:50,8,8,1797,22,1775,2.74%,1.22%
2020-01-01 00:11:50,8,9,6845,330,6515,10.44%,4.82%
2020-01-01 00:11:50,8,10,1881,23,1858,2.87%,1.22%
2020-01-01 00:11:50,8,11,198,2,196,0.30%,1.01%
2020-01-01 00:11:50,8,12,4829,169,4660,7.37%,3.50%
2020-01-01 00:11:50,9,1,306,2,304,0.47%,0.65%
2020-01-01 00:11:50,9,2,3367,71,3296,5.14%,2.11%
2020-01-01 00:11:50,9,3,2673,45,2628,4.08%,1.68%
2020-01-01 00:11:50,9,4,5418,211,5207,8.27%,3.89%
2020-01-01 00:11:50,9,5,265,0,265,0.40%,0.00%
2020-01-01 00:11:50,9,6,6840,350,6490,10.44%,5.12%
2020-01-01 00:11:50,9,7,30318,5979,24339,46.26%,19.72%
2020-01-01 00:11:50,9,8,12927,1141,11786,19.73%,8.83%
2020-01-01 00:11:50,9,9,199,0,199,0.30%,0.00%
2020-01-01 00:11:50,9,10,4895,164,4731,7.47%,3.35%
2020-01-01 00:11:50,9,11,11857,961,10896,18.09%,8.10%
2020-01-01 00:11:50,9,12,6561,317,6244,10.01%,4.83%
2020-01-01 00:11:50,10,1,1426,255,1171,2.18%,17.87%
2020-01-01 00:11:50,10,2,3759,315,3444,5.74%,8.38%
2020-01-01 00:11:50,10,3,1701,15,1686,2.60%,0.88%
2020-01-01 00:11:50,10,4,4205,864,3341,6.42%,20.54%
2020-01-01 00:11:50,10,5,792,37,755,1.21%,4.67%
2020-01-01 00:11:50,10,6,6059,1031,5028,9.25%,17.01%
2020-01-01 00:11:50,10,7,11471,1813,9658,17.50%,15.80%
2020-01-01 00:11:50,10,8,29367,7406,21961,44.81%,25.22%
2020-01-01 00:11:50,10,9,601,2,599,0.92%,0.33%
2020-01-01 00:11:50,10,10,2497,41,2456,3.81%,1.64%
2020-01-01 00:11:50,10,11,14279,1794,12485,21.79%,12.56%
2020-01-01 00:11:50,10,12,11253,1292,9961,17.17%,11.48%
2020-01-01 00:11:50,11,1,2282,45,2237,3.48%,1.97%
2020-01-01 00:11:50,11,2,3305,100,3205,5.04%,3.02%
2020-01-01 00:11:50,11,3,879,8,871,1.34%,0.91%
2020-01-01 00:11:50,11,4,2964,82,2882,4.52%,2.77%
2020-01-01 00:11:50,11,5,171,1,170,0.26%,0.58%
2020-01-01 00:11:50,11,6,3668,111,3557,5.60%,3.03%
2020-01-01 00:11:50,11,7,8881,598,8283,13.55%,6.73%
2020-01-01 00:11:50,11,8,22730,3633,19097,34.68%,15.98%
2020-01-01 00:11:50,11,9,205,0,205,0.31%,0.00%
2020-01-01 00:11:50,11,10,2939,67,2872,4.48%,2.28%
2020-01-01 00:11:50,11,11,9846,695,9151,15.02%,7.06%
2020-01-01 00:11:50,11,12,6432,296,6136,9.81%,4.60%
2020-01-01 00:11:50,12,1,31,0,31,0.05%,0.00%
2020-01-01 00:11:50,12,2,549,178,371,0.84%,32.36%
2020-01-01 00:11:50,12,3,2558,218,2340,3.90%,8.52%
2020-01-01 00:11:50,12,4,3305,81,3224,5.04%,2.45%
2020-01-01 00:11:50,12,5,8781,717,8064,13.40%,8.16%
2020-01-01 00:11:50,12,6,5395,187,5208,8.23%,3.47%
2020-01-01 00:11:50,12,7,1981,31,1950,3.02%,1.56%
2020-01-01 00:11:50,12,8,1409,352,1057,2.15%,24.96%
2020-01-01 00:11:50,12,9,22291,4445,17846,34.01%,19.94%
2020-01-01 00:11:50,12,10,4414,457,3957,6.74%,10.35%
2020-01-01 00:11:50,12,11,1837,359,1478,2.80%,19.53%
2020-01-01 00:11:50,12,12,8147,1305,6842,12.43%,16.02%
2020-01-01 00:11:50,13,1,1922,29,1893,2.93%,1.51%
2020-01-01 00:11:50,13,2,2278,44,2234,3.48%,1.93%
2020-01-01 00:11:50,13,3,646,4,642,0.99%,0.62%
2020-01-01 00:11:50,13,4,5734,607,5127,8.75%,10.58%
2020-01-01 00:11:50,13,5,7947,977,6970,12.13%,12.29%
2020-01-01 00:11:50,13,6,6440,668,5772,9.83%,10.37%
2020-01-01 00:11:50,13,7,4802,148,4654,7.33%,3.08%
2020-01-01 00:11:50,13,8,7261,354,6907,11.08%,4.87%
2020-01-01 00:11:50,13,9,8303,1015,7288,12.67%,12.22%
2020-01-01 00:11:50,13,10,30750,6808,23942,46.92%,22.14%
2020-01-01 00:11:50,13,11,18003,2536,15467,27.47%,14.09%
2020-01-01 00:11:50,13,12,10254,1121,9133,15.65%,10.93%
2020-01-01 00:11:50,14,1,319,0,319,0.49%,0.00%
2020-01-01 00:11:50,14,2,1598,12,1586,2.44%,0.75%
2020-01-01 00:11:50,14,3,1152,5,1147,1.76%,0.43%
2020-01-01 00:11:50,14,4,4951,179,4772,7.55%,3.61%
2020-01-01 00:11:50,14,5,1525,25,1500,2.33%,1.64%
2020-01-01 00:11:50,14,6,5290,211,5079,8.07%,3.99%
2020-01-01 00:11:50,14,7,12653,1146,11507,19.31%,9.06%
2020-01-01 00:11:50,14,8,14226,1434,12792,21.71%,10.08%
2020-01-01 00:11:50,14,9,1713,34,1679,2.61%,1.98%
2020-01-01 00:11:50,14,10,4800,173,4627,7.32%,3.60%
2020-01-01 00:11:50,14,11,30000,5874,24126,45.78%,19.58%
2020-01-01 00:11:50,14,12,10627,818,9809,16.22%,7.70%
2020-01-01 00:11:50,15,1,537,2,535,0.82%,0.37%
2020-01-01 00:11:50,15,2,161,0,161,0.25%,0.00%
2020-01-01 00:11:50,15,3,3361,88,3273,5.13%,2.62%
2020-01-01 00:11:50,15,4,5426,292,5134,8.28%,5.38%
2020-01-01 00:11:50,15,5,9971,948,9023,15.21%,9.51%
2020-01-01 00:11:50,15,6,5777,338,5439,8.82%,5.85%
2020-01-01 00:11:50,15,7,3378,73,3305,5.15%,2.16%
2020-01-01 00:11:50,15,8,5443,205,5238,8.31%,3.77%
2020-01-01 00:11:50,15,9,10217,983,9234,15.59%,9.62%
2020-01-01 00:11:50,15,10,6421,394,6027,9.80%,6.14%
2020-01-01 00:11:50,15,11,11987,1076,10911,18.29%,8.98%
2020-01-01 00:11:50,15,12,27841,5678,22163,42.48%,20.39%
2020-01-01 00:11:50,16,1,398,4,394,0.61%,1.00%
2020-01-01 00:11:50,16,2,257,1,256,0.39%,0.39%
2020-01-01 00:11:50,16,3,1338,16,1322,2.04%,1.19%
2020-01-01 00:11:50,16,4,3887,136,3751,5.93%,3.50%
2020-01-01 00:11:50,16,5,7551,513,7038,11.52%,6.79%
2020-01-01 00:11:50,16,6,4902,187,4715,7.48%,3.81%
2020-01-01 00:11:50,16,7,3280,91,3189,5.00%,2.77%
2020-01-01 00:11:50,16,8,7265,461,6804,11.09%,6.34%
2020-01-01 00:11:50,16,9,7958,559,7399,12.14%,7.02%
2020-01-01 00:11:50,16,10,1484,20,1464,2.26%,1.35%
2020-01-01 00:11:50,16,11,8972,661,8311,13.69%,7.37%
2020-01-01 00:11:50,16,12,24838,4370,20468,37.90%,17.59%
2020-01-01 00:12:00,1,1,15879,1807,14072,24.23%,11.38%
2020-01-01 00:12:00,1,2,6427,323,6104,9.81%,5.02%
2020-01-01 00:12:00,1,3,625,6,619,0.95%,0.96%
2020-01-01 00:12:00,1,4,8988,607,8381,13.71%,6.75%
2020-01-01 00:12:00,1,5,8584,563,8021,13.10%,6.56%
2020-01-01 00:12:00,1,6,8512,552,7960,12.99%,6.48%
2020-01-01 00:12:00,1,7,5780,256,5524,8.82%,4.43%
2020-01-01 00:12:00,1,8,4737,179,4558,7.23%,3.78%
2020-01-01 00:12:00,1,9,8473,548,7925,12.93%,6.47%
2020-01-01 00:12:00,1,10,4062,131,3931,6.20%,3.22%
2020-01-01 00:12:00,1,11,4147,134,4013,6.33%,3.23%
2020-01-01 00:12:00,1,12,8409,541,7868,12.83%,6.43%
2020-01-01 00:12:00,2,1,996,4,992,1.52%,0.40%
2020-01-01 00:12:00,2,2,30266,6076,24190,46.18%,20.07%
2020-01-01 00:12:00,2,3,24163,3990,20173,36.87%,16.51%
2020-01-01 00:12:00,2,4,869,3,866,1.33%,0.34%
2020-01-01 00:12:00,2,5,15213,1686,13527,23.21%,11.08%
2020-01-01 00:12:00,2,6,44,0,44,0.07%,0.00%
2020-01-01 00:12:00,2,7,5089,216,4873,7.77%,4.24%
2020-01-01 00:12:00,2,8,3584,97,3487,5.47%,2.71%
2020-01-01 00:12:00,2,9,15065,1653,13412,22.99%,10.97%
2020-01-01 00:12:00,2,10,2845,61,2784,4.34%,2.14%
2020-01-01 00:12:00,2,11,2856,61,2795,4.36%,2.14%
2020-01-01 00:12:00,2,12,14879,1609,13270,22.70%,10.81%
2020-01-01 00:12:00,3,1,1448,16,1432,2.21%,1.10%
2020-01-01 00:12:00,3,2,22429,3415,19014,34.22%,15.23%
2020-01-01 00:12:00,3,3,66432,24709,41723,101.37%,37.19%
2020-01-01 00:12:00,3,4,5441,225,5216,8.30%,4.13%
2020-01-01 00:12:00,3,5,43201,11555,31646,65.92%,26.75%
2020-01-01 00:12:00,3,6,6341,290,6051,9.68%,4.57%
2020-01-01 00:12:00,3,7,19373,2592,16781,29.56%,13.38%
2020-01-01 00:12:00,3,8,15369,1668,13701,23.45%,10.85%
2020-01-01 00:12:00,3,9,36464,8455,28009,55.64%,23.19%
2020-01-01 00:12:00,3,10,7999,493,7506,12.21%,6.16%
2020-01-01 00:12:00,3,11,2326,45,2281,3.55%,1.93%
2020-01-01 00:12:00,3,12,25667,4320,21347,39.16%,16.83%
2020-01-01 00:12:00,4,1,552,3,549,0.84%,0.54%
2020-01-01 00:12:00,4,2,327,1,326,0.50%,0.30%
2020-01-01 00:12:00,4,3,736,4,732,1.12%,0.54%
2020-01-01 00:12:00,4,4,29079,5481,23598,44.37%,18.85%
2020-01-01 00:12:00,4,5,17481,2155,15326,26.67%,12.33%
2020-01-01 00:12:00,4,6,25143,4207,20936,38.37%,16.73%
2020-01-01 00:12:00,4,7,6263,263,6000,9.56%,4.20%
2020-01-01 00:12:00,4,8,2703,54,2649,4.12%,2.00%
2020-01-01 00:12:00,4,9,15579,1732,13847,23.77%,11.12%
2020-01-01 00:12:00,4,10,1954,35,1919,2.98%,1.79%
2020-01-01 00:12:00,4,11,202,0,202,0.31%,0.00%
2020-01-01 00:12:00,4,12,12784,1177,11607,19.51%,9.21%
2020-01-01 00:12:00,5,1,2875,87,2788,4.39%,3.03%
2020-01-01 00:12:00,5,2,725,10,715,1.11%,1.38%
2020-01-01 00:12:00,5,3,429,1,428,0.65%,0.23%
2020-01-01 00:12:00,5,4,26333,4583,21750,40.18%,17.40%
2020-01-01 00:12:00,5,5,9847,685,9162,15.03%,6.96%
2020-01-01 00:12:00,5,6,15908,1730,14178,24.27%,10.87%
2020-01-01 00:12:00,5,7,5549,219,5330,8.47%,3.95%
2020-01-01 00:12:00,5,8,3419,73,3346,5.22%,2.13%
2020-01-01 00:12:00,5,9,9205,612,8593,14.05%,6.65%
2020-01-01 00:12:00,5,10,1333,15,1318,2.03%,1.12%
2020-01-01 00:12:00,5,11,685,3,682,1.05%,0.44%
2020-01-01 00:12:00,5,12,7610,436,7174,11.61%,5.73%
2020-01-01 00:12:00,6,1,1127,12,1115,1.72%,1.06%
2020-01-01 00:12:00,6,2,1281,17,1264,1.95%,1.33%
2020-01-01 00:12:00,6,3,1800,23,1777,2.75%,1.28%
2020-01-01 00:12:00,6,4,1103,6,1097,1.68%,0.54%
2020-01-01 00:12:00,6,5,13148,1246,11902,20.06%,9.48%
2020-01-01 00:12:00,6,6,4646,193,4453,7.09%,4.15%
2020-01-01 00:12:00,6,7,3097,80,3017,4.73%,2.58%
2020-01-01 00:12:00,6,8,2533,48,2485,3.87%,1.89%
2020-01-01 00:12:00,6,9,6337,328,6009,9.67%,5.18%
2020-01-01 00:12:00,6,10,2012,34,1978,3.07%,1.69%
2020-01-01 00:12:00,6,11,382,0,382,0.58%,0.00%
2020-01-01 00:12:00,6,12,4265,135,4130,6.51%,3.16%
2020-01-01 00:12:00,7,1,377,1,376,0.58%,0.26%
2020-01-01 00:12:00,7,2,191,0,191,0.29%,0.00%
2020-01-01 00:12:00,7,3,990,6,984,1.51%,0.61%
2020-01-01 00:12:00,7,4,1897,42,1855,2.89%,2.21%
2020-01-01 00:12:00,7,5,7584,415,7169,11.57%,5.47%
2020-01-01 00:12:00,7,6,12993,1206,11787,19.83%,9.28%
2020-01-01 00:12:00,7,7,3421,89,3332,5.22%,2.60%
2020-01-01 00:12:00,7,8,1218,9,1209,1.86%,0.74%
2020-01-01 00:12:00,7,9,6335,286,6049,9.67%,4.51%
2020-01-01 00:12:00,7,10,970,13,957,1.48%,1.34%
2020-01-01 00:12:00,7,11,91,0,91,0.14%,0.00%
2020-01-01 00:12:00,7,12,5279,186,5093,8.06%,3.52%
2020-01-01 00:12:00,8,1,541,2,539,0.83%,0.37%
2020-01-01 00:12:00,8,2,43,0,43,0.07%,0.00%
2020-01-01 00:12:00,8,3,1404,19,1385,2.14%,1.35%
2020-01-01 00:12:00,8,4,2855,53,2802,4.36%,1.86%
2020-01-01 00:12:00,8,5,8994,623,8371,13.72%,6.93%
2020-01-01 00:12:00,8,6,16998,2041,14957,25.94%,12.01%
2020-01-01 00:12:00,8,7,5035,197,4838,7.68%,3.91%
2020-01-01 00:12:00,8,8,2177,41,2136,3.32%,1.88%
2020-01-01 00:12:00,8,9,7277,415,6862,11.10%,5.70%
2020-01-01 00:12:00,8,10,1848,25,1823,2.82%,1.35%
2020-01-01 00:12:00,8,11,198,0,198,0.30%,0.00%
2020-01-01 00:12:00,8,12,5308,230,5078,8.10%,4.33%
2020-01-01 00:12:00,9,1,671,2,669,1.02%,0.30%
2020-01-01 00:12:00,9,2,2861,62,2799,4.37%,2.17%
2020-01-01 00:12:00,9,3,1756,19,1737,2.68%,1.08%
2020-01-01 00:12:00,9,4,4878,214,4664,7.44%,4.39%
2020-01-01 00:12:00,9,5,257,0,257,0.39%,0.00%
2020-01-01 00:12:00,9,6,5917,299,5618,9.03%,5.05%
2020-01-01 00:12:00,9,7,24416,4189,20227,37.26%,17.16%
2020-01-01 00:12:00,9,8,9074,660,8414,13.85%,7.27%
2020-01-01 00:12:00,9,9,177,0,177,0.27%,0.00%
2020-01-01 00:12:00,9,10,2865,133,2732,4.37%,4.64%
2020-01-01 00:12:00,9,11,7887,516,7371,12.03%,6.54%
2020-01-01 00:12:00,9,12,4609,173,4436,7.03%,3.75%
2020-01-01 00:12:00,10,1,1391,260,1131,2.12%,18.68%
2020-01-01 00:12:00,10,2,3414,331,3083,5.21%,9.69%
2020-01-01 00:12:00,10,3,1479,18,1461,2.26%,1.22%
2020-01-01 00:12:00,10,4,5449,968,4481,8.31%,17.76%
2020-01-01 00:12:00,10,5,979,34,945,1.49%,3.47%
2020-01-01 00:12:00,10,6,7390,1167,6223,11.28%,15.79%
2020-01-01 00:12:00,10,7,12761,2099,10662,19.47%,16.45%
2020-01-01 00:12:00,10,8,29546,7337,22209,45.08%,24.83%
2020-01-01 00:12:00,10,9,592,3,589,0.90%,0.51%
2020-01-01 00:12:00,10,10,2016,37,1979,3.08%,1.83%
2020-01-01 00:12:00,10,11,12792,1494,11298,19.52%,11.68%
2020-01-01 00:12:00,10,12,10133,1075,9058,15.46%,10.61%
2020-01-01 00:12:00,11,1,2309,42,2267,3.52%,1.82%
2020-01-01 00:12:00,11,2,5324,205,5119,8.12%,3.85%
2020-01-01 00:12:00,11,3,2832,58,2774,4.32%,2.05%
2020-01-01 00:12:00,11,4,5666,233,5433,8.65%,4.11%
2020-01-01 00:12:00,11,5,254,0,254,0.39%,0.00%
2020-01-01 00:12:00,11,6,6558,298,6260,10.01%,4.54%
2020-01-01 00:12:00,11,7,13784,1323,12461,21.03%,9.60%
2020-01-01 00:12:00,11,8,28086,5287,22799,42.86%,18.82%
2020-01-01 00:12:00,11,9,200,2,198,0.31%,1.00%
2020-01-01 00:12:00,11,10,3059,86,2973,4.67%,2.81%
2020-01-01 00:12:00,11,11,9935,767,9168,15.16%,7.72%
2020-01-01 00:12:00,11,12,6414,336,6078,9.79%,5.24%
2020-01-01 00:12:00,12,1,52,0,52,0.08%,0.00%
2020-01-01 00:12:00,12,2,517,164,353,0.79%,31.66%
2020-01-01 00:12:00,12,3,3187,252,2935,4.86%,7.90%
2020-01-01 00:12:00,12,4,2860,60,2800,4.36%,2.10%
2020-01-01 00:12:00,12,5,8860,712,8148,13.52%,8.04%
2020-01-01 00:12:00,12,6,4955,183,4772,7.56%,3.69%
2020-01-01 00:12:00,12,7,1967,37,1930,3.00%,1.88%
2020-01-01 00:12:00,12,8,1429,368,1061,2.18%,25.73%
2020-01-01 00:12:00,12,9,21990,4353,17637,33.55%,19.79%
2020-01-01 00:12:00,12,10,4192,440,3752,6.40%,10.49%
2020-01-01 00:12:00,12,11,1832,371,1461,2.80%,20.24%
2020-01-01 00:12:00,12,12,8066,1319,6747,12.31%,16.35%
2020-01-01 00:12:00,13,1,1991,40,1951,3.04%,2.01%
2020-01-01 00:12:00,13,2,2354,50,2304,3.59%,2.12%
2020-01-01 00:12:00,13,3,653,2,651,1.00%,0.31%
2020-01-01 00:12:00,13,4,5381,619,4762,8.21%,11.50%
2020-01-01 00:12:00,13,5,7741,989,6752,11.81%,12.77%
2020-01-01 00:12:00,13,6,6039,679,5360,9.21%,11.24%
2020-01-01 00:12:00,13,7,5417,223,5194,8.27%,4.12%
2020-01-01 00:12:00,13,8,7555,406,7149,11.53%,5.37%
2020-01-01 00:12:00,13,9,8057,1015,7042,12.29%,12.60%
2020-01-01 00:12:00,13,10,31599,7149,24450,48.22%,22.62%
2020-01-01 00:12:00,13,11,19145,2835,16310,29.21%,14.81%
2020-01-01 00:12:00,13,12,11166,1209,9957,17.04%,10.83%
2020-01-01 00:12:00,14,1,398,1,397,0.61%,0.25%
2020-01-01 00:12:00,14,2,1634,21,1613,2.49%,1.28%
2020-01-01 00:12:00,14,3,1089,10,1079,1.66%,0.92%
2020-01-01 00:12:00,14,4,3712,106,3606,5.66%,2.85%
2020-01-01 00:12:00,14,5,1121,4,1117,1.71%,0.36%
2020-01-01 00:12:00,14,6,4053,126,3927,6.18%,3.11%
2020-01-01 00:12:00,14,7,11729,983,10746,17.90%,8.38%
2020-01-01 00:12:00,14,8,13311,1263,12048,20.31%,9.49%
2020-01-01 00:12:00,14,9,1365,6,1359,2.08%,0.44%
2020-01-01 00:12:00,14,10,4125,117,4008,6.29%,2.84%
2020-01-01 00:12:00,14,11,27388,4919,22469,41.79%,17.96%
2020-01-01 00:12:00,14,12,9495,655,8840,14.49%,6.90%
2020-01-01 00:12:00,15,1,476,0,476,0.73%,0.00%
2020-01-01 00:12:00,15,2,132,0,132,0.20%,0.00%
2020-01-01 00:12:00,15,3,6496,279,6217,9.91%,4.29%
2020-01-01 00:12:00,15,4,5155,279,4876,7.87%,5.41%
2020-01-01 00:12:00,15,5,12609,1198,11411,19.24%,9.50%
2020-01-01 00:12:00,15,6,5426,323,5103,8.28%,5.95%
2020-01-01 00:12:00,15,7,3518,87,3431,5.37%,2.47%
2020-01-01 00:12:00,15,8,6050,266,5784,9.23%,4.40%
2020-01-01 00:12:00,15,9,12898,1252,11646,19.68%,9.71%
2020-01-01 00:12:00,15,10,5150,306,4844,7.86%,5.94%
2020-01-01 00:12:00,15,11,11359,983,10376,17.33%,8.65%
2020-01-01 00:12:00,15,12,29693,6195,23498,45.31%,20.86%
2020-01-01 00:12:00,16,1,425,2,423,0.65%,0.47%
2020-01-01 00:12:00,16,2,222,0,222,0.34%,0.00%
2020-01-01 00:12:00,16,3,1491,14,1477,2.28%,0.94%
2020-01-01 00:12:00,16,4,3909,119,3790,5.96%,3.04%
2020-01-01 00:12:00,16,5,7818,545,7273,11.93%,6.97%
2020-01-01 00:12:00,16,6,4858,180,4678,7.41%,3.70%
2020-01-01 00:12:00,16,7,3452,76,3376,5.27%,2.20%
2020-01-01 00:12:00,16,8,8286,518,7768,12.64%,6.25%
2020-01-01 00:12:00,16,9,8200,593,7607,12.51%,7.23%
2020-01-01 00:12:00,16,10,1826,13,1813,2.79%,0.71%
2020-01-01 00:12:00,16,11,10328,770,9558,15.76%,7.45%
2020-01-01 00:12:00,16,12,26155,4669,21486,39.91%,17.85%
2020-01-01 00:12:10,1,1,13839,1375,12464,21.12%,9.93%
2020-01-01 00:12:10,1,2,5174,188,4986,7.89%,3.63%
2020-01-01 00:12:10,1,3,413,1,412,0.63%,0.24%
2020-01-01 00:12:10,1,4,8213,528,7685,12.53%,6.43%
2020-01-01 00:12:10,1,5,7779,479,7300,11.87%,6.16%
2020-01-01 00:12:10,1,6,7759,477,7282,11.84%,6.15%
2020-01-01 00:12:10,1,7,4753,156,4597,7.25%,3.28%
2020-01-01 00:12:10,1,8,3727,93,3634,5.69%,2.49%
2020-01-01 00:12:10,1,9,7720,473,7247,11.78%,6.13%
2020-01-01 00:12:10,1,10,3010,48,2962,4.59%,1.59%
2020-01-01 00:12:10,1,11,3116,50,3066,4.75%,1.60%
2020-01-01 00:12:10,1,12,7683,467,7216,11.72%,6.08%
2020-01-01 00:12:10,2,1,1185,8,1177,1.81%,0.67%
2020-01-01 00:12:10,2,2,28842,5504,23338,44.01%,19.08%
2020-01-01 00:12:10,2,3,23635,3788,19847,36.06%,16.03%
2020-01-01 00:12:10,2,4,1094,5,1089,1.67%,0.46%
2020-01-01 00:12:10,2,5,15786,1750,14036,24.09%,11.09%
2020-01-01 00:12:10,2,6,95,0,95,0.14%,0.00%
2020-01-01 00:12:10,2,7,3988,114,3874,6.09%,2.86%
2020-01-01 00:12:10,2,8,2804,72,2732,4.28%,2.57%
2020-01-01 00:12:10,2,9,15648,1721,13927,23.88%,11.00%
2020-01-01 00:12:10,2,10,2040,42,1998,3.11%,2.06%
2020-01-01 00:12:10,2,11,2054,43,2011,3.13%,2.09%
2020-01-01 00:12:10,2,12,15433,1666,13767,23.55%,10.79%
2020-01-01 00:12:10,3,1,1710,32,1678,2.61%,1.87%
2020-01-01 00:12:10,3,2,21716,3305,18411,33.14%,15.22%
2020-01-01 00:12:10,3,3,62451,22247,40204,95.29%,35.62%
2020-01-01 00:12:10,3,4,5185,235,4950,7.91%,4.53%
2020-01-01 00:12:10,3,5,39718,9975,29743,60.60%,25.11%
2020-01-01 00:12:10,3,6,5987,316,5671,9.14%,5.28%
2020-01-01 00:12:10,3,7,18359,2388,15971,28.01%,13.01%
2020-01-01 00:12:10,3,8,15219,1660,13559,23.22%,10.91%
2020-01-01 00:12:10,3,9,33423,7256,26167,51.00%,21.71%
2020-01-01 00:12:10,3,10,5483,236,5247,8.37%,4.30%
2020-01-01 00:12:10,3,11,2137,24,2113,3.26%,1.12%
2020-01-01 00:12:10,3,12,25074,4249,20825,38.26%,16.95%
2020-01-01 00:12:10,4,1,530,4,526,0.81%,0.75%
2020-01-01 00:12:10,4,2,316,1,315,0.48%,0.32%
2020-01-01 00:12:10,4,3,878,14,864,1.34%,1.59%
2020-01-01 00:12:10,4,4,28041,5231,22810,42.79%,18.65%
2020-01-01 00:12:10,4,5,16923,2027,14896,25.82%,11.98%
2020-01-01 00:12:10,4,6,23201,3728,19473,35.40%,16.07%
2020-01-01 00:12:10,4,7,5098,221,4877,7.78%,4.33%
2020-01-01 00:12:10,4,8,2750,53,2697,4.20%,1.93%
2020-01-01 00:12:10,4,9,14903,1601,13302,22.74%,10.74%
2020-01-01 00:12:10,4,10,1831,26,1805,2.79%,1.42%
2020-01-01 00:12:10,4,11,209,0,209,0.32%,0.00%
2020-01-01 00:12:10,4,12,12375,1130,11245,18.88%,9.13%
2020-01-01 00:12:10,5,1,2865,54,2811,4.37%,1.88%
2020-01-01 00:12:10,5,2,778,1,777,1.19%,0.13%
2020-01-01 00:12:10,5,3,464,2,462,0.71%,0.43%
2020-01-01 00:12:10,5,4,42413,11316,31097,64.72%,26.68%
2020-01-01 00:12:10,5,5,9228,632,8596,14.08%,6.85%
2020-01-01 00:12:10,5,6,16880,1986,14894,25.76%,11.76%
2020-01-01 00:12:10,5,7,7264,366,6898,11.08%,5.04%
2020-01-01 00:12:10,5,8,3373,82,3291,5.15%,2.43%
2020-01-01 00:12:10,5,9,8572,555,8017,13.08%,6.47%
2020-01-01 00:12:10,5,10,1112,12,1100,1.70%,1.08%
2020-01-01 00:12:10,5,11,762,5,757,1.16%,0.66%
2020-01-01 00:12:10,5,12,7118,363,6755,10.86%,5.10%
2020-01-01 00:12:10,6,1,1035,15,1020,1.58%,1.45%
2020-01-01 00:12:10,6,2,1210,15,1195,1.85%,1.24%
2020-01-01 00:12:10,6,3,1811,34,1777,2.76%,1.88%
2020-01-01 00:12:10,6,4,1067,12,1055,1.63%,1.12%
2020-01-01 00:12:10,6,5,14321,1468,12853,21.85%,10.25%
2020-01-01 00:12:10,6,6,4292,159,4133,6.55%,3.70%
2020-01-01 00:12:10,6,7,2795,81,2714,4.26%,2.90%
2020-01-01 00:12:10,6,8,2327,63,2264,3.55%,2.71%
2020-01-01 00:12:10,6,9,7818,462,7356,11.93%,5.91%
2020-01-01 00:12:10,6,10,2132,43,2089,3.25%,2.02%
2020-01-01 00:12:10,6,11,461,1,460,0.70%,0.22%
2020-01-01 00:12:10,6,12,5598,254,5344,8.54%,4.54%
2020-01-01 00:12:10,7,1,571,2,569,0.87%,0.35%
2020-01-01 00:12:10,7,2,185,0,185,0.28%,0.00%
2020-01-01 00:12:10,7,3,650,3,647,0.99%,0.46%
2020-01-01 00:12:10,7,4,2183,50,2133,3.33%,2.29%
2020-01-01 00:12:10,7,5,7085,376,6709,10.81%,5.31%
2020-01-01 00:12:10,7,6,12534,1183,11351,19.13%,9.44%
2020-01-01 00:12:10,7,7,3172,76,3096,4.84%,2.40%
2020-01-01 00:12:10,7,8,1147,17,1130,1.75%,1.48%
2020-01-01 00:12:10,7,9,6040,272,5768,9.22%,4.50%
2020-01-01 00:12:10,7,10,1197,8,1189,1.83%,0.67%
2020-01-01 00:12:10,7,11,89,0,89,0.14%,0.00%
2020-01-01 00:12:10,7,12,4819,181,4638,7.35%,3.76%
2020-01-01 00:12:10,8,1,482,2,480,0.74%,0.41%
2020-01-01 00:12:10,8,2,77,0,77,0.12%,0.00%
2020-01-01 00:12:10,8,3,1812,24,1788,2.76%,1.32%
2020-01-01 00:12:10,8,4,2993,47,2946,4.57%,1.57%
2020-01-01 00:12:10,8,5,9063,579,8484,13.83%,6.39%
2020-01-01 00:12:10,8,6,17297,2007,15290,26.39%,11.60%
2020-01-01 00:12:10,8,7,5117,205,4912,7.81%,4.01%
2020-01-01 00:12:10,8,8,2142,39,2103,3.27%,1.82%
2020-01-01 00:12:10,8,9,6943,366,6577,10.59%,5.27%
2020-01-01 00:12:10,8,10,1809,23,1786,2.76%,1.27%
2020-01-01 00:12:10,8,11,181,1,180,0.28%,0.55%
2020-01-01 00:12:10,8,12,5044,220,4824,7.70%,4.36%
2020-01-01 00:12:10,9,1,503,2,501,0.77%,0.40%
2020-01-01 00:12:10,9,2,1984,30,1954,3.03%,1.51%
2020-01-01 00:12:10,9,3,1126,6,1120,1.72%,0.53%
2020-01-01 00:12:10,9,4,7882,487,7395,12.03%,6.18%
2020-01-01 00:12:10,9,5,452,0,452,0.69%,0.00%
2020-01-01 00:12:10,9,6,9270,673,8597,14.14%,7.26%
2020-01-01 00:12:10,9,7,27342,5027,22315,41.72%,18.38%
2020-01-01 00:12:10,9,8,10838,849,9989,16.54%,7.83%
2020-01-01 00:12:10,9,9,270,0,270,0.41%,0.00%
2020-01-01 00:12:10,9,10,3705,104,3601,5.65%,2.81%
2020-01-01 00:12:10,9,11,9602,680,8922,14.65%,7.08%
2020-01-01 00:12:10,9,12,5515,235,5280,8.42%,4.26%
2020-01-01 00:12:10,10,1,1431,280,1151,2.18%,19.55%
2020-01-01 00:12:10,10,2,3134,333,2801,4.78%,10.62%
2020-01-01 00:12:10,10,3,1550,10,1540,2.37%,0.64%
2020-01-01 00:12:10,10,4,4313,1051,3262,6.58%,24.36%
2020-01-01 00:12:10,10,5,766,32,734,1.17%,4.17%
2020-01-01 00:12:10,10,6,6058,1195,4863,9.24%,19.72%
2020-01-01 00:12:10,10,7,11360,2038,9322,17.33%,17.94%
2020-01-01 00:12:10,10,8,28001,7010,20991,42.73%,25.03%
2020-01-01 00:12:10,10,9,682,1,681,1.04%,0.15%
2020-01-01 00:12:10,10,10,2108,47,2061,3.22%,2.23%
2020-01-01 00:12:10,10,11,12444,1463,10981,18.99%,11.76%
2020-01-01 00:12:10,10,12,9513,1044,8469,14.52%,10.97%
2020-01-01 00:12:10,11,1,2316,39,2277,3.53%,1.68%
2020-01-01 00:12:10,11,2,3692,90,3602,5.63%,2.44%
2020-01-01 00:12:10,11,3,1224,9,1215,1.87%,0.73%
2020-01-01 00:12:10,11,4,4513,186,4327,6.89%,4.12%
2020-01-01 00:12:10,11,5,191,1,190,0.29%,0.52%
2020-01-01 00:12:10,11,6,5421,267,5154,8.27%,4.92%
2020-01-01 00:12:10,11,7,11171,931,10240,17.05%,8.33%
2020-01-01 00:12:10,11,8,25244,4421,20823,38.52%,17.51%
2020-01-01 00:12:10,11,9,165,1,164,0.25%,0.60%
2020-01-01 00:12:10,11,10,3019,58,2961,4.61%,1.92%
2020-01-01 00:12:10,11,11,10049,737,9312,15.33%,7.33%
2020-01-01 00:12:10,11,12,6574,346,6228,10.03%,5.26%
2020-01-01 00:12:10,12,1,30,0,30,0.05%,0.00%
2020-01-01 00:12:10,12,2,599,160,439,0.91%,26.67%
2020-01-01 00:12:10,12,3,2730,217,2513,4.17%,7.95%
2020-01-01 00:12:10,12,4,3135,105,3030,4.78%,3.35%
2020-01-01 00:12:10,12,5,9022,756,8266,13.77%,8.38%
2020-01-01 00:12:10,12,6,5495,242,5253,8.38%,4.40%
2020-01-01 00:12:10,12,7,2225,37,2188,3.40%,1.66%
2020-01-01 00:12:10,12,8,1458,287,1171,2.22%,19.67%
2020-01-01 00:12:10,12,9,21234,4068,17166,32.40%,19.16%
2020-01-01 00:12:10,12,10,4024,376,3648,6.14%,9.34%
2020-01-01 00:12:10,12,11,1643,289,1354,2.51%,17.58%
2020-01-01 00:12:10,12,12,7140,1126,6014,10.89%,15.77%
2020-01-01 00:12:10,13,1,1664,19,1645,2.54%,1.14%
2020-01-01 00:12:10,13,2,2003,29,1974,3.06%,1.45%
2020-01-01 00:12:10,13,3,514,4,510,0.78%,0.78%
2020-01-01 00:12:10,13,4,4819,631,4188,7.35%,13.09%
2020-01-01 00:12:10,13,5,7135,934,6201,10.89%,13.09%
2020-01-01 00:12:10,13,6,5492,683,4809,8.38%,12.43%
2020-01-01 00:12:10,13,7,4355,155,4200,6.65%,3.56%
2020-01-01 00:12:10,13,8,6117,291,5826,9.33%,4.76%
2020-01-01 00:12:10,13,9,7463,990,6473,11.39%,13.26%
2020-01-01 00:12:10,13,10,28702,6156,22546,43.80%,21.45%
2020-01-01 00:12:10,13,11,17800,2421,15379,27.16%,13.60%
2020-01-01 00:12:10,13,12,11285,1144,10141,17.22%,10.14%
2020-01-01 00:12:10,14,1,357,1,356,0.54%,0.28%
2020-01-01 00:12:10,14,2,1529,24,1505,2.33%,1.57%
2020-01-01 00:12:10,14,3,1025,11,1014,1.56%,1.07%
2020-01-01 00:12:10,14,4,5236,205,5031,7.99%,3.91%
2020-01-01 00:12:10,14,5,1138,12,1126,1.74%,1.05%
2020-01-01 00:12:10,14,6,5624,245,5379,8.58%,4.36%
2020-01-01 00:12:10,14,7,12798,1163,11635,19.53%,9.09%
2020-01-01 00:12:10,14,8,14532,1516,13016,22.17%,10.43%
2020-01-01 00:12:10,14,9,1534,21,1513,2.34%,1.37%
2020-01-01 00:12:10,14,10,4200,150,4050,6.41%,3.57%
2020-01-01 00:12:10,14,11,26471,4771,21700,40.39%,18.02%
2020-01-01 00:12:10,14,12,7442,411,7031,11.36%,5.52%
2020-01-01 00:12:10,15,1,429,2,427,0.65%,0.47%
2020-01-01 00:12:10,15,2,159,0,159,0.24%,0.00%
2020-01-01 00:12:10,15,3,5013,188,4825,7.65%,3.75%
2020-01-01 00:12:10,15,4,5981,340,5641,9.13%,5.68%
2020-01-01 00:12:10,15,5,12342,1195,11147,18.83%,9.68%
2020-01-01 00:12:10,15,6,6222,394,5828,9.49%,6.33%
2020-01-01 00:12:10,15,7,3414,91,3323,5.21%,2.66%
2020-01-01 00:12:10,15,8,5714,244,5470,8.72%,4.27%
2020-01-01 00:12:10,15,9,12590,1234,11356,19.21%,9.80%
2020-01-01 00:12:10,15,10,4251,267,3984,6.49%,6.28%
2020-01-01 00:12:10,15,11,10176,901,9275,15.53%,8.85%
2020-01-01 00:12:10,15,12,28514,5809,22705,43.51%,20.37%
2020-01-01 00:12:10,16,1,350,4,346,0.53%,1.14%
2020-01-01 00:12:10,16,2,293,2,291,0.45%,0.68%
2020-01-01 00:12:10,16,3,1368,15,1353,2.09%,1.10%
2020-01-01 00:12:10,16,4,3995,126,3869,6.10%,3.15%
2020-01-01 00:12:10,16,5,7468,464,7004,11.40%,6.21%
2020-01-01 00:12:10,16,6,4797,175,4622,7.32%,3.65%
2020-01-01 00:12:10,16,7,3641,122,3519,5.56%,3.35%
2020-01-01 00:12:10,16,8,7619,515,7104,11.63%,6.76%
2020-01-01 00:12:10,16,9,7850,502,7348,11.98%,6.39%
2020-01-01 00:12:10,16,10,1404,16,1388,2.14%,1.14%
2020-01-01 00:12:10,16,11,9211,676,8535,14.05%,7.34%
2020-01-01 00:12:10,16,12,24755,4243,20512,37.77%,17.14%
2020-01-01 00:12:20,1,1,18722,2436,16286,28.57%,13.01%
2020-01-01 00:12:20,1,2,7268,403,6865,11.09%,5.54%
2020-01-01 00:12:20,1,3,701,3,698,1.07%,0.43%
2020-01-01 00:12:20,1,4,11156,860,10296,17.02%,7.71%
2020-01-01 00:12:20,1,5,10710,805,9905,16.34%,7.52%
2020-01-01 00:12:20,1,6,10698,803,9895,16.32%,7.51%
2020-01-01 00:12:20,1,7,6554,326,6228,10.00%,4.97%
2020-01-01 00:12:20,1,8,5949,277,5672,9.08%,4.66%
2020-01-01 00:12:20,1,9,10643,795,9848,16.24%,7.47%
2020-01-01 00:12:20,1,10,5227,207,5020,7.98%,3.96%
2020-01-01 00:12:20,1,11,5285,213,5072,8.06%,4.03%
2020-01-01 00:12:20,1,12,10608,793,9815,16.19%,7.47%
2020-01-01 00:12:20,2,1,551,3,548,0.84%,0.54%
2020-01-01 00:12:20,2,2,26520,4774,21746,40.47%,18.00%
2020-01-01 00:12:20,2,3,21579,3255,18324,32.93%,15.08%
2020-01-01 00:12:20,2,4,493,3,490,0.75%,0.61%
2020-01-01 00:12:20,2,5,12785,1178,11607,19.51%,9.21%
2020-01-01 00:12:20,2,6,64,1,63,0.10%,1.54%
2020-01-01 00:12:20,2,7,4359,136,4223,6.65%,3.12%
2020-01-01 00:12:20,2,8,3240,75,3165,4.94%,2.31%
2020-01-01 00:12:20,2,9,12646,1147,11499,19.30%,9.07%
2020-01-01 00:12:20,2,10,2500,45,2455,3.81%,1.80%
2020-01-01 00:12:20,2,11,2518,46,2472,3.84%,1.83%
2020-01-01 00:12:20,2,12,12428,1109,11319,18.96%,8.92%
2020-01-01 00:12:20,3,1,2241,35,2206,3.42%,1.56%
2020-01-01 00:12:20,3,2,23135,3693,19442,35.30%,15.96%
2020-01-01 00:12:20,3,3,66540,24793,41747,101.53%,37.26%
2020-01-01 00:12:20,3,4,4979,191,4788,7.60%,3.84%
2020-01-01 00:12:20,3,5,41321,10670,30651,63.05%,25.82%
2020-01-01 00:12:20,3,6,6364,301,6063,9.71%,4.73%
2020-01-01 00:12:20,3,7,19295,2590,16705,29.44%,13.42%
2020-01-01 00:12:20,3,8,16048,1856,14192,24.49%,11.56%
2020-01-01 00:12:20,3,9,34567,7702,26865,52.75%,22.28%
2020-01-01 00:12:20,3,10,4819,170,4649,7.35%,3.53%
2020-01-01 00:12:20,3,11,2188,44,2144,3.34%,2.01%
2020-01-01 00:12:20,3,12,26896,4809,22087,41.04%,17.88%
2020-01-01 00:12:20,4,1,491,2,489,0.75%,0.41%
2020-01-01 00:12:20,4,2,267,1,266,0.41%,0.37%
2020-01-01 00:12:20,4,3,1148,8,1140,1.75%,0.70%
2020-01-01 00:12:20,4,4,28310,5191,23119,43.20%,18.34%
2020-01-01 00:12:20,4,5,17560,2097,15463,26.79%,11.94%
2020-01-01 00:12:20,4,6,23546,3711,19835,35.93%,15.76%
2020-01-01 00:12:20,4,7,4936,181,4755,7.53%,3.67%
2020-01-01 00:12:20,4,8,2651,43,2608,4.05%,1.62%
2020-01-01 00:12:20,4,9,15269,1613,13656,23.30%,10.56%
2020-01-01 00:12:20,4,10,1915,17,1898,2.92%,0.89%
2020-01-01 00:12:20,4,11,134,0,134,0.20%,0.00%
2020-01-01 00:12:20,4,12,12754,1105,11649,19.46%,8.66%
2020-01-01 00:12:20,5,1,3153,71,3082,4.81%,2.25%
2020-01-01 00:12:20,5,2,779,7,772,1.19%,0.90%
2020-01-01 00:12:20,5,3,369,0,369,0.56%,0.00%
2020-01-01 00:12:20,5,4,24649,4112,20537,37.61%,16.68%
2020-01-01 00:12:20,5,5,9294,703,8591,14.18%,7.56%
2020-01-01 00:12:20,5,6,15307,1699,13608,23.36%,11.10%
2020-01-01 00:12:20,5,7,5585,235,5350,8.52%,4.21%
2020-01-01 00:12:20,5,8,3661,105,3556,5.59%,2.87%
2020-01-01 00:12:20,5,9,8787,618,8169,13.41%,7.03%
2020-01-01 00:12:20,5,10,928,11,917,1.42%,1.18%
2020-01-01 00:12:20,5,11,1076,10,1066,1.64%,0.93%
2020-01-01 00:12:20,5,12,7101,414,6687,10.84%,5.83%
2020-01-01 00:12:20,6,1,1093,11,1082,1.67%,1.01%
2020-01-01 00:12:20,6,2,1190,12,1178,1.82%,1.01%
2020-01-01 00:12:20,6,3,1693,24,1669,2.58%,1.42%
2020-01-01 00:12:20,6,4,1395,26,1369,2.13%,1.86%
2020-01-01 00:12:20,6,5,18802,2483,16319,28.69%,13.21%
2020-01-01 00:12:20,6,6,5861,296,5565,8.94%,5.05%
2020-01-01 00:12:20,6,7,4024,138,3886,6.14%,3.43%
2020-01-01 00:12:20,6,8,3531,101,3430,5.39%,2.86%
2020-01-01 00:12:20,6,9,10779,794,9985,16.45%,7.37%
2020-01-01 00:12:20,6,10,2857,49,2808,4.36%,1.71%
2020-01-01 00:12:20,6,11,500,3,497,0.76%,0.60%
2020-01-01 00:12:20,6,12,7835,420,7415,11.96%,5.36%
2020-01-01 00:12:20,7,1,432,2,430,0.66%,0.46%
2020-01-01 00:12:20,7,2,97,0,97,0.15%,0.00%
2020-01-01 00:12:20,7,3,1417,14,1403,2.16%,0.99%
2020-01-01 00:12:20,7,4,1875,17,1858,2.86%,0.91%
2020-01-01 00:12:20,7,5,7921,469,7452,12.09%,5.92%
2020-01-01 00:12:20,7,6,12665,1124,11541,19.33%,8.87%
2020-01-01 00:12:20,7,7,2774,67,2707,4.23%,2.41%
2020-01-01 00:12:20,7,8,897,3,894,1.37%,0.33%
2020-01-01 00:12:20,7,9,6392,295,6097,9.75%,4.61%
2020-01-01 00:12:20,7,10,1740,24,1716,2.66%,1.38%
2020-01-01 00:12:20,7,11,81,0,81,0.12%,0.00%
2020-01-01 00:12:20,7,12,4628,153,4475,7.06%,3.31%
2020-01-01 00:12:20,8,1,422,0,422,0.64%,0.00%
2020-01-01 00:12:20,8,2,126,0,126,0.19%,0.00%
2020-01-01 00:12:20,8,3,2024,23,2001,3.09%,1.14%
2020-01-01 00:12:20,8,4,2771,32,2739,4.23%,1.15%
2020-01-01 00:12:20,8,5,8198,513,7685,12.51%,6.26%
2020-01-01 00:12:20,8,6,16583,1969,14614,25.30%,11.87%
2020-01-01 00:12:20,8,7,5554,242,5312,8.47%,4.36%
2020-01-01 00:12:20,8,8,2259,49,2210,3.45%,2.17%
2020-01-01 00:12:20,8,9,5948,274,5674,9.08%,4.61%
2020-01-01 00:12:20,8,10,1661,22,1639,2.53%,1.32%
2020-01-01 00:12:20,8,11,250,0,250,0.38%,0.00%
2020-01-01 00:12:20,8,12,4095,128,3967,6.25%,3.12%
2020-01-01 00:12:20,9,1,477,2,475,0.73%,0.42%
2020-01-01 00:12:20,9,2,2649,60,2589,4.04%,2.26%
2020-01-01 00:12:20,9,3,1552,23,1529,2.37%,1.48%
2020-01-01 00:12:20,9,4,9551,628,8923,14.57%,6.57%
2020-01-01 00:12:20,9,5,461,2,459,0.70%,0.43%
2020-01-01 00:12:20,9,6,10796,825,9971,16.47%,7.64%
2020-01-01 00:12:20,9,7,34508,7691,26817,52.66%,22.29%
2020-01-01 00:12:20,9,8,15088,1653,13435,23.02%,10.96%
2020-01-01 00:12:20,9,9,375,0,375,0.57%,0.00%
2020-01-01 00:12:20,9,10,6632,335,6297,10.12%,5.05%
2020-01-01 00:12:20,9,11,13277,1288,11989,20.26%,9.70%
2020-01-01 00:12:20,9,12,6302,269,6033,9.62%,4.27%
2020-01-01 00:12:20,10,1,1228,281,947,1.87%,22.86%
2020-01-01 00:12:20,10,2,4162,391,3771,6.35%,9.39%
2020-01-01 00:12:20,10,3,2751,56,2695,4.20%,2.03%
2020-01-01 00:12:20,10,4,4713,1088,3625,7.19%,23.08%
2020-01-01 00:12:20,10,5,540,3,537,0.82%,0.55%
2020-01-01 00:12:20,10,6,6576,1218,5358,10.03%,18.52%
2020-01-01 00:12:20,10,7,12748,2213,10535,19.45%,17.36%
2020-01-01 00:12:20,10,8,29001,7352,21649,44.25%,25.35%
2020-01-01 00:12:20,10,9,823,11,812,1.26%,1.33%
2020-01-01 00:12:20,10,10,2437,54,2383,3.72%,2.21%
2020-01-01 00:12:20,10,11,12139,1449,10690,18.52%,11.94%
2020-01-01 00:12:20,10,12,9057,1011,8046,13.82%,11.16%
2020-01-01 00:12:20,11,1,2288,50,2238,3.49%,2.18%
2020-01-01 00:12:20,11,2,3425,88,3337,5.23%,2.57%
2020-01-01 00:12:20,11,3,998,6,992,1.52%,0.60%
2020-01-01 00:12:20,11,4,3499,103,3396,5.34%,2.94%
2020-01-01 00:12:20,11,5,408,0,408,0.62%,0.00%
2020-01-01 00:12:20,11,6,4660,176,4484,7.11%,3.78%
2020-01-01 00:12:20,11,7,10741,817,9924,16.39%,7.61%
2020-01-01 00:12:20,11,8,23985,3839,20146,36.60%,16.01%
2020-01-01 00:12:20,11,9,170,0,170,0.26%,0.00%
2020-01-01 00:12:20,11,10,3140,78,3062,4.79%,2.48%
2020-01-01 00:12:20,11,11,9875,711,9164,15.07%,7.20%
2020-01-01 00:12:20,11,12,6489,313,6176,9.90%,4.82%
2020-01-01 00:12:20,12,1,44,0,44,0.07%,0.00%
2020-01-01 00:12:20,12,2,773,223,550,1.18%,28.81%
2020-01-01 00:12:20,12,3,3011,278,2733,4.59%,9.23%
2020-01-01 00:12:20,12,4,2557,61,2496,3.90%,2.38%
2020-01-01 00:12:20,12,5,9584,915,8669,14.62%,9.55%
2020-01-01 00:12:20,12,6,5702,276,5426,8.70%,4.84%
2020-01-01 00:12:20,12,7,3038,100,2938,4.64%,3.29%
2020-01-01 00:12:20,12,8,1362,273,1089,2.08%,20.03%
2020-01-01 00:12:20,12,9,22415,4488,17927,34.20%,20.02%
2020-01-01 00:12:20,12,10,4105,407,3698,6.26%,9.91%
2020-01-01 00:12:20,12,11,1466,273,1193,2.24%,18.61%
2020-01-01 00:12:20,12,12,7605,1098,6507,11.60%,14.44%
2020-01-01 00:12:20,13,1,2360,47,2313,3.60%,1.99%
2020-01-01 00:12:20,13,2,2669,58,2611,4.07%,2.17%
2020-01-01 00:12:20,13,3,532,4,528,0.81%,0.75%
2020-01-01 00:12:20,13,4,4476,511,3965,6.83%,11.41%
2020-01-01 00:12:20,13,5,6572,796,5776,10.03%,12.11%
2020-01-01 00:12:20,13,6,5370,570,4800,8.19%,10.61%
2020-01-01 00:12:20,13,7,5207,201,5006,7.95%,3.86%
2020-01-01 00:12:20,13,8,6914,374,6540,10.55%,5.41%
2020-01-01 00:12:20,13,9,6933,853,6080,10.58%,12.30%
2020-01-01 00:12:20,13,10,26847,5428,21419,40.97%,20.22%
2020-01-01 00:12:20,13,11,16927,2269,14658,25.83%,13.40%
2020-01-01 00:12:20,13,12,9490,916,8574,14.48%,9.65%
2020-01-01 00:12:20,14,1,359,1,358,0.55%,0.28%
2020-01-01 00:12:20,14,2,1648,20,1628,2.51%,1.21%
2020-01-01 00:12:20,14,3,1144,4,1140,1.75%,0.35%
2020-01-01 00:12:20,14,4,4107,125,3982,6.27%,3.04%
2020-01-01 00:12:20,14,5,1256,18,1238,1.92%,1.43%
2020-01-01 00:12:20,14,6,4325,139,4186,6.60%,3.21%
2020-01-01 00:12:20,14,7,11321,933,10388,17.27%,8.24%
2020-01-01 00:12:20,14,8,13440,1288,12152,20.51%,9.58%
2020-01-01 00:12:20,14,9,1562,26,1536,2.38%,1.66%
2020-01-01 00:12:20,14,10,4132,137,3995,6.30%,3.31%
2020-01-01 00:12:20,14,11,24704,4152,20552,37.70%,16.81%
2020-01-01 00:12:20,14,12,6906,320,6586,10.54%,4.63%
2020-01-01 00:12:20,15,1,539,1,538,0.82%,0.19%
2020-01-01 00:12:20,15,2,147,0,147,0.22%,0.00%
2020-01-01 00:12:20,15,3,3596,112,3484,5.49%,3.11%
2020-01-01 00:12:20,15,4,6101,301,5800,9.31%,4.93%
2020-01-01 00:12:20,15,5,11410,952,10458,17.41%,8.34%
2020-01-01 00:12:20,15,6,6332,312,6020,9.66%,4.93%
2020-01-01 00:12:20,15,7,3536,107,3429,5.40%,3.03%
2020-01-01 00:12:20,15,8,5634,259,5375,8.60%,4.60%
2020-01-01 00:12:20,15,9,11640,989,10651,17.76%,8.50%
2020-01-01 00:12:20,15,10,4670,207,4463,7.13%,4.43%
2020-01-01 00:12:20,15,11,10547,878,9669,16.09%,8.32%
2020-01-01 00:12:20,15,12,28499,5759,22740,43.49%,20.21%
2020-01-01 00:12:20,16,1,411,2,409,0.63%,0.49%
2020-01-01 00:12:20,16,2,274,4,270,0.42%,1.45%
2020-01-01 00:12:20,16,3,1248,28,1220,1.90%,2.24%
2020-01-01 00:12:20,16,4,5328,227,5101,8.13%,4.26%
2020-01-01 00:12:20,16,5,9142,673,8469,13.95%,7.36%
2020-01-01 00:12:20,16,6,6117,288,5829,9.33%,4.71%
2020-01-01 00:12:20,16,7,3859,154,3705,5.89%,3.99%
2020-01-01 00:12:20,16,8,8001,506,7495,12.21%,6.32%
2020-01-01 00:12:20,16,9,9496,722,8774,14.49%,7.60%
2020-01-01 00:12:20,16,10,1615,22,1593,2.46%,1.36%
2020-01-01 00:12:20,16,11,9769,729,9040,14.91%,7.46%
2020-01-01 00:12:20,16,12,27251,5071,22180,41.58%,18.61%
2020-01-01 00:12:30,1,1,15154,1724,13430,23.12%,11.38%
2020-01-01 00:12:30,1,2,7287,425,6862,11.12%,5.83%
2020-01-01 00:12:30,1,3,479,1,478,0.73%,0.21%
2020-01-01 00:12:30,1,4,7498,477,7021,11.44%,6.36%
2020-01-01 00:12:30,1,5,7233,446,6787,11.04%,6.17%
2020-01-01 00:12:30,1,6,7209,441,6768,11.00%,6.12%
2020-01-01 00:12:30,1,7,6778,362,6416,10.34%,5.34%
2020-01-01 00:12:30,1,8,5918,275,5643,9.03%,4.65%
2020-01-01 00:12:30,1,9,7153,435,6718,10.91%,6.08%
2020-01-01 00:12:30,1,10,5277,204,5073,8.05%,3.87%
2020-01-01 00:12:30,1,11,5353,215,5138,8.17%,4.02%
2020-01-01 00:12:30,1,12,7129,435,6694,10.88%,6.10%
2020-01-01 00:12:30,2,1,660,2,658,1.01%,0.30%
2020-01-01 00:12:30,2,2,31144,6350,24794,47.52%,20.39%
2020-01-01 00:12:30,2,3,25081,4181,20900,38.27%,16.67%
2020-01-01 00:12:30,2,4,577,2,575,0.88%,0.35%
2020-01-01 00:12:30,2,5,15643,1705,13938,23.87%,10.90%
2020-01-01 00:12:30,2,6,51,0,51,0.08%,0.00%
2020-01-01 00:12:30,2,7,5373,213,5160,8.20%,3.96%
2020-01-01 00:12:30,2,8,4132,119,4013,6.30%,2.88%
2020-01-01 00:12:30,2,9,15557,1688,13869,23.74%,10.85%
2020-01-01 00:12:30,2,10,3190,75,3115,4.87%,2.35%
2020-01-01 00:12:30,2,11,3207,75,3132,4.89%,2.34%
2020-01-01 00:12:30,2,12,15373,1650,13723,23.46%,10.73%
2020-01-01 00:12:30,3,1,1600,21,1579,2.44%,1.31%
2020-01-01 00:12:30,3,2,23163,3675,19488,35.34%,15.87%
2020-01-01 00:12:30,3,3,71448,28062,43386,109.02%,39.28%
2020-01-01 00:12:30,3,4,7772,461,7311,11.86%,5.93%
2020-01-01 00:12:30,3,5,41862,11083,30779,63.88%,26.47%
2020-01-01 00:12:30,3,6,8841,593,8248,13.49%,6.71%
2020-01-01 00:12:30,3,7,19689,2705,16984,30.04%,13.74%
2020-01-01 00:12:30,3,8,16756,1949,14807,25.57%,11.63%
2020-01-01 00:12:30,3,9,32510,7033,25477,49.61%,21.63%
2020-01-01 00:12:30,3,10,4902,198,4704,7.48%,4.04%
2020-01-01 00:12:30,3,11,2115,32,2083,3.23%,1.51%
2020-01-01 00:12:30,3,12,24386,4100,20286,37.21%,16.81%
2020-01-01 00:12:30,4,1,498,1,497,0.76%,0.20%
2020-01-01 00:12:30,4,2,339,0,339,0.52%,0.00%
2020-01-01 00:12:30,4,3,904,7,897,1.38%,0.77%
2020-01-01 00:12:30,4,4,27981,5120,22861,42.70%,18.30%
2020-01-01 00:12:30,4,5,17459,2102,15357,26.64%,12.04%
2020-01-01 00:12:30,4,6,24106,3849,20257,36.78%,15.97%
2020-01-01 00:12:30,4,7,5424,230,5194,8.28%,4.24%
2020-01-01 00:12:30,4,8,3172,91,3081,4.84%,2.87%
2020-01-01 00:12:30,4,9,15348,1646,13702,23.42%,10.72%
2020-01-01 00:12:30,4,10,2069,29,2040,3.16%,1.40%
2020-01-01 00:12:30,4,11,179,1,178,0.27%,0.56%
2020-01-01 00:12:30,4,12,12136,1055,11081,18.52%,8.69%
2020-01-01 00:12:30,5,1,3054,68,2986,4.66%,2.23%
2020-01-01 00:12:30,5,2,898,5,893,1.37%,0.56%
2020-01-01 00:12:30,5,3,438,2,436,0.67%,0.46%
2020-01-01 00:12:30,5,4,22361,3416,18945,34.12%,15.28%
2020-01-01 00:12:30,5,5,9947,720,9227,15.18%,7.24%
2020-01-01 00:12:30,5,6,15086,1610,13476,23.02%,10.67%
2020-01-01 00:12:30,5,7,4667,154,4513,7.12%,3.30%
2020-01-01 00:12:30,5,8,3186,70,3116,4.86%,2.20%
2020-01-01 00:12:30,5,9,9315,640,8675,14.21%,6.87%
2020-01-01 00:12:30,5,10,1099,8,1091,1.68%,0.73%
2020-01-01 00:12:30,5,11,832,7,825,1.27%,0.84%
2020-01-01 00:12:30,5,12,7602,450,7152,11.60%,5.92%
2020-01-01 00:12:30,6,1,982,8,974,1.50%,0.81%
2020-01-01 00:12:30,6,2,1045,9,1036,1.59%,0.86%
2020-01-01 00:12:30,6,3,1903,26,1877,2.90%,1.37%
2020-01-01 00:12:30,6,4,1732,25,1707,2.64%,1.44%
2020-01-01 00:12:30,6,5,17662,2261,15401,26.95%,12.80%
2020-01-01 00:12:30,6,6,6142,276,5866,9.37%,4.49%
2020-01-01 00:12:30,6,7,3928,114,3814,5.99%,2.90%
2020-01-01 00:12:30,6,8,3366,77,3289,5.14%,2.29%
2020-01-01 00:12:30,6,9,9314,650,8664,14.21%,6.98%
2020-01-01 00:12:30,6,10,2599,54,2545,3.97%,2.08%
2020-01-01 00:12:30,6,11,463,0,463,0.71%,0.00%
2020-01-01 00:12:30,6,12,6657,333,6324,10.16%,5.00%
2020-01-01 00:12:30,7,1,456,2,454,0.70%,0.44%
2020-01-01 00:12:30,7,2,178,0,178,0.27%,0.00%
2020-01-01 00:12:30,7,3,1215,10,1205,1.85%,0.82%
2020-01-01 00:12:30,7,4,2263,61,2202,3.45%,2.69%
2020-01-01 00:12:30,7,5,8102,500,7602,12.36%,6.17%
2020-01-01 00:12:30,7,6,13613,1410,12203,20.77%,10.36%
2020-01-01 00:12:30,7,7,3162,114,3048,4.82%,3.60%
2020-01-01 00:12:30,7,8,1210,37,1173,1.85%,3.06%
2020-01-01 00:12:30,7,9,6734,369,6365,10.28%,5.48%
2020-01-01 00:12:30,7,10,1655,18,1637,2.53%,1.09%
2020-01-01 00:12:30,7,11,97,0,97,0.15%,0.00%
2020-01-01 00:12:30,7,12,5053,238,4815,7.71%,4.71%
2020-01-01 00:12:30,8,1,515,4,511,0.79%,0.78%
2020-01-01 00:12:30,8,2,90,0,90,0.14%,0.00%
2020-01-01 00:12:30,8,3,1737,25,1712,2.65%,1.44%
2020-01-01 00:12:30,8,4,2953,65,2888,4.51%,2.20%
2020-01-01 00:12:30,8,5,8178,501,7677,12.48%,6.13%
2020-01-01 00:12:30,8,6,16509,1924,14585,25.19%,11.65%
2020-01-01 00:12:30,8,7,5253,173,5080,8.02%,3.29%
2020-01-01 00:12:30,8,8,1974,23,1951,3.01%,1.16%
2020-01-01 00:12:30,8,9,6203,285,5918,9.47%,4.59%
2020-01-01 00:12:30,8,10,1876,31,1845,2.86%,1.65%
2020-01-01 00:12:30,8,11,125,0,125,0.19%,0.00%
2020-01-01 00:12:30,8,12,4041,102,3939,6.17%,2.52%
2020-01-01 00:12:30,9,1,395,2,393,0.60%,0.51%
2020-01-01 00:12:30,9,2,2277,54,2223,3.47%,2.37%
2020-01-01 00:12:30,9,3,1134,15,1119,1.73%,1.32%
2020-01-01 00:12:30,9,4,6582,323,6259,10.04%,4.91%
2020-01-01 00:12:30,9,5,456,4,452,0.70%,0.88%
2020-01-01 00:12:30,9,6,7816,462,7354,11.93%,5.91%
2020-01-01 00:12:30,9,7,29208,5583,23625,44.57%,19.11%
2020-01-01 00:12:30,9,8,12506,1076,11430,19.08%,8.60%
2020-01-01 00:12:30,9,9,426,4,422,0.65%,0.94%
2020-01-01 00:12:30,9,10,3736,84,3652,5.70%,2.25%
2020-01-01 00:12:30,9,11,9823,657,9166,14.99%,6.69%
2020-01-01 00:12:30,9,12,5699,242,5457,8.70%,4.25%
2020-01-01 00:12:30,10,1,1283,277,1006,1.96%,21.57%
2020-01-01 00:12:30,10,2,2910,316,2594,4.44%,10.86%
2020-01-01 00:12:30,10,3,1440,21,1419,2.20%,1.46%
2020-01-01 00:12:30,10,4,4405,1123,3282,6.72%,25.49%
2020-01-01 00:12:30,10,5,579,24,555,0.88%,4.14%
2020-01-01 00:12:30,10,6,6196,1259,4937,9.45%,20.32%
2020-01-01 00:12:30,10,7,11249,2050,9199,17.16%,18.22%
2020-01-01 00:12:30,10,8,28517,7248,21269,43.51%,25.42%
2020-01-01 00:12:30,10,9,731,3,728,1.12%,0.41%
2020-01-01 00:12:30,10,10,2635,60,2575,4.02%,2.28%
2020-01-01 00:12:30,10,11,13214,1585,11629,20.16%,11.99%
2020-01-01 00:12:30,10,12,9817,1055,8762,14.98%,10.75%
2020-01-01 00:12:30,11,1,2283,37,2246,3.48%,1.62%
2020-01-01 00:12:30,11,2,3802,99,3703,5.80%,2.60%
2020-01-01 00:12:30,11,3,1355,13,1342,2.07%,0.96%
2020-01-01 00:12:30,11,4,3446,99,3347,5.26%,2.87%
2020-01-01 00:12:30,11,5,314,1,313,0.48%,0.32%
2020-01-01 00:12:30,11,6,4488,162,4326,6.85%,3.61%
2020-01-01 00:12:30,11,7,10017,709,9308,15.28%,7.08%
2020-01-01 00:12:30,11,8,23832,3803,20029,36.36%,15.96%
2020-01-01 00:12:30,11,9,232,1,231,0.35%,0.43%
2020-01-01 00:12:30,11,10,3447,124,3323,5.26%,3.60%
2020-01-01 00:12:30,11,11,10706,865,9841,16.34%,8.08%
2020-01-01 00:12:30,11,12,6860,363,6497,10.47%,5.29%
2020-01-01 00:12:30,12,1,30,0,30,0.05%,0.00%
2020-01-01 00:12:30,12,2,740,202,538,1.13%,27.26%
2020-01-01 00:12:30,12,3,2942,265,2677,4.49%,9.00%
2020-01-01 00:12:30,12,4,2726,66,2660,4.16%,2.42%
2020-01-01 00:12:30,12,5,9177,843,8334,14.00%,9.19%
2020-01-01 00:12:30,12,6,5411,226,5185,8.26%,4.18%
2020-01-01 00:12:30,12,7,2550,54,2496,3.89%,2.12%
2020-01-01 00:12:30,12,8,1340,275,1065,2.04%,20.51%
2020-01-01 00:12:30,12,9,22446,4490,17956,34.25%,20.00%
2020-01-01 00:12:30,12,10,4348,416,3932,6.63%,9.57%
2020-01-01 00:12:30,12,11,1510,278,1232,2.30%,18.40%
2020-01-01 00:12:30,12,12,8341,1155,7186,12.73%,13.85%
2020-01-01 00:12:30,13,1,2154,40,2114,3.29%,1.86%
2020-01-01 00:12:30,13,2,2592,61,2531,3.96%,2.35%
2020-01-01 00:12:30,13,3,816,3,813,1.25%,0.37%
2020-01-01 00:12:30,13,4,6015,594,5421,9.18%,9.87%
2020-01-01 00:12:30,13,5,9702,1144,8558,14.80%,11.79%
2020-01-01 00:12:30,13,6,7196,691,6505,10.98%,9.60%
2020-01-01 00:12:30,13,7,5651,246,5405,8.62%,4.35%
2020-01-01 00:12:30,13,8,7955,449,7506,12.14%,5.64%
2020-01-01 00:12:30,13,9,10176,1213,8963,15.53%,11.92%
2020-01-01 00:12:30,13,10,31436,7072,24364,47.97%,22.50%
2020-01-01 00:12:30,13,11,18074,2605,15469,27.58%,14.41%
2020-01-01 00:12:30,13,12,9422,1068,8354,14.38%,11.33%
2020-01-01 00:12:30,14,1,301,1,300,0.46%,0.33%
2020-01-01 00:12:30,14,2,1475,13,1462,2.25%,0.88%
2020-01-01 00:12:30,14,3,961,4,957,1.47%,0.42%
2020-01-01 00:12:30,14,4,3580,99,3481,5.46%,2.76%
2020-01-01 00:12:30,14,5,1152,12,1140,1.76%,1.04%
2020-01-01 00:12:30,14,6,3834,110,3724,5.85%,2.87%
2020-01-01 00:12:30,14,7,10894,923,9971,16.62%,8.47%
2020-01-01 00:12:30,14,8,12780,1222,11558,19.50%,9.56%
2020-01-01 00:12:30,14,9,1413,15,1398,2.16%,1.06%
2020-01-01 00:12:30,14,10,3750,102,3648,5.72%,2.72%
2020-01-01 00:12:30,14,11,24504,4077,20427,37.39%,16.64%
2020-01-01 00:12:30,14,12,7761,420,7341,11.84%,5.41%
2020-01-01 00:12:30,15,1,457,2,455,0.70%,0.44%
2020-01-01 00:12:30,15,2,135,1,134,0.21%,0.74%
2020-01-01 00:12:30,15,3,3873,108,3765,5.91%,2.79%
2020-01-01 00:12:30,15,4,5027,229,4798,7.67%,4.55%
2020-01-01 00:12:30,15,5,10219,803,9416,15.59%,7.86%
2020-01-01 00:12:30,15,6,5292,241,5051,8.07%,4.55%
2020-01-01 00:12:30,15,7,3746,113,3633,5.72%,3.02%
2020-01-01 00:12:30,15,8,5720,256,5464,8.73%,4.47%
2020-01-01 00:12:30,15,9,10456,845,9611,15.95%,8.08%
2020-01-01 00:12:30,15,10,4035,161,3874,6.16%,3.99%
2020-01-01 00:12:30,15,11,9871,764,9107,15.06%,7.74%
2020-01-01 00:12:30,15,12,26638,5044,21594,40.65%,18.93%
2020-01-01 00:12:30,16,1,313,4,309,0.48%,1.27%
2020-01-01 00:12:30,16,2,253,0,253,0.39%,0.00%
2020-01-01 00:12:30,16,3,1375,9,1366,2.10%,0.65%
2020-01-01 00:12:30,16,4,5997,255,5742,9.15%,4.25%
2020-01-01 00:12:30,16,5,9307,721,8586,14.20%,7.75%
2020-01-01 00:12:30,16,6,6904,351,6553,10.53%,5.08%
2020-01-01 00:12:30,16,7,3625,122,3503,5.53%,3.36%
2020-01-01 00:12:30,16,8,8316,577,7739,12.69%,6.94%
2020-01-01 00:12:30,16,9,9673,776,8897,14.76%,8.02%
2020-01-01 00:12:30,16,10,1346,10,1336,2.05%,0.74%
2020-01-01 00:12:30,16,11,9937,787,9150,15.16%,7.92%
2020-01-01 00:12:30,16,12,27548,5286,22262,42.03%,19.19%
2020-01-01 00:12:40,1,1,16106,1853,14253,24.58%,11.50%
2020-01-01 00:12:40,1,2,8678,549,8129,13.24%,6.33%
2020-01-01 00:12:40,1,3,890,8,882,1.36%,0.90%
2020-01-01 00:12:40,1,4,7026,396,6630,10.72%,5.64%
2020-01-01 00:12:40,1,5,6772,363,6409,10.33%,5.36%
2020-01-01 00:12:40,1,6,6689,353,6336,10.21%,5.28%
2020-01-01 00:12:40,1,7,7773,440,7333,11.86%,5.66%
2020-01-01 00:12:40,1,8,6542,314,6228,9.98%,4.80%
2020-01-01 00:12:40,1,9,6623,349,6274,10.11%,5.27%
2020-01-01 00:12:40,1,10,6065,264,5801,9.25%,4.35%
2020-01-01 00:12:40,1,11,6179,277,5902,9.43%,4.48%
2020-01-01 00:12:40,1,12,6588,344,6244,10.05%,5.22%
2020-01-01 00:12:40,2,1,890,3,887,1.36%,0.34%
2020-01-01 00:12:40,2,2,28657,5430,23227,43.73%,18.95%
2020-01-01 00:12:40,2,3,22771,3516,19255,34.75%,15.44%
2020-01-01 00:12:40,2,4,814,3,811,1.24%,0.37%
2020-01-01 00:12:40,2,5,16999,1978,15021,25.94%,11.64%
2020-01-01 00:12:40,2,6,352,0,352,0.54%,0.00%
2020-01-01 00:12:40,2,7,4970,215,4755,7.58%,4.33%
2020-01-01 00:12:40,2,8,3258,100,3158,4.97%,3.07%
2020-01-01 00:12:40,2,9,16919,1960,14959,25.82%,11.58%
2020-01-01 00:12:40,2,10,2333,48,2285,3.56%,2.06%
2020-01-01 00:12:40,2,11,2345,49,2296,3.58%,2.09%
2020-01-01 00:12:40,2,12,16775,1926,14849,25.60%,11.48%
2020-01-01 00:12:40,3,1,2707,54,2653,4.13%,1.99%
2020-01-01 00:12:40,3,2,23403,3653,19750,35.71%,15.61%
2020-01-01 00:12:40,3,3,67617,25375,42242,103.18%,37.53%
2020-01-01 00:12:40,3,4,8008,448,7560,12.22%,5.59%
2020-01-01 00:12:40,3,5,42267,11072,31195,64.49%,26.19%
2020-01-01 00:12:40,3,6,9080,570,8510,13.85%,6.28%
2020-01-01 00:12:40,3,7,18503,2321,16182,28.23%,12.54%
2020-01-01 00:12:40,3,8,15706,1710,13996,23.97%,10.89%
2020-01-01 00:12:40,3,9,32861,7001,25860,50.14%,21.30%
2020-01-01 00:12:40,3,10,6343,297,6046,9.68%,4.68%
2020-01-01 00:12:40,3,11,1874,26,1848,2.86%,1.39%
2020-01-01 00:12:40,3,12,22751,3616,19135,34.72%,15.89%
2020-01-01 00:12:40,4,1,561,3,558,0.86%,0.53%
2020-01-01 00:12:40,4,2,353,1,352,0.54%,0.28%
2020-01-01 00:12:40,4,3,775,4,771,1.18%,0.52%
2020-01-01 00:12:40,4,4,29610,5757,23853,45.18%,19.44%
2020-01-01 00:12:40,4,5,17578,2123,15455,26.82%,12.08%
2020-01-01 00:12:40,4,6,24895,4121,20774,37.99%,16.55%
2020-01-01 00:12:40,4,7,5820,269,5551,8.88%,4.62%
2020-01-01 00:12:40,4,8,3324,94,3230,5.07%,2.83%
2020-01-01 00:12:40,4,9,15743,1732,14011,24.02%,11.00%
2020-01-01 00:12:40,4,10,2059,37,2022,3.14%,1.80%
2020-01-01 00:12:40,4,11,212,0,212,0.32%,0.00%
2020-01-01 00:12:40,4,12,12362,1090,11272,18.86%,8.82%
2020-01-01 00:12:40,5,1,3119,71,3048,4.76%,2.28%
2020-01-01 00:12:40,5,2,1134,4,1130,1.73%,0.35%
2020-01-01 00:12:40,5,3,1636,21,1615,2.50%,1.28%
2020-01-01 00:12:40,5,4,24468,4076,20392,37.34%,16.66%
2020-01-01 00:12:40,5,5,10522,875,9647,16.06%,8.32%
2020-01-01 00:12:40,5,6,15885,1836,14049,24.24%,11.56%
2020-01-01 00:12:40,5,7,4701,170,4531,7.17%,3.62%
2020-01-01 00:12:40,5,8,3623,116,3507,5.53%,3.20%
2020-01-01 00:12:40,5,9,8763,613,8150,13.37%,6.99%
2020-01-01 00:12:40,5,10,1143,15,1128,1.74%,1.31%
2020-01-01 00:12:40,5,11,609,2,607,0.93%,0.33%
2020-01-01 00:12:40,5,12,7311,433,6878,11.16%,5.92%
2020-01-01 00:12:40,6,1,1054,9,1045,1.61%,0.85%
2020-01-01 00:12:40,6,2,1148,14,1134,1.75%,1.22%
2020-01-01 00:12:40,6,3,1830,26,1804,2.79%,1.42%
2020-01-01 00:12:40,6,4,1782,15,1767,2.72%,0.84%
2020-01-01 00:12:40,6,5,14210,1410,12800,21.68%,9.92%
2020-01-01 00:12:40,6,6,5757,233,5524,8.78%,4.05%
2020-01-01 00:12:40,6,7,3355,93,3262,5.12%,2.77%
2020-01-01 00:12:40,6,8,2744,67,2677,4.19%,2.44%
2020-01-01 00:12:40,6,9,6349,293,6056,9.69%,4.61%
2020-01-01 00:12:40,6,10,1788,21,1767,2.73%,1.17%
2020-01-01 00:12:40,6,11,350,0,350,0.53%,0.00%
2020-01-01 00:12:40,6,12,4500,150,4350,6.87%,3.33%
2020-01-01 00:12:40,7,1,599,2,597,0.91%,0.33%
2020-01-01 00:12:40,7,2,188,0,188,0.29%,0.00%
2020-01-01 00:12:40,7,3,668,6,662,1.02%,0.90%
2020-01-01 00:12:40,7,4,2805,57,2748,4.28%,2.03%
2020-01-01 00:12:40,7,5,8200,482,7718,12.51%,5.88%
2020-01-01 00:12:40,7,6,14400,1576,12824,21.97%,10.94%
2020-01-01 00:12:40,7,7,3336,96,3240,5.09%,2.88%
2020-01-01 00:12:40,7,8,1517,21,1496,2.31%,1.38%
2020-01-01 00:12:40,7,9,7213,374,6839,11.01%,5.18%
2020-01-01 00:12:40,7,10,1997,21,1976,3.05%,1.05%
2020-01-01 00:12:40,7,11,71,0,71,0.11%,0.00%
2020-01-01 00:12:40,7,12,5193,196,4997,7.92%,3.77%
2020-01-01 00:12:40,8,1,555,5,550,0.85%,0.90%
2020-01-01 00:12:40,8,2,90,0,90,0.14%,0.00%
2020-01-01 00:12:40,8,3,1623,15,1608,2.48%,0.92%
2020-01-01 00:12:40,8,4,3269,79,3190,4.99%,2.42%
2020-01-01 00:12:40,8,5,7921,454,7467,12.09%,5.73%
2020-01-01 00:12:40,8,6,17343,2137,15206,26.46%,12.32%
2020-01-01 00:12:40,8,7,5981,298,5683,9.13%,4.98%
2020-01-01 00:12:40,8,8,3048,78,2970,4.65%,2.56%
2020-01-01 00:12:40,8,9,6114,276,5838,9.33%,4.51%
2020-01-01 00:12:40,8,10,1751,37,1714,2.67%,2.11%
2020-01-01 00:12:40,8,11,124,0,124,0.19%,0.00%
2020-01-01 00:12:40,8,12,4255,127,4128,6.49%,2.98%
2020-01-01 00:12:40,9,1,343,1,342,0.52%,0.29%
2020-01-01 00:12:40,9,2,2103,48,2055,3.21%,2.28%
2020-01-01 00:12:40,9,3,1250,18,1232,1.91%,1.44%
2020-01-01 00:12:40,9,4,7320,396,6924,11.17%,5.41%
2020-01-01 00:12:40,9,5,553,4,549,0.84%,0.72%
2020-01-01 00:12:40,9,6,8878,597,8281,13.55%,6.72%
2020-01-01 00:12:40,9,7,28880,5671,23209,44.07%,19.64%
2020-01-01 00:12:40,9,8,10725,827,9898,16.37%,7.71%
2020-01-01 00:12:40,9,9,333,2,331,0.51%,0.60%
2020-01-01 00:12:40,9,10,3289,96,3193,5.02%,2.92%
2020-01-01 00:12:40,9,11,8883,583,8300,13.55%,6.56%
2020-01-01 00:12:40,9,12,5278,203,5075,8.05%,3.85%
2020-01-01 00:12:40,10,1,1383,257,1126,2.11%,18.57%
2020-01-01 00:12:40,10,2,3195,336,2859,4.88%,10.51%
2020-01-01 00:12:40,10,3,1674,43,1631,2.55%,2.57%
2020-01-01 00:12:40,10,4,3904,1119,2785,5.96%,28.66%
2020-01-01 00:12:40,10,5,816,60,756,1.25%,7.34%
2020-01-01 00:12:40,10,6,5756,1274,4482,8.78%,22.13%
2020-01-01 00:12:40,10,7,10751,1982,8769,16.40%,18.43%
2020-01-01 00:12:40,10,8,29290,7685,21605,44.69%,26.24%
2020-01-01 00:12:40,10,9,704,5,699,1.07%,0.71%
2020-01-01 00:12:40,10,10,2501,47,2454,3.82%,1.88%
2020-01-01 00:12:40,10,11,14099,1820,12279,21.51%,12.91%
2020-01-01 00:12:40,10,12,10731,1278,9453,16.37%,11.91%
2020-01-01 00:12:40,11,1,2359,45,2314,3.60%,1.91%
2020-01-01 00:12:40,11,2,4233,140,4093,6.46%,3.31%
2020-01-01 00:12:40,11,3,1726,21,1705,2.63%,1.22%
2020-01-01 00:12:40,11,4,4831,174,4657,7.37%,3.60%
2020-01-01 00:12:40,11,5,194,0,194,0.30%,0.00%
2020-01-01 00:12:40,11,6,5802,248,5554,8.85%,4.27%
2020-01-01 00:12:40,11,7,11700,987,10713,17.85%,8.44%
2020-01-01 00:12:40,11,8,25850,4506,21344,39.44%,17.43%
2020-01-01 00:12:40,11,9,253,0,253,0.39%,0.00%
2020-01-01 00:12:40,11,10,3135,85,3050,4.78%,2.71%
2020-01-01 00:12:40,11,11,10473,798,9675,15.98%,7.62%
2020-01-01 00:12:40,11,12,6950,366,6584,10.60%,5.27%
2020-01-01 00:12:40,12,1,50,0,50,0.08%,0.00%
2020-01-01 00:12:40,12,2,604,147,457,0.92%,24.30%
2020-01-01 00:12:40,12,3,2723,192,2531,4.15%,7.05%
2020-01-01 00:12:40,12,4,2702,45,2657,4.12%,1.66%
2020-01-01 00:12:40,12,5,7884,584,7300,12.03%,7.41%
2020-01-01 00:12:40,12,6,4405,140,4265,6.72%,3.18%
2020-01-01 00:12:40,12,7,1549,21,1528,2.36%,1.35%
2020-01-01 00:12:40,12,8,1466,291,1175,2.24%,19.84%
2020-01-01 00:12:40,12,9,22380,4146,18234,34.15%,18.52%
2020-01-01 00:12:40,12,10,4326,403,3923,6.60%,9.31%
2020-01-01 00:12:40,12,11,1667,295,1372,2.54%,17.69%
2020-01-01 00:12:40,12,12,9283,1141,8142,14.16%,12.29%
2020-01-01 00:12:40,13,1,2129,40,2089,3.25%,1.88%
2020-01-01 00:12:40,13,2,2394,54,2340,3.65%,2.25%
2020-01-01 00:12:40,13,3,663,3,660,1.01%,0.45%
2020-01-01 00:12:40,13,4,4744,545,4199,7.24%,11.49%
2020-01-01 00:12:40,13,5,8656,1024,7632,13.21%,11.83%
2020-01-01 00:12:40,13,6,5787,614,5173,8.83%,10.61%
2020-01-01 00:12:40,13,7,5366,209,5157,8.19%,3.89%
2020-01-01 00:12:40,13,8,8028,470,7558,12.25%,5.85%
2020-01-01 00:12:40,13,9,9099,1071,8028,13.88%,11.77%
2020-01-01 00:12:40,13,10,29191,6212,22979,44.54%,21.28%
2020-01-01 00:12:40,13,11,17070,2333,14737,26.05%,13.67%
2020-01-01 00:12:40,13,12,8558,892,7666,13.06%,10.42%
2020-01-01 00:12:40,14,1,226,0,226,0.34%,0.00%
2020-01-01 00:12:40,14,2,4494,157,4337,6.86%,3.49%
2020-01-01 00:12:40,14,3,4029,129,3900,6.15%,3.20%
2020-01-01 00:12:40,14,4,3464,93,3371,5.29%,2.68%
2020-01-01 00:12:40,14,5,1230,13,1217,1.88%,1.06%
2020-01-01 00:12:40,14,6,3779,116,3663,5.77%,3.07%
2020-01-01 00:12:40,14,7,14723,1554,13169,22.47%,10.55%
2020-01-01 00:12:40,14,8,16529,1954,14575,25.22%,11.82%
2020-01-01 00:12:40,14,9,1433,15,1418,2.19%,1.05%
2020-01-01 00:12:40,14,10,4061,120,3941,6.20%,2.95%
2020-01-01 00:12:40,14,11,31471,6441,25030,48.02%,20.47%
2020-01-01 00:12:40,14,12,10588,785,9803,16.16%,7.41%
2020-01-01 00:12:40,15,1,535,3,532,0.82%,0.56%
2020-01-01 00:12:40,15,2,94,0,94,0.14%,0.00%
2020-01-01 00:12:40,15,3,4399,141,4258,6.71%,3.20%
2020-01-01 00:12:40,15,4,4443,192,4251,6.78%,4.32%
2020-01-01 00:12:40,15,5,9829,768,9061,15.00%,7.81%
2020-01-01 00:12:40,15,6,4685,223,4462,7.15%,4.76%
2020-01-01 00:12:40,15,7,3408,88,3320,5.20%,2.58%
2020-01-01 00:12:40,15,8,5525,233,5292,8.43%,4.22%
2020-01-01 00:12:40,15,9,10053,805,9248,15.34%,8.01%
2020-01-01 00:12:40,15,10,4322,256,4066,6.59%,5.92%
2020-01-01 00:12:40,15,11,10017,856,9161,15.28%,8.54%
2020-01-01 00:12:40,15,12,25394,4802,20592,38.75%,18.91%
2020-01-01 00:12:40,16,1,371,3,368,0.57%,0.81%
2020-01-01 00:12:40,16,2,236,0,236,0.36%,0.00%
2020-01-01 00:12:40,16,3,1340,10,1330,2.04%,0.75%
2020-01-01 00:12:40,16,4,3736,99,3637,5.70%,2.65%
2020-01-01 00:12:40,16,5,6938,404,6534,10.59%,5.82%
2020-01-01 00:12:40,16,6,4476,138,4338,6.83%,3.08%
2020-01-01 00:12:40,16,7,3122,73,3049,4.76%,2.34%
2020-01-01 00:12:40,16,8,7859,508,7351,11.99%,6.46%
2020-01-01 00:12:40,16,9,7292,439,6853,11.13%,6.02%
2020-01-01 00:12:40,16,10,1650,21,1629,2.52%,1.27%
2020-01-01 00:12:40,16,11,9742,771,8971,14.87%,7.91%
2020-01-01 00:12:40,16,12,25134,4296,20838,38.35%,17.09%
2020-01-01 00:12:50,1,1,19214,2650,16564,29.32%,13.79%
2020-01-01 00:12:50,1,2,8170,514,7656,12.47%,6.29%
2020-01-01 00:12:50,1,3,487,5,482,0.74%,1.02%
2020-01-01 00:12:50,1,4,10734,891,9843,16.38%,8.30%
2020-01-01 00:12:50,1,5,10373,835,9538,15.83%,8.05%
2020-01-01 00:12:50,1,6,10364,833,9531,15.81%,8.04%
2020-01-01 00:12:50,1,7,7668,451,7217,11.70%,5.88%
2020-01-01 00:12:50,1,8,5874,266,5608,8.96%,4.53%
2020-01-01 00:12:50,1,9,10312,827,9485,15.73%,8.02%
2020-01-01 00:12:50,1,10,5335,215,5120,8.14%,4.03%
2020-01-01 00:12:50,1,11,5441,218,5223,8.30%,4.01%
2020-01-01 00:12:50,1,12,10263,815,9448,15.66%,7.94%
2020-01-01 00:12:50,2,1,1986,32,1954,3.03%,1.61%
2020-01-01 00:12:50,2,2,25840,4481,21359,39.43%,17.34%
2020-01-01 00:12:50,2,3,19094,2548,16546,29.14%,13.34%
2020-01-01 00:12:50,2,4,1888,29,1859,2.88%,1.54%
2020-01-01 00:12:50,2,5,11971,1025,10946,18.27%,8.56%
2020-01-01 00:12:50,2,6,78,0,78,0.12%,0.00%
2020-01-01 00:12:50,2,7,4731,181,4550,7.22%,3.83%
2020-01-01 00:12:50,2,8,3575,111,3464,5.46%,3.10%
2020-01-01 00:12:50,2,9,11891,1013,10878,18.14%,8.52%
2020-01-01 00:12:50,2,10,2605,68,2537,3.97%,2.61%
2020-01-01 00:12:50,2,11,2626,68,2558,4.01%,2.59%
2020-01-01 00:12:50,2,12,11761,996,10765,17.95%,8.47%
2020-01-01 00:12:50,3,1,1301,19,1282,1.99%,1.46%
2020-01-01 00:12:50,3,2,23923,3917,20006,36.50%,16.37%
2020-01-01 00:12:50,3,3,72009,28076,43933,109.88%,38.99%
2020-01-01 00:12:50,3,4,10572,837,9735,16.13%,7.92%
2020-01-01 00:12:50,3,5,47438,13587,33851,72.38%,28.64%
2020-01-01 00:12:50,3,6,11974,1035,10939,18.27%,8.64%
2020-01-01 00:12:50,3,7,20453,2884,17569,31.21%,14.10%
2020-01-01 00:12:50,3,8,17914,2225,15689,27.33%,12.42%
2020-01-01 00:12:50,3,9,35147,7947,27200,53.63%,22.61%
2020-01-01 00:12:50,3,10,5262,205,5057,8.03%,3.90%
2020-01-01 00:12:50,3,11,1682,19,1663,2.57%,1.13%
2020-01-01 00:12:50,3,12,26933,4855,22078,41.10%,18.03%
2020-01-01 00:12:50,4,1,494,2,492,0.75%,0.40%
2020-01-01 00:12:50,4,2,303,2,301,0.46%,0.66%
2020-01-01 00:12:50,4,3,900,4,896,1.37%,0.44%
2020-01-01 00:12:50,4,4,27546,5081,22465,42.03%,18.44%
2020-01-01 00:12:50,4,5,17102,2009,15093,26.10%,11.75%
2020-01-01 00:12:50,4,6,23470,3753,19717,35.81%,15.99%
2020-01-01 00:12:50,4,7,4755,161,4594,7.26%,3.39%
2020-01-01 00:12:50,4,8,2766,58,2708,4.22%,2.10%
2020-01-01 00:12:50,4,9,14764,1493,13271,22.53%,10.11%
2020-01-01 00:12:50,4,10,1976,31,1945,3.02%,1.57%
2020-01-01 00:12:50,4,11,233,0,233,0.36%,0.00%
2020-01-01 00:12:50,4,12,12231,1057,11174,18.66%,8.64%
2020-01-01 00:12:50,5,1,2699,52,2647,4.12%,1.93%
2020-01-01 00:12:50,5,2,1343,11,1332,2.05%,0.82%
2020-01-01 00:12:50,5,3,441,1,440,0.67%,0.23%
2020-01-01 00:12:50,5,4,21565,3292,18273,32.91%,15.26%
2020-01-01 00:12:50,5,5,9275,663,8612,14.15%,7.15%
2020-01-01 00:12:50,5,6,14342,1521,12821,21.88%,10.60%
2020-01-01 00:12:50,5,7,4463,173,4290,6.81%,3.88%
2020-01-01 00:12:50,5,8,3397,104,3293,5.18%,3.06%
2020-01-01 00:12:50,5,9,8648,580,8068,13.20%,6.71%
2020-01-01 00:12:50,5,10,1075,21,1054,1.64%,1.95%
2020-01-01 00:12:50,5,11,653,3,650,1.00%,0.46%
2020-01-01 00:12:50,5,12,7185,400,6785,10.96%,5.57%
2020-01-01 00:12:50,6,1,1143,8,1135,1.74%,0.70%
2020-01-01 00:12:50,6,2,1260,10,1250,1.92%,0.79%
2020-01-01 00:12:50,6,3,1963,34,1929,3.00%,1.73%
2020-01-01 00:12:50,6,4,1583,97,1486,2.42%,6.12%
2020-01-01 00:12:50,6,5,14463,1557,12906,22.07%,10.76%
2020-01-01 00:12:50,6,6,4934,299,4635,7.53%,6.06%
2020-01-01 00:12:50,6,7,3011,85,2926,4.59%,2.82%
2020-01-01 00:12:50,6,8,2502,63,2439,3.82%,2.52%
2020-01-01 00:12:50,6,9,7373,421,6952,11.25%,5.71%
2020-01-01 00:12:50,6,10,2129,39,2090,3.25%,1.83%
2020-01-01 00:12:50,6,11,368,1,367,0.56%,0.27%
2020-01-01 00:12:50,6,12,5177,184,4993,7.90%,3.55%
2020-01-01 00:12:50,7,1,375,1,374,0.57%,0.27%
2020-01-01 00:12:50,7,2,185,0,185,0.28%,0.00%
2020-01-01 00:12:50,7,3,1024,5,1019,1.56%,0.49%
2020-01-01 00:12:50,7,4,1886,29,1857,2.88%,1.54%
2020-01-01 00:12:50,7,5,6878,350,6528,10.49%,5.09%
2020-01-01 00:12:50,7,6,12678,1208,11470,19.35%,9.53%
2020-01-01 00:12:50,7,7,3829,116,3713,5.84%,3.03%
2020-01-01 00:12:50,7,8,1680,28,1652,2.56%,1.67%
2020-01-01 00:12:50,7,9,5618,241,5377,8.57%,4.29%
2020-01-01 00:12:50,7,10,1284,13,1271,1.96%,1.01%
2020-01-01 00:12:50,7,11,51,0,51,0.08%,0.00%
2020-01-01 00:12:50,7,12,4308,153,4155,6.57%,3.55%
2020-01-01 00:12:50,8,1,428,2,426,0.65%,0.47%
2020-01-01 00:12:50,8,2,69,0,69,0.11%,0.00%
2020-01-01 00:12:50,8,3,1377,17,1360,2.10%,1.23%
2020-01-01 00:12:50,8,4,2903,58,2845,4.43%,2.00%
2020-01-01 00:12:50,8,5,7587,440,7147,11.58%,5.80%
2020-01-01 00:12:50,8,6,16316,1861,14455,24.90%,11.41%
2020-01-01 00:12:50,8,7,5763,244,5519,8.79%,4.23%
2020-01-01 00:12:50,8,8,2938,72,2866,4.48%,2.45%
2020-01-01 00:12:50,8,9,5978,265,5713,9.12%,4.43%
2020-01-01 00:12:50,8,10,1712,26,1686,2.61%,1.52%
2020-01-01 00:12:50,8,11,207,1,206,0.32%,0.48%
2020-01-01 00:12:50,8,12,4110,135,3975,6.27%,3.28%
2020-01-01 00:12:50,9,1,359,2,357,0.55%,0.56%
2020-01-01 00:12:50,9,2,2086,34,2052,3.18%,1.63%
2020-01-01 00:12:50,9,3,1085,5,1080,1.66%,0.46%
2020-01-01 00:12:50,9,4,5783,245,5538,8.82%,4.24%
2020-01-01 00:12:50,9,5,933,9,924,1.42%,0.96%
2020-01-01 00:12:50,9,6,7668,451,7217,11.70%,5.88%
2020-01-01 00:12:50,9,7,31040,6240,24800,47.36%,20.10%
2020-01-01 00:12:50,9,8,13957,1364,12593,21.30%,9.77%
2020-01-01 00:12:50,9,9,513,1,512,0.78%,0.19%
2020-01-01 00:12:50,9,10,5197,171,5026,7.93%,3.29%
2020-01-01 00:12:50,9,11,11498,937,10561,17.54%,8.15%
2020-01-01 00:12:50,9,12,6007,269,5738,9.17%,4.48%
2020-01-01 00:12:50,10,1,1224,225,999,1.87%,18.37%
2020-01-01 00:12:50,10,2,3254,299,2955,4.97%,9.19%
2020-01-01 00:12:50,10,3,1901,41,1860,2.90%,2.16%
2020-01-01 00:12:50,10,4,3919,970,2949,5.98%,24.74%
2020-01-01 00:12:50,10,5,838,39,799,1.28%,4.65%
2020-01-01 00:12:50,10,6,5692,1098,4594,8.69%,19.29%
2020-01-01 00:12:50,10,7,10579,1800,8779,16.14%,17.01%
2020-01-01 00:12:50,10,8,28123,7213,20910,42.91%,25.65%
2020-01-01 00:12:50,10,9,572,2,570,0.87%,0.35%
2020-01-01 00:12:50,10,10,2160,36,2124,3.30%,1.67%
2020-01-01 00:12:50,10,11,13378,1728,11650,20.41%,12.92%
2020-01-01 00:12:50,10,12,10530,1251,9279,16.07%,11.88%
2020-01-01 00:12:50,11,1,2060,38,2022,3.14%,1.84%
2020-01-01 00:12:50,11,2,3289,84,3205,5.02%,2.55%
2020-01-01 00:12:50,11,3,1045,9,1036,1.59%,0.86%
2020-01-01 00:12:50,11,4,5162,222,4940,7.88%,4.30%
2020-01-01 00:12:50,11,5,172,0,172,0.26%,0.00%
2020-01-01 00:12:50,11,6,5895,282,5613,9.00%,4.78%
2020-01-01 00:12:50,11,7,11080,933,10147,16.91%,8.42%
2020-01-01 00:12:50,11,8,25693,4552,21141,39.20%,17.72%
2020-01-01 00:12:50,11,9,175,0,175,0.27%,0.00%
2020-01-01 00:12:50,11,10,2762,68,2694,4.21%,2.46%
2020-01-01 00:12:50,11,11,10628,820,9808,16.22%,7.71%
2020-01-01 00:12:50,11,12,7451,421,7030,11.37%,5.65%
2020-01-01 00:12:50,12,1,53,0,53,0.08%,0.00%
2020-01-01 00:12:50,12,2,442,151,291,0.67%,34.09%
2020-01-01 00:12:50,12,3,2088,180,1908,3.19%,8.62%
2020-01-01 00:12:50,12,4,2507,52,2455,3.83%,2.07%
2020-01-01 00:12:50,12,5,7130,519,6611,10.88%,7.28%
2020-01-01 00:12:50,12,6,4147,165,3982,6.33%,3.98%
2020-01-01 00:12:50,12,7,1499,12,1487,2.29%,0.80%
2020-01-01 00:12:50,12,8,1348,236,1112,2.06%,17.49%
2020-01-01 00:12:50,12,9,20576,3637,16939,31.40%,17.68%
2020-01-01 00:12:50,12,10,3883,322,3561,5.92%,8.29%
2020-01-01 00:12:50,12,11,1520,239,1281,2.32%,15.71%
2020-01-01 00:12:50,12,12,7758,920,6838,11.84%,11.86%
2020-01-01 00:12:50,13,1,1784,25,1759,2.72%,1.40%
2020-01-01 00:12:50,13,2,2069,42,2027,3.16%,2.03%
2020-01-01 00:12:50,13,3,572,1,571,0.87%,0.17%
2020-01-01 00:12:50,13,4,4282,458,3824,6.53%,10.69%
2020-01-01 00:12:50,13,5,6748,778,5970,10.30%,11.53%
2020-01-01 00:12:50,13,6,4893,512,4381,7.47%,10.46%
2020-01-01 00:12:50,13,7,4284,143,4141,6.54%,3.34%
2020-01-01 00:12:50,13,8,6610,319,6291,10.09%,4.83%
2020-01-01 00:12:50,13,9,7197,821,6376,10.98%,11.41%
2020-01-01 00:12:50,13,10,28937,6121,22816,44.15%,21.15%
2020-01-01 00:12:50,13,11,17320,2362,14958,26.43%,13.64%
2020-01-01 00:12:50,13,12,10301,1081,9220,15.72%,10.49%
2020-01-01 00:12:50,14,1,364,0,364,0.56%,0.00%
2020-01-01 00:12:50,14,2,8716,551,8165,13.30%,6.32%
2020-01-01 00:12:50,14,3,8186,494,7692,12.49%,6.03%
2020-01-01 00:12:50,14,4,3849,89,3760,5.87%,2.31%
2020-01-01 00:12:50,14,5,1469,30,1439,2.24%,2.04%
2020-01-01 00:12:50,14,6,4075,107,3968,6.22%,2.63%
2020-01-01 00:12:50,14,7,17830,2170,15660,27.21%,12.17%
2020-01-01 00:12:50,14,8,19637,2594,17043,29.96%,13.21%
2020-01-01 00:12:50,14,9,1917,37,1880,2.93%,1.93%
2020-01-01 00:12:50,14,10,4313,162,4151,6.58%,3.76%
2020-01-01 00:12:50,14,11,32149,6678,25471,49.06%,20.77%
2020-01-01 00:12:50,14,12,7813,452,7361,11.92%,5.78%
2020-01-01 00:12:50,15,1,628,5,623,0.96%,0.79%
2020-01-01 00:12:50,15,2,142,1,141,0.22%,0.70%
2020-01-01 00:12:50,15,3,6656,329,6327,10.16%,4.94%
2020-01-01 00:12:50,15,4,4740,291,4449,7.23%,6.14%
2020-01-01 00:12:50,15,5,12556,1287,11269,19.16%,10.25%
2020-01-01 00:12:50,15,6,5003,342,4661,7.63%,6.83%
2020-01-01 00:12:50,15,7,3270,76,3194,4.99%,2.32%
2020-01-01 00:12:50,15,8,5493,234,5259,8.38%,4.26%
2020-01-01 00:12:50,15,9,12731,1313,11418,19.43%,10.31%
2020-01-01 00:12:50,15,10,5455,299,5156,8.32%,5.48%
2020-01-01 00:12:50,15,11,11094,963,10131,16.93%,8.68%
2020-01-01 00:12:50,15,12,29236,6154,23082,44.61%,21.05%
2020-01-01 00:12:50,16,1,409,0,409,0.62%,0.00%
2020-01-01 00:12:50,16,2,171,0,171,0.26%,0.00%
2020-01-01 00:12:50,16,3,980,12,968,1.50%,1.22%
2020-01-01 00:12:50,16,4,4030,156,3874,6.15%,3.87%
2020-01-01 00:12:50,16,5,7313,467,6846,11.16%,6.39%
2020-01-01 00:12:50,16,6,4848,220,4628,7.40%,4.54%
2020-01-01 00:12:50,16,7,3777,92,3685,5.76%,2.44%
2020-01-01 00:12:50,16,8,7516,409,7107,11.47%,5.44%
2020-01-01 00:12:50,16,9,7821,534,7287,11.93%,6.83%
2020-01-01 00:12:50,16,10,1521,18,1503,2.32%,1.18%
2020-01-01 00:12:50,16,11,9237,594,8643,14.09%,6.43%
2020-01-01 00:12:50,16,12,24616,4155,20461,37.56%,16.88%
2020-01-01 00:13:00,1,1,18017,2286,15731,27.49%,12.69%
2020-01-01 00:13:00,1,2,8105,474,7631,12.37%,5.85%
2020-01-01 00:13:00,1,3,1417,10,1407,2.16%,0.71%
2020-01-01 00:13:00,1,4,9506,714,8792,14.51%,7.51%
2020-01-01 00:13:00,1,5,9023,644,8379,13.77%,7.14%
2020-01-01 00:13:00,1,6,8998,639,8359,13.73%,7.10%
2020-01-01 00:13:00,1,7,6674,324,6350,10.18%,4.85%
2020-01-01 00:13:00,1,8,4902,185,4717,7.48%,3.77%
2020-01-01 00:13:00,1,9,8960,637,8323,13.67%,7.11%
2020-01-01 00:13:00,1,10,4112,119,3993,6.27%,2.89%
2020-01-01 00:13:00,1,11,4215,134,4081,6.43%,3.18%
2020-01-01 00:13:00,1,12,8933,635,8298,13.63%,7.11%
2020-01-01 00:13:00,2,1,889,5,884,1.36%,0.56%
2020-01-01 00:13:00,2,2,26346,4606,21740,40.20%,17.48%
2020-01-01 00:13:00,2,3,20904,2960,17944,31.90%,14.16%
2020-01-01 00:13:00,2,4,819,4,815,1.25%,0.49%
2020-01-01 00:13:00,2,5,14446,1435,13011,22.04%,9.93%
2020-01-01 00:13:00,2,6,62,0,62,0.09%,0.00%
2020-01-01 00:13:00,2,7,4535,156,4379,6.92%,3.44%
2020-01-01 00:13:00,2,8,3459,98,3361,5.28%,2.83%
2020-01-01 00:13:00,2,9,14293,1406,12887,21.81%,9.84%
2020-01-01 00:13:00,2,10,2649,62,2587,4.04%,2.34%
2020-01-01 00:13:00,2,11,2669,64,2605,4.07%,2.40%
2020-01-01 00:13:00,2,12,14084,1365,12719,21.49%,9.69%
2020-01-01 00:13:00,3,1,1678,15,1663,2.56%,0.89%
2020-01-01 00:13:00,3,2,21764,3351,18413,33.21%,15.40%
2020-01-01 00:13:00,3,3,74525,30032,44493,113.72%,40.30%
2020-01-01 00:13:00,3,4,13849,1368,12481,21.13%,9.88%
2020-01-01 00:13:00,3,5,51101,15536,35565,77.97%,30.40%
2020-01-01 00:13:00,3,6,15002,1582,13420,22.89%,10.54%
2020-01-01 00:13:00,3,7,17992,2322,15670,27.45%,12.91%
2020-01-01 00:13:00,3,8,15266,1680,13586,23.29%,11.00%
2020-01-01 00:13:00,3,9,35517,8041,27476,54.19%,22.64%
2020-01-01 00:13:00,3,10,4796,183,4613,7.32%,3.81%
2020-01-01 00:13:00,3,11,2124,40,2084,3.24%,1.88%
2020-01-01 00:13:00,3,12,29026,5536,23490,44.29%,19.07%
2020-01-01 00:13:00,4,1,450,0,450,0.69%,0.00%
2020-01-01 00:13:00,4,2,304,0,304,0.46%,0.00%
2020-01-01 00:13:00,4,3,1861,37,1824,2.84%,1.99%
2020-01-01 00:13:00,4,4,28091,5136,22955,42.86%,18.28%
2020-01-01 00:13:00,4,5,18417,2348,16069,28.10%,12.75%
2020-01-01 00:13:00,4,6,24260,3933,20327,37.02%,16.21%
2020-01-01 00:13:00,4,7,4480,164,4316,6.84%,3.66%
2020-01-01 00:13:00,4,8,2938,64,2874,4.48%,2.18%
2020-01-01 00:13:00,4,9,15259,1632,13627,23.28%,10.69%
2020-01-01 00:13:00,4,10,1895,24,1871,2.89%,1.27%
2020-01-01 00:13:00,4,11,145,0,145,0.22%,0.00%
2020-01-01 00:13:00,4,12,12732,1163,11569,19.43%,9.13%
2020-01-01 00:13:00,5,1,2357,36,2321,3.60%,1.53%
2020-01-01 00:13:00,5,2,606,3,603,0.92%,0.49%
2020-01-01 00:13:00,5,3,489,1,488,0.75%,0.20%
2020-01-01 00:13:00,5,4,22813,3549,19264,34.81%,15.56%
2020-01-01 00:13:00,5,5,8970,594,8376,13.69%,6.62%
2020-01-01 00:13:00,5,6,15457,1715,13742,23.59%,11.09%
2020-01-01 00:13:00,5,7,5983,255,5728,9.13%,4.26%
2020-01-01 00:13:00,5,8,3142,82,3060,4.79%,2.61%
2020-01-01 00:13:00,5,9,8320,509,7811,12.70%,6.12%
2020-01-01 00:13:00,5,10,802,9,793,1.22%,1.12%
2020-01-01 00:13:00,5,11,599,3,596,0.91%,0.50%
2020-01-01 00:13:00,5,12,7213,378,6835,11.01%,5.24%
2020-01-01 00:13:00,6,1,1040,3,1037,1.59%,0.29%
2020-01-01 00:13:00,6,2,1170,6,1164,1.79%,0.51%
2020-01-01 00:13:00,6,3,2591,53,2538,3.95%,2.04%
2020-01-01 00:13:00,6,4,1561,33,1528,2.38%,2.11%
2020-01-01 00:13:00,6,5,16973,2058,14915,25.90%,12.12%
2020-01-01 00:13:00,6,6,5935,244,5691,9.06%,4.11%
2020-01-01 00:13:00,6,7,4104,98,4006,6.26%,2.39%
2020-01-01 00:13:00,6,8,3476,66,3410,5.30%,1.90%
2020-01-01 00:13:00,6,9,8245,537,7708,12.58%,6.51%
2020-01-01 00:13:00,6,10,1816,21,1795,2.77%,1.16%
2020-01-01 00:13:00,6,11,371,1,370,0.57%,0.27%
2020-01-01 00:13:00,6,12,6377,346,6031,9.73%,5.42%
2020-01-01 00:13:00,7,1,453,1,452,0.69%,0.22%
2020-01-01 00:13:00,7,2,188,0,188,0.29%,0.00%
2020-01-01 00:13:00,7,3,1653,11,1642,2.52%,0.67%
2020-01-01 00:13:00,7,4,1710,15,1695,2.61%,0.88%
2020-01-01 00:13:00,7,5,7463,421,7042,11.39%,5.64%
2020-01-01 00:13:00,7,6,12725,1133,11592,19.42%,8.90%
2020-01-01 00:13:00,7,7,3422,86,3336,5.22%,2.51%
2020-01-01 00:13:00,7,8,1260,14,1246,1.92%,1.11%
2020-01-01 00:13:00,7,9,5743,252,5491,8.76%,4.39%
2020-01-01 00:13:00,7,10,1263,7,1256,1.93%,0.55%
2020-01-01 00:13:00,7,11,71,0,71,0.11%,0.00%
2020-01-01 00:13:00,7,12,4420,164,4256,6.74%,3.71%
2020-01-01 00:13:00,8,1,435,2,433,0.66%,0.46%
2020-01-01 00:13:00,8,2,105,1,104,0.16%,0.94%
2020-01-01 00:13:00,8,3,1493,30,1463,2.28%,2.01%
2020-01-01 00:13:00,8,4,2666,52,2614,4.07%,1.95%
2020-01-01 00:13:00,8,5,7788,461,7327,11.88%,5.92%
2020-01-01 00:13:00,8,6,15189,1659,13530,23.18%,10.92%
2020-01-01 00:13:00,8,7,4651,152,4499,7.10%,3.27%
2020-01-01 00:13:00,8,8,1613,21,1592,2.46%,1.30%
2020-01-01 00:13:00,8,9,6044,260,5784,9.22%,4.30%
2020-01-01 00:13:00,8,10,1858,24,1834,2.84%,1.29%
2020-01-01 00:13:00,8,11,273,0,273,0.42%,0.00%
2020-01-01 00:13:00,8,12,4052,119,3933,6.18%,2.94%
2020-01-01 00:13:00,9,1,644,4,640,0.98%,0.62%
2020-01-01 00:13:00,9,2,3662,103,3559,5.59%,2.81%
2020-01-01 00:13:00,9,3,2550,54,2496,3.89%,2.12%
2020-01-01 00:13:00,9,4,9799,705,9094,14.95%,7.19%
2020-01-01 00:13:00,9,5,303,0,303,0.46%,0.00%
2020-01-01 00:13:00,9,6,10567,814,9753,16.12%,7.70%
2020-01-01 00:13:00,9,7,32080,6684,25396,48.95%,20.83%
2020-01-01 00:13:00,9,8,12513,1150,11363,19.09%,9.19%
2020-01-01 00:13:00,9,9,179,0,179,0.27%,0.00%
2020-01-01 00:13:00,9,10,3966,104,3862,6.05%,2.62%
2020-01-01 00:13:00,9,11,11453,955,10498,17.48%,8.34%
2020-01-01 00:13:00,9,12,7229,416,6813,11.03%,5.75%
2020-01-01 00:13:00,10,1,1220,267,953,1.86%,21.87%
2020-01-01 00:13:00,10,2,2931,315,2616,4.47%,10.74%
2020-01-01 00:13:00,10,3,1533,19,1514,2.34%,1.24%
2020-01-01 00:13:00,10,4,3937,1026,2911,6.01%,26.05%
2020-01-01 00:13:00,10,5,786,37,749,1.20%,4.70%
2020-01-01 00:13:00,10,6,5914,1190,4724,9.02%,20.12%
2020-01-01 00:13:00,10,7,10683,1917,8766,16.30%,17.94%
2020-01-01 00:13:00,10,8,26709,6660,20049,40.75%,24.93%
2020-01-01 00:13:00,10,9,535,3,532,0.82%,0.56%
2020-01-01 00:13:00,10,10,2260,45,2215,3.45%,1.99%
2020-01-01 00:13:00,10,11,12139,1412,10727,18.52%,11.63%
2020-01-01 00:13:00,10,12,9326,1009,8317,14.23%,10.82%
2020-01-01 00:13:00,11,1,2163,27,2136,3.30%,1.25%
2020-01-01 00:13:00,11,2,3811,125,3686,5.82%,3.28%
2020-01-01 00:13:00,11,3,1507,50,1457,2.30%,3.32%
2020-01-01 00:13:00,11,4,4976,186,4790,7.59%,3.74%
2020-01-01 00:13:00,11,5,267,0,267,0.41%,0.00%
2020-01-01 00:13:00,11,6,5999,284,5715,9.15%,4.73%
2020-01-01 00:13:00,11,7,11550,1003,10547,17.62%,8.68%
2020-01-01 00:13:00,11,8,27697,5197,22500,42.26%,18.76%
2020-01-01 00:13:00,11,9,268,1,267,0.41%,0.37%
2020-01-01 00:13:00,11,10,3055,55,3000,4.66%,1.80%
2020-01-01 00:13:00,11,11,12271,1071,11200,18.72%,8.73%
2020-01-01 00:13:00,11,12,8778,536,8242,13.39%,6.11%
2020-01-01 00:13:00,12,1,96,0,96,0.15%,0.00%
2020-01-01 00:13:00,12,2,623,218,405,0.95%,34.94%
2020-01-01 00:13:00,12,3,2905,271,2634,4.43%,9.33%
2020-01-01 00:13:00,12,4,2856,47,2809,4.36%,1.65%
2020-01-01 00:13:00,12,5,9080,782,8298,13.85%,8.61%
2020-01-01 00:13:00,12,6,4937,156,4781,7.53%,3.16%
2020-01-01 00:13:00,12,7,1956,26,1930,2.98%,1.33%
2020-01-01 00:13:00,12,8,1169,251,918,1.78%,21.45%
2020-01-01 00:13:00,12,9,23361,4643,18718,35.65%,19.87%
2020-01-01 00:13:00,12,10,4056,371,3685,6.19%,9.14%
2020-01-01 00:13:00,12,11,1362,254,1108,2.08%,18.64%
2020-01-01 00:13:00,12,12,8623,1151,7472,13.16%,13.35%
2020-01-01 00:13:00,13,1,2380,33,2347,3.63%,1.39%
2020-01-01 00:13:00,13,2,2670,36,2634,4.07%,1.35%
2020-01-01 00:13:00,13,3,656,1,655,1.00%,0.15%
2020-01-01 00:13:00,13,4,4623,483,4140,7.05%,10.45%
2020-01-01 00:13:00,13,5,6813,750,6063,10.40%,11.01%
2020-01-01 00:13:00,13,6,5220,518,4702,7.97%,9.92%
2020-01-01 00:13:00,13,7,5066,197,4869,7.73%,3.89%
2020-01-01 00:13:00,13,8,7214,400,6814,11.01%,5.54%
2020-01-01 00:13:00,13,9,7146,783,6363,10.90%,10.96%
2020-01-01 00:13:00,13,10,26595,5270,21325,40.58%,19.82%
2020-01-01 00:13:00,13,11,16627,2274,14353,25.37%,13.68%
2020-01-01 00:13:00,13,12,9005,916,8089,13.74%,10.17%
2020-01-01 00:13:00,14,1,463,3,460,0.71%,0.65%
2020-01-01 00:13:00,14,2,1681,23,1658,2.57%,1.37%
2020-01-01 00:13:00,14,3,1025,8,1017,1.56%,0.78%
2020-01-01 00:13:00,14,4,4134,135,3999,6.31%,3.26%
2020-01-01 00:13:00,14,5,1539,17,1522,2.35%,1.10%
2020-01-01 00:13:00,14,6,4525,163,4362,6.90%,3.60%
2020-01-01 00:13:00,14,7,11665,1052,10613,17.80%,9.02%
2020-01-01 00:13:00,14,8,13060,1287,11773,19.93%,9.85%
2020-01-01 00:13:00,14,9,1791,28,1763,2.73%,1.56%
2020-01-01 00:13:00,14,10,4527,167,4360,6.91%,3.69%
2020-01-01 00:13:00,14,11,24391,4059,20332,37.22%,16.64%
2020-01-01 00:13:00,14,12,6575,331,6244,10.03%,5.03%
2020-01-01 00:13:00,15,1,610,4,606,0.93%,0.65%
2020-01-01 00:13:00,15,2,134,0,134,0.20%,0.00%
2020-01-01 00:13:00,15,3,3804,103,3701,5.80%,2.71%
2020-01-01 00:13:00,15,4,5141,187,4954,7.84%,3.64%
2020-01-01 00:13:00,15,5,10547,764,9783,16.09%,7.24%
2020-01-01 00:13:00,15,6,5319,200,5119,8.12%,3.76%
2020-01-01 00:13:00,15,7,4073,118,3955,6.21%,2.90%
2020-01-01 00:13:00,15,8,6027,261,5766,9.20%,4.33%
2020-01-01 00:13:00,15,9,10693,773,9920,16.32%,7.23%
2020-01-01 00:13:00,15,10,5315,277,5038,8.11%,5.21%
2020-01-01 00:13:00,15,11,11470,991,10479,17.50%,8.64%
2020-01-01 00:13:00,15,12,28534,5646,22888,43.54%,19.79%
2020-01-01 00:13:00,16,1,495,1,494,0.76%,0.20%
2020-01-01 00:13:00,16,2,221,0,221,0.34%,0.00%
2020-01-01 00:13:00,16,3,1106,8,1098,1.69%,0.72%
2020-01-01 00:13:00,16,4,4978,219,4759,7.60%,4.40%
2020-01-01 00:13:00,16,5,7815,542,7273,11.92%,6.93%
2020-01-01 00:13:00,16,6,5743,277,5466,8.76%,4.82%
2020-01-01 00:13:00,16,7,4135,120,4015,6.31%,2.90%
2020-01-01 00:13:00,16,8,7676,427,7249,11.71%,5.56%
2020-01-01 00:13:00,16,9,8428,621,7807,12.86%,7.37%
2020-01-01 00:13:00,16,10,1318,13,1305,2.01%,0.99%
2020-01-01 00:13:00,16,11,9146,585,8561,13.96%,6.40%
2020-01-01 00:13:00,16,12,25955,4660,21295,39.60%,17.95%
2020-01-01 00:13:10,1,1,23568,3720,19848,35.96%,15.78%
2020-01-01 00:13:10,1,2,7927,445,7482,12.10%,5.61%
2020-01-01 00:13:10,1,3,555,6,549,0.85%,1.08%
2020-01-01 00:13:10,1,4,15139,1568,13571,23.10%,10.36%
2020-01-01 00:13:10,1,5,14811,1494,13317,22.60%,10.09%
2020-01-01 00:13:10,1,6,14770,1493,13277,22.54%,10.11%
2020-01-01 00:13:10,1,7,7353,380,6973,11.22%,5.17%
2020-01-01 00:13:10,1,8,5265,207,5058,8.03%,3.93%
2020-01-01 00:13:10,1,9,14732,1481,13251,22.48%,10.05%
2020-01-01 00:13:10,1,10,4330,152,4178,6.61%,3.51%
2020-01-01 00:13:10,1,11,4415,155,4260,6.74%,3.51%
2020-01-01 00:13:10,1,12,14700,1477,13223,22.43%,10.05%
2020-01-01 00:13:10,2,1,954,7,947,1.46%,0.73%
2020-01-01 00:13:10,2,2,26065,4535,21530,39.77%,17.40%
2020-01-01 00:13:10,2,3,21782,3244,18538,33.24%,14.89%
2020-01-01 00:13:10,2,4,752,3,749,1.15%,0.40%
2020-01-01 00:13:10,2,5,12933,1204,11729,19.73%,9.31%
2020-01-01 00:13:10,2,6,44,0,44,0.07%,0.00%
2020-01-01 00:13:10,2,7,3299,55,3244,5.03%,1.67%
2020-01-01 00:13:10,2,8,2224,23,2201,3.39%,1.03%
2020-01-01 00:13:10,2,9,12871,1191,11680,19.64%,9.25%
2020-01-01 00:13:10,2,10,1460,11,1449,2.23%,0.75%
2020-01-01 00:13:10,2,11,1487,12,1475,2.27%,0.81%
2020-01-01 00:13:10,2,12,12671,1148,11523,19.33%,9.06%
2020-01-01 00:13:10,3,1,1242,20,1222,1.90%,1.61%
2020-01-01 00:13:10,3,2,21243,3074,18169,32.41%,14.47%
2020-01-01 00:13:10,3,3,66460,24657,41803,101.41%,37.10%
2020-01-01 00:13:10,3,4,8173,458,7715,12.47%,5.60%
2020-01-01 00:13:10,3,5,43155,11540,31615,65.85%,26.74%
2020-01-01 00:13:10,3,6,9367,610,8757,14.29%,6.51%
2020-01-01 00:13:10,3,7,18014,2244,15770,27.49%,12.46%
2020-01-01 00:13:10,3,8,15440,1670,13770,23.56%,10.82%
2020-01-01 00:13:10,3,9,33142,7232,25910,50.57%,21.82%
2020-01-01 00:13:10,3,10,5840,262,5578,8.91%,4.49%
2020-01-01 00:13:10,3,11,2255,30,2225,3.44%,1.33%
2020-01-01 00:13:10,3,12,24883,4256,20627,37.97%,17.10%
2020-01-01 00:13:10,4,1,588,3,585,0.90%,0.51%
2020-01-01 00:13:10,4,2,379,2,377,0.58%,0.53%
2020-01-01 00:13:10,4,3,756,11,745,1.15%,1.45%
2020-01-01 00:13:10,4,4,27784,5167,22617,42.40%,18.60%
2020-01-01 00:13:10,4,5,16806,1959,14847,25.64%,11.66%
2020-01-01 00:13:10,4,6,23338,3686,19652,35.61%,15.79%
2020-01-01 00:13:10,4,7,5172,203,4969,7.89%,3.92%
2020-01-01 00:13:10,4,8,3091,79,3012,4.72%,2.55%
2020-01-01 00:13:10,4,9,14759,1540,13219,22.52%,10.43%
2020-01-01 00:13:10,4,10,2035,30,2005,3.11%,1.47%
2020-01-01 00:13:10,4,11,184,0,184,0.28%,0.00%
2020-01-01 00:13:10,4,12,12084,1063,11021,18.44%,8.80%
2020-01-01 00:13:10,5,1,2463,51,2412,3.76%,2.07%
2020-01-01 00:13:10,5,2,672,1,671,1.03%,0.15%
2020-01-01 00:13:10,5,3,766,1,765,1.17%,0.13%
2020-01-01 00:13:10,5,4,22307,3443,18864,34.04%,15.43%
2020-01-01 00:13:10,5,5,9350,662,8688,14.27%,7.08%
2020-01-01 00:13:10,5,6,14242,1425,12817,21.73%,10.00%
2020-01-01 00:13:10,5,7,4402,178,4224,6.72%,4.04%
2020-01-01 00:13:10,5,8,3014,90,2924,4.60%,2.99%
2020-01-01 00:13:10,5,9,8492,550,7942,12.96%,6.48%
2020-01-01 00:13:10,5,10,1089,16,1073,1.66%,1.47%
2020-01-01 00:13:10,5,11,453,3,450,0.69%,0.66%
2020-01-01 00:13:10,5,12,7135,380,6755,10.89%,5.33%
2020-01-01 00:13:10,6,1,1031,10,1021,1.57%,0.97%
2020-01-01 00:13:10,6,2,1106,13,1093,1.69%,1.17%
2020-01-01 00:13:10,6,3,1835,28,1807,2.80%,1.53%
2020-01-01 00:13:10,6,4,1181,6,1175,1.80%,0.51%
2020-01-01 00:13:10,6,5,13399,1282,12117,20.45%,9.57%
2020-01-01 00:13:10,6,6,5390,218,5172,8.22%,4.04%
2020-01-01 00:13:10,6,7,3765,103,3662,5.74%,2.73%
2020-01-01 00:13:10,6,8,2878,59,2819,4.39%,2.05%
2020-01-01 00:13:10,6,9,5984,262,5722,9.13%,4.38%
2020-01-01 00:13:10,6,10,1695,18,1677,2.59%,1.06%
2020-01-01 00:13:10,6,11,402,0,402,0.61%,0.00%
2020-01-01 00:13:10,6,12,4240,151,4089,6.47%,3.56%
2020-01-01 00:13:10,7,1,655,5,650,1.00%,0.76%
2020-01-01 00:13:10,7,2,195,0,195,0.30%,0.00%
2020-01-01 00:13:10,7,3,619,2,617,0.94%,0.32%
2020-01-01 00:13:10,7,4,2779,57,2722,4.24%,2.05%
2020-01-01 00:13:10,7,5,7247,394,6853,11.06%,5.44%
2020-01-01 00:13:10,7,6,13559,1295,12264,20.69%,9.55%
2020-01-01 00:13:10,7,7,3449,103,3346,5.26%,2.99%
2020-01-01 00:13:10,7,8,1604,22,1582,2.45%,1.37%
2020-01-01 00:13:10,7,9,6421,315,6106,9.80%,4.91%
2020-01-01 00:13:10,7,10,838,1,837,1.28%,0.12%
2020-01-01 00:13:10,7,11,139,0,139,0.21%,0.00%
2020-01-01 00:13:10,7,12,5533,251,5282,8.44%,4.54%
2020-01-01 00:13:10,8,1,738,7,731,1.13%,0.95%
2020-01-01 00:13:10,8,2,90,0,90,0.14%,0.00%
2020-01-01 00:13:10,8,3,1811,18,1793,2.76%,0.99%
2020-01-01 00:13:10,8,4,2792,52,2740,4.26%,1.86%
2020-01-01 00:13:10,8,5,9038,606,8432,13.79%,6.70%
2020-01-01 00:13:10,8,6,16963,1969,14994,25.88%,11.61%
2020-01-01 00:13:10,8,7,4962,154,4808,7.57%,3.10%
2020-01-01 00:13:10,8,8,2097,34,2063,3.20%,1.62%
2020-01-01 00:13:10,8,9,6752,346,6406,10.30%,5.12%
2020-01-01 00:13:10,8,10,1905,36,1869,2.91%,1.89%
2020-01-01 00:13:10,8,11,191,0,191,0.29%,0.00%
2020-01-01 00:13:10,8,12,4814,164,4650,7.35%,3.41%
2020-01-01 00:13:10,9,1,327,2,325,0.50%,0.61%
2020-01-01 00:13:10,9,2,1942,32,1910,2.96%,1.65%
2020-01-01 00:13:10,9,3,1223,10,1213,1.87%,0.82%
2020-01-01 00:13:10,9,4,14459,1511,12948,22.06%,10.45%
2020-01-01 00:13:10,9,5,593,0,593,0.90%,0.00%
2020-01-01 00:13:10,9,6,15684,1781,13903,23.93%,11.35%
2020-01-01 00:13:10,9,7,38820,9510,29310,59.23%,24.50%
2020-01-01 00:13:10,9,8,13872,1327,12545,21.17%,9.57%
2020-01-01 00:13:10,9,9,116,0,116,0.18%,0.00%
2020-01-01 00:13:10,9,10,5484,198,5286,8.37%,3.61%
2020-01-01 00:13:10,9,11,13042,1159,11883,19.90%,8.89%
2020-01-01 00:13:10,9,12,7149,321,6828,10.91%,4.49%
2020-01-01 00:13:10,10,1,1535,277,1258,2.34%,18.03%
2020-01-01 00:13:10,10,2,3507,348,3159,5.35%,9.92%
2020-01-01 00:13:10,10,3,1808,22,1786,2.76%,1.22%
2020-01-01 00:13:10,10,4,3741,980,2761,5.71%,26.19%
2020-01-01 00:13:10,10,5,1050,101,949,1.60%,9.61%
2020-01-01 00:13:10,10,6,6262,1222,5040,9.56%,19.51%
2020-01-01 00:13:10,10,7,11552,2074,9478,17.63%,17.95%
2020-01-01 00:13:10,10,8,29331,7518,21813,44.76%,25.63%
2020-01-01 00:13:10,10,9,487,3,484,0.74%,0.61%
2020-01-01 00:13:10,10,10,2518,49,2469,3.84%,1.95%
2020-01-01 00:13:10,10,11,13432,1556,11876,20.50%,11.58%
2020-01-01 00:13:10,10,12,10137,1049,9088,15.47%,10.35%
2020-01-01 00:13:10,11,1,2410,41,2369,3.68%,1.70%
2020-01-01 00:13:10,11,2,3366,85,3281,5.14%,2.52%
2020-01-01 00:13:10,11,3,725,3,722,1.11%,0.41%
2020-01-01 00:13:10,11,4,3466,98,3368,5.29%,2.83%
2020-01-01 00:13:10,11,5,253,1,252,0.39%,0.39%
2020-01-01 00:13:10,11,6,4434,159,4275,6.77%,3.59%
2020-01-01 00:13:10,11,7,9681,722,8959,14.77%,7.46%
2020-01-01 00:13:10,11,8,24508,4109,20399,37.40%,16.77%
2020-01-01 00:13:10,11,9,288,0,288,0.44%,0.00%
2020-01-01 00:13:10,11,10,3083,77,3006,4.70%,2.50%
2020-01-01 00:13:10,11,11,10309,740,9569,15.73%,7.18%
2020-01-01 00:13:10,11,12,6721,315,6406,10.26%,4.69%
2020-01-01 00:13:10,12,1,117,0,117,0.18%,0.00%
2020-01-01 00:13:10,12,2,597,109,488,0.91%,18.23%
2020-01-01 00:13:10,12,3,2816,182,2634,4.30%,6.46%
2020-01-01 00:13:10,12,4,2916,69,2847,4.45%,2.37%
2020-01-01 00:13:10,12,5,8940,679,8261,13.64%,7.59%
2020-01-01 00:13:10,12,6,4410,141,4269,6.73%,3.20%
2020-01-01 00:13:10,12,7,1373,11,1362,2.10%,0.80%
2020-01-01 00:13:10,12,8,1453,253,1200,2.22%,17.40%
2020-01-01 00:13:10,12,9,21165,3914,17251,32.30%,18.49%
2020-01-01 00:13:10,12,10,4665,376,4289,7.12%,8.06%
2020-01-01 00:13:10,12,11,1789,262,1527,2.73%,14.64%
2020-01-01 00:13:10,12,12,7088,1071,6017,10.82%,15.11%
2020-01-01 00:13:10,13,1,2068,35,2033,3.16%,1.69%
2020-01-01 00:13:10,13,2,2399,48,2351,3.66%,2.00%
2020-01-01 00:13:10,13,3,794,2,792,1.21%,0.25%
2020-01-01 00:13:10,13,4,5209,749,4460,7.95%,14.38%
2020-01-01 00:13:10,13,5,7510,1040,6470,11.46%,13.85%
2020-01-01 00:13:10,13,6,5768,783,4985,8.80%,13.57%
2020-01-01 00:13:10,13,7,4475,150,4325,6.83%,3.35%
2020-01-01 00:13:10,13,8,8146,502,7644,12.43%,6.16%
2020-01-01 00:13:10,13,9,7801,1070,6731,11.90%,13.71%
2020-01-01 00:13:10,13,10,29859,6453,23406,45.56%,21.61%
2020-01-01 00:13:10,13,11,19042,2741,16301,29.06%,14.39%
2020-01-01 00:13:10,13,12,10543,1057,9486,16.09%,10.02%
2020-01-01 00:13:10,14,1,309,3,306,0.47%,0.97%
2020-01-01 00:13:10,14,2,1481,16,1465,2.26%,1.08%
2020-01-01 00:13:10,14,3,942,3,939,1.44%,0.32%
2020-01-01 00:13:10,14,4,3004,66,2938,4.58%,2.20%
2020-01-01 00:13:10,14,5,1462,13,1449,2.23%,0.89%
2020-01-01 00:13:10,14,6,3318,81,3237,5.06%,2.44%
2020-01-01 00:13:10,14,7,10815,867,9948,16.50%,8.02%
2020-01-01 00:13:10,14,8,12658,1176,11482,19.31%,9.29%
2020-01-01 00:13:10,14,9,1610,14,1596,2.46%,0.87%
2020-01-01 00:13:10,14,10,4524,174,4350,6.90%,3.85%
2020-01-01 00:13:10,14,11,25562,4361,21201,39.00%,17.06%
2020-01-01 00:13:10,14,12,8036,479,7557,12.26%,5.96%
2020-01-01 00:13:10,15,1,526,1,525,0.80%,0.19%
2020-01-01 00:13:10,15,2,134,0,134,0.20%,0.00%
2020-01-01 00:13:10,15,3,4038,144,3894,6.16%,3.57%
2020-01-01 00:13:10,15,4,4438,201,4237,6.77%,4.53%
2020-01-01 00:13:10,15,5,9528,705,8823,14.54%,7.40%
2020-01-01 00:13:10,15,6,4707,224,4483,7.18%,4.76%
2020-01-01 00:13:10,15,7,3576,107,3469,5.46%,2.99%
2020-01-01 00:13:10,15,8,5457,237,5220,8.33%,4.34%
2020-01-01 00:13:10,15,9,9738,735,9003,14.86%,7.55%
2020-01-01 00:13:10,15,10,5358,479,4879,8.18%,8.94%
2020-01-01 00:13:10,15,11,10948,1121,9827,16.71%,10.24%
2020-01-01 00:13:10,15,12,26405,5235,21170,40.29%,19.83%
2020-01-01 00:13:10,16,1,323,2,321,0.49%,0.62%
2020-01-01 00:13:10,16,2,247,1,246,0.38%,0.40%
2020-01-01 00:13:10,16,3,1248,16,1232,1.90%,1.28%
2020-01-01 00:13:10,16,4,4194,114,4080,6.40%,2.72%
2020-01-01 00:13:10,16,5,7398,447,6951,11.29%,6.04%
2020-01-01 00:13:10,16,6,5088,176,4912,7.76%,3.46%
2020-01-01 00:13:10,16,7,3353,87,3266,5.12%,2.59%
2020-01-01 00:13:10,16,8,6918,382,6536,10.56%,5.52%
2020-01-01 00:13:10,16,9,7983,503,7480,12.18%,6.30%
2020-01-01 00:13:10,16,10,1632,17,1615,2.49%,1.04%
2020-01-01 00:13:10,16,11,8748,581,8167,13.35%,6.64%
2020-01-01 00:13:10,16,12,24246,3943,20303,37.00%,16.26%
2020-01-01 00:13:20,1,1,15507,1689,13818,23.66%,10.89%
2020-01-01 00:13:20,1,2,5700,234,5466,8.70%,4.10%
2020-01-01 00:13:20,1,3,317,0,317,0.48%,0.00%
2020-01-01 00:13:20,1,4,9307,621,8686,14.20%,6.67%
2020-01-01 00:13:20,1,5,9026,586,8440,13.77%,6.49%
2020-01-01 00:13:20,1,6,9001,581,8420,13.73%,6.45%
2020-01-01 00:13:20,1,7,5371,210,5161,8.20%,3.91%
2020-01-01 00:13:20,1,8,4533,140,4393,6.92%,3.09%
2020-01-01 00:13:20,1,9,8959,579,8380,13.67%,6.46%
2020-01-01 00:13:20,1,10,3803,106,3697,5.80%,2.79%
2020-01-01 00:13:20,1,11,3889,109,3780,5.93%,2.80%
2020-01-01 00:13:20,1,12,8927,578,8349,13.62%,6.47%
2020-01-01 00:13:20,2,1,786,3,783,1.20%,0.38%
2020-01-01 00:13:20,2,2,25209,4339,20870,38.47%,17.21%
2020-01-01 00:13:20,2,3,18311,2395,15916,27.94%,13.08%
2020-01-01 00:13:20,2,4,683,1,682,1.04%,0.15%
2020-01-01 00:13:20,2,5,10845,870,9975,16.55%,8.02%
2020-01-01 00:13:20,2,6,65,0,65,0.10%,0.00%
2020-01-01 00:13:20,2,7,6093,281,5812,9.30%,4.61%
2020-01-01 00:13:20,2,8,4243,151,4092,6.47%,3.56%
2020-01-01 00:13:20,2,9,10769,862,9907,16.43%,8.00%
2020-01-01 00:13:20,2,10,3338,101,3237,5.09%,3.02%
2020-01-01 00:13:20,2,11,3366,103,3263,5.14%,3.06%
2020-01-01 00:13:20,2,12,10585,830,9755,16.15%,7.84%
2020-01-01 00:13:20,3,1,1373,19,1354,2.10%,1.38%
2020-01-01 00:13:20,3,2,23162,3662,19500,35.34%,15.81%
2020-01-01 00:13:20,3,3,64220,23376,40844,97.99%,36.40%
2020-01-01 00:13:20,3,4,7257,378,6879,11.07%,5.21%
2020-01-01 00:13:20,3,5,40176,10129,30047,61.30%,25.21%
2020-01-01 00:13:20,3,6,8068,468,7600,12.31%,5.80%
2020-01-01 00:13:20,3,7,20018,2791,17227,30.55%,13.94%
2020-01-01 00:13:20,3,8,17239,2106,15133,26.30%,12.22%
2020-01-01 00:13:20,3,9,31559,6513,25046,48.16%,20.64%
2020-01-01 00:13:20,3,10,5817,238,5579,8.88%,4.09%
2020-01-01 00:13:20,3,11,2642,41,2601,4.03%,1.55%
2020-01-01 00:13:20,3,12,22217,3417,18800,33.90%,15.38%
2020-01-01 00:13:20,4,1,570,1,569,0.87%,0.18%
2020-01-01 00:13:20,4,2,364,1,363,0.56%,0.27%
2020-01-01 00:13:20,4,3,908,2,906,1.39%,0.22%
2020-01-01 00:13:20,4,4,29083,5632,23451,44.38%,19.36%
2020-01-01 00:13:20,4,5,17572,2170,15402,26.81%,12.35%
2020-01-01 00:13:20,4,6,24249,3984,20265,37.00%,16.43%
2020-01-01 00:13:20,4,7,5427,215,5212,8.28%,3.96%
2020-01-01 00:13:20,4,8,3190,75,3115,4.87%,2.35%
2020-01-01 00:13:20,4,9,15378,1678,13700,23.46%,10.91%
2020-01-01 00:13:20,4,10,2079,24,2055,3.17%,1.15%
2020-01-01 00:13:20,4,11,264,0,264,0.40%,0.00%
2020-01-01 00:13:20,4,12,12611,1148,11463,19.24%,9.10%
2020-01-01 00:13:20,5,1,2986,69,2917,4.56%,2.31%
2020-01-01 00:13:20,5,2,816,4,812,1.25%,0.49%
2020-01-01 00:13:20,5,3,512,3,509,0.78%,0.58%
2020-01-01 00:13:20,5,4,28682,5513,23169,43.77%,19.22%
2020-01-01 00:13:20,5,5,9603,725,8878,14.65%,7.55%
2020-01-01 00:13:20,5,6,14363,1576,12787,21.92%,10.97%
2020-01-01 00:13:20,5,7,4110,168,3942,6.27%,4.09%
2020-01-01 00:13:20,5,8,3142,111,3031,4.79%,3.53%
2020-01-01 00:13:20,5,9,8912,632,8280,13.60%,7.09%
2020-01-01 00:13:20,5,10,1607,17,1590,2.45%,1.06%
2020-01-01 00:13:20,5,11,483,3,480,0.74%,0.62%
2020-01-01 00:13:20,5,12,7161,416,6745,10.93%,5.81%
2020-01-01 00:13:20,6,1,1154,21,1133,1.76%,1.82%
2020-01-01 00:13:20,6,2,1243,22,1221,1.90%,1.77%
2020-01-01 00:13:20,6,3,1985,36,1949,3.03%,1.81%
2020-01-01 00:13:20,6,4,1900,27,1873,2.90%,1.42%
2020-01-01 00:13:20,6,5,16299,1902,14397,24.87%,11.67%
2020-01-01 00:13:20,6,6,6772,369,6403,10.33%,5.45%
2020-01-01 00:13:20,6,7,4350,143,4207,6.64%,3.29%
2020-01-01 00:13:20,6,8,3669,104,3565,5.60%,2.83%
2020-01-01 00:13:20,6,9,7242,343,6899,11.05%,4.74%
2020-01-01 00:13:20,6,10,2114,32,2082,3.23%,1.51%
2020-01-01 00:13:20,6,11,448,2,446,0.68%,0.45%
2020-01-01 00:13:20,6,12,5080,163,4917,7.75%,3.21%
2020-01-01 00:13:20,7,1,432,4,428,0.66%,0.92%
2020-01-01 00:13:20,7,2,197,0,197,0.30%,0.00%
2020-01-01 00:13:20,7,3,640,4,636,0.98%,0.62%
2020-01-01 00:13:20,7,4,2314,44,2270,3.53%,1.90%
2020-01-01 00:13:20,7,5,7578,435,7143,11.56%,5.74%
2020-01-01 00:13:20,7,6,13979,1417,12562,21.33%,10.14%
2020-01-01 00:13:20,7,7,4005,135,3870,6.11%,3.37%
2020-01-01 00:13:20,7,8,1983,41,1942,3.03%,2.07%
2020-01-01 00:13:20,7,9,5554,241,5313,8.47%,4.34%
2020-01-01 00:13:20,7,10,742,3,739,1.13%,0.40%
2020-01-01 00:13:20,7,11,241,1,240,0.37%,0.41%
2020-01-01 00:13:20,7,12,4796,188,4608,7.32%,3.92%
2020-01-01 00:13:20,8,1,532,0,532,0.81%,0.00%
2020-01-01 00:13:20,8,2,81,0,81,0.12%,0.00%
2020-01-01 00:13:20,8,3,1921,19,1902,2.93%,0.99%
2020-01-01 00:13:20,8,4,2981,69,2912,4.55%,2.31%
2020-01-01 00:13:20,8,5,9087,589,8498,13.87%,6.48%
2020-01-01 00:13:20,8,6,17305,2124,15181,26.41%,12.27%
2020-01-01 00:13:20,8,7,5100,185,4915,7.78%,3.63%
2020-01-01 00:13:20,8,8,2249,39,2210,3.43%,1.73%
2020-01-01 00:13:20,8,9,6949,340,6609,10.60%,4.89%
2020-01-01 00:13:20,8,10,2034,25,2009,3.10%,1.23%
2020-01-01 00:13:20,8,11,117,0,117,0.18%,0.00%
2020-01-01 00:13:20,8,12,4872,183,4689,7.43%,3.76%
2020-01-01 00:13:20,9,1,489,3,486,0.75%,0.61%
2020-01-01 00:13:20,9,2,1861,23,1838,2.84%,1.24%
2020-01-01 00:13:20,9,3,1071,9,1062,1.63%,0.84%
2020-01-01 00:13:20,9,4,7159,391,6768,10.92%,5.46%
2020-01-01 00:13:20,9,5,580,2,578,0.89%,0.34%
2020-01-01 00:13:20,9,6,8701,570,8131,13.28%,6.55%
2020-01-01 00:13:20,9,7,27767,5096,22671,42.37%,18.35%
2020-01-01 00:13:20,9,8,9965,683,9282,15.21%,6.85%
2020-01-01 00:13:20,9,9,245,0,245,0.37%,0.00%
2020-01-01 00:13:20,9,10,3530,98,3432,5.39%,2.78%
2020-01-01 00:13:20,9,11,9270,586,8684,14.14%,6.32%
2020-01-01 00:13:20,9,12,5355,221,5134,8.17%,4.13%
2020-01-01 00:13:20,10,1,1674,296,1378,2.55%,17.67%
2020-01-01 00:13:20,10,2,4920,440,4480,7.51%,8.94%
2020-01-01 00:13:20,10,3,3086,75,3011,4.71%,2.43%
2020-01-01 00:13:20,10,4,3766,1018,2748,5.75%,27.02%
2020-01-01 00:13:20,10,5,908,75,833,1.39%,8.25%
2020-01-01 00:13:20,10,6,6006,1212,4794,9.16%,20.18%
2020-01-01 00:13:20,10,7,12505,2232,10273,19.08%,17.85%
2020-01-01 00:13:20,10,8,32674,8758,23916,49.86%,26.80%
2020-01-01 00:13:20,10,9,537,1,536,0.82%,0.19%
2020-01-01 00:13:20,10,10,3063,68,2995,4.67%,2.22%
2020-01-01 00:13:20,10,11,15459,2101,13358,23.59%,13.59%
2020-01-01 00:13:20,10,12,11713,1417,10296,17.87%,12.10%
2020-01-01 00:13:20,11,1,2548,55,2493,3.89%,2.16%
2020-01-01 00:13:20,11,2,3605,113,3492,5.50%,3.13%
2020-01-01 00:13:20,11,3,868,6,862,1.32%,0.69%
2020-01-01 00:13:20,11,4,6216,307,5909,9.48%,4.94%
2020-01-01 00:13:20,11,5,279,0,279,0.43%,0.00%
2020-01-01 00:13:20,11,6,7217,411,6806,11.01%,5.69%
2020-01-01 00:13:20,11,7,12524,1136,11388,19.11%,9.07%
2020-01-01 00:13:20,11,8,27344,5010,22334,41.72%,18.32%
2020-01-01 00:13:20,11,9,299,1,298,0.46%,0.33%
2020-01-01 00:13:20,11,10,3390,96,3294,5.17%,2.83%
2020-01-01 00:13:20,11,11,10300,766,9534,15.72%,7.44%
2020-01-01 00:13:20,11,12,6495,313,6182,9.91%,4.82%
2020-01-01 00:13:20,12,1,36,0,36,0.05%,0.00%
2020-01-01 00:13:20,12,2,499,126,373,0.76%,25.20%
2020-01-01 00:13:20,12,3,2973,190,2783,4.54%,6.39%
2020-01-01 00:13:20,12,4,2977,66,2911,4.54%,2.22%
2020-01-01 00:13:20,12,5,8149,605,7544,12.43%,7.42%
2020-01-01 00:13:20,12,6,4427,156,4271,6.76%,3.52%
2020-01-01 00:13:20,12,7,1336,12,1324,2.04%,0.90%
2020-01-01 00:13:20,12,8,1643,349,1294,2.51%,21.23%
2020-01-01 00:13:20,12,9,21503,4204,17299,32.81%,19.55%
2020-01-01 00:13:20,12,10,4977,471,4506,7.59%,9.46%
2020-01-01 00:13:20,12,11,1935,353,1582,2.95%,18.23%
2020-01-01 00:13:20,12,12,7751,1371,6380,11.83%,17.69%
2020-01-01 00:13:20,13,1,1864,25,1839,2.84%,1.34%
2020-01-01 00:13:20,13,2,2310,35,2275,3.52%,1.51%
2020-01-01 00:13:20,13,3,712,5,707,1.09%,0.70%
2020-01-01 00:13:20,13,4,4825,798,4027,7.36%,16.54%
2020-01-01 00:13:20,13,5,7156,1118,6038,10.92%,15.62%
2020-01-01 00:13:20,13,6,5417,827,4590,8.27%,15.26%
2020-01-01 00:13:20,13,7,4207,127,4080,6.42%,3.02%
2020-01-01 00:13:20,13,8,7655,419,7236,11.68%,5.47%
2020-01-01 00:13:20,13,9,7509,1148,6361,11.46%,15.29%
2020-01-01 00:13:20,13,10,30296,6608,23688,46.23%,21.81%
2020-01-01 00:13:20,13,11,18688,2546,16142,28.52%,13.62%
2020-01-01 00:13:20,13,12,10612,1015,9597,16.19%,9.56%
2020-01-01 00:13:20,14,1,235,1,234,0.36%,0.42%
2020-01-01 00:13:20,14,2,1173,13,1160,1.79%,1.11%
2020-01-01 00:13:20,14,3,728,1,727,1.11%,0.14%
2020-01-01 00:13:20,14,4,3275,89,3186,5.00%,2.72%
2020-01-01 00:13:20,14,5,1277,14,1263,1.95%,1.10%
2020-01-01 00:13:20,14,6,3694,111,3583,5.64%,3.00%
2020-01-01 00:13:20,14,7,11247,991,10256,17.16%,8.81%
2020-01-01 00:13:20,14,8,12951,1255,11696,19.76%,9.69%
2020-01-01 00:13:20,14,9,1493,19,1474,2.28%,1.27%
2020-01-01 00:13:20,14,10,4201,151,4050,6.41%,3.59%
2020-01-01 00:13:20,14,11,27342,5033,22309,41.72%,18.41%
2020-01-01 00:13:20,14,12,9733,679,9054,14.85%,6.98%
2020-01-01 00:13:20,15,1,508,1,507,0.78%,0.20%
2020-01-01 00:13:20,15,2,127,0,127,0.19%,0.00%
2020-01-01 00:13:20,15,3,4264,165,4099,6.51%,3.87%
2020-01-01 00:13:20,15,4,4737,220,4517,7.23%,4.64%
2020-01-01 00:13:20,15,5,9971,802,9169,15.21%,8.04%
2020-01-01 00:13:20,15,6,5103,279,4824,7.79%,5.47%
2020-01-01 00:13:20,15,7,3430,89,3341,5.23%,2.59%
2020-01-01 00:13:20,15,8,5780,238,5542,8.82%,4.12%
2020-01-01 00:13:20,15,9,10169,825,9344,15.52%,8.11%
2020-01-01 00:13:20,15,10,6155,568,5587,9.39%,9.23%
2020-01-01 00:13:20,15,11,12153,1309,10844,18.54%,10.77%
2020-01-01 00:13:20,15,12,27892,5704,22188,42.56%,20.45%
2020-01-01 00:13:20,16,1,503,1,502,0.77%,0.20%
2020-01-01 00:13:20,16,2,296,0,296,0.45%,0.00%
2020-01-01 00:13:20,16,3,1359,11,1348,2.07%,0.81%
2020-01-01 00:13:20,16,4,3722,108,3614,5.68%,2.90%
2020-01-01 00:13:20,16,5,7227,431,6796,11.03%,5.96%
2020-01-01 00:13:20,16,6,4711,190,4521,7.19%,4.03%
2020-01-01 00:13:20,16,7,3193,93,3100,4.87%,2.91%
2020-01-01 00:13:20,16,8,7525,531,6994,11.48%,7.06%
2020-01-01 00:13:20,16,9,7688,490,7198,11.73%,6.37%
2020-01-01 00:13:20,16,10,1952,25,1927,2.98%,1.28%
2020-01-01 00:13:20,16,11,9637,794,8843,14.70%,8.24%
2020-01-01 00:13:20,16,12,24899,4284,20615,37.99%,17.20%
2020-01-01 00:13:30,1,1,18337,2375,15962,27.98%,12.95%
2020-01-01 00:13:30,1,2,8276,529,7747,12.63%,6.39%
2020-01-01 00:13:30,1,3,776,3,773,1.18%,0.39%
2020-01-01 00:13:30,1,4,9692,727,8965,14.79%,7.50%
2020-01-01 00:13:30,1,5,9347,669,8678,14.26%,7.16%
2020-01-01 00:13:30,1,6,9290,666,8624,14.18%,7.17%
2020-01-01 00:13:30,1,7,7495,419,7076,11.44%,5.59%
2020-01-01 00:13:30,1,8,5911,254,5657,9.02%,4.30%
2020-01-01 00:13:30,1,9,9205,654,8551,14.05%,7.10%
2020-01-01 00:13:30,1,10,4936,176,4760,7.53%,3.56%
2020-01-01 00:13:30,1,11,5071,187,4884,7.74%,3.69%
2020-01-01 00:13:30,1,12,9161,646,8515,13.98%,7.05%
2020-01-01 00:13:30,2,1,656,2,654,1.00%,0.30%
2020-01-01 00:13:30,2,2,24391,4036,20355,37.22%,16.55%
2020-01-01 00:13:30,2,3,19782,2735,17047,30.18%,13.83%
2020-01-01 00:13:30,2,4,601,1,600,0.92%,0.17%
2020-01-01 00:13:30,2,5,11103,948,10155,16.94%,8.54%
2020-01-01 00:13:30,2,6,44,0,44,0.07%,0.00%
2020-01-01 00:13:30,2,7,3940,103,3837,6.01%,2.61%
2020-01-01 00:13:30,2,8,2920,62,2858,4.46%,2.12%
2020-01-01 00:13:30,2,9,10980,931,10049,16.75%,8.48%
2020-01-01 00:13:30,2,10,1985,27,1958,3.03%,1.36%
2020-01-01 00:13:30,2,11,2036,28,2008,3.11%,1.37%
2020-01-01 00:13:30,2,12,10783,895,9888,16.45%,8.30%
2020-01-01 00:13:30,3,1,1641,21,1620,2.50%,1.28%
2020-01-01 00:13:30,3,2,25510,4397,21113,38.93%,17.24%
2020-01-01 00:13:30,3,3,71128,27718,43410,108.53%,38.97%
2020-01-01 00:13:30,3,4,9811,700,9111,14.97%,7.13%
2020-01-01 00:13:30,3,5,44286,11977,32309,67.58%,27.04%
2020-01-01 00:13:30,3,6,11893,1009,10884,18.15%,8.48%
2020-01-01 00:13:30,3,7,22139,3346,18793,33.78%,15.11%
2020-01-01 00:13:30,3,8,17723,2202,15521,27.04%,12.42%
2020-01-01 00:13:30,3,9,32098,6657,25441,48.98%,20.74%
2020-01-01 00:13:30,3,10,7860,418,7442,11.99%,5.32%
2020-01-01 00:13:30,3,11,2135,38,2097,3.26%,1.78%
2020-01-01 00:13:30,3,12,21390,3127,18263,32.64%,14.62%
2020-01-01 00:13:30,4,1,665,2,663,1.01%,0.30%
2020-01-01 00:13:30,4,2,435,1,434,0.66%,0.23%
2020-01-01 00:13:30,4,3,918,10,908,1.40%,1.09%
2020-01-01 00:13:30,4,4,27636,5098,22538,42.17%,18.45%
2020-01-01 00:13:30,4,5,16856,2016,14840,25.72%,11.96%
2020-01-01 00:13:30,4,6,23731,3845,19886,36.21%,16.20%
2020-01-01 00:13:30,4,7,5572,267,5305,8.50%,4.79%
2020-01-01 00:13:30,4,8,3371,103,3268,5.14%,3.05%
2020-01-01 00:13:30,4,9,14739,1575,13164,22.49%,10.69%
2020-01-01 00:13:30,4,10,1876,19,1857,2.86%,1.01%
2020-01-01 00:13:30,4,11,228,0,228,0.35%,0.00%
2020-01-01 00:13:30,4,12,12005,1059,10946,18.32%,8.82%
2020-01-01 00:13:30,5,1,2965,63,2902,4.52%,2.12%
2020-01-01 00:13:30,5,2,735,3,732,1.12%,0.41%
2020-01-01 00:13:30,5,3,1182,16,1166,1.80%,1.35%
2020-01-01 00:13:30,5,4,24475,4025,20450,37.35%,16.44%
2020-01-01 00:13:30,5,5,9264,644,8620,14.14%,6.95%
2020-01-01 00:13:30,5,6,14236,1467,12769,21.72%,10.30%
2020-01-01 00:13:30,5,7,4615,182,4433,7.04%,3.94%
2020-01-01 00:13:30,5,8,3205,86,3119,4.89%,2.68%
2020-01-01 00:13:30,5,9,7941,464,7477,12.12%,5.84%
2020-01-01 00:13:30,5,10,888,8,880,1.35%,0.90%
2020-01-01 00:13:30,5,11,570,4,566,0.87%,0.70%
2020-01-01 00:13:30,5,12,6716,333,6383,10.25%,4.96%
2020-01-01 00:13:30,6,1,1062,6,1056,1.62%,0.56%
2020-01-01 00:13:30,6,2,1315,13,1302,2.01%,0.99%
2020-01-01 00:13:30,6,3,1812,23,1789,2.76%,1.27%
2020-01-01 00:13:30,6,4,1464,6,1458,2.23%,0.41%
2020-01-01 00:13:30,6,5,14521,1480,13041,22.16%,10.19%
2020-01-01 00:13:30,6,6,6001,275,5726,9.16%,4.58%
2020-01-01 00:13:30,6,7,3960,118,3842,6.04%,2.98%
2020-01-01 00:13:30,6,8,2996,77,2919,4.57%,2.57%
2020-01-01 00:13:30,6,9,6392,281,6111,9.75%,4.40%
2020-01-01 00:13:30,6,10,1788,20,1768,2.73%,1.12%
2020-01-01 00:13:30,6,11,422,2,420,0.64%,0.47%
2020-01-01 00:13:30,6,12,4538,142,4396,6.92%,3.13%
2020-01-01 00:13:30,7,1,353,0,353,0.54%,0.00%
2020-01-01 00:13:30,7,2,213,1,212,0.33%,0.47%
2020-01-01 00:13:30,7,3,849,4,845,1.30%,0.47%
2020-01-01 00:13:30,7,4,2369,39,2330,3.61%,1.65%
2020-01-01 00:13:30,7,5,7437,438,6999,11.35%,5.89%
2020-01-01 00:13:30,7,6,13375,1425,11950,20.41%,10.65%
2020-01-01 00:13:30,7,7,3504,99,3405,5.35%,2.82%
2020-01-01 00:13:30,7,8,1699,45,1654,2.59%,2.65%
2020-01-01 00:13:30,7,9,6192,297,5895,9.45%,4.80%
2020-01-01 00:13:30,7,10,932,7,925,1.42%,0.75%
2020-01-01 00:13:30,7,11,72,0,72,0.11%,0.00%
2020-01-01 00:13:30,7,12,5241,216,5025,8.00%,4.12%
2020-01-01 00:13:30,8,1,491,2,489,0.75%,0.41%
2020-01-01 00:13:30,8,2,79,0,79,0.12%,0.00%
2020-01-01 00:13:30,8,3,2506,54,2452,3.82%,2.15%
2020-01-01 00:13:30,8,4,2922,76,2846,4.46%,2.60%
2020-01-01 00:13:30,8,5,8997,652,8345,13.73%,7.25%
2020-01-01 00:13:30,8,6,17045,2131,14914,26.01%,12.50%
2020-01-01 00:13:30,8,7,4999,169,4830,7.63%,3.38%
2020-01-01 00:13:30,8,8,2071,28,2043,3.16%,1.35%
2020-01-01 00:13:30,8,9,6278,292,5986,9.58%,4.65%
2020-01-01 00:13:30,8,10,2014,31,1983,3.07%,1.54%
2020-01-01 00:13:30,8,11,115,0,115,0.18%,0.00%
2020-01-01 00:13:30,8,12,4183,141,4042,6.38%,3.37%
2020-01-01 00:13:30,9,1,495,1,494,0.76%,0.20%
2020-01-01 00:13:30,9,2,2421,37,2384,3.69%,1.53%
2020-01-01 00:13:30,9,3,1498,11,1487,2.29%,0.73%
2020-01-01 00:13:30,9,4,9064,653,8411,13.83%,7.20%
2020-01-01 00:13:30,9,5,182,1,181,0.28%,0.55%
2020-01-01 00:13:30,9,6,9718,745,8973,14.83%,7.67%
2020-01-01 00:13:30,9,7,30636,6200,24436,46.75%,20.24%
2020-01-01 00:13:30,9,8,9950,714,9236,15.18%,7.18%
2020-01-01 00:13:30,9,9,149,1,148,0.23%,0.67%
2020-01-01 00:13:30,9,10,3241,84,3157,4.95%,2.59%
2020-01-01 00:13:30,9,11,8544,526,8018,13.04%,6.16%
2020-01-01 00:13:30,9,12,4922,193,4729,7.51%,3.92%
2020-01-01 00:13:30,10,1,1538,295,1243,2.35%,19.17%
2020-01-01 00:13:30,10,2,2907,330,2577,4.44%,11.35%
2020-01-01 00:13:30,10,3,1207,11,1196,1.84%,0.91%
2020-01-01 00:13:30,10,4,3780,989,2791,5.77%,26.16%
2020-01-01 00:13:30,10,5,750,100,650,1.14%,13.32%
2020-01-01 00:13:30,10,6,5853,1200,4653,8.93%,20.50%
2020-01-01 00:13:30,10,7,10575,1906,8669,16.14%,18.02%
2020-01-01 00:13:30,10,8,30472,7900,22572,46.50%,25.92%
2020-01-01 00:13:30,10,9,579,5,574,0.88%,0.86%
2020-01-01 00:13:30,10,10,3053,76,2977,4.66%,2.49%
2020-01-01 00:13:30,10,11,15280,2088,13192,23.32%,13.66%
2020-01-01 00:13:30,10,12,11536,1405,10131,17.60%,12.18%
2020-01-01 00:13:30,11,1,2453,59,2394,3.74%,2.40%
2020-01-01 00:13:30,11,2,3457,115,3342,5.27%,3.33%
2020-01-01 00:13:30,11,3,778,13,765,1.19%,1.67%
2020-01-01 00:13:30,11,4,5267,216,5051,8.04%,4.10%
2020-01-01 00:13:30,11,5,172,1,171,0.26%,0.58%
2020-01-01 00:13:30,11,6,6182,301,5881,9.43%,4.87%
2020-01-01 00:13:30,11,7,11464,994,10470,17.49%,8.67%
2020-01-01 00:13:30,11,8,24771,4126,20645,37.80%,16.66%
2020-01-01 00:13:30,11,9,213,0,213,0.33%,0.00%
2020-01-01 00:13:30,11,10,3154,72,3082,4.81%,2.28%
2020-01-01 00:13:30,11,11,9995,796,9199,15.25%,7.96%
2020-01-01 00:13:30,11,12,6525,338,6187,9.96%,5.18%
2020-01-01 00:13:30,12,1,28,0,28,0.04%,0.00%
2020-01-01 00:13:30,12,2,625,172,453,0.95%,27.48%
2020-01-01 00:13:30,12,3,2413,207,2206,3.68%,8.57%
2020-01-01 00:13:30,12,4,2974,128,2846,4.54%,4.30%
2020-01-01 00:13:30,12,5,7983,744,7239,12.18%,9.32%
2020-01-01 00:13:30,12,6,4847,273,4574,7.40%,5.63%
2020-01-01 00:13:30,12,7,1764,26,1738,2.69%,1.47%
2020-01-01 00:13:30,12,8,1527,356,1171,2.33%,23.30%
2020-01-01 00:13:30,12,9,20455,4036,16419,31.21%,19.73%
2020-01-01 00:13:30,12,10,4739,502,4237,7.23%,10.59%
2020-01-01 00:13:30,12,11,1757,356,1401,2.68%,20.25%
2020-01-01 00:13:30,12,12,7137,1183,5954,10.89%,16.57%
2020-01-01 00:13:30,13,1,1927,25,1902,2.94%,1.30%
2020-01-01 00:13:30,13,2,2295,36,2259,3.50%,1.57%
2020-01-01 00:13:30,13,3,952,5,947,1.45%,0.52%
2020-01-01 00:13:30,13,4,4980,635,4345,7.60%,12.75%
2020-01-01 00:13:30,13,5,7873,980,6893,12.01%,12.45%
2020-01-01 00:13:30,13,6,6081,718,5363,9.28%,11.81%
2020-01-01 00:13:30,13,7,4217,125,4092,6.43%,2.96%
2020-01-01 00:13:30,13,8,7711,439,7272,11.77%,5.69%
2020-01-01 00:13:30,13,9,8212,1018,7194,12.53%,12.39%
2020-01-01 00:13:30,13,10,28477,6080,22397,43.45%,21.35%
2020-01-01 00:13:30,13,11,17322,2453,14869,26.43%,14.16%
2020-01-01 00:13:30,13,12,9290,1013,8277,14.18%,10.90%
2020-01-01 00:13:30,14,1,332,0,332,0.51%,0.00%
2020-01-01 00:13:30,14,2,1563,24,1539,2.38%,1.53%
2020-01-01 00:13:30,14,3,1089,10,1079,1.66%,0.92%
2020-01-01 00:13:30,14,4,3403,96,3307,5.19%,2.82%
2020-01-01 00:13:30,14,5,1108,12,1096,1.69%,1.08%
2020-01-01 00:13:30,14,6,3810,117,3693,5.81%,3.07%
2020-01-01 00:13:30,14,7,11407,893,10514,17.41%,7.83%
2020-01-01 00:13:30,14,8,13610,1232,12378,20.77%,9.05%
2020-01-01 00:13:30,14,9,1359,15,1344,2.07%,1.10%
2020-01-01 00:13:30,14,10,3655,89,3566,5.58%,2.43%
2020-01-01 00:13:30,14,11,26696,4708,21988,40.73%,17.63%
2020-01-01 00:13:30,14,12,9058,621,8437,13.82%,6.86%
2020-01-01 00:13:30,15,1,558,2,556,0.85%,0.36%
2020-01-01 00:13:30,15,2,132,0,132,0.20%,0.00%
2020-01-01 00:13:30,15,3,6108,279,5829,9.32%,4.57%
2020-01-01 00:13:30,15,4,4544,194,4350,6.93%,4.27%
2020-01-01 00:13:30,15,5,11646,1020,10626,17.77%,8.76%
2020-01-01 00:13:30,15,6,4828,212,4616,7.37%,4.39%
2020-01-01 00:13:30,15,7,3939,141,3798,6.01%,3.58%
2020-01-01 00:13:30,15,8,6745,404,6341,10.29%,5.99%
2020-01-01 00:13:30,15,9,11845,1047,10798,18.07%,8.84%
2020-01-01 00:13:30,15,10,7104,541,6563,10.84%,7.61%
2020-01-01 00:13:30,15,11,13924,1587,12337,21.25%,11.40%
2020-01-01 00:13:30,15,12,30775,6722,24053,46.96%,21.84%
2020-01-01 00:13:30,16,1,536,5,531,0.82%,0.93%
2020-01-01 00:13:30,16,2,237,4,233,0.36%,1.68%
2020-01-01 00:13:30,16,3,1250,18,1232,1.91%,1.44%
2020-01-01 00:13:30,16,4,4625,168,4457,7.06%,3.63%
2020-01-01 00:13:30,16,5,7874,543,7331,12.01%,6.90%
2020-01-01 00:13:30,16,6,5523,239,5284,8.43%,4.33%
2020-01-01 00:13:30,16,7,3540,105,3435,5.40%,2.97%
2020-01-01 00:13:30,16,8,8489,615,7874,12.95%,7.24%
2020-01-01 00:13:30,16,9,8446,609,7837,12.89%,7.21%
2020-01-01 00:13:30,16,10,1581,21,1560,2.41%,1.33%
2020-01-01 00:13:30,16,11,10290,839,9451,15.70%,8.15%
2020-01-01 00:13:30,16,12,26811,5010,21801,40.91%,18.69%
2020-01-01 00:13:40,1,1,18621,2416,16205,28.41%,12.97%
2020-01-01 00:13:40,1,2,6474,303,6171,9.88%,4.68%
2020-01-01 00:13:40,1,3,678,2,676,1.03%,0.29%
2020-01-01 00:13:40,1,4,11885,1063,10822,18.14%,8.94%
2020-01-01 00:13:40,1,5,11681,1031,10650,17.82%,8.83%
2020-01-01 00:13:40,1,6,11566,1012,10554,17.65%,8.75%
2020-01-01 00:13:40,1,7,5782,244,5538,8.82%,4.22%
2020-01-01 00:13:40,1,8,3391,70,3321,5.17%,2.06%
2020-01-01 00:13:40,1,9,11515,1001,10514,17.57%,8.69%
2020-01-01 00:13:40,1,10,2930,49,2881,4.47%,1.67%
2020-01-01 00:13:40,1,11,2996,51,2945,4.57%,1.70%
2020-01-01 00:13:40,1,12,11484,996,10488,17.52%,8.67%
2020-01-01 00:13:40,2,1,989,4,985,1.51%,0.40%
2020-01-01 00:13:40,2,2,27921,5180,22741,42.60%,18.55%
2020-01-01 00:13:40,2,3,22305,3378,18927,34.03%,15.14%
2020-01-01 00:13:40,2,4,937,3,934,1.43%,0.32%
2020-01-01 00:13:40,2,5,13298,1274,12024,20.29%,9.58%
2020-01-01 00:13:40,2,6,46,0,46,0.07%,0.00%
2020-01-01 00:13:40,2,7,4606,155,4451,7.03%,3.36%
2020-01-01 00:13:40,2,8,3759,102,3657,5.74%,2.71%
2020-01-01 00:13:40,2,9,13148,1245,11903,20.06%,9.47%
2020-01-01 00:13:40,2,10,2962,65,2897,4.52%,2.19%
2020-01-01 00:13:40,2,11,3008,66,2942,4.59%,2.19%
2020-01-01 00:13:40,2,12,12977,1213,11764,19.80%,9.35%
2020-01-01 00:13:40,3,1,1408,11,1397,2.15%,0.78%
2020-01-01 00:13:40,3,2,22300,3326,18974,34.03%,14.91%
2020-01-01 00:13:40,3,3,66996,24820,42176,102.23%,37.05%
2020-01-01 00:13:40,3,4,7441,370,7071,11.35%,4.97%
2020-01-01 00:13:40,3,5,43300,11516,31784,66.07%,26.60%
2020-01-01 00:13:40,3,6,8923,530,8393,13.62%,5.94%
2020-01-01 00:13:40,3,7,19159,2493,16666,29.23%,13.01%
2020-01-01 00:13:40,3,8,15609,1715,13894,23.82%,10.99%
2020-01-01 00:13:40,3,9,34027,7408,26619,51.92%,21.77%
2020-01-01 00:13:40,3,10,5062,177,4885,7.72%,3.50%
2020-01-01 00:13:40,3,11,1768,31,1737,2.70%,1.75%
2020-01-01 00:13:40,3,12,27385,4950,22435,41.79%,18.07%
2020-01-01 00:13:40,4,1,513,5,508,0.78%,0.97%
2020-01-01 00:13:40,4,2,314,1,313,0.48%,0.32%
2020-01-01 00:13:40,4,3,1059,5,1054,1.62%,0.47%
2020-01-01 00:13:40,4,4,28012,5177,22835,42.74%,18.48%
2020-01-01 00:13:40,4,5,17501,2138,15363,26.70%,12.22%
2020-01-01 00:13:40,4,6,23677,3829,19848,36.13%,16.17%
2020-01-01 00:13:40,4,7,5017,191,4826,7.66%,3.81%
2020-01-01 00:13:40,4,8,2897,60,2837,4.42%,2.07%
2020-01-01 00:13:40,4,9,15060,1610,13450,22.98%,10.69%
2020-01-01 00:13:40,4,10,1839,25,1814,2.81%,1.36%
2020-01-01 00:13:40,4,11,163,1,162,0.25%,0.61%
2020-01-01 00:13:40,4,12,12586,1126,11460,19.20%,8.95%
2020-01-01 00:13:40,5,1,2892,63,2829,4.41%,2.18%
2020-01-01 00:13:40,5,2,712,3,709,1.09%,0.42%
2020-01-01 00:13:40,5,3,560,1,559,0.85%,0.18%
2020-01-01 00:13:40,5,4,23857,3800,20057,36.40%,15.93%
2020-01-01 00:13:40,5,5,9417,635,8782,14.37%,6.74%
2020-01-01 00:13:40,5,6,15958,1797,14161,24.35%,11.26%
2020-01-01 00:13:40,5,7,6107,282,5825,9.32%,4.62%
2020-01-01 00:13:40,5,8,4559,153,4406,6.96%,3.36%
2020-01-01 00:13:40,5,9,8717,552,8165,13.30%,6.33%
2020-01-01 00:13:40,5,10,1054,10,1044,1.61%,0.95%
2020-01-01 00:13:40,5,11,904,11,893,1.38%,1.22%
2020-01-01 00:13:40,5,12,7336,384,6952,11.19%,5.23%
2020-01-01 00:13:40,6,1,1119,13,1106,1.71%,1.16%
2020-01-01 00:13:40,6,2,1222,14,1208,1.86%,1.14%
2020-01-01 00:13:40,6,3,1789,38,1751,2.73%,2.12%
2020-01-01 00:13:40,6,4,1260,8,1252,1.92%,0.63%
2020-01-01 00:13:40,6,5,16847,2024,14823,25.71%,12.01%
2020-01-01 00:13:40,6,6,4515,178,4337,6.89%,3.94%
2020-01-01 00:13:40,6,7,2737,87,2650,4.18%,3.18%
2020-01-01 00:13:40,6,8,2179,68,2111,3.32%,3.12%
2020-01-01 00:13:40,6,9,10198,778,9420,15.56%,7.63%
2020-01-01 00:13:40,6,10,2119,34,2085,3.23%,1.60%
2020-01-01 00:13:40,6,11,475,3,472,0.72%,0.63%
2020-01-01 00:13:40,6,12,7919,489,7430,12.08%,6.17%
2020-01-01 00:13:40,7,1,452,3,449,0.69%,0.66%
2020-01-01 00:13:40,7,2,170,1,169,0.26%,0.58%
2020-01-01 00:13:40,7,3,1298,18,1280,1.98%,1.39%
2020-01-01 00:13:40,7,4,1320,13,1307,2.01%,0.98%
2020-01-01 00:13:40,7,5,7454,428,7026,11.37%,5.74%
2020-01-01 00:13:40,7,6,12194,1086,11108,18.61%,8.91%
2020-01-01 00:13:40,7,7,3390,74,3316,5.17%,2.18%
2020-01-01 00:13:40,7,8,1263,12,1251,1.93%,0.95%
2020-01-01 00:13:40,7,9,6021,283,5738,9.19%,4.70%
2020-01-01 00:13:40,7,10,1475,12,1463,2.25%,0.81%
2020-01-01 00:13:40,7,11,116,0,116,0.18%,0.00%
2020-01-01 00:13:40,7,12,4512,156,4356,6.88%,3.46%
2020-01-01 00:13:40,8,1,455,4,451,0.69%,0.88%
2020-01-01 00:13:40,8,2,88,0,88,0.13%,0.00%
2020-01-01 00:13:40,8,3,1670,26,1644,2.55%,1.56%
2020-01-01 00:13:40,8,4,2527,50,2477,3.86%,1.98%
2020-01-01 00:13:40,8,5,8238,534,7704,12.57%,6.48%
2020-01-01 00:13:40,8,6,15546,1725,13821,23.72%,11.10%
2020-01-01 00:13:40,8,7,4641,172,4469,7.08%,3.71%
2020-01-01 00:13:40,8,8,1888,27,1861,2.88%,1.43%
2020-01-01 00:13:40,8,9,6343,340,6003,9.68%,5.36%
2020-01-01 00:13:40,8,10,1836,26,1810,2.80%,1.42%
2020-01-01 00:13:40,8,11,118,0,118,0.18%,0.00%
2020-01-01 00:13:40,8,12,4329,167,4162,6.61%,3.86%
2020-01-01 00:13:40,9,1,489,1,488,0.75%,0.20%
2020-01-01 00:13:40,9,2,2201,34,2167,3.36%,1.54%
2020-01-01 00:13:40,9,3,1155,17,1138,1.76%,1.47%
2020-01-01 00:13:40,9,4,14523,1474,13049,22.16%,10.15%
2020-01-01 00:13:40,9,5,307,1,306,0.47%,0.32%
2020-01-01 00:13:40,9,6,15022,1568,13454,22.92%,10.44%
2020-01-01 00:13:40,9,7,36316,8365,27951,55.41%,23.03%
2020-01-01 00:13:40,9,8,13118,1219,11899,20.02%,9.29%
2020-01-01 00:13:40,9,9,239,0,239,0.36%,0.00%
2020-01-01 00:13:40,9,10,5737,226,5511,8.75%,3.94%
2020-01-01 00:13:40,9,11,11948,1020,10928,18.23%,8.54%
2020-01-01 00:13:40,9,12,5894,275,5619,8.99%,4.66%
2020-01-01 00:13:40,10,1,1682,281,1401,2.57%,16.70%
2020-01-01 00:13:40,10,2,4078,374,3704,6.22%,9.17%
2020-01-01 00:13:40,10,3,2190,35,2155,3.34%,1.60%
2020-01-01 00:13:40,10,4,3633,950,2683,5.54%,26.14%
2020-01-01 00:13:40,10,5,563,7,556,0.86%,1.24%
2020-01-01 00:13:40,10,6,5301,1040,4261,8.09%,19.62%
2020-01-01 00:13:40,10,7,11099,1860,9239,16.94%,16.76%
2020-01-01 00:13:40,10,8,28130,6999,21131,42.92%,24.88%
2020-01-01 00:13:40,10,9,639,2,637,0.98%,0.31%
2020-01-01 00:13:40,10,10,2584,60,2524,3.94%,2.32%
2020-01-01 00:13:40,10,11,12526,1525,11001,19.11%,12.17%
2020-01-01 00:13:40,10,12,9116,1037,8079,13.91%,11.37%
2020-01-01 00:13:40,11,1,2063,38,2025,3.15%,1.84%
2020-01-01 00:13:40,11,2,3737,99,3638,5.70%,2.65%
2020-01-01 00:13:40,11,3,1456,11,1445,2.22%,0.75%
2020-01-01 00:13:40,11,4,3427,103,3324,5.23%,3.00%
2020-01-01 00:13:40,11,5,606,2,604,0.92%,0.33%
2020-01-01 00:13:40,11,6,4669,176,4493,7.12%,3.77%
2020-01-01 00:13:40,11,7,12951,1186,11765,19.76%,9.16%
2020-01-01 00:13:40,11,8,26648,4671,21977,40.66%,17.53%
2020-01-01 00:13:40,11,9,286,0,286,0.44%,0.00%
2020-01-01 00:13:40,11,10,3753,109,3644,5.73%,2.90%
2020-01-01 00:13:40,11,11,10701,866,9835,16.33%,8.09%
2020-01-01 00:13:40,11,12,6751,357,6394,10.30%,5.29%
2020-01-01 00:13:40,12,1,42,0,42,0.06%,0.00%
2020-01-01 00:13:40,12,2,626,217,409,0.96%,34.61%
2020-01-01 00:13:40,12,3,2463,265,2198,3.76%,10.75%
2020-01-01 00:13:40,12,4,2465,52,2413,3.76%,2.11%
2020-01-01 00:13:40,12,5,9339,924,8415,14.25%,9.89%
2020-01-01 00:13:40,12,6,6058,366,5692,9.24%,6.04%
2020-01-01 00:13:40,12,7,3467,172,3295,5.29%,4.96%
2020-01-01 00:13:40,12,8,1470,283,1187,2.24%,19.24%
2020-01-01 00:13:40,12,9,22205,4442,17763,33.88%,20.00%
2020-01-01 00:13:40,12,10,4707,397,4310,7.18%,8.43%
2020-01-01 00:13:40,12,11,1630,287,1343,2.49%,17.60%
2020-01-01 00:13:40,12,12,7412,992,6420,11.31%,13.38%
2020-01-01 00:13:40,13,1,2180,30,2150,3.33%,1.38%
2020-01-01 00:13:40,13,2,2635,46,2589,4.02%,1.75%
2020-01-01 00:13:40,13,3,803,1,802,1.23%,0.12%
2020-01-01 00:13:40,13,4,4315,628,3687,6.58%,14.55%
2020-01-01 00:13:40,13,5,7129,950,6179,10.88%,13.32%
2020-01-01 00:13:40,13,6,5396,701,4695,8.23%,12.99%
2020-01-01 00:13:40,13,7,5243,194,5049,8.00%,3.70%
2020-01-01 00:13:40,13,8,7635,403,7232,11.65%,5.28%
2020-01-01 00:13:40,13,9,7360,967,6393,11.23%,13.14%
2020-01-01 00:13:40,13,10,27299,5613,21686,41.65%,20.56%
2020-01-01 00:13:40,13,11,17251,2307,14944,26.32%,13.37%
2020-01-01 00:13:40,13,12,8923,914,8009,13.62%,10.24%
2020-01-01 00:13:40,14,1,451,4,447,0.69%,0.88%
2020-01-01 00:13:40,14,2,1644,33,1611,2.51%,2.01%
2020-01-01 00:13:40,14,3,1054,10,1044,1.61%,0.95%
2020-01-01 00:13:40,14,4,3715,104,3611,5.67%,2.80%
2020-01-01 00:13:40,14,5,1252,9,1243,1.91%,0.72%
2020-01-01 00:13:40,14,6,4240,138,4102,6.47%,3.25%
2020-01-01 00:13:40,14,7,11581,966,10615,17.67%,8.34%
2020-01-01 00:13:40,14,8,13247,1251,11996,20.21%,9.44%
2020-01-01 00:13:40,14,9,1607,19,1588,2.45%,1.18%
2020-01-01 00:13:40,14,10,3996,112,3884,6.10%,2.80%
2020-01-01 00:13:40,14,11,24068,3867,20201,36.72%,16.07%
2020-01-01 00:13:40,14,12,6592,304,6288,10.06%,4.61%
2020-01-01 00:13:40,15,1,531,7,524,0.81%,1.32%
2020-01-01 00:13:40,15,2,133,0,133,0.20%,0.00%
2020-01-01 00:13:40,15,3,3541,91,3450,5.40%,2.57%
2020-01-01 00:13:40,15,4,5747,275,5472,8.77%,4.78%
2020-01-01 00:13:40,15,5,11160,923,10237,17.03%,8.27%
2020-01-01 00:13:40,15,6,6003,302,5701,9.16%,5.03%
2020-01-01 00:13:40,15,7,3751,103,3648,5.72%,2.75%
2020-01-01 00:13:40,15,8,5454,212,5242,8.32%,3.89%
2020-01-01 00:13:40,15,9,11414,962,10452,17.42%,8.43%
2020-01-01 00:13:40,15,10,3807,159,3648,5.81%,4.18%
2020-01-01 00:13:40,15,11,9441,709,8732,14.41%,7.51%
2020-01-01 00:13:40,15,12,25812,4801,21011,39.39%,18.60%
2020-01-01 00:13:40,16,1,429,2,427,0.65%,0.47%
2020-01-01 00:13:40,16,2,284,0,284,0.43%,0.00%
2020-01-01 00:13:40,16,3,1254,21,1233,1.91%,1.67%
2020-01-01 00:13:40,16,4,5755,267,5488,8.78%,4.64%
2020-01-01 00:13:40,16,5,9188,747,8441,14.02%,8.13%
2020-01-01 00:13:40,16,6,6607,344,6263,10.08%,5.21%
2020-01-01 00:13:40,16,7,3597,98,3499,5.49%,2.72%
2020-01-01 00:13:40,16,8,9619,886,8733,14.68%,9.21%
2020-01-01 00:13:40,16,9,9599,803,8796,14.65%,8.36%
2020-01-01 00:13:40,16,10,1533,16,1517,2.34%,1.04%
2020-01-01 00:13:40,16,11,11453,1135,10318,17.48%,9.91%
2020-01-01 00:13:40,16,12,29529,6012,23517,45.06%,20.36%
2020-01-01 00:13:50,1,1,17596,2236,15360,26.85%,12.71%
2020-01-01 00:13:50,1,2,7055,378,6677,10.77%,5.36%
2020-01-01 00:13:50,1,3,487,2,485,0.74%,0.41%
2020-01-01 00:13:50,1,4,9991,784,9207,15.25%,7.85%
2020-01-01 00:13:50,1,5,9481,697,8784,14.47%,7.35%
2020-01-01 00:13:50,1,6,9449,693,8756,14.42%,7.33%
2020-01-01 00:13:50,1,7,6548,332,6216,9.99%,5.07%
2020-01-01 00:13:50,1,8,5420,238,5182,8.27%,4.39%
2020-01-01 00:13:50,1,9,9398,688,8710,14.34%,7.32%
2020-01-01 00:13:50,1,10,4758,192,4566,7.26%,4.03%
2020-01-01 00:13:50,1,11,4858,201,4657,7.41%,4.14%
2020-01-01 00:13:50,1,12,9373,688,8685,14.30%,7.34%
2020-01-01 00:13:50,2,1,677,2,675,1.03%,0.29%
2020-01-01 00:13:50,2,2,29932,5882,24050,45.67%,19.65%
2020-01-01 00:13:50,2,3,23573,3721,19852,35.97%,15.78%
2020-01-01 00:13:50,2,4,629,1,628,0.96%,0.16%
2020-01-01 00:13:50,2,5,11386,939,10447,17.37%,8.25%
2020-01-01 00:13:50,2,6,56,0,56,0.09%,0.00%
2020-01-01 00:13:50,2,7,5660,238,5422,8.64%,4.20%
2020-01-01 00:13:50,2,8,4331,142,4189,6.61%,3.28%
2020-01-01 00:13:50,2,9,11320,929,10391,17.27%,8.21%
2020-01-01 00:13:50,2,10,3169,81,3088,4.84%,2.56%
2020-01-01 00:13:50,2,11,3184,81,3103,4.86%,2.54%
2020-01-01 00:13:50,2,12,11184,907,10277,17.07%,8.11%
2020-01-01 00:13:50,3,1,1107,10,1097,1.69%,0.90%
2020-01-01 00:13:50,3,2,23723,3870,19853,36.20%,16.31%
2020-01-01 00:13:50,3,3,68877,26288,42589,105.10%,38.17%
2020-01-01 00:13:50,3,4,9734,690,9044,14.85%,7.09%
2020-01-01 00:13:50,3,5,39590,9815,29775,60.41%,24.79%
2020-01-01 00:13:50,3,6,11075,913,10162,16.90%,8.24%
2020-01-01 00:13:50,3,7,20788,3030,17758,31.72%,14.58%
2020-01-01 00:13:50,3,8,16151,1869,14282,24.64%,11.57%
2020-01-01 00:13:50,3,9,28192,5244,22948,43.02%,18.60%
2020-01-01 00:13:50,3,10,5861,254,5607,8.94%,4.33%
2020-01-01 00:13:50,3,11,1596,15,1581,2.44%,0.94%
2020-01-01 00:13:50,3,12,18837,2416,16421,28.74%,12.83%
2020-01-01 00:13:50,4,1,563,3,560,0.86%,0.53%
2020-01-01 00:13:50,4,2,373,1,372,0.57%,0.27%
2020-01-01 00:13:50,4,3,1056,19,1037,1.61%,1.80%
2020-01-01 00:13:50,4,4,27455,5052,22403,41.89%,18.40%
2020-01-01 00:13:50,4,5,16479,1933,14546,25.14%,11.73%
2020-01-01 00:13:50,4,6,23170,3710,19460,35.35%,16.01%
2020-01-01 00:13:50,4,7,5366,260,5106,8.19%,4.84%
2020-01-01 00:13:50,4,8,3187,89,3098,4.86%,2.79%
2020-01-01 00:13:50,4,9,14331,1487,12844,21.87%,10.38%
2020-01-01 00:13:50,4,10,1922,35,1887,2.93%,1.82%
2020-01-01 00:13:50,4,11,276,0,276,0.42%,0.00%
2020-01-01 00:13:50,4,12,11646,999,10647,17.77%,8.58%
2020-01-01 00:13:50,5,1,3161,87,3074,4.82%,2.75%
2020-01-01 00:13:50,5,2,753,5,748,1.15%,0.66%
2020-01-01 00:13:50,5,3,562,1,561,0.86%,0.18%
2020-01-01 00:13:50,5,4,22373,3444,18929,34.14%,15.39%
2020-01-01 00:13:50,5,5,9164,622,8542,13.98%,6.79%
2020-01-01 00:13:50,5,6,15385,1718,13667,23.48%,11.17%
2020-01-01 00:13:50,5,7,5737,268,5469,8.75%,4.67%
2020-01-01 00:13:50,5,8,4286,153,4133,6.54%,3.57%
2020-01-01 00:13:50,5,9,8489,538,7951,12.95%,6.34%
2020-01-01 00:13:50,5,10,1347,15,1332,2.06%,1.11%
2020-01-01 00:13:50,5,11,660,4,656,1.01%,0.61%
2020-01-01 00:13:50,5,12,6794,348,6446,10.37%,5.12%
2020-01-01 00:13:50,6,1,1052,11,1041,1.61%,1.04%
2020-01-01 00:13:50,6,2,1115,14,1101,1.70%,1.25%
2020-01-01 00:13:50,6,3,1580,29,1551,2.41%,1.83%
2020-01-01 00:13:50,6,4,1218,10,1208,1.86%,0.82%
2020-01-01 00:13:50,6,5,11664,992,10672,17.80%,8.50%
2020-01-01 00:13:50,6,6,3872,109,3763,5.91%,2.81%
2020-01-01 00:13:50,6,7,2319,51,2268,3.54%,2.20%
2020-01-01 00:13:50,6,8,1873,40,1833,2.86%,2.13%
2020-01-01 00:13:50,6,9,5961,281,5680,9.10%,4.71%
2020-01-01 00:13:50,6,10,1989,26,1963,3.03%,1.31%
2020-01-01 00:13:50,6,11,471,1,470,0.72%,0.21%
2020-01-01 00:13:50,6,12,3891,109,3782,5.94%,2.80%
2020-01-01 00:13:50,7,1,583,0,583,0.89%,0.00%
2020-01-01 00:13:50,7,2,147,0,147,0.22%,0.00%
2020-01-01 00:13:50,7,3,1310,11,1299,2.00%,0.84%
2020-01-01 00:13:50,7,4,2122,27,2095,3.24%,1.27%
2020-01-01 00:13:50,7,5,8420,519,7901,12.85%,6.16%
2020-01-01 00:13:50,7,6,14277,1413,12864,21.78%,9.90%
2020-01-01 00:13:50,7,7,3684,102,3582,5.62%,2.77%
2020-01-01 00:13:50,7,8,1117,11,1106,1.70%,0.98%
2020-01-01 00:13:50,7,9,7046,366,6680,10.75%,5.19%
2020-01-01 00:13:50,7,10,1485,19,1466,2.27%,1.28%
2020-01-01 00:13:50,7,11,77,0,77,0.12%,0.00%
2020-01-01 00:13:50,7,12,5443,213,5230,8.31%,3.91%
2020-01-01 00:13:50,8,1,542,1,541,0.83%,0.18%
2020-01-01 00:13:50,8,2,69,0,69,0.11%,0.00%
2020-01-01 00:13:50,8,3,2015,38,1977,3.07%,1.88%
2020-01-01 00:13:50,8,4,2876,76,2800,4.39%,2.64%
2020-01-01 00:13:50,8,5,7975,498,7477,12.17%,6.24%
2020-01-01 00:13:50,8,6,15273,1714,13559,23.30%,11.22%
2020-01-01 00:13:50,8,7,4277,151,4126,6.53%,3.53%
2020-01-01 00:13:50,8,8,1929,38,1891,2.94%,1.97%
2020-01-01 00:13:50,8,9,5748,245,5503,8.77%,4.26%
2020-01-01 00:13:50,8,10,1603,24,1579,2.45%,1.50%
2020-01-01 00:13:50,8,11,72,0,72,0.11%,0.00%
2020-01-01 00:13:50,8,12,4086,128,3958,6.23%,3.13%
2020-01-01 00:13:50,9,1,1098,3,1095,1.68%,0.27%
2020-01-01 00:13:50,9,2,4554,140,4414,6.95%,3.07%
2020-01-01 00:13:50,9,3,3118,68,3050,4.76%,2.18%
2020-01-01 00:13:50,9,4,7056,388,6668,10.77%,5.50%
2020-01-01 00:13:50,9,5,566,3,563,0.86%,0.53%
2020-01-01 00:13:50,9,6,8479,528,7951,12.94%,6.23%
2020-01-01 00:13:50,9,7,29186,5685,23501,44.53%,19.48%
2020-01-01 00:13:50,9,8,10317,776,9541,15.74%,7.52%
2020-01-01 00:13:50,9,9,284,0,284,0.43%,0.00%
2020-01-01 00:13:50,9,10,3795,105,3690,5.79%,2.77%
2020-01-01 00:13:50,9,11,9180,610,8570,14.01%,6.64%
2020-01-01 00:13:50,9,12,5066,176,4890,7.73%,3.47%
2020-01-01 00:13:50,10,1,1558,222,1336,2.38%,14.24%
2020-01-01 00:13:50,10,2,3119,271,2848,4.76%,8.69%
2020-01-01 00:13:50,10,3,1376,16,1360,2.10%,1.16%
2020-01-01 00:13:50,10,4,3889,1161,2728,5.93%,29.85%
2020-01-01 00:13:50,10,5,682,51,631,1.04%,7.47%
2020-01-01 00:13:50,10,6,5980,1317,4663,9.12%,22.02%
2020-01-01 00:13:50,10,7,10865,2006,8859,16.58%,18.46%
2020-01-01 00:13:50,10,8,28615,7241,21374,43.66%,25.30%
2020-01-01 00:13:50,10,9,561,2,559,0.86%,0.36%
2020-01-01 00:13:50,10,10,2224,31,2193,3.39%,1.39%
2020-01-01 00:13:50,10,11,13921,1899,12022,21.24%,13.64%
2020-01-01 00:13:50,10,12,11252,1444,9808,17.17%,12.83%
2020-01-01 00:13:50,11,1,2360,40,2320,3.60%,1.69%
2020-01-01 00:13:50,11,2,3388,85,3303,5.17%,2.51%
2020-01-01 00:13:50,11,3,754,5,749,1.15%,0.66%
2020-01-01 00:13:50,11,4,5587,253,5334,8.53%,4.53%
2020-01-01 00:13:50,11,5,143,0,143,0.22%,0.00%
2020-01-01 00:13:50,11,6,6334,310,6024,9.66%,4.89%
2020-01-01 00:13:50,11,7,31044,6288,24756,47.37%,20.25%
2020-01-01 00:13:50,11,8,43612,11825,31787,66.55%,27.11%
2020-01-01 00:13:50,11,9,328,1,327,0.50%,0.30%
2020-01-01 00:13:50,11,10,2854,59,2795,4.35%,2.07%
2020-01-01 00:13:50,11,11,9113,623,8490,13.91%,6.84%
2020-01-01 00:13:50,11,12,5861,255,5606,8.94%,4.35%
2020-01-01 00:13:50,12,1,199,0,199,0.30%,0.00%
2020-01-01 00:13:50,12,2,527,159,368,0.80%,30.11%
2020-01-01 00:13:50,12,3,2946,229,2717,4.50%,7.77%
2020-01-01 00:13:50,12,4,2951,54,2897,4.50%,1.83%
2020-01-01 00:13:50,12,5,8267,630,7637,12.61%,7.62%
2020-01-01 00:13:50,12,6,4599,155,4444,7.02%,3.37%
2020-01-01 00:13:50,12,7,1488,27,1461,2.27%,1.81%
2020-01-01 00:13:50,12,8,1513,320,1193,2.31%,21.14%
2020-01-01 00:13:50,12,9,23681,4762,18919,36.13%,20.11%
2020-01-01 00:13:50,12,10,4558,441,4117,6.95%,9.67%
2020-01-01 00:13:50,12,11,1622,326,1296,2.47%,20.09%
2020-01-01 00:13:50,12,12,9830,1414,8416,15.00%,14.38%
2020-01-01 00:13:50,13,1,2281,47,2234,3.48%,2.06%
2020-01-01 00:13:50,13,2,2571,60,2511,3.92%,2.33%
2020-01-01 00:13:50,13,3,1126,13,1113,1.72%,1.15%
2020-01-01 00:13:50,13,4,4767,430,4337,7.27%,9.02%
2020-01-01 00:13:50,13,5,8020,892,7128,12.24%,11.12%
2020-01-01 00:13:50,13,6,5927,502,5425,9.04%,8.47%
2020-01-01 00:13:50,13,7,5508,255,5253,8.40%,4.63%
2020-01-01 00:13:50,13,8,7566,428,7138,11.54%,5.66%
2020-01-01 00:13:50,13,9,8256,925,7331,12.60%,11.20%
2020-01-01 00:13:50,13,10,26101,5109,20992,39.83%,19.57%
2020-01-01 00:13:50,13,11,15498,1961,13537,23.65%,12.65%
2020-01-01 00:13:50,13,12,7531,734,6797,11.49%,9.75%
2020-01-01 00:13:50,14,1,699,1,698,1.07%,0.14%
2020-01-01 00:13:50,14,2,1541,10,1531,2.35%,0.65%
2020-01-01 00:13:50,14,3,590,2,588,0.90%,0.34%
2020-01-01 00:13:50,14,4,3261,83,3178,4.98%,2.54%
2020-01-01 00:13:50,14,5,1385,11,1374,2.11%,0.79%
2020-01-01 00:13:50,14,6,3651,102,3549,5.57%,2.79%
2020-01-01 00:13:50,14,7,11307,910,10397,17.25%,8.05%
2020-01-01 00:13:50,14,8,12599,1134,11465,19.22%,9.00%
2020-01-01 00:13:50,14,9,1486,14,1472,2.27%,0.94%
2020-01-01 00:13:50,14,10,3948,139,3809,6.02%,3.52%
2020-01-01 00:13:50,14,11,24741,4197,20544,37.75%,16.96%
2020-01-01 00:13:50,14,12,7940,504,7436,12.12%,6.35%
2020-01-01 00:13:50,15,1,474,0,474,0.72%,0.00%
2020-01-01 00:13:50,15,2,138,0,138,0.21%,0.00%
2020-01-01 00:13:50,15,3,4323,131,4192,6.60%,3.03%
2020-01-01 00:13:50,15,4,4329,173,4156,6.61%,4.00%
2020-01-01 00:13:50,15,5,9618,660,8958,14.68%,6.86%
2020-01-01 00:13:50,15,6,4539,176,4363,6.93%,3.88%
2020-01-01 00:13:50,15,7,3086,86,3000,4.71%,2.79%
2020-01-01 00:13:50,15,8,4720,209,4511,7.20%,4.43%
2020-01-01 00:13:50,15,9,9883,689,9194,15.08%,6.97%
2020-01-01 00:13:50,15,10,3536,322,3214,5.40%,9.10%
2020-01-01 00:13:50,15,11,8326,760,7566,12.70%,9.13%
2020-01-01 00:13:50,15,12,23022,4060,18962,35.13%,17.63%
2020-01-01 00:13:50,16,1,378,1,377,0.58%,0.26%
2020-01-01 00:13:50,16,2,224,0,224,0.34%,0.00%
2020-01-01 00:13:50,16,3,1327,15,1312,2.02%,1.13%
2020-01-01 00:13:50,16,4,4010,130,3880,6.12%,3.24%
2020-01-01 00:13:50,16,5,6927,383,6544,10.57%,5.53%
2020-01-01 00:13:50,16,6,4804,178,4626,7.33%,3.70%
2020-01-01 00:13:50,16,7,3285,77,3208,5.01%,2.34%
2020-01-01 00:13:50,16,8,7197,459,6738,10.98%,6.38%
2020-01-01 00:13:50,16,9,7380,423,6957,11.26%,5.73%
2020-01-01 00:13:50,16,10,1206,3,1203,1.84%,0.25%
2020-01-01 00:13:50,16,11,8609,619,7990,13.14%,7.19%
2020-01-01 00:13:50,16,12,23596,3790,19806,36.00%,16.06%
2020-01-01 00:14:00,1,1,22985,3654,19331,35.07%,15.90%
2020-01-01 00:14:00,1,2,13880,1363,12517,21.18%,9.82%
2020-01-01 00:14:00,1,3,796,3,793,1.21%,0.38%
2020-01-01 00:14:00,1,4,8739,611,8128,13.33%,6.99%
2020-01-01 00:14:00,1,5,8424,565,7859,12.85%,6.71%
2020-01-01 00:14:00,1,6,8332,553,7779,12.71%,6.64%
2020-01-01 00:14:00,1,7,13069,1222,11847,19.94%,9.35%
2020-01-01 00:14:00,1,8,10587,764,9823,16.15%,7.22%
2020-01-01 00:14:00,1,9,8297,548,7749,12.66%,6.60%
2020-01-01 00:14:00,1,10,10063,680,9383,15.35%,6.76%
2020-01-01 00:14:00,1,11,10099,686,9413,15.41%,6.79%
2020-01-01 00:14:00,1,12,8261,542,7719,12.61%,6.56%
2020-01-01 00:14:00,2,1,1302,6,1296,1.99%,0.46%
2020-01-01 00:14:00,2,2,32516,6761,25755,49.62%,20.79%
2020-01-01 00:14:00,2,3,23203,3617,19586,35.40%,15.59%
2020-01-01 00:14:00,2,4,1254,6,1248,1.91%,0.48%
2020-01-01 00:14:00,2,5,15664,1709,13955,23.90%,10.91%
2020-01-01 00:14:00,2,6,15,0,15,0.02%,0.00%
2020-01-01 00:14:00,2,7,7996,396,7600,12.20%,4.95%
2020-01-01 00:14:00,2,8,6842,281,6561,10.44%,4.11%
2020-01-01 00:14:00,2,9,15599,1695,13904,23.80%,10.87%
2020-01-01 00:14:00,2,10,5880,215,5665,8.97%,3.66%
2020-01-01 00:14:00,2,11,5885,216,5669,8.98%,3.67%
2020-01-01 00:14:00,2,12,15413,1645,13768,23.52%,10.67%
2020-01-01 00:14:00,3,1,1774,30,1744,2.71%,1.69%
2020-01-01 00:14:00,3,2,22745,3611,19134,34.71%,15.88%
2020-01-01 00:14:00,3,3,64501,23647,40854,98.42%,36.66%
2020-01-01 00:14:00,3,4,4339,127,4212,6.62%,2.93%
2020-01-01 00:14:00,3,5,40487,10436,30051,61.78%,25.78%
2020-01-01 00:14:00,3,6,6172,266,5906,9.42%,4.31%
2020-01-01 00:14:00,3,7,18913,2559,16354,28.86%,13.53%
2020-01-01 00:14:00,3,8,15092,1657,13435,23.03%,10.98%
2020-01-01 00:14:00,3,9,33961,7591,26370,51.82%,22.35%
2020-01-01 00:14:00,3,10,6499,332,6167,9.92%,5.11%
2020-01-01 00:14:00,3,11,1893,22,1871,2.89%,1.16%
2020-01-01 00:14:00,3,12,24408,4118,20290,37.24%,16.87%
2020-01-01 00:14:00,4,1,518,0,518,0.79%,0.00%
2020-01-01 00:14:00,4,2,305,0,305,0.47%,0.00%
2020-01-01 00:14:00,4,3,856,1,855,1.31%,0.12%
2020-01-01 00:14:00,4,4,27906,5095,22811,42.58%,18.26%
2020-01-01 00:14:00,4,5,17460,2042,15418,26.64%,11.69%
2020-01-01 00:14:00,4,6,24314,3883,20431,37.10%,15.97%
2020-01-01 00:14:00,4,7,5461,213,5248,8.33%,3.90%
2020-01-01 00:14:00,4,8,2972,68,2904,4.53%,2.29%
2020-01-01 00:14:00,4,9,15238,1629,13609,23.25%,10.69%
2020-01-01 00:14:00,4,10,2179,25,2154,3.32%,1.15%
2020-01-01 00:14:00,4,11,176,0,176,0.27%,0.00%
2020-01-01 00:14:00,4,12,12252,1042,11210,18.70%,8.50%
2020-01-01 00:14:00,5,1,2918,64,2854,4.45%,2.19%
2020-01-01 00:14:00,5,2,1359,11,1348,2.07%,0.81%
2020-01-01 00:14:00,5,3,611,3,608,0.93%,0.49%
2020-01-01 00:14:00,5,4,22407,3389,19018,34.19%,15.12%
2020-01-01 00:14:00,5,5,9887,708,9179,15.09%,7.16%
2020-01-01 00:14:00,5,6,14308,1448,12860,21.83%,10.12%
2020-01-01 00:14:00,5,7,4017,128,3889,6.13%,3.19%
2020-01-01 00:14:00,5,8,3230,87,3143,4.93%,2.69%
2020-01-01 00:14:00,5,9,9058,588,8470,13.82%,6.49%
2020-01-01 00:14:00,5,10,902,12,890,1.38%,1.33%
2020-01-01 00:14:00,5,11,722,9,713,1.10%,1.24%
2020-01-01 00:14:00,5,12,7980,460,7520,12.18%,5.76%
2020-01-01 00:14:00,6,1,1092,13,1079,1.67%,1.19%
2020-01-01 00:14:00,6,2,1160,14,1146,1.77%,1.21%
2020-01-01 00:14:00,6,3,1757,24,1733,2.68%,1.37%
2020-01-01 00:14:00,6,4,1756,13,1743,2.68%,0.74%
2020-01-01 00:14:00,6,5,14019,1383,12636,21.39%,9.86%
2020-01-01 00:14:00,6,6,4760,177,4583,7.26%,3.72%
2020-01-01 00:14:00,6,7,2544,70,2474,3.88%,2.75%
2020-01-01 00:14:00,6,8,2036,53,1983,3.11%,2.60%
2020-01-01 00:14:00,6,9,7208,360,6848,11.00%,4.99%
2020-01-01 00:14:00,6,10,2707,49,2658,4.13%,1.81%
2020-01-01 00:14:00,6,11,445,2,443,0.68%,0.45%
2020-01-01 00:14:00,6,12,4435,133,4302,6.77%,3.00%
2020-01-01 00:14:00,7,1,409,5,404,0.62%,1.22%
2020-01-01 00:14:00,7,2,143,0,143,0.22%,0.00%
2020-01-01 00:14:00,7,3,785,3,782,1.20%,0.38%
2020-01-01 00:14:00,7,4,1508,24,1484,2.30%,1.59%
2020-01-01 00:14:00,7,5,7145,375,6770,10.90%,5.25%
2020-01-01 00:14:00,7,6,12095,1087,11008,18.46%,8.99%
2020-01-01 00:14:00,7,7,3409,101,3308,5.20%,2.96%
2020-01-01 00:14:00,7,8,1302,13,1289,1.99%,1.00%
2020-01-01 00:14:00,7,9,6300,313,5987,9.61%,4.97%
2020-01-01 00:14:00,7,10,1218,22,1196,1.86%,1.80%
2020-01-01 00:14:00,7,11,123,1,122,0.19%,0.81%
2020-01-01 00:14:00,7,12,5052,217,4835,7.71%,4.29%
2020-01-01 00:14:00,8,1,433,1,432,0.66%,0.23%
2020-01-01 00:14:00,8,2,119,0,119,0.18%,0.00%
2020-01-01 00:14:00,8,3,1570,17,1553,2.40%,1.08%
2020-01-01 00:14:00,8,4,3010,62,2948,4.59%,2.06%
2020-01-01 00:14:00,8,5,8552,546,8006,13.05%,6.38%
2020-01-01 00:14:00,8,6,18183,2297,15886,27.75%,12.63%
2020-01-01 00:14:00,8,7,6505,311,6194,9.93%,4.78%
2020-01-01 00:14:00,8,8,3423,86,3337,5.22%,2.51%
2020-01-01 00:14:00,8,9,6747,345,6402,10.30%,5.11%
2020-01-01 00:14:00,8,10,1654,17,1637,2.52%,1.03%
2020-01-01 00:14:00,8,11,182,0,182,0.28%,0.00%
2020-01-01 00:14:00,8,12,5063,211,4852,7.73%,4.17%
2020-01-01 00:14:00,9,1,429,2,427,0.65%,0.47%
2020-01-01 00:14:00,9,2,6902,365,6537,10.53%,5.29%
2020-01-01 00:14:00,9,3,6147,289,5858,9.38%,4.70%
2020-01-01 00:14:00,9,4,2821,89,2732,4.30%,3.15%
2020-01-01 00:14:00,9,5,300,1,299,0.46%,0.33%
2020-01-01 00:14:00,9,6,3620,126,3494,5.52%,3.48%
2020-01-01 00:14:00,9,7,29898,6057,23841,45.62%,20.26%
2020-01-01 00:14:00,9,8,13335,1480,11855,20.35%,11.10%
2020-01-01 00:14:00,9,9,197,1,196,0.30%,0.51%
2020-01-01 00:14:00,9,10,6281,408,5873,9.58%,6.49%
2020-01-01 00:14:00,9,11,11882,1124,10758,18.13%,9.46%
2020-01-01 00:14:00,9,12,5323,191,5132,8.12%,3.59%
2020-01-01 00:14:00,10,1,1384,183,1201,2.11%,13.21%
2020-01-01 00:14:00,10,2,3023,246,2777,4.61%,8.13%
2020-01-01 00:14:00,10,3,1496,33,1463,2.28%,2.20%
2020-01-01 00:14:00,10,4,4123,791,3332,6.29%,19.18%
2020-01-01 00:14:00,10,5,571,1,570,0.87%,0.17%
2020-01-01 00:14:00,10,6,5741,888,4853,8.76%,15.46%
2020-01-01 00:14:00,10,7,10652,1579,9073,16.25%,14.82%
2020-01-01 00:14:00,10,8,28055,6764,21291,42.81%,24.11%
2020-01-01 00:14:00,10,9,519,0,519,0.79%,0.00%
2020-01-01 00:14:00,10,10,2234,36,2198,3.41%,1.61%
2020-01-01 00:14:00,10,11,13736,1813,11923,20.96%,13.20%
2020-01-01 00:14:00,10,12,10772,1348,9424,16.44%,12.51%
2020-01-01 00:14:00,11,1,2371,64,2307,3.62%,2.70%
2020-01-01 00:14:00,11,2,3471,106,3365,5.30%,3.05%
2020-01-01 00:14:00,11,3,924,3,921,1.41%,0.32%
2020-01-01 00:14:00,11,4,6755,419,6336,10.31%,6.20%
2020-01-01 00:14:00,11,5,209,0,209,0.32%,0.00%
2020-01-01 00:14:00,11,6,7448,485,6963,11.36%,6.51%
2020-01-01 00:14:00,11,7,13028,1265,11763,19.88%,9.71%
2020-01-01 00:14:00,11,8,26334,4707,21627,40.18%,17.87%
2020-01-01 00:14:00,11,9,142,0,142,0.22%,0.00%
2020-01-01 00:14:00,11,10,2781,60,2721,4.24%,2.16%
2020-01-01 00:14:00,11,11,9447,721,8726,14.41%,7.63%
2020-01-01 00:14:00,11,12,6365,350,6015,9.71%,5.50%
2020-01-01 00:14:00,12,1,77,0,77,0.12%,0.00%
2020-01-01 00:14:00,12,2,558,218,340,0.85%,39.00%
2020-01-01 00:14:00,12,3,2270,259,2011,3.46%,11.40%
2020-01-01 00:14:00,12,4,2707,71,2636,4.13%,2.62%
2020-01-01 00:14:00,12,5,8590,721,7869,13.11%,8.39%
2020-01-01 00:14:00,12,6,5454,216,5238,8.32%,3.96%
2020-01-01 00:14:00,12,7,2540,41,2499,3.88%,1.61%
2020-01-01 00:14:00,12,8,1356,315,1041,2.07%,23.21%
2020-01-01 00:14:00,12,9,21082,4058,17024,32.17%,19.25%
2020-01-01 00:14:00,12,10,3982,405,3577,6.08%,10.17%
2020-01-01 00:14:00,12,11,1516,318,1198,2.31%,20.96%
2020-01-01 00:14:00,12,12,8018,1100,6918,12.23%,13.72%
2020-01-01 00:14:00,13,1,2256,41,2215,3.44%,1.82%
2020-01-01 00:14:00,13,2,2552,55,2497,3.89%,2.15%
2020-01-01 00:14:00,13,3,873,3,870,1.33%,0.34%
2020-01-01 00:14:00,13,4,5787,409,5378,8.83%,7.07%
2020-01-01 00:14:00,13,5,7861,717,7144,11.99%,9.12%
2020-01-01 00:14:00,13,6,6346,444,5902,9.68%,7.00%
2020-01-01 00:14:00,13,7,5278,212,5066,8.05%,4.02%
2020-01-01 00:14:00,13,8,7581,428,7153,11.57%,5.64%
2020-01-01 00:14:00,13,9,8148,757,7391,12.43%,9.29%
2020-01-01 00:14:00,13,10,28029,5763,22266,42.77%,20.56%
2020-01-01 00:14:00,13,11,17243,2459,14784,26.31%,14.26%
2020-01-01 00:14:00,13,12,9274,1032,8242,14.15%,11.13%
2020-01-01 00:14:00,14,1,353,1,352,0.54%,0.28%
2020-01-01 00:14:00,14,2,1472,17,1455,2.25%,1.15%
2020-01-01 00:14:00,14,3,913,6,907,1.39%,0.66%
2020-01-01 00:14:00,14,4,4438,129,4309,6.77%,2.91%
2020-01-01 00:14:00,14,5,1394,11,1383,2.13%,0.79%
2020-01-01 00:14:00,14,6,4765,155,4610,7.27%,3.25%
2020-01-01 00:14:00,14,7,11833,985,10848,18.06%,8.32%
2020-01-01 00:14:00,14,8,13150,1209,11941,20.07%,9.19%
2020-01-01 00:14:00,14,9,1558,16,1542,2.38%,1.03%
2020-01-01 00:14:00,14,10,3875,185,3690,5.91%,4.77%
2020-01-01 00:14:00,14,11,25067,4339,20728,38.25%,17.31%
2020-01-01 00:14:00,14,12,7832,478,7354,11.95%,6.10%
2020-01-01 00:14:00,15,1,590,5,585,0.90%,0.85%
2020-01-01 00:14:00,15,2,211,0,211,0.32%,0.00%
2020-01-01 00:14:00,15,3,4309,152,4157,6.58%,3.53%
2020-01-01 00:14:00,15,4,8235,507,7728,12.57%,6.16%
2020-01-01 00:14:00,15,5,13708,1352,12356,20.92%,9.86%
2020-01-01 00:14:00,15,6,8481,540,7941,12.94%,6.37%
2020-01-01 00:14:00,15,7,4080,134,3946,6.23%,3.28%
2020-01-01 00:14:00,15,8,5718,259,5459,8.72%,4.53%
2020-01-01 00:14:00,15,9,13888,1385,12503,21.19%,9.97%
2020-01-01 00:14:00,15,10,4249,130,4119,6.48%,3.06%
2020-01-01 00:14:00,15,11,10065,750,9315,15.36%,7.45%
2020-01-01 00:14:00,15,12,29618,5975,23643,45.19%,20.17%
2020-01-01 00:14:00,16,1,397,2,395,0.61%,0.50%
2020-01-01 00:14:00,16,2,214,2,212,0.33%,0.93%
2020-01-01 00:14:00,16,3,3231,88,3143,4.93%,2.72%
2020-01-01 00:14:00,16,4,4163,154,4009,6.35%,3.70%
2020-01-01 00:14:00,16,5,9469,683,8786,14.45%,7.21%
2020-01-01 00:14:00,16,6,4946,194,4752,7.55%,3.92%
2020-01-01 00:14:00,16,7,3412,127,3285,5.21%,3.72%
2020-01-01 00:14:00,16,8,7817,563,7254,11.93%,7.20%
2020-01-01 00:14:00,16,9,9809,736,9073,14.97%,7.50%
2020-01-01 00:14:00,16,10,1884,30,1854,2.87%,1.59%
2020-01-01 00:14:00,16,11,9859,855,9004,15.04%,8.67%
2020-01-01 00:14:00,16,12,27306,5111,22195,41.67%,18.72%
2020-01-01 00:14:10,1,1,30083,5994,24089,45.90%,19.92%
2020-01-01 00:14:10,1,2,16621,1957,14664,25.36%,11.77%
2020-01-01 00:14:10,1,3,763,3,760,1.16%,0.39%
2020-01-01 00:14:10,1,4,13198,1360,11838,20.14%,10.30%
2020-01-01 00:14:10,1,5,12765,1266,11499,19.48%,9.92%
2020-01-01 00:14:10,1,6,12699,1249,11450,19.38%,9.83%
2020-01-01 00:14:10,1,7,15831,1796,14035,24.16%,11.34%
2020-01-01 00:14:10,1,8,14998,1627,13371,22.89%,10.85%
2020-01-01 00:14:10,1,9,12670,1244,11426,19.33%,9.82%
2020-01-01 00:14:10,1,10,14366,1504,12862,21.92%,10.47%
2020-01-01 00:14:10,1,11,14447,1516,12931,22.04%,10.49%
2020-01-01 00:14:10,1,12,12607,1235,11372,19.24%,9.80%
2020-01-01 00:14:10,2,1,835,5,830,1.27%,0.60%
2020-01-01 00:14:10,2,2,23944,3827,20117,36.54%,15.98%
2020-01-01 00:14:10,2,3,17708,2177,15531,27.02%,12.29%
2020-01-01 00:14:10,2,4,783,5,778,1.19%,0.64%
2020-01-01 00:14:10,2,5,11400,975,10425,17.40%,8.55%
2020-01-01 00:14:10,2,6,31,0,31,0.05%,0.00%
2020-01-01 00:14:10,2,7,5389,182,5207,8.22%,3.38%
2020-01-01 00:14:10,2,8,4323,122,4201,6.60%,2.82%
2020-01-01 00:14:10,2,9,11260,958,10302,17.18%,8.51%
2020-01-01 00:14:10,2,10,3524,75,3449,5.38%,2.13%
2020-01-01 00:14:10,2,11,3528,75,3453,5.38%,2.13%
2020-01-01 00:14:10,2,12,11090,938,10152,16.92%,8.46%
2020-01-01 00:14:10,3,1,1666,21,1645,2.54%,1.26%
2020-01-01 00:14:10,3,2,24311,4022,20289,37.10%,16.54%
2020-01-01 00:14:10,3,3,78067,32473,45594,119.12%,41.60%
2020-01-01 00:14:10,3,4,8831,580,8251,13.48%,6.57%
2020-01-01 00:14:10,3,5,51532,15903,35629,78.63%,30.86%
2020-01-01 00:14:10,3,6,10067,769,9298,15.36%,7.64%
2020-01-01 00:14:10,3,7,20864,2988,17876,31.84%,14.32%
2020-01-01 00:14:10,3,8,17205,2039,15166,26.25%,11.85%
2020-01-01 00:14:10,3,9,41106,10557,30549,62.72%,25.68%
2020-01-01 00:14:10,3,10,4667,158,4509,7.12%,3.38%
2020-01-01 00:14:10,3,11,2194,42,2152,3.35%,1.91%
2020-01-01 00:14:10,3,12,35056,7964,27092,53.49%,22.72%
2020-01-01 00:14:10,4,1,398,2,396,0.61%,0.50%
2020-01-01 00:14:10,4,2,215,2,213,0.33%,0.93%
2020-01-01 00:14:10,4,3,1127,7,1120,1.72%,0.62%
2020-01-01 00:14:10,4,4,27107,4875,22232,41.36%,17.98%
2020-01-01 00:14:10,4,5,17406,2133,15273,26.56%,12.25%
2020-01-01 00:14:10,4,6,23430,3684,19746,35.75%,15.72%
2020-01-01 00:14:10,4,7,4776,185,4591,7.29%,3.87%
2020-01-01 00:14:10,4,8,3253,92,3161,4.96%,2.83%
2020-01-01 00:14:10,4,9,15142,1621,13521,23.10%,10.70%
2020-01-01 00:14:10,4,10,1748,20,1728,2.67%,1.14%
2020-01-01 00:14:10,4,11,143,0,143,0.22%,0.00%
2020-01-01 00:14:10,4,12,12710,1161,11549,19.39%,9.13%
2020-01-01 00:14:10,5,1,2893,60,2833,4.41%,2.07%
2020-01-01 00:14:10,5,2,790,7,783,1.21%,0.88%
2020-01-01 00:14:10,5,3,437,1,436,0.67%,0.23%
2020-01-01 00:14:10,5,4,23266,3656,19610,35.50%,15.71%
2020-01-01 00:14:10,5,5,10366,798,9568,15.82%,7.70%
2020-01-01 00:14:10,5,6,15552,1736,13816,23.73%,11.16%
2020-01-01 00:14:10,5,7,4617,180,4437,7.04%,3.90%
2020-01-01 00:14:10,5,8,3601,120,3481,5.49%,3.33%
2020-01-01 00:14:10,5,9,9733,697,9036,14.85%,7.16%
2020-01-01 00:14:10,5,10,1172,7,1165,1.79%,0.60%
2020-01-01 00:14:10,5,11,1044,15,1029,1.59%,1.44%
2020-01-01 00:14:10,5,12,7897,445,7452,12.05%,5.63%
2020-01-01 00:14:10,6,1,1032,11,1021,1.57%,1.06%
2020-01-01 00:14:10,6,2,1181,13,1168,1.80%,1.10%
2020-01-01 00:14:10,6,3,1568,16,1552,2.39%,1.02%
2020-01-01 00:14:10,6,4,1042,27,1015,1.59%,2.59%
2020-01-01 00:14:10,6,5,15986,1792,14194,24.39%,11.21%
2020-01-01 00:14:10,6,6,3698,123,3575,5.64%,3.33%
2020-01-01 00:14:10,6,7,2141,29,2112,3.27%,1.35%
2020-01-01 00:14:10,6,8,1495,21,1474,2.28%,1.40%
2020-01-01 00:14:10,6,9,10414,822,9592,15.89%,7.89%
2020-01-01 00:14:10,6,10,2948,71,2877,4.50%,2.41%
2020-01-01 00:14:10,6,11,426,1,425,0.65%,0.23%
2020-01-01 00:14:10,6,12,7388,411,6977,11.27%,5.56%
2020-01-01 00:14:10,7,1,339,2,337,0.52%,0.59%
2020-01-01 00:14:10,7,2,72,0,72,0.11%,0.00%
2020-01-01 00:14:10,7,3,1379,9,1370,2.10%,0.65%
2020-01-01 00:14:10,7,4,1666,23,1643,2.54%,1.38%
2020-01-01 00:14:10,7,5,6809,425,6384,10.39%,6.24%
2020-01-01 00:14:10,7,6,12161,1095,11066,18.56%,9.00%
2020-01-01 00:14:10,7,7,3629,102,3527,5.54%,2.81%
2020-01-01 00:14:10,7,8,1442,18,1424,2.20%,1.25%
2020-01-01 00:14:10,7,9,5387,310,5077,8.22%,5.75%
2020-01-01 00:14:10,7,10,1530,20,1510,2.33%,1.31%
2020-01-01 00:14:10,7,11,136,2,134,0.21%,1.46%
2020-01-01 00:14:10,7,12,3828,123,3705,5.84%,3.21%
2020-01-01 00:14:10,8,1,387,6,381,0.59%,1.55%
2020-01-01 00:14:10,8,2,59,0,59,0.09%,0.00%
2020-01-01 00:14:10,8,3,1423,15,1408,2.17%,1.05%
2020-01-01 00:14:10,8,4,2502,44,2458,3.82%,1.76%
2020-01-01 00:14:10,8,5,7950,481,7469,12.13%,6.05%
2020-01-01 00:14:10,8,6,16355,1855,14500,24.96%,11.34%
2020-01-01 00:14:10,8,7,5703,238,5465,8.70%,4.17%
2020-01-01 00:14:10,8,8,2440,38,2402,3.72%,1.56%
2020-01-01 00:14:10,8,9,6162,287,5875,9.40%,4.66%
2020-01-01 00:14:10,8,10,1825,20,1805,2.78%,1.10%
2020-01-01 00:14:10,8,11,372,1,371,0.57%,0.27%
2020-01-01 00:14:10,8,12,4273,141,4132,6.52%,3.30%
2020-01-01 00:14:10,9,1,215,0,215,0.33%,0.00%
2020-01-01 00:14:10,9,2,2129,29,2100,3.25%,1.36%
2020-01-01 00:14:10,9,3,1450,10,1440,2.21%,0.69%
2020-01-01 00:14:10,9,4,4622,164,4458,7.05%,3.55%
2020-01-01 00:14:10,9,5,194,1,193,0.30%,0.51%
2020-01-01 00:14:10,9,6,5533,224,5309,8.44%,4.05%
2020-01-01 00:14:10,9,7,22756,3635,19121,34.72%,15.97%
2020-01-01 00:14:10,9,8,9787,762,9025,14.93%,7.79%
2020-01-01 00:14:10,9,9,165,0,165,0.25%,0.00%
2020-01-01 00:14:10,9,10,2874,126,2748,4.39%,4.38%
2020-01-01 00:14:10,9,11,8798,621,8177,13.42%,7.06%
2020-01-01 00:14:10,9,12,5631,240,5391,8.59%,4.26%
2020-01-01 00:14:10,10,1,1258,329,929,1.92%,26.13%
2020-01-01 00:14:10,10,2,2991,385,2606,4.56%,12.87%
2020-01-01 00:14:10,10,3,1593,28,1565,2.43%,1.76%
2020-01-01 00:14:10,10,4,4631,1066,3565,7.07%,23.01%
2020-01-01 00:14:10,10,5,641,2,639,0.98%,0.31%
2020-01-01 00:14:10,10,6,6277,1162,5115,9.58%,18.51%
2020-01-01 00:14:10,10,7,10988,1979,9009,16.77%,18.01%
2020-01-01 00:14:10,10,8,28355,6895,21460,43.27%,24.32%
2020-01-01 00:14:10,10,9,1376,17,1359,2.10%,1.23%
2020-01-01 00:14:10,10,10,3227,81,3146,4.92%,2.51%
2020-01-01 00:14:10,10,11,13963,1813,12150,21.31%,12.98%
2020-01-01 00:14:10,10,12,10298,1207,9091,15.71%,11.72%
2020-01-01 00:14:10,11,1,2568,68,2500,3.92%,2.65%
2020-01-01 00:14:10,11,2,3691,123,3568,5.63%,3.33%
2020-01-01 00:14:10,11,3,968,9,959,1.48%,0.93%
2020-01-01 00:14:10,11,4,3476,123,3353,5.30%,3.54%
2020-01-01 00:14:10,11,5,209,0,209,0.32%,0.00%
2020-01-01 00:14:10,11,6,4374,174,4200,6.67%,3.98%
2020-01-01 00:14:10,11,7,10176,821,9355,15.53%,8.07%
2020-01-01 00:14:10,11,8,23332,3792,19540,35.60%,16.25%
2020-01-01 00:14:10,11,9,181,0,181,0.28%,0.00%
2020-01-01 00:14:10,11,10,3183,63,3120,4.86%,1.98%
2020-01-01 00:14:10,11,11,9593,657,8936,14.64%,6.85%
2020-01-01 00:14:10,11,12,6182,308,5874,9.43%,4.98%
2020-01-01 00:14:10,12,1,77,0,77,0.12%,0.00%
2020-01-01 00:14:10,12,2,725,268,457,1.11%,36.91%
2020-01-01 00:14:10,12,3,3560,350,3210,5.43%,9.83%
2020-01-01 00:14:10,12,4,3554,83,3471,5.42%,2.33%
2020-01-01 00:14:10,12,5,10153,974,9179,15.49%,9.59%
2020-01-01 00:14:10,12,6,5960,270,5690,9.09%,4.53%
2020-01-01 00:14:10,12,7,2303,44,2259,3.51%,1.91%
2020-01-01 00:14:10,12,8,1056,290,766,1.61%,27.44%
2020-01-01 00:14:10,12,9,22601,4575,18026,34.49%,20.24%
2020-01-01 00:14:10,12,10,3906,381,3525,5.96%,9.75%
2020-01-01 00:14:10,12,11,1461,294,1167,2.23%,20.11%
2020-01-01 00:14:10,12,12,7428,1074,6354,11.33%,14.46%
2020-01-01 00:14:10,13,1,1987,34,1953,3.03%,1.71%
2020-01-01 00:14:10,13,2,2570,47,2523,3.92%,1.83%
2020-01-01 00:14:10,13,3,832,6,826,1.27%,0.72%
2020-01-01 00:14:10,13,4,4738,548,4190,7.23%,11.56%
2020-01-01 00:14:10,13,5,6947,865,6082,10.60%,12.45%
2020-01-01 00:14:10,13,6,5379,599,4780,8.21%,11.13%
2020-01-01 00:14:10,13,7,5092,183,4909,7.77%,3.59%
2020-01-01 00:14:10,13,8,6773,339,6434,10.33%,5.00%
2020-01-01 00:14:10,13,9,7174,884,6290,10.95%,12.32%
2020-01-01 00:14:10,13,10,25950,5152,20798,39.60%,19.85%
2020-01-01 00:14:10,13,11,16370,2139,14231,24.98%,13.07%
2020-01-01 00:14:10,13,12,9145,879,8266,13.95%,9.61%
2020-01-01 00:14:10,14,1,499,1,498,0.76%,0.20%
2020-01-01 00:14:10,14,2,2266,48,2218,3.46%,2.12%
2020-01-01 00:14:10,14,3,1185,18,1167,1.81%,1.52%
2020-01-01 00:14:10,14,4,4525,167,4358,6.90%,3.69%
2020-01-01 00:14:10,14,5,1220,11,1209,1.86%,0.90%
2020-01-01 00:14:10,14,6,4910,191,4719,7.49%,3.89%
2020-01-01 00:14:10,14,7,12350,1106,11244,18.84%,8.95%
2020-01-01 00:14:10,14,8,13949,1414,12535,21.28%,10.14%
2020-01-01 00:14:10,14,9,1681,18,1663,2.57%,1.07%
2020-01-01 00:14:10,14,10,4194,142,4052,6.40%,3.38%
2020-01-01 00:14:10,14,11,25446,4342,21104,38.83%,17.06%
2020-01-01 00:14:10,14,12,7112,362,6750,10.85%,5.09%
2020-01-01 00:14:10,15,1,421,4,417,0.64%,0.95%
2020-01-01 00:14:10,15,2,130,0,130,0.20%,0.00%
2020-01-01 00:14:10,15,3,3963,133,3830,6.05%,3.36%
2020-01-01 00:14:10,15,4,6279,277,6002,9.58%,4.41%
2020-01-01 00:14:10,15,5,10965,873,10092,16.73%,7.96%
2020-01-01 00:14:10,15,6,6423,291,6132,9.80%,4.53%
2020-01-01 00:14:10,15,7,3709,111,3598,5.66%,2.99%
2020-01-01 00:14:10,15,8,6609,332,6277,10.08%,5.02%
2020-01-01 00:14:10,15,9,11096,895,10201,16.93%,8.07%
2020-01-01 00:14:10,15,10,3835,122,3713,5.85%,3.18%
2020-01-01 00:14:10,15,11,10691,863,9828,16.31%,8.07%
2020-01-01 00:14:10,15,12,26588,4989,21599,40.57%,18.76%
2020-01-01 00:14:10,16,1,456,2,454,0.70%,0.44%
2020-01-01 00:14:10,16,2,291,0,291,0.44%,0.00%
2020-01-01 00:14:10,16,3,3983,116,3867,6.08%,2.91%
2020-01-01 00:14:10,16,4,3983,107,3876,6.08%,2.69%
2020-01-01 00:14:10,16,5,10134,821,9313,15.46%,8.10%
2020-01-01 00:14:10,16,6,4767,160,4607,7.27%,3.36%
2020-01-01 00:14:10,16,7,2979,73,2906,4.55%,2.45%
2020-01-01 00:14:10,16,8,6832,374,6458,10.42%,5.47%
2020-01-01 00:14:10,16,9,10605,883,9722,16.18%,8.33%
2020-01-01 00:14:10,16,10,1371,16,1355,2.09%,1.17%
2020-01-01 00:14:10,16,11,8599,590,8009,13.12%,6.86%
2020-01-01 00:14:10,16,12,28004,5372,22632,42.73%,19.18%
2020-01-01 00:14:20,1,1,22239,3432,18807,33.93%,15.43%
2020-01-01 00:14:20,1,2,7031,392,6639,10.73%,5.57%
2020-01-01 00:14:20,1,3,902,2,900,1.38%,0.22%
2020-01-01 00:14:20,1,4,14857,1614,13243,22.67%,10.86%
2020-01-01 00:14:20,1,5,14364,1495,12869,21.92%,10.41%
2020-01-01 00:14:20,1,6,14375,1499,12876,21.93%,10.43%
2020-01-01 00:14:20,1,7,6118,308,5810,9.34%,5.03%
2020-01-01 00:14:20,1,8,4652,178,4474,7.10%,3.83%
2020-01-01 00:14:20,1,9,14319,1485,12834,21.85%,10.37%
2020-01-01 00:14:20,1,10,3720,98,3622,5.68%,2.63%
2020-01-01 00:14:20,1,11,3834,110,3724,5.85%,2.87%
2020-01-01 00:14:20,1,12,14302,1482,12820,21.82%,10.36%
2020-01-01 00:14:20,2,1,1686,16,1670,2.57%,0.95%
2020-01-01 00:14:20,2,2,27376,5040,22336,41.77%,18.41%
2020-01-01 00:14:20,2,3,21727,3304,18423,33.15%,15.21%
2020-01-01 00:14:20,2,4,1586,9,1577,2.42%,0.57%
2020-01-01 00:14:20,2,5,13506,1281,12225,20.61%,9.48%
2020-01-01 00:14:20,2,6,17,1,16,0.03%,5.56%
2020-01-01 00:14:20,2,7,3942,106,3836,6.02%,2.69%
2020-01-01 00:14:20,2,8,2876,56,2820,4.39%,1.95%
2020-01-01 00:14:20,2,9,13104,1208,11896,20.00%,9.22%
2020-01-01 00:14:20,2,10,2199,35,2164,3.36%,1.59%
2020-01-01 00:14:20,2,11,2212,35,2177,3.38%,1.58%
2020-01-01 00:14:20,2,12,12863,1180,11683,19.63%,9.17%
2020-01-01 00:14:20,3,1,1448,19,1429,2.21%,1.31%
2020-01-01 00:14:20,3,2,23481,3751,19730,35.83%,15.97%
2020-01-01 00:14:20,3,3,71275,27960,43315,108.76%,39.23%
2020-01-01 00:14:20,3,4,6126,249,5877,9.35%,4.06%
2020-01-01 00:14:20,3,5,46028,12949,33079,70.23%,28.13%
2020-01-01 00:14:20,3,6,7355,376,6979,11.22%,5.11%
2020-01-01 00:14:20,3,7,20373,2841,17532,31.09%,13.94%
2020-01-01 00:14:20,3,8,17613,2126,15487,26.88%,12.07%
2020-01-01 00:14:20,3,9,38395,9372,29023,58.59%,24.41%
2020-01-01 00:14:20,3,10,5485,206,5279,8.37%,3.76%
2020-01-01 00:14:20,3,11,2556,36,2520,3.90%,1.41%
2020-01-01 00:14:20,3,12,30660,6211,24449,46.78%,20.26%
2020-01-01 00:14:20,4,1,409,0,409,0.62%,0.00%
2020-01-01 00:14:20,4,2,186,0,186,0.28%,0.00%
2020-01-01 00:14:20,4,3,960,8,952,1.46%,0.83%
2020-01-01 00:14:20,4,4,27832,5095,22737,42.47%,18.31%
2020-01-01 00:14:20,4,5,18140,2192,15948,27.68%,12.08%
2020-01-01 00:14:20,4,6,23661,3690,19971,36.10%,15.59%
2020-01-01 00:14:20,4,7,4248,124,4124,6.48%,2.92%
2020-01-01 00:14:20,4,8,2792,56,2736,4.26%,2.01%
2020-01-01 00:14:20,4,9,15955,1716,14239,24.35%,10.75%
2020-01-01 00:14:20,4,10,1992,25,1967,3.04%,1.25%
2020-01-01 00:14:20,4,11,146,0,146,0.22%,0.00%
2020-01-01 00:14:20,4,12,13213,1186,12027,20.16%,8.98%
2020-01-01 00:14:20,5,1,2494,48,2446,3.81%,1.92%
2020-01-01 00:14:20,5,2,937,9,928,1.43%,0.96%
2020-01-01 00:14:20,5,3,568,3,565,0.87%,0.53%
2020-01-01 00:14:20,5,4,31963,6617,25346,48.77%,20.70%
2020-01-01 00:14:20,5,5,9567,695,8872,14.60%,7.26%
2020-01-01 00:14:20,5,6,24531,4046,20485,37.43%,16.49%
2020-01-01 00:14:20,5,7,14295,1505,12790,21.81%,10.53%
2020-01-01 00:14:20,5,8,3758,120,3638,5.73%,3.19%
2020-01-01 00:14:20,5,9,8861,608,8253,13.52%,6.86%
2020-01-01 00:14:20,5,10,1100,13,1087,1.68%,1.18%
2020-01-01 00:14:20,5,11,1010,12,998,1.54%,1.19%
2020-01-01 00:14:20,5,12,7377,429,6948,11.26%,5.81%
2020-01-01 00:14:20,6,1,949,10,939,1.45%,1.05%
2020-01-01 00:14:20,6,2,1066,12,1054,1.63%,1.12%
2020-01-01 00:14:20,6,3,1425,16,1409,2.17%,1.12%
2020-01-01 00:14:20,6,4,1418,25,1393,2.16%,1.76%
2020-01-01 00:14:20,6,5,16992,1950,15042,25.93%,11.48%
2020-01-01 00:14:20,6,6,4815,168,4647,7.35%,3.49%
2020-01-01 00:14:20,6,7,2863,61,2802,4.37%,2.13%
2020-01-01 00:14:20,6,8,2036,27,2009,3.11%,1.33%
2020-01-01 00:14:20,6,9,10413,782,9631,15.89%,7.51%
2020-01-01 00:14:20,6,10,2092,34,2058,3.19%,1.62%
2020-01-01 00:14:20,6,11,399,0,399,0.61%,0.00%
2020-01-01 00:14:20,6,12,8244,497,7747,12.58%,6.03%
2020-01-01 00:14:20,7,1,525,2,523,0.80%,0.38%
2020-01-01 00:14:20,7,2,96,0,96,0.15%,0.00%
2020-01-01 00:14:20,7,3,1032,9,1023,1.57%,0.87%
2020-01-01 00:14:20,7,4,2509,53,2456,3.83%,2.11%
2020-01-01 00:14:20,7,5,6611,269,6342,10.09%,4.07%
2020-01-01 00:14:20,7,6,12499,1043,11456,19.07%,8.34%
2020-01-01 00:14:20,7,7,3319,82,3237,5.06%,2.47%
2020-01-01 00:14:20,7,8,1140,13,1127,1.74%,1.14%
2020-01-01 00:14:20,7,9,5488,186,5302,8.37%,3.39%
2020-01-01 00:14:20,7,10,841,0,841,1.28%,0.00%
2020-01-01 00:14:20,7,11,140,0,140,0.21%,0.00%
2020-01-01 00:14:20,7,12,4635,137,4498,7.07%,2.96%
2020-01-01 00:14:20,8,1,417,2,415,0.64%,0.48%
2020-01-01 00:14:20,8,2,69,0,69,0.11%,0.00%
2020-01-01 00:14:20,8,3,1430,21,1409,2.18%,1.47%
2020-01-01 00:14:20,8,4,3003,68,2935,4.58%,2.26%
2020-01-01 00:14:20,8,5,8069,497,7572,12.31%,6.16%
2020-01-01 00:14:20,8,6,15886,1826,14060,24.24%,11.49%
2020-01-01 00:14:20,8,7,4717,174,4543,7.20%,3.69%
2020-01-01 00:14:20,8,8,1946,46,1900,2.97%,2.36%
2020-01-01 00:14:20,8,9,6350,300,6050,9.69%,4.72%
2020-01-01 00:14:20,8,10,1736,23,1713,2.65%,1.32%
2020-01-01 00:14:20,8,11,343,0,343,0.52%,0.00%
2020-01-01 00:14:20,8,12,4533,144,4389,6.92%,3.18%
2020-01-01 00:14:20,9,1,220,3,217,0.34%,1.36%
2020-01-01 00:14:20,9,2,3327,100,3227,5.08%,3.00%
2020-01-01 00:14:20,9,3,2589,58,2531,3.95%,2.24%
2020-01-01 00:14:20,9,4,8130,485,7645,12.41%,5.96%
2020-01-01 00:14:20,9,5,171,1,170,0.26%,0.58%
2020-01-01 00:14:20,9,6,8581,541,8040,13.09%,6.30%
2020-01-01 00:14:20,9,7,28955,5671,23284,44.18%,19.58%
2020-01-01 00:14:20,9,8,11439,999,10440,17.45%,8.73%
2020-01-01 00:14:20,9,9,135,1,134,0.21%,0.74%
2020-01-01 00:14:20,9,10,3855,143,3712,5.88%,3.71%
2020-01-01 00:14:20,9,11,9249,649,8600,14.11%,7.02%
2020-01-01 00:14:20,9,12,5120,197,4923,7.81%,3.85%
2020-01-01 00:14:20,10,1,1172,434,738,1.79%,37.00%
2020-01-01 00:14:20,10,2,2463,456,2007,3.76%,18.51%
2020-01-01 00:14:20,10,3,1147,9,1138,1.75%,0.78%
2020-01-01 00:14:20,10,4,4454,993,3461,6.80%,22.29%
2020-01-01 00:14:20,10,5,552,4,548,0.84%,0.72%
2020-01-01 00:14:20,10,6,6287,1109,5178,9.59%,17.64%
2020-01-01 00:14:20,10,7,10483,1932,8551,16.00%,18.43%
2020-01-01 00:14:20,10,8,25724,6349,19375,39.25%,24.68%
2020-01-01 00:14:20,10,9,644,4,640,0.98%,0.62%
2020-01-01 00:14:20,10,10,2378,60,2318,3.63%,2.52%
2020-01-01 00:14:20,10,11,11980,1433,10547,18.28%,11.96%
2020-01-01 00:14:20,10,12,9082,992,8090,13.86%,10.92%
2020-01-01 00:14:20,11,1,2684,64,2620,4.10%,2.38%
2020-01-01 00:14:20,11,2,5637,229,5408,8.60%,4.06%
2020-01-01 00:14:20,11,3,2843,45,2798,4.34%,1.58%
2020-01-01 00:14:20,11,4,3313,91,3222,5.06%,2.75%
2020-01-01 00:14:20,11,5,579,4,575,0.88%,0.69%
2020-01-01 00:14:20,11,6,4526,184,4342,6.91%,4.06%
2020-01-01 00:14:20,11,7,12421,1148,11273,18.95%,9.24%
2020-01-01 00:14:20,11,8,27525,5080,22445,42.00%,18.46%
2020-01-01 00:14:20,11,9,290,3,287,0.44%,1.03%
2020-01-01 00:14:20,11,10,3473,93,3380,5.30%,2.68%
2020-01-01 00:14:20,11,11,11004,932,10072,16.79%,8.47%
2020-01-01 00:14:20,11,12,7355,422,6933,11.22%,5.74%
2020-01-01 00:14:20,12,1,27,0,27,0.04%,0.00%
2020-01-01 00:14:20,12,2,725,267,458,1.11%,36.78%
2020-01-01 00:14:20,12,3,2909,316,2593,4.44%,10.86%
2020-01-01 00:14:20,12,4,3283,109,3174,5.01%,3.32%
2020-01-01 00:14:20,12,5,9568,953,8615,14.60%,9.96%
2020-01-01 00:14:20,12,6,5801,256,5545,8.85%,4.41%
2020-01-01 00:14:20,12,7,2393,37,2356,3.65%,1.55%
2020-01-01 00:14:20,12,8,945,197,748,1.44%,20.82%
2020-01-01 00:14:20,12,9,21017,3951,17066,32.07%,18.80%
2020-01-01 00:14:20,12,10,3736,279,3457,5.70%,7.47%
2020-01-01 00:14:20,12,11,1195,198,997,1.82%,16.56%
2020-01-01 00:14:20,12,12,7128,790,6338,10.88%,11.08%
2020-01-01 00:14:20,13,1,1973,35,1938,3.01%,1.77%
2020-01-01 00:14:20,13,2,2222,45,2177,3.39%,2.02%
2020-01-01 00:14:20,13,3,1053,5,1048,1.61%,0.47%
2020-01-01 00:14:20,13,4,5054,429,4625,7.71%,8.49%
2020-01-01 00:14:20,13,5,7617,766,6851,11.62%,10.06%
2020-01-01 00:14:20,13,6,5592,465,5127,8.53%,8.31%
2020-01-01 00:14:20,13,7,4282,138,4144,6.53%,3.22%
2020-01-01 00:14:20,13,8,5827,258,5569,8.89%,4.43%
2020-01-01 00:14:20,13,9,7852,784,7068,11.98%,9.98%
2020-01-01 00:14:20,13,10,24968,4771,20197,38.10%,19.11%
2020-01-01 00:14:20,13,11,14568,1873,12695,22.23%,12.86%
2020-01-01 00:14:20,13,12,8265,860,7405,12.61%,10.40%
2020-01-01 00:14:20,14,1,651,1,650,0.99%,0.15%
2020-01-01 00:14:20,14,2,2439,42,2397,3.72%,1.72%
2020-01-01 00:14:20,14,3,1592,23,1569,2.43%,1.44%
2020-01-01 00:14:20,14,4,4248,165,4083,6.48%,3.88%
2020-01-01 00:14:20,14,5,1388,17,1371,2.12%,1.22%
2020-01-01 00:14:20,14,6,4649,185,4464,7.09%,3.98%
2020-01-01 00:14:20,14,7,12278,1102,11176,18.73%,8.97%
2020-01-01 00:14:20,14,8,13509,1328,12181,20.61%,9.83%
2020-01-01 00:14:20,14,9,1677,23,1654,2.56%,1.37%
2020-01-01 00:14:20,14,10,4323,137,4186,6.60%,3.17%
2020-01-01 00:14:20,14,11,24318,4007,20311,37.11%,16.48%
2020-01-01 00:14:20,14,12,6264,288,5976,9.56%,4.60%
2020-01-01 00:14:20,15,1,412,1,411,0.63%,0.24%
2020-01-01 00:14:20,15,2,165,2,163,0.25%,1.20%
2020-01-01 00:14:20,15,3,3707,127,3580,5.66%,3.43%
2020-01-01 00:14:20,15,4,4372,126,4246,6.67%,2.88%
2020-01-01 00:14:20,15,5,9227,630,8597,14.08%,6.83%
2020-01-01 00:14:20,15,6,4578,135,4443,6.99%,2.95%
2020-01-01 00:14:20,15,7,3556,110,3446,5.43%,3.09%
2020-01-01 00:14:20,15,8,5176,221,4955,7.90%,4.27%
2020-01-01 00:14:20,15,9,9394,655,8739,14.33%,6.97%
2020-01-01 00:14:20,15,10,4011,134,3877,6.12%,3.34%
2020-01-01 00:14:20,15,11,9287,661,8626,14.17%,7.12%
2020-01-01 00:14:20,15,12,24486,4315,20171,37.36%,17.62%
2020-01-01 00:14:20,16,1,386,0,386,0.59%,0.00%
2020-01-01 00:14:20,16,2,199,1,198,0.30%,0.50%
2020-01-01 00:14:20,16,3,1365,15,1350,2.08%,1.10%
2020-01-01 00:14:20,16,4,4577,159,4418,6.98%,3.47%
2020-01-01 00:14:20,16,5,7962,573,7389,12.15%,7.20%
2020-01-01 00:14:20,16,6,5315,212,5103,8.11%,3.99%
2020-01-01 00:14:20,16,7,2952,55,2897,4.50%,1.86%
2020-01-01 00:14:20,16,8,6625,296,6329,10.11%,4.47%
2020-01-01 00:14:20,16,9,8400,627,7773,12.82%,7.46%
2020-01-01 00:14:20,16,10,2976,59,2917,4.54%,1.98%
2020-01-01 00:14:20,16,11,9760,637,9123,14.89%,6.53%
2020-01-01 00:14:20,16,12,26946,5008,21938,41.12%,18.58%
2020-01-01 00:14:30,1,1,16765,2064,14701,25.58%,12.31%
2020-01-01 00:14:30,1,2,5306,240,5066,8.10%,4.52%
2020-01-01 00:14:30,1,3,514,4,510,0.78%,0.78%
2020-01-01 00:14:30,1,4,11130,938,10192,16.98%,8.43%
2020-01-01 00:14:30,1,5,10871,901,9970,16.59%,8.29%
2020-01-01 00:14:30,1,6,10809,887,9922,16.49%,8.21%
2020-01-01 00:14:30,1,7,4784,191,4593,7.30%,3.99%
2020-01-01 00:14:30,1,8,3957,122,3835,6.04%,3.08%
2020-01-01 00:14:30,1,9,10782,884,9898,16.45%,8.20%
2020-01-01 00:14:30,1,10,3449,92,3357,5.26%,2.67%
2020-01-01 00:14:30,1,11,3490,94,3396,5.33%,2.69%
2020-01-01 00:14:30,1,12,10763,881,9882,16.42%,8.18%
2020-01-01 00:14:30,2,1,1019,7,1012,1.55%,0.69%
2020-01-01 00:14:30,2,2,26137,4585,21552,39.88%,17.54%
2020-01-01 00:14:30,2,3,20369,2860,17509,31.08%,14.04%
2020-01-01 00:14:30,2,4,903,6,897,1.38%,0.66%
2020-01-01 00:14:30,2,5,13620,1324,12296,20.78%,9.72%
2020-01-01 00:14:30,2,6,26,0,26,0.04%,0.00%
2020-01-01 00:14:30,2,7,4734,184,4550,7.22%,3.89%
2020-01-01 00:14:30,2,8,3576,103,3473,5.46%,2.88%
2020-01-01 00:14:30,2,9,13515,1301,12214,20.62%,9.63%
2020-01-01 00:14:30,2,10,2707,59,2648,4.13%,2.18%
2020-01-01 00:14:30,2,11,2730,60,2670,4.17%,2.20%
2020-01-01 00:14:30,2,12,13330,1269,12061,20.34%,9.52%
2020-01-01 00:14:30,3,1,1341,5,1336,2.05%,0.37%
2020-01-01 00:14:30,3,2,21271,3144,18127,32.46%,14.78%
2020-01-01 00:14:30,3,3,70917,27638,43279,108.21%,38.97%
2020-01-01 00:14:30,3,4,13984,1423,12561,21.34%,10.18%
2020-01-01 00:14:30,3,5,46319,13123,33196,70.68%,28.33%
2020-01-01 00:14:30,3,6,16036,1838,14198,24.47%,11.46%
2020-01-01 00:14:30,3,7,17640,2208,15432,26.92%,12.52%
2020-01-01 00:14:30,3,8,14876,1577,13299,22.70%,10.60%
2020-01-01 00:14:30,3,9,29916,5881,24035,45.65%,19.66%
2020-01-01 00:14:30,3,10,5332,216,5116,8.14%,4.05%
2020-01-01 00:14:30,3,11,1914,24,1890,2.92%,1.25%
2020-01-01 00:14:30,3,12,21037,3000,18037,32.10%,14.26%
2020-01-01 00:14:30,4,1,558,1,557,0.85%,0.18%
2020-01-01 00:14:30,4,2,327,1,326,0.50%,0.30%
2020-01-01 00:14:30,4,3,829,6,823,1.26%,0.72%
2020-01-01 00:14:30,4,4,28174,5332,22842,42.99%,18.92%
2020-01-01 00:14:30,4,5,17914,2224,15690,27.33%,12.41%
2020-01-01 00:14:30,4,6,23970,3899,20071,36.58%,16.27%
2020-01-01 00:14:30,4,7,4817,153,4664,7.35%,3.18%
2020-01-01 00:14:30,4,8,2631,45,2586,4.01%,1.71%
2020-01-01 00:14:30,4,9,15703,1697,14006,23.96%,10.81%
2020-01-01 00:14:30,4,10,2335,57,2278,3.56%,2.44%
2020-01-01 00:14:30,4,11,138,0,138,0.21%,0.00%
2020-01-01 00:14:30,4,12,12642,1121,11521,19.29%,8.87%
2020-01-01 00:14:30,5,1,3006,69,2937,4.59%,2.29%
2020-01-01 00:14:30,5,2,1427,18,1409,2.18%,1.26%
2020-01-01 00:14:30,5,3,650,3,647,0.99%,0.46%
2020-01-01 00:14:30,5,4,25909,4545,21364,39.53%,17.54%
2020-01-01 00:14:30,5,5,9757,723,9034,14.89%,7.41%
2020-01-01 00:14:30,5,6,16231,1895,14336,24.77%,11.67%
2020-01-01 00:14:30,5,7,6052,281,5771,9.23%,4.64%
2020-01-01 00:14:30,5,8,4327,127,4200,6.60%,2.93%
2020-01-01 00:14:30,5,9,8985,617,8368,13.71%,6.87%
2020-01-01 00:14:30,5,10,792,10,782,1.21%,1.26%
2020-01-01 00:14:30,5,11,701,8,693,1.07%,1.14%
2020-01-01 00:14:30,5,12,7964,472,7492,12.15%,5.93%
2020-01-01 00:14:30,6,1,1103,10,1093,1.68%,0.91%
2020-01-01 00:14:30,6,2,1172,10,1162,1.79%,0.85%
2020-01-01 00:14:30,6,3,1650,18,1632,2.52%,1.09%
2020-01-01 00:14:30,6,4,1597,15,1582,2.44%,0.94%
2020-01-01 00:14:30,6,5,14467,1499,12968,22.07%,10.36%
2020-01-01 00:14:30,6,6,4625,149,4476,7.06%,3.22%
2020-01-01 00:14:30,6,7,2558,53,2505,3.90%,2.07%
2020-01-01 00:14:30,6,8,2029,34,1995,3.10%,1.67%
2020-01-01 00:14:30,6,9,7930,495,7435,12.10%,6.24%
2020-01-01 00:14:30,6,10,2538,63,2475,3.87%,2.48%
2020-01-01 00:14:30,6,11,525,2,523,0.80%,0.38%
2020-01-01 00:14:30,6,12,5315,213,5102,8.11%,4.01%
2020-01-01 00:14:30,7,1,289,10,279,0.44%,3.45%
2020-01-01 00:14:30,7,2,118,0,118,0.18%,0.00%
2020-01-01 00:14:30,7,3,1706,14,1692,2.60%,0.82%
2020-01-01 00:14:30,7,4,1645,26,1619,2.51%,1.58%
2020-01-01 00:14:30,7,5,8348,534,7814,12.74%,6.40%
2020-01-01 00:14:30,7,6,13250,1276,11974,20.22%,9.63%
2020-01-01 00:14:30,7,7,3206,79,3127,4.89%,2.46%
2020-01-01 00:14:30,7,8,1247,18,1229,1.90%,1.44%
2020-01-01 00:14:30,7,9,6597,333,6264,10.07%,5.05%
2020-01-01 00:14:30,7,10,1318,13,1305,2.01%,0.99%
2020-01-01 00:14:30,7,11,106,0,106,0.16%,0.00%
2020-01-01 00:14:30,7,12,5209,203,5006,7.95%,3.90%
2020-01-01 00:14:30,8,1,361,1,360,0.55%,0.28%
2020-01-01 00:14:30,8,2,145,0,145,0.22%,0.00%
2020-01-01 00:14:30,8,3,1474,22,1452,2.25%,1.49%
2020-01-01 00:14:30,8,4,2676,41,2635,4.08%,1.53%
2020-01-01 00:14:30,8,5,8081,460,7621,12.33%,5.69%
2020-01-01 00:14:30,8,6,16340,1877,14463,24.93%,11.49%
2020-01-01 00:14:30,8,7,5479,214,5265,8.36%,3.91%
2020-01-01 00:14:30,8,8,2018,29,1989,3.08%,1.44%
2020-01-01 00:14:30,8,9,6409,275,6134,9.78%,4.29%
2020-01-01 00:14:30,8,10,1743,22,1721,2.66%,1.26%
2020-01-01 00:14:30,8,11,181,0,181,0.28%,0.00%
2020-01-01 00:14:30,8,12,4638,138,4500,7.08%,2.97%
2020-01-01 00:14:30,9,1,2227,18,2209,3.40%,0.81%
2020-01-01 00:14:30,9,2,4451,167,4284,6.79%,3.75%
2020-01-01 00:14:30,9,3,1861,26,1835,2.84%,1.40%
2020-01-01 00:14:30,9,4,6692,324,6368,10.21%,4.84%
2020-01-01 00:14:30,9,5,127,0,127,0.19%,0.00%
2020-01-01 00:14:30,9,6,7398,398,7000,11.29%,5.38%
2020-01-01 00:14:30,9,7,30176,6035,24141,46.04%,20.00%
2020-01-01 00:14:30,9,8,10975,855,10120,16.75%,7.79%
2020-01-01 00:14:30,9,9,112,0,112,0.17%,0.00%
2020-01-01 00:14:30,9,10,1827,25,1802,2.79%,1.37%
2020-01-01 00:14:30,9,11,9351,642,8709,14.27%,6.86%
2020-01-01 00:14:30,9,12,7303,392,6911,11.14%,5.37%
2020-01-01 00:14:30,10,1,1146,181,965,1.75%,15.78%
2020-01-01 00:14:30,10,2,2820,236,2584,4.30%,8.37%
2020-01-01 00:14:30,10,3,1465,29,1436,2.24%,1.98%
2020-01-01 00:14:30,10,4,3963,781,3182,6.05%,19.70%
2020-01-01 00:14:30,10,5,560,2,558,0.85%,0.36%
2020-01-01 00:14:30,10,6,5581,868,4713,8.52%,15.55%
2020-01-01 00:14:30,10,7,10421,1529,8892,15.90%,14.67%
2020-01-01 00:14:30,10,8,28732,7040,21692,43.84%,24.50%
2020-01-01 00:14:30,10,9,422,2,420,0.64%,0.47%
2020-01-01 00:14:30,10,10,2507,48,2459,3.83%,1.91%
2020-01-01 00:14:30,10,11,14597,2077,12520,22.27%,14.23%
2020-01-01 00:14:30,10,12,11497,1520,9977,17.54%,13.22%
2020-01-01 00:14:30,11,1,2109,47,2062,3.22%,2.23%
2020-01-01 00:14:30,11,2,3322,95,3227,5.07%,2.86%
2020-01-01 00:14:30,11,3,1031,8,1023,1.57%,0.78%
2020-01-01 00:14:30,11,4,5934,362,5572,9.05%,6.10%
2020-01-01 00:14:30,11,5,221,2,219,0.34%,0.90%
2020-01-01 00:14:30,11,6,6747,434,6313,10.30%,6.43%
2020-01-01 00:14:30,11,7,12188,1145,11043,18.60%,9.39%
2020-01-01 00:14:30,11,8,25618,4490,21128,39.09%,17.53%
2020-01-01 00:14:30,11,9,284,0,284,0.43%,0.00%
2020-01-01 00:14:30,11,10,3056,60,2996,4.66%,1.96%
2020-01-01 00:14:30,11,11,9490,642,8848,14.48%,6.76%
2020-01-01 00:14:30,11,12,6018,277,5741,9.18%,4.60%
2020-01-01 00:14:30,12,1,99,0,99,0.15%,0.00%
2020-01-01 00:14:30,12,2,543,220,323,0.83%,40.44%
2020-01-01 00:14:30,12,3,2577,276,2301,3.93%,10.71%
2020-01-01 00:14:30,12,4,3272,68,3204,4.99%,2.08%
2020-01-01 00:14:30,12,5,9613,941,8672,14.67%,9.79%
2020-01-01 00:14:30,12,6,6166,342,5824,9.41%,5.55%
2020-01-01 00:14:30,12,7,2640,134,2506,4.03%,5.07%
2020-01-01 00:14:30,12,8,1718,271,1447,2.62%,15.76%
2020-01-01 00:14:30,12,9,22448,4611,17837,34.25%,20.54%
2020-01-01 00:14:30,12,10,4284,390,3894,6.54%,9.10%
2020-01-01 00:14:30,12,11,1932,274,1658,2.95%,14.17%
2020-01-01 00:14:30,12,12,8037,1233,6804,12.26%,15.34%
2020-01-01 00:14:30,13,1,2835,54,2781,4.33%,1.90%
2020-01-01 00:14:30,13,2,3070,62,3008,4.68%,2.02%
2020-01-01 00:14:30,13,3,755,5,750,1.15%,0.66%
2020-01-01 00:14:30,13,4,5399,412,4987,8.24%,7.63%
2020-01-01 00:14:30,13,5,7552,700,6852,11.52%,9.27%
2020-01-01 00:14:30,13,6,5947,451,5496,9.07%,7.58%
2020-01-01 00:14:30,13,7,5448,238,5210,8.31%,4.37%
2020-01-01 00:14:30,13,8,8016,512,7504,12.23%,6.39%
2020-01-01 00:14:30,13,9,7956,738,7218,12.14%,9.27%
2020-01-01 00:14:30,13,10,29528,6303,23225,45.06%,21.35%
2020-01-01 00:14:30,13,11,18076,2645,15431,27.58%,14.63%
2020-01-01 00:14:30,13,12,9700,1055,8645,14.80%,10.88%
2020-01-01 00:14:30,14,1,288,0,288,0.44%,0.00%
2020-01-01 00:14:30,14,2,1654,11,1643,2.52%,0.66%
2020-01-01 00:14:30,14,3,1029,2,1027,1.57%,0.19%
2020-01-01 00:14:30,14,4,5892,242,5650,8.99%,4.11%
2020-01-01 00:14:30,14,5,1795,24,1771,2.74%,1.34%
2020-01-01 00:14:30,14,6,6210,271,5939,9.48%,4.36%
2020-01-01 00:14:30,14,7,13495,1263,12232,20.59%,9.36%
2020-01-01 00:14:30,14,8,15160,1591,13569,23.13%,10.49%
2020-01-01 00:14:30,14,9,1999,31,1968,3.05%,1.55%
2020-01-01 00:14:30,14,10,4716,206,4510,7.20%,4.37%
2020-01-01 00:14:30,14,11,28289,5366,22923,43.17%,18.97%
2020-01-01 00:14:30,14,12,8296,529,7767,12.66%,6.38%
2020-01-01 00:14:30,15,1,685,3,682,1.05%,0.44%
2020-01-01 00:14:30,15,2,190,2,188,0.29%,1.05%
2020-01-01 00:14:30,15,3,4317,132,4185,6.59%,3.06%
2020-01-01 00:14:30,15,4,5351,241,5110,8.16%,4.50%
2020-01-01 00:14:30,15,5,11423,948,10475,17.43%,8.30%
2020-01-01 00:14:30,15,6,5681,264,5417,8.67%,4.65%
2020-01-01 00:14:30,15,7,4462,154,4308,6.81%,3.45%
2020-01-01 00:14:30,15,8,6182,296,5886,9.43%,4.79%
2020-01-01 00:14:30,15,9,11616,982,10634,17.72%,8.45%
2020-01-01 00:14:30,15,10,3855,120,3735,5.88%,3.11%
2020-01-01 00:14:30,15,11,10132,750,9382,15.46%,7.40%
2020-01-01 00:14:30,15,12,27828,5430,22398,42.46%,19.51%
2020-01-01 00:14:30,16,1,400,0,400,0.61%,0.00%
2020-01-01 00:14:30,16,2,213,0,213,0.33%,0.00%
2020-01-01 00:14:30,16,3,1648,26,1622,2.51%,1.58%
2020-01-01 00:14:30,16,4,3946,120,3826,6.02%,3.04%
2020-01-01 00:14:30,16,5,8095,564,7531,12.35%,6.97%
2020-01-01 00:14:30,16,6,4953,194,4759,7.56%,3.92%
2020-01-01 00:14:30,16,7,3335,105,3230,5.09%,3.15%
2020-01-01 00:14:30,16,8,7426,534,6892,11.33%,7.19%
2020-01-01 00:14:30,16,9,8424,597,7827,12.85%,7.09%
2020-01-01 00:14:30,16,10,1777,21,1756,2.71%,1.18%
2020-01-01 00:14:30,16,11,9383,766,8617,14.32%,8.16%
2020-01-01 00:14:30,16,12,25423,4459,20964,38.79%,17.54%
2020-01-01 00:14:40,1,1,28048,5369,22679,42.80%,19.14%
2020-01-01 00:14:40,1,2,13637,1372,12265,20.81%,10.06%
2020-01-01 00:14:40,1,3,301,2,299,0.46%,0.66%
2020-01-01 00:14:40,1,4,13826,1402,12424,21.10%,10.14%
2020-01-01 00:14:40,1,5,13379,1315,12064,20.41%,9.83%
2020-01-01 00:14:40,1,6,13372,1315,12057,20.40%,9.83%
2020-01-01 00:14:40,1,7,13326,1309,12017,20.33%,9.82%
2020-01-01 00:14:40,1,8,6806,325,6481,10.39%,4.77%
2020-01-01 00:14:40,1,9,13334,1306,12028,20.35%,9.79%
2020-01-01 00:14:40,1,10,5564,228,5336,8.49%,4.10%
2020-01-01 00:14:40,1,11,5725,243,5482,8.74%,4.24%
2020-01-01 00:14:40,1,12,13297,1301,11996,20.29%,9.78%
2020-01-01 00:14:40,2,1,603,1,602,0.92%,0.17%
2020-01-01 00:14:40,2,2,24970,4237,20733,38.10%,16.97%
2020-01-01 00:14:40,2,3,19901,2816,17085,30.37%,14.15%
2020-01-01 00:14:40,2,4,542,0,542,0.83%,0.00%
2020-01-01 00:14:40,2,5,11089,901,10188,16.92%,8.12%
2020-01-01 00:14:40,2,6,62,0,62,0.09%,0.00%
2020-01-01 00:14:40,2,7,4448,167,4281,6.79%,3.75%
2020-01-01 00:14:40,2,8,3031,67,2964,4.62%,2.21%
2020-01-01 00:14:40,2,9,10951,885,10066,16.71%,8.08%
2020-01-01 00:14:40,2,10,2016,32,1984,3.08%,1.59%
2020-01-01 00:14:40,2,11,2036,33,2003,3.11%,1.62%
2020-01-01 00:14:40,2,12,10786,865,9921,16.46%,8.02%
2020-01-01 00:14:40,3,1,2702,50,2652,4.12%,1.85%
2020-01-01 00:14:40,3,2,23172,3654,19518,35.36%,15.77%
2020-01-01 00:14:40,3,3,75406,30525,44881,115.06%,40.48%
2020-01-01 00:14:40,3,4,12843,1181,11662,19.60%,9.19%
2020-01-01 00:14:40,3,5,51245,15681,35564,78.19%,30.60%
2020-01-01 00:14:40,3,6,13449,1280,12169,20.52%,9.52%
2020-01-01 00:14:40,3,7,18978,2525,16453,28.96%,13.30%
2020-01-01 00:14:40,3,8,14034,1396,12638,21.41%,9.95%
2020-01-01 00:14:40,3,9,37344,8820,28524,56.98%,23.62%
2020-01-01 00:14:40,3,10,5389,210,5179,8.22%,3.90%
2020-01-01 00:14:40,3,11,1056,8,1048,1.61%,0.76%
2020-01-01 00:14:40,3,12,27183,4902,22281,41.48%,18.03%
2020-01-01 00:14:40,4,1,571,2,569,0.87%,0.35%
2020-01-01 00:14:40,4,2,393,1,392,0.60%,0.25%
2020-01-01 00:14:40,4,3,741,1,740,1.13%,0.13%
2020-01-01 00:14:40,4,4,27991,5212,22779,42.71%,18.62%
2020-01-01 00:14:40,4,5,18049,2345,15704,27.54%,12.99%
2020-01-01 00:14:40,4,6,24481,4068,20413,37.36%,16.62%
2020-01-01 00:14:40,4,7,5104,204,4900,7.79%,4.00%
2020-01-01 00:14:40,4,8,2597,54,2543,3.96%,2.08%
2020-01-01 00:14:40,4,9,16159,1894,14265,24.66%,11.72%
2020-01-01 00:14:40,4,10,2007,51,1956,3.06%,2.54%
2020-01-01 00:14:40,4,11,157,1,156,0.24%,0.63%
2020-01-01 00:14:40,4,12,12827,1223,11604,19.57%,9.53%
2020-01-01 00:14:40,5,1,2848,68,2780,4.35%,2.39%
2020-01-01 00:14:40,5,2,718,6,712,1.10%,0.83%
2020-01-01 00:14:40,5,3,527,3,524,0.80%,0.57%
2020-01-01 00:14:40,5,4,21831,3252,18579,33.31%,14.90%
2020-01-01 00:14:40,5,5,8637,510,8127,13.18%,5.90%
2020-01-01 00:14:40,5,6,15606,1683,13923,23.81%,10.78%
2020-01-01 00:14:40,5,7,6585,348,6237,10.05%,5.28%
2020-01-01 00:14:40,5,8,3320,99,3221,5.07%,2.98%
2020-01-01 00:14:40,5,9,7989,423,7566,12.19%,5.29%
2020-01-01 00:14:40,5,10,967,13,954,1.48%,1.34%
2020-01-01 00:14:40,5,11,449,5,444,0.69%,1.11%
2020-01-01 00:14:40,5,12,6886,311,6575,10.51%,4.52%
2020-01-01 00:14:40,6,1,948,8,940,1.45%,0.84%
2020-01-01 00:14:40,6,2,996,8,988,1.52%,0.80%
2020-01-01 00:14:40,6,3,1724,15,1709,2.63%,0.87%
2020-01-01 00:14:40,6,4,1481,24,1457,2.26%,1.62%
2020-01-01 00:14:40,6,5,12848,1198,11650,19.60%,9.32%
2020-01-01 00:14:40,6,6,4857,205,4652,7.41%,4.22%
2020-01-01 00:14:40,6,7,2797,64,2733,4.27%,2.29%
2020-01-01 00:14:40,6,8,2203,47,2156,3.36%,2.13%
2020-01-01 00:14:40,6,9,6034,261,5773,9.21%,4.32%
2020-01-01 00:14:40,6,10,1952,23,1929,2.98%,1.18%
2020-01-01 00:14:40,6,11,379,0,379,0.58%,0.00%
2020-01-01 00:14:40,6,12,3990,115,3875,6.09%,2.88%
2020-01-01 00:14:40,7,1,419,4,415,0.64%,0.95%
2020-01-01 00:14:40,7,2,180,0,180,0.27%,0.00%
2020-01-01 00:14:40,7,3,545,0,545,0.83%,0.00%
2020-01-01 00:14:40,7,4,1391,11,1380,2.12%,0.79%
2020-01-01 00:14:40,7,5,8146,465,7681,12.43%,5.71%
2020-01-01 00:14:40,7,6,13002,1174,11828,19.84%,9.03%
2020-01-01 00:14:40,7,7,3373,92,3281,5.15%,2.73%
2020-01-01 00:14:40,7,8,1396,12,1384,2.13%,0.86%
2020-01-01 00:14:40,7,9,7548,386,7162,11.52%,5.11%
2020-01-01 00:14:40,7,10,2524,42,2482,3.85%,1.66%
2020-01-01 00:14:40,7,11,241,1,240,0.37%,0.41%
2020-01-01 00:14:40,7,12,4918,169,4749,7.50%,3.44%
2020-01-01 00:14:40,8,1,522,1,521,0.80%,0.19%
2020-01-01 00:14:40,8,2,106,0,106,0.16%,0.00%
2020-01-01 00:14:40,8,3,1587,20,1567,2.42%,1.26%
2020-01-01 00:14:40,8,4,3022,77,2945,4.61%,2.55%
2020-01-01 00:14:40,8,5,7811,471,7340,11.92%,6.03%
2020-01-01 00:14:40,8,6,15928,1805,14123,24.30%,11.33%
2020-01-01 00:14:40,8,7,4692,151,4541,7.16%,3.22%
2020-01-01 00:14:40,8,8,2035,28,2007,3.11%,1.38%
2020-01-01 00:14:40,8,9,5970,283,5687,9.11%,4.74%
2020-01-01 00:14:40,8,10,1510,19,1491,2.30%,1.26%
2020-01-01 00:14:40,8,11,251,0,251,0.38%,0.00%
2020-01-01 00:14:40,8,12,4413,152,4261,6.73%,3.44%
2020-01-01 00:14:40,9,1,1904,10,1894,2.91%,0.52%
2020-01-01 00:14:40,9,2,4419,118,4301,6.74%,2.67%
2020-01-01 00:14:40,9,3,2070,34,2036,3.16%,1.64%
2020-01-01 00:14:40,9,4,4992,207,4785,7.62%,4.15%
2020-01-01 00:14:40,9,5,238,1,237,0.36%,0.42%
2020-01-01 00:14:40,9,6,5713,264,5449,8.72%,4.62%
2020-01-01 00:14:40,9,7,28378,5397,22981,43.30%,19.02%
2020-01-01 00:14:40,9,8,11463,965,10498,17.49%,8.42%
2020-01-01 00:14:40,9,9,126,0,126,0.19%,0.00%
2020-01-01 00:14:40,9,10,4087,125,3962,6.24%,3.06%
2020-01-01 00:14:40,9,11,10535,824,9711,16.08%,7.82%
2020-01-01 00:14:40,9,12,6093,317,5776,9.30%,5.20%
2020-01-01 00:14:40,10,1,1190,172,1018,1.82%,14.44%
2020-01-01 00:14:40,10,2,4138,290,3848,6.31%,7.01%
2020-01-01 00:14:40,10,3,2771,66,2705,4.23%,2.38%
2020-01-01 00:14:40,10,4,3751,905,2846,5.72%,24.12%
2020-01-01 00:14:40,10,5,730,52,678,1.11%,7.11%
2020-01-01 00:14:40,10,6,5278,1037,4241,8.05%,19.64%
2020-01-01 00:14:40,10,7,10965,1801,9164,16.73%,16.42%
2020-01-01 00:14:40,10,8,29904,7514,22390,45.63%,25.13%
2020-01-01 00:14:40,10,9,1176,14,1162,1.79%,1.19%
2020-01-01 00:14:40,10,10,2915,74,2841,4.45%,2.54%
2020-01-01 00:14:40,10,11,14716,2029,12687,22.45%,13.79%
2020-01-01 00:14:40,10,12,10952,1399,9553,16.71%,12.77%
2020-01-01 00:14:40,11,1,2739,56,2683,4.18%,2.04%
2020-01-01 00:14:40,11,2,3579,94,3485,5.46%,2.63%
2020-01-01 00:14:40,11,3,649,4,645,0.99%,0.62%
2020-01-01 00:14:40,11,4,4889,175,4714,7.46%,3.58%
2020-01-01 00:14:40,11,5,1077,6,1071,1.64%,0.56%
2020-01-01 00:14:40,11,6,6679,327,6352,10.19%,4.90%
2020-01-01 00:14:40,11,7,12045,998,11047,18.38%,8.28%
2020-01-01 00:14:40,11,8,25531,4445,21086,38.96%,17.41%
2020-01-01 00:14:40,11,9,149,0,149,0.23%,0.00%
2020-01-01 00:14:40,11,10,2765,57,2708,4.22%,2.06%
2020-01-01 00:14:40,11,11,9464,739,8725,14.44%,7.81%
2020-01-01 00:14:40,11,12,6380,342,6038,9.74%,5.36%
2020-01-01 00:14:40,12,1,42,0,42,0.06%,0.00%
2020-01-01 00:14:40,12,2,589,166,423,0.90%,28.14%
2020-01-01 00:14:40,12,3,2741,239,2502,4.18%,8.72%
2020-01-01 00:14:40,12,4,3389,72,3317,5.17%,2.12%
2020-01-01 00:14:40,12,5,9753,792,8961,14.88%,8.12%
2020-01-01 00:14:40,12,6,6142,236,5906,9.37%,3.84%
2020-01-01 00:14:40,12,7,2547,37,2510,3.89%,1.45%
2020-01-01 00:14:40,12,8,1237,284,953,1.89%,22.94%
2020-01-01 00:14:40,12,9,22439,4200,18239,34.24%,18.72%
2020-01-01 00:14:40,12,10,3829,398,3431,5.84%,10.39%
2020-01-01 00:14:40,12,11,1383,284,1099,2.11%,20.52%
2020-01-01 00:14:40,12,12,8397,1061,7336,12.81%,12.63%
2020-01-01 00:14:40,13,1,2080,22,2058,3.17%,1.06%
2020-01-01 00:14:40,13,2,2447,69,2378,3.73%,2.82%
2020-01-01 00:14:40,13,3,828,5,823,1.26%,0.60%
2020-01-01 00:14:40,13,4,4996,536,4460,7.62%,10.73%
2020-01-01 00:14:40,13,5,7120,772,6348,10.86%,10.84%
2020-01-01 00:14:40,13,6,5627,588,5039,8.59%,10.45%
2020-01-01 00:14:40,13,7,4329,145,4184,6.61%,3.35%
2020-01-01 00:14:40,13,8,6391,297,6094,9.75%,4.65%
2020-01-01 00:14:40,13,9,7428,802,6626,11.33%,10.80%
2020-01-01 00:14:40,13,10,26810,5411,21399,40.91%,20.18%
2020-01-01 00:14:40,13,11,16156,2178,13978,24.65%,13.48%
2020-01-01 00:14:40,13,12,9267,1018,8249,14.14%,10.98%
2020-01-01 00:14:40,14,1,229,1,228,0.35%,0.43%
2020-01-01 00:14:40,14,2,1301,20,1281,1.99%,1.54%
2020-01-01 00:14:40,14,3,885,7,878,1.35%,0.79%
2020-01-01 00:14:40,14,4,4027,115,3912,6.14%,2.86%
2020-01-01 00:14:40,14,5,1296,10,1286,1.98%,0.77%
2020-01-01 00:14:40,14,6,4249,123,4126,6.48%,2.89%
2020-01-01 00:14:40,14,7,12182,1087,11095,18.59%,8.92%
2020-01-01 00:14:40,14,8,13299,1275,12024,20.29%,9.59%
2020-01-01 00:14:40,14,9,1431,13,1418,2.18%,0.91%
2020-01-01 00:14:40,14,10,4128,124,4004,6.30%,3.00%
2020-01-01 00:14:40,14,11,25833,4427,21406,39.42%,17.14%
2020-01-01 00:14:40,14,12,8156,473,7683,12.45%,5.80%
2020-01-01 00:14:40,15,1,494,3,491,0.75%,0.61%
2020-01-01 00:14:40,15,2,196,0,196,0.30%,0.00%
2020-01-01 00:14:40,15,3,3702,81,3621,5.65%,2.19%
2020-01-01 00:14:40,15,4,4794,152,4642,7.32%,3.17%
2020-01-01 00:14:40,15,5,9147,573,8574,13.96%,6.26%
2020-01-01 00:14:40,15,6,4985,164,4821,7.61%,3.29%
2020-01-01 00:14:40,15,7,3462,107,3355,5.28%,3.09%
2020-01-01 00:14:40,15,8,5411,238,5173,8.26%,4.40%
2020-01-01 00:14:40,15,9,9306,602,8704,14.20%,6.47%
2020-01-01 00:14:40,15,10,3847,113,3734,5.87%,2.94%
2020-01-01 00:14:40,15,11,9451,665,8786,14.42%,7.04%
2020-01-01 00:14:40,15,12,25019,4625,20394,38.18%,18.49%
2020-01-01 00:14:40,16,1,539,1,538,0.82%,0.19%
2020-01-01 00:14:40,16,2,217,0,217,0.33%,0.00%
2020-01-01 00:14:40,16,3,2613,55,2558,3.99%,2.10%
2020-01-01 00:14:40,16,4,4511,152,4359,6.88%,3.37%
2020-01-01 00:14:40,16,5,9395,690,8705,14.34%,7.34%
2020-01-01 00:14:40,16,6,5140,185,4955,7.84%,3.60%
2020-01-01 00:14:40,16,7,3421,88,3333,5.22%,2.57%
2020-01-01 00:14:40,16,8,6856,445,6411,10.46%,6.49%
2020-01-01 00:14:40,16,9,9807,756,9051,14.96%,7.71%
2020-01-01 00:14:40,16,10,1491,16,1475,2.28%,1.07%
2020-01-01 00:14:40,16,11,8611,627,7984,13.14%,7.28%
2020-01-01 00:14:40,16,12,26063,4643,21420,39.77%,17.81%
2020-01-01 00:14:50,1,1,22360,3433,18927,34.12%,15.35%
2020-01-01 00:14:50,1,2,10151,727,9424,15.49%,7.16%
2020-01-01 00:14:50,1,3,486,1,485,0.74%,0.21%
2020-01-01 00:14:50,1,4,11615,989,10626,17.72%,8.51%
2020-01-01 00:14:50,1,5,10824,862,9962,16.52%,7.96%
2020-01-01 00:14:50,1,6,10723,846,9877,16.36%,7.89%
2020-01-01 00:14:50,1,7,9649,659,8990,14.72%,6.83%
2020-01-01 00:14:50,1,8,8478,508,7970,12.94%,5.99%
2020-01-01 00:14:50,1,9,10698,844,9854,16.32%,7.89%
2020-01-01 00:14:50,1,10,7877,438,7439,12.02%,5.56%
2020-01-01 00:14:50,1,11,7968,447,7521,12.16%,5.61%
2020-01-01 00:14:50,1,12,10676,839,9837,16.29%,7.86%
2020-01-01 00:14:50,2,1,700,2,698,1.07%,0.29%
2020-01-01 00:14:50,2,2,28219,5244,22975,43.06%,18.58%
2020-01-01 00:14:50,2,3,22520,3388,19132,34.36%,15.04%
2020-01-01 00:14:50,2,4,658,1,657,1.00%,0.15%
2020-01-01 00:14:50,2,5,14244,1431,12813,21.73%,10.05%
2020-01-01 00:14:50,2,6,58,0,58,0.09%,0.00%
2020-01-01 00:14:50,2,7,4986,190,4796,7.61%,3.81%
2020-01-01 00:14:50,2,8,4062,126,3936,6.20%,3.10%
2020-01-01 00:14:50,2,9,14169,1420,12749,21.62%,10.02%
2020-01-01 00:14:50,2,10,2966,67,2899,4.53%,2.26%
2020-01-01 00:14:50,2,11,2979,67,2912,4.55%,2.25%
2020-01-01 00:14:50,2,12,13986,1382,12604,21.34%,9.88%
2020-01-01 00:14:50,3,1,2027,37,1990,3.09%,1.82%
2020-01-01 00:14:50,3,2,22964,3603,19361,35.04%,15.69%
2020-01-01 00:14:50,3,3,69658,26924,42734,106.29%,38.65%
2020-01-01 00:14:50,3,4,10219,779,9440,15.59%,7.62%
2020-01-01 00:14:50,3,5,45161,12578,32583,68.91%,27.85%
2020-01-01 00:14:50,3,6,11566,1007,10559,17.65%,8.71%
2020-01-01 00:14:50,3,7,19299,2600,16699,29.45%,13.47%
2020-01-01 00:14:50,3,8,14645,1518,13127,22.35%,10.36%
2020-01-01 00:14:50,3,9,33268,7168,26100,50.76%,21.55%
2020-01-01 00:14:50,3,10,3171,79,3092,4.84%,2.49%
2020-01-01 00:14:50,3,11,1742,25,1717,2.66%,1.43%
2020-01-01 00:14:50,3,12,26002,4537,21465,39.68%,17.45%
2020-01-01 00:14:50,4,1,540,0,540,0.82%,0.00%
2020-01-01 00:14:50,4,2,401,0,401,0.61%,0.00%
2020-01-01 00:14:50,4,3,1704,14,1690,2.60%,0.82%
2020-01-01 00:14:50,4,4,27827,5119,22708,42.46%,18.40%
2020-01-01 00:14:50,4,5,17286,2099,15187,26.38%,12.14%
2020-01-01 00:14:50,4,6,23879,3855,20024,36.44%,16.14%
2020-01-01 00:14:50,4,7,5252,189,5063,8.01%,3.60%
2020-01-01 00:14:50,4,8,2946,78,2868,4.50%,2.65%
2020-01-01 00:14:50,4,9,14406,1524,12882,21.98%,10.58%
2020-01-01 00:14:50,4,10,1859,38,1821,2.84%,2.04%
2020-01-01 00:14:50,4,11,237,2,235,0.36%,0.84%
2020-01-01 00:14:50,4,12,11765,1036,10729,17.95%,8.81%
2020-01-01 00:14:50,5,1,2777,81,2696,4.24%,2.92%
2020-01-01 00:14:50,5,2,659,3,656,1.01%,0.45%
2020-01-01 00:14:50,5,3,1164,13,1151,1.78%,1.12%
2020-01-01 00:14:50,5,4,23550,3863,19687,35.93%,16.40%
2020-01-01 00:14:50,5,5,9479,700,8779,14.46%,7.38%
2020-01-01 00:14:50,5,6,15056,1661,13395,22.97%,11.03%
2020-01-01 00:14:50,5,7,4960,200,4760,7.57%,4.03%
2020-01-01 00:14:50,5,8,3285,77,3208,5.01%,2.34%
2020-01-01 00:14:50,5,9,8159,532,7627,12.45%,6.52%
2020-01-01 00:14:50,5,10,1052,6,1046,1.61%,0.57%
2020-01-01 00:14:50,5,11,687,11,676,1.05%,1.60%
2020-01-01 00:14:50,5,12,6807,404,6403,10.39%,5.93%
2020-01-01 00:14:50,6,1,1196,9,1187,1.82%,0.75%
2020-01-01 00:14:50,6,2,1279,9,1270,1.95%,0.70%
2020-01-01 00:14:50,6,3,1823,25,1798,2.78%,1.37%
2020-01-01 00:14:50,6,4,1305,8,1297,1.99%,0.61%
2020-01-01 00:14:50,6,5,15676,1645,14031,23.92%,10.49%
2020-01-01 00:14:50,6,6,6389,299,6090,9.75%,4.68%
2020-01-01 00:14:50,6,7,4535,150,4385,6.92%,3.31%
2020-01-01 00:14:50,6,8,3901,119,3782,5.95%,3.05%
2020-01-01 00:14:50,6,9,7238,349,6889,11.04%,4.82%
2020-01-01 00:14:50,6,10,2176,26,2150,3.32%,1.19%
2020-01-01 00:14:50,6,11,394,1,393,0.60%,0.25%
2020-01-01 00:14:50,6,12,5006,181,4825,7.64%,3.61%
2020-01-01 00:14:50,7,1,486,1,485,0.74%,0.21%
2020-01-01 00:14:50,7,2,143,0,143,0.22%,0.00%
2020-01-01 00:14:50,7,3,690,1,689,1.05%,0.14%
2020-01-01 00:14:50,7,4,2292,45,2247,3.50%,1.96%
2020-01-01 00:14:50,7,5,8866,558,8308,13.53%,6.29%
2020-01-01 00:14:50,7,6,15306,1658,13648,23.36%,10.83%
2020-01-01 00:14:50,7,7,4049,161,3888,6.18%,3.98%
2020-01-01 00:14:50,7,8,1587,17,1570,2.42%,1.07%
2020-01-01 00:14:50,7,9,7865,449,7416,12.00%,5.71%
2020-01-01 00:14:50,7,10,1987,21,1966,3.03%,1.06%
2020-01-01 00:14:50,7,11,90,0,90,0.14%,0.00%
2020-01-01 00:14:50,7,12,5825,265,5560,8.89%,4.55%
2020-01-01 00:14:50,8,1,334,0,334,0.51%,0.00%
2020-01-01 00:14:50,8,2,83,0,83,0.13%,0.00%
2020-01-01 00:14:50,8,3,1930,32,1898,2.94%,1.66%
2020-01-01 00:14:50,8,4,2552,43,2509,3.89%,1.68%
2020-01-01 00:14:50,8,5,8115,492,7623,12.38%,6.06%
2020-01-01 00:14:50,8,6,15416,1702,13714,23.52%,11.04%
2020-01-01 00:14:50,8,7,4571,174,4397,6.97%,3.81%
2020-01-01 00:14:50,8,8,1985,34,1951,3.03%,1.71%
2020-01-01 00:14:50,8,9,6002,270,5732,9.16%,4.50%
2020-01-01 00:14:50,8,10,1714,23,1691,2.62%,1.34%
2020-01-01 00:14:50,8,11,71,0,71,0.11%,0.00%
2020-01-01 00:14:50,8,12,4235,133,4102,6.46%,3.14%
2020-01-01 00:14:50,9,1,507,3,504,0.77%,0.59%
2020-01-01 00:14:50,9,2,4304,133,4171,6.57%,3.09%
2020-01-01 00:14:50,9,3,3405,75,3330,5.20%,2.20%
2020-01-01 00:14:50,9,4,9053,576,8477,13.81%,6.36%
2020-01-01 00:14:50,9,5,403,0,403,0.61%,0.00%
2020-01-01 00:14:50,9,6,10041,703,9338,15.32%,7.00%
2020-01-01 00:14:50,9,7,32536,6801,25735,49.65%,20.90%
2020-01-01 00:14:50,9,8,10834,915,9919,16.53%,8.44%
2020-01-01 00:14:50,9,9,130,0,130,0.20%,0.00%
2020-01-01 00:14:50,9,10,3989,134,3855,6.09%,3.36%
2020-01-01 00:14:50,9,11,10033,794,9239,15.31%,7.91%
2020-01-01 00:14:50,9,12,5756,247,5509,8.78%,4.29%
2020-01-01 00:14:50,10,1,1276,213,1063,1.95%,16.68%
2020-01-01 00:14:50,10,2,3231,267,2964,4.93%,8.26%
2020-01-01 00:14:50,10,3,1800,19,1781,2.75%,1.05%
2020-01-01 00:14:50,10,4,4020,1376,2644,6.13%,34.22%
2020-01-01 00:14:50,10,5,699,55,644,1.07%,7.86%
2020-01-01 00:14:50,10,6,6096,1534,4562,9.30%,25.16%
2020-01-01 00:14:50,10,7,11050,2203,8847,16.86%,19.93%
2020-01-01 00:14:50,10,8,28192,7111,21081,43.02%,25.22%
2020-01-01 00:14:50,10,9,813,4,809,1.24%,0.49%
2020-01-01 00:14:50,10,10,2472,41,2431,3.77%,1.66%
2020-01-01 00:14:50,10,11,13625,1824,11801,20.79%,13.39%
2020-01-01 00:14:50,10,12,10536,1323,9213,16.08%,12.56%
2020-01-01 00:14:50,11,1,2228,37,2191,3.40%,1.66%
2020-01-01 00:14:50,11,2,4205,131,4074,6.42%,3.11%
2020-01-01 00:14:50,11,3,1707,24,1683,2.60%,1.41%
2020-01-01 00:14:50,11,4,4315,114,4201,6.58%,2.64%
2020-01-01 00:14:50,11,5,340,2,338,0.52%,0.59%
2020-01-01 00:14:50,11,6,5460,205,5255,8.33%,3.75%
2020-01-01 00:14:50,11,7,11251,887,10364,17.17%,7.88%
2020-01-01 00:14:50,11,8,24568,4043,20525,37.49%,16.46%
2020-01-01 00:14:50,11,9,245,0,245,0.37%,0.00%
2020-01-01 00:14:50,11,10,2857,67,2790,4.36%,2.34%
2020-01-01 00:14:50,11,11,9346,688,8658,14.26%,7.36%
2020-01-01 00:14:50,11,12,6112,315,5797,9.33%,5.15%
2020-01-01 00:14:50,12,1,132,1,131,0.20%,0.75%
2020-01-01 00:14:50,12,2,487,160,327,0.74%,32.79%
2020-01-01 00:14:50,12,3,2647,202,2445,4.04%,7.63%
2020-01-01 00:14:50,12,4,3186,86,3100,4.86%,2.70%
2020-01-01 00:14:50,12,5,8362,665,7697,12.76%,7.95%
2020-01-01 00:14:50,12,6,4952,188,4764,7.56%,3.80%
2020-01-01 00:14:50,12,7,1581,22,1559,2.41%,1.39%
2020-01-01 00:14:50,12,8,1790,368,1422,2.73%,20.55%
2020-01-01 00:14:50,12,9,22819,4578,18241,34.82%,20.06%
2020-01-01 00:14:50,12,10,4623,519,4104,7.05%,11.22%
2020-01-01 00:14:50,12,11,1909,372,1537,2.91%,19.48%
2020-01-01 00:14:50,12,12,8864,1336,7528,13.53%,15.07%
2020-01-01 00:14:50,13,1,2025,29,1996,3.09%,1.43%
2020-01-01 00:14:50,13,2,2400,41,2359,3.66%,1.71%
2020-01-01 00:14:50,13,3,1278,7,1271,1.95%,0.55%
2020-01-01 00:14:50,13,4,5019,438,4581,7.66%,8.73%
2020-01-01 00:14:50,13,5,8207,878,7329,12.52%,10.70%
2020-01-01 00:14:50,13,6,6087,523,5564,9.29%,8.59%
2020-01-01 00:14:50,13,7,4321,145,4176,6.59%,3.35%
2020-01-01 00:14:50,13,8,6387,321,6066,9.75%,5.03%
2020-01-01 00:14:50,13,9,8456,900,7556,12.90%,10.64%
2020-01-01 00:14:50,13,10,26300,5140,21160,40.13%,19.54%
2020-01-01 00:14:50,13,11,14986,1865,13121,22.87%,12.44%
2020-01-01 00:14:50,13,12,8242,839,7403,12.58%,10.18%
2020-01-01 00:14:50,14,1,260,0,260,0.40%,0.00%
2020-01-01 00:14:50,14,2,953,9,944,1.45%,0.94%
2020-01-01 00:14:50,14,3,479,2,477,0.73%,0.42%
2020-01-01 00:14:50,14,4,3890,144,3746,5.94%,3.70%
2020-01-01 00:14:50,14,5,1420,20,1400,2.17%,1.41%
2020-01-01 00:14:50,14,6,4286,166,4120,6.54%,3.87%
2020-01-01 00:14:50,14,7,11719,1153,10566,17.88%,9.84%
2020-01-01 00:14:50,14,8,13241,1448,11793,20.20%,10.93%
2020-01-01 00:14:50,14,9,1679,32,1647,2.56%,1.90%
2020-01-01 00:14:50,14,10,4110,120,3990,6.27%,2.92%
2020-01-01 00:14:50,14,11,25851,4620,21231,39.45%,17.87%
2020-01-01 00:14:50,14,12,8193,486,7707,12.50%,5.93%
2020-01-01 00:14:50,15,1,585,1,584,0.89%,0.17%
2020-01-01 00:14:50,15,2,145,1,144,0.22%,0.68%
2020-01-01 00:14:50,15,3,4163,124,4039,6.35%,2.98%
2020-01-01 00:14:50,15,4,5131,284,4847,7.83%,5.53%
2020-01-01 00:14:50,15,5,10152,793,9359,15.49%,7.81%
2020-01-01 00:14:50,15,6,5493,310,5183,8.38%,5.64%
2020-01-01 00:14:50,15,7,3165,88,3077,4.83%,2.78%
2020-01-01 00:14:50,15,8,5553,245,5308,8.47%,4.41%
2020-01-01 00:14:50,15,9,10373,819,9554,15.83%,7.89%
2020-01-01 00:14:50,15,10,3848,221,3627,5.87%,5.74%
2020-01-01 00:14:50,15,11,9669,783,8886,14.75%,8.10%
2020-01-01 00:14:50,15,12,25531,4780,20751,38.96%,18.72%
2020-01-01 00:14:50,16,1,456,1,455,0.70%,0.22%
2020-01-01 00:14:50,16,2,185,0,185,0.28%,0.00%
2020-01-01 00:14:50,16,3,1876,30,1846,2.86%,1.60%
2020-01-01 00:14:50,16,4,3886,128,3758,5.93%,3.29%
2020-01-01 00:14:50,16,5,7423,485,6938,11.33%,6.53%
2020-01-01 00:14:50,16,6,4561,184,4377,6.96%,4.03%
2020-01-01 00:14:50,16,7,3361,95,3266,5.13%,2.83%
2020-01-01 00:14:50,16,8,8428,625,7803,12.86%,7.41%
2020-01-01 00:14:50,16,9,7903,533,7370,12.06%,6.74%
2020-01-01 00:14:50,16,10,1829,23,1806,2.79%,1.26%
2020-01-01 00:14:50,16,11,10467,871,9596,15.97%,8.32%
2020-01-01 00:14:50,16,12,26192,4722,21470,39.97%,18.03%
2020-01-01 00:15:00,1,1,16403,1898,14505,25.03%,11.57%
2020-01-01 00:15:00,1,2,6492,307,6185,9.91%,4.73%
2020-01-01 00:15:00,1,3,586,4,582,0.89%,0.68%
2020-01-01 00:15:00,1,4,9597,685,8912,14.64%,7.14%
2020-01-01 00:15:00,1,5,9256,637,8619,14.12%,6.88%
2020-01-01 00:15:00,1,6,9189,626,8563,14.02%,6.81%
2020-01-01 00:15:00,1,7,5891,255,5636,8.99%,4.33%
2020-01-01 00:15:00,1,8,4004,114,3890,6.11%,2.85%
2020-01-01 00:15:00,1,9,9135,620,8515,13.94%,6.79%
2020-01-01 00:15:00,1,10,3226,70,3156,4.92%,2.17%
2020-01-01 00:15:00,1,11,3296,77,3219,5.03%,2.34%
2020-01-01 00:15:00,1,12,9109,615,8494,13.90%,6.75%
2020-01-01 00:15:00,2,1,884,4,880,1.35%,0.45%
2020-01-01 00:15:00,2,2,28761,5447,23314,43.89%,18.94%
2020-01-01 00:15:00,2,3,20880,2953,17927,31.86%,14.14%
2020-01-01 00:15:00,2,4,747,2,745,1.14%,0.27%
2020-01-01 00:15:00,2,5,12163,1068,11095,18.56%,8.78%
2020-01-01 00:15:00,2,6,24,0,24,0.04%,0.00%
2020-01-01 00:15:00,2,7,6980,335,6645,10.65%,4.80%
2020-01-01 00:15:00,2,8,5726,223,5503,8.74%,3.89%
2020-01-01 00:15:00,2,9,11980,1032,10948,18.28%,8.61%
2020-01-01 00:15:00,2,10,4796,157,4639,7.32%,3.27%
2020-01-01 00:15:00,2,11,4837,158,4679,7.38%,3.27%
2020-01-01 00:15:00,2,12,11763,994,10769,17.95%,8.45%
2020-01-01 00:15:00,3,1,1448,8,1440,2.21%,0.55%
2020-01-01 00:15:00,3,2,25417,4254,21163,38.78%,16.74%
2020-01-01 00:15:00,3,3,67434,25230,42204,102.90%,37.41%
2020-01-01 00:15:00,3,4,5347,225,5122,8.16%,4.21%
2020-01-01 00:15:00,3,5,40668,10242,30426,62.05%,25.18%
2020-01-01 00:15:00,3,6,6274,312,5962,9.57%,4.97%
2020-01-01 00:15:00,3,7,21945,3220,18725,33.49%,14.67%
2020-01-01 00:15:00,3,8,18437,2321,16116,28.13%,12.59%
2020-01-01 00:15:00,3,9,34002,7383,26619,51.88%,21.71%
2020-01-01 00:15:00,3,10,4076,117,3959,6.22%,2.87%
2020-01-01 00:15:00,3,11,1858,20,1838,2.84%,1.08%
2020-01-01 00:15:00,3,12,27226,4881,22345,41.54%,17.93%
2020-01-01 00:15:00,4,1,545,2,543,0.83%,0.37%
2020-01-01 00:15:00,4,2,351,1,350,0.54%,0.28%
2020-01-01 00:15:00,4,3,1307,12,1295,1.99%,0.92%
2020-01-01 00:15:00,4,4,29434,5844,23590,44.91%,19.85%
2020-01-01 00:15:00,4,5,18348,2358,15990,28.00%,12.85%
2020-01-01 00:15:00,4,6,25257,4355,20902,38.54%,17.24%
2020-01-01 00:15:00,4,7,5629,261,5368,8.59%,4.64%
2020-01-01 00:15:00,4,8,3311,74,3237,5.05%,2.23%
2020-01-01 00:15:00,4,9,15812,1787,14025,24.13%,11.30%
2020-01-01 00:15:00,4,10,2079,42,2037,3.17%,2.02%
2020-01-01 00:15:00,4,11,173,0,173,0.26%,0.00%
2020-01-01 00:15:00,4,12,12957,1192,11765,19.77%,9.20%
2020-01-01 00:15:00,5,1,2951,64,2887,4.50%,2.17%
2020-01-01 00:15:00,5,2,821,4,817,1.25%,0.49%
2020-01-01 00:15:00,5,3,339,0,339,0.52%,0.00%
2020-01-01 00:15:00,5,4,23121,3629,19492,35.28%,15.70%
2020-01-01 00:15:00,5,5,10361,747,9614,15.81%,7.21%
2020-01-01 00:15:00,5,6,16634,1930,14704,25.38%,11.60%
2020-01-01 00:15:00,5,7,5750,255,5495,8.77%,4.43%
2020-01-01 00:15:00,5,8,4819,162,4657,7.35%,3.36%
2020-01-01 00:15:00,5,9,9830,678,9152,15.00%,6.90%
2020-01-01 00:15:00,5,10,1009,7,1002,1.54%,0.69%
2020-01-01 00:15:00,5,11,961,8,953,1.47%,0.83%
2020-01-01 00:15:00,5,12,7820,427,7393,11.93%,5.46%
2020-01-01 00:15:00,6,1,1093,18,1075,1.67%,1.65%
2020-01-01 00:15:00,6,2,1220,23,1197,1.86%,1.88%
2020-01-01 00:15:00,6,3,1931,35,1896,2.95%,1.81%
2020-01-01 00:15:00,6,4,2168,16,2152,3.31%,0.74%
2020-01-01 00:15:00,6,5,19043,2503,16540,29.06%,13.14%
2020-01-01 00:15:00,6,6,4900,172,4728,7.48%,3.51%
2020-01-01 00:15:00,6,7,2254,43,2211,3.44%,1.91%
2020-01-01 00:15:00,6,8,1727,29,1698,2.64%,1.68%
2020-01-01 00:15:00,6,9,11853,998,10855,18.09%,8.42%
2020-01-01 00:15:00,6,10,4171,133,4038,6.36%,3.19%
2020-01-01 00:15:00,6,11,273,0,273,0.42%,0.00%
2020-01-01 00:15:00,6,12,7627,419,7208,11.64%,5.49%
2020-01-01 00:15:00,7,1,404,0,404,0.62%,0.00%
2020-01-01 00:15:00,7,2,188,0,188,0.29%,0.00%
2020-01-01 00:15:00,7,3,1515,16,1499,2.31%,1.06%
2020-01-01 00:15:00,7,4,1581,13,1568,2.41%,0.82%
2020-01-01 00:15:00,7,5,8650,557,8093,13.20%,6.44%
2020-01-01 00:15:00,7,6,13903,1358,12545,21.21%,9.77%
2020-01-01 00:15:00,7,7,3558,99,3459,5.43%,2.78%
2020-01-01 00:15:00,7,8,1423,13,1410,2.17%,0.91%
2020-01-01 00:15:00,7,9,6869,362,6507,10.48%,5.27%
2020-01-01 00:15:00,7,10,1543,27,1516,2.35%,1.75%
2020-01-01 00:15:00,7,11,115,0,115,0.18%,0.00%
2020-01-01 00:15:00,7,12,5291,209,5082,8.07%,3.95%
2020-01-01 00:15:00,8,1,394,1,393,0.60%,0.25%
2020-01-01 00:15:00,8,2,86,0,86,0.13%,0.00%
2020-01-01 00:15:00,8,3,2179,29,2150,3.32%,1.33%
2020-01-01 00:15:00,8,4,2602,63,2539,3.97%,2.42%
2020-01-01 00:15:00,8,5,8836,579,8257,13.48%,6.55%
2020-01-01 00:15:00,8,6,16435,1871,14564,25.08%,11.38%
2020-01-01 00:15:00,8,7,4872,167,4705,7.43%,3.43%
2020-01-01 00:15:00,8,8,1561,23,1538,2.38%,1.47%
2020-01-01 00:15:00,8,9,6431,303,6128,9.81%,4.71%
2020-01-01 00:15:00,8,10,1872,27,1845,2.86%,1.44%
2020-01-01 00:15:00,8,11,311,0,311,0.47%,0.00%
2020-01-01 00:15:00,8,12,4503,168,4335,6.87%,3.73%
2020-01-01 00:15:00,9,1,919,1,918,1.40%,0.11%
2020-01-01 00:15:00,9,2,2720,42,2678,4.15%,1.54%
2020-01-01 00:15:00,9,3,1438,11,1427,2.19%,0.76%
2020-01-01 00:15:00,9,4,5250,203,5047,8.01%,3.87%
2020-01-01 00:15:00,9,5,367,0,367,0.56%,0.00%
2020-01-01 00:15:00,9,6,5926,268,5658,9.04%,4.52%
2020-01-01 00:15:00,9,7,26948,4732,22216,41.12%,17.56%
2020-01-01 00:15:00,9,8,11991,1025,10966,18.30%,8.55%
2020-01-01 00:15:00,9,9,287,0,287,0.44%,0.00%
2020-01-01 00:15:00,9,10,4513,143,4370,6.89%,3.17%
2020-01-01 00:15:00,9,11,10576,794,9782,16.14%,7.51%
2020-01-01 00:15:00,9,12,5729,251,5478,8.74%,4.38%
2020-01-01 00:15:00,10,1,1530,340,1190,2.33%,22.21%
2020-01-01 00:15:00,10,2,4594,473,4121,7.01%,10.29%
2020-01-01 00:15:00,10,3,2926,71,2855,4.46%,2.43%
2020-01-01 00:15:00,10,4,4305,1093,3212,6.57%,25.38%
2020-01-01 00:15:00,10,5,558,9,549,0.85%,1.61%
2020-01-01 00:15:00,10,6,6207,1208,4999,9.47%,19.46%
2020-01-01 00:15:00,10,7,13282,2372,10910,20.27%,17.86%
2020-01-01 00:15:00,10,8,30981,7927,23054,47.27%,25.59%
2020-01-01 00:15:00,10,9,729,1,728,1.11%,0.14%
2020-01-01 00:15:00,10,10,2759,55,2704,4.21%,1.99%
2020-01-01 00:15:00,10,11,13570,1606,11964,20.71%,11.83%
2020-01-01 00:15:00,10,12,10313,1101,9212,15.74%,10.67%
2020-01-01 00:15:00,11,1,2128,35,2093,3.25%,1.64%
2020-01-01 00:15:00,11,2,3526,86,3440,5.38%,2.44%
2020-01-01 00:15:00,11,3,1176,8,1168,1.79%,0.68%
2020-01-01 00:15:00,11,4,3770,106,3664,5.75%,2.81%
2020-01-01 00:15:00,11,5,170,0,170,0.26%,0.00%
2020-01-01 00:15:00,11,6,4728,170,4558,7.21%,3.59%
2020-01-01 00:15:00,11,7,10168,738,9430,15.52%,7.26%
2020-01-01 00:15:00,11,8,24587,4140,20447,37.52%,16.84%
2020-01-01 00:15:00,11,9,214,1,213,0.33%,0.47%
2020-01-01 00:15:00,11,10,3696,120,3576,5.64%,3.25%
2020-01-01 00:15:00,11,11,10664,870,9794,16.27%,8.16%
2020-01-01 00:15:00,11,12,6761,351,6410,10.32%,5.19%
2020-01-01 00:15:00,12,1,75,0,75,0.11%,0.00%
2020-01-01 00:15:00,12,2,616,220,396,0.94%,35.66%
2020-01-01 00:15:00,12,3,2566,251,2315,3.92%,9.78%
2020-01-01 00:15:00,12,4,3295,77,3218,5.03%,2.34%
2020-01-01 00:15:00,12,5,9870,901,8969,15.06%,9.13%
2020-01-01 00:15:00,12,6,6352,303,6049,9.69%,4.77%
2020-01-01 00:15:00,12,7,2911,57,2854,4.44%,1.96%
2020-01-01 00:15:00,12,8,1286,278,1008,1.96%,21.60%
2020-01-01 00:15:00,12,9,22942,4607,18335,35.01%,20.08%
2020-01-01 00:15:00,12,10,3687,346,3341,5.63%,9.38%
2020-01-01 00:15:00,12,11,1392,278,1114,2.12%,19.96%
2020-01-01 00:15:00,12,12,7854,1151,6703,11.98%,14.65%
2020-01-01 00:15:00,13,1,2267,50,2217,3.46%,2.20%
2020-01-01 00:15:00,13,2,2559,63,2496,3.90%,2.46%
2020-01-01 00:15:00,13,3,864,5,859,1.32%,0.58%
2020-01-01 00:15:00,13,4,5665,536,5129,8.64%,9.46%
2020-01-01 00:15:00,13,5,8562,921,7641,13.06%,10.76%
2020-01-01 00:15:00,13,6,6836,634,6202,10.43%,9.27%
2020-01-01 00:15:00,13,7,5077,208,4869,7.75%,4.10%
2020-01-01 00:15:00,13,8,7024,346,6678,10.72%,4.93%
2020-01-01 00:15:00,13,9,8957,962,7995,13.67%,10.74%
2020-01-01 00:15:00,13,10,28796,5947,22849,43.94%,20.65%
2020-01-01 00:15:00,13,11,16572,2150,14422,25.29%,12.97%
2020-01-01 00:15:00,13,12,8993,902,8091,13.72%,10.03%
2020-01-01 00:15:00,14,1,293,0,293,0.45%,0.00%
2020-01-01 00:15:00,14,2,1553,18,1535,2.37%,1.16%
2020-01-01 00:15:00,14,3,994,5,989,1.52%,0.50%
2020-01-01 00:15:00,14,4,4907,302,4605,7.49%,6.15%
2020-01-01 00:15:00,14,5,1371,14,1357,2.09%,1.02%
2020-01-01 00:15:00,14,6,5055,314,4741,7.71%,6.21%
2020-01-01 00:15:00,14,7,12123,1181,10942,18.50%,9.74%
2020-01-01 00:15:00,14,8,13820,1481,12339,21.09%,10.72%
2020-01-01 00:15:00,14,9,1645,18,1627,2.51%,1.09%
2020-01-01 00:15:00,14,10,4656,160,4496,7.10%,3.44%
2020-01-01 00:15:00,14,11,27001,4990,22011,41.20%,18.48%
2020-01-01 00:15:00,14,12,8236,561,7675,12.57%,6.81%
2020-01-01 00:15:00,15,1,440,1,439,0.67%,0.23%
2020-01-01 00:15:00,15,2,117,0,117,0.18%,0.00%
2020-01-01 00:15:00,15,3,3935,113,3822,6.00%,2.87%
2020-01-01 00:15:00,15,4,5187,288,4899,7.91%,5.55%
2020-01-01 00:15:00,15,5,10813,911,9902,16.50%,8.42%
2020-01-01 00:15:00,15,6,5411,305,5106,8.26%,5.64%
2020-01-01 00:15:00,15,7,3843,135,3708,5.86%,3.51%
2020-01-01 00:15:00,15,8,5693,282,5411,8.69%,4.95%
2020-01-01 00:15:00,15,9,11048,949,10099,16.86%,8.59%
2020-01-01 00:15:00,15,10,3972,128,3844,6.06%,3.22%
2020-01-01 00:15:00,15,11,9884,745,9139,15.08%,7.54%
2020-01-01 00:15:00,15,12,27530,5363,22167,42.01%,19.48%
2020-01-01 00:15:00,16,1,410,2,408,0.63%,0.49%
2020-01-01 00:15:00,16,2,254,1,253,0.39%,0.39%
2020-01-01 00:15:00,16,3,1415,24,1391,2.16%,1.69%
2020-01-01 00:15:00,16,4,4170,102,4068,6.36%,2.45%
2020-01-01 00:15:00,16,5,7410,428,6982,11.31%,5.78%
2020-01-01 00:15:00,16,6,5032,156,4876,7.68%,3.10%
2020-01-01 00:15:00,16,7,3884,136,3748,5.93%,3.50%
2020-01-01 00:15:00,16,8,8025,511,7514,12.25%,6.37%
2020-01-01 00:15:00,16,9,7841,473,7368,11.96%,6.03%
2020-01-01 00:15:00,16,10,2008,21,1987,3.06%,1.05%
2020-01-01 00:15:00,16,11,10304,767,9537,15.72%,7.44%
2020-01-01 00:15:00,16,12,26682,4705,21977,40.71%,17.63%
2020-01-01 00:15:10,1,1,15440,1733,13707,23.56%,11.22%
2020-01-01 00:15:10,1,2,4979,217,4762,7.60%,4.36%
2020-01-01 00:15:10,1,3,741,5,736,1.13%,0.67%
2020-01-01 00:15:10,1,4,9980,716,9264,15.23%,7.17%
2020-01-01 00:15:10,1,5,9608,670,8938,14.66%,6.97%
2020-01-01 00:15:10,1,6,9565,658,8907,14.60%,6.88%
2020-01-01 00:15:10,1,7,4217,164,4053,6.43%,3.89%
2020-01-01 00:15:10,1,8,3445,104,3341,5.26%,3.02%
2020-01-01 00:15:10,1,9,9510,654,8856,14.51%,6.88%
2020-01-01 00:15:10,1,10,2744,60,2684,4.19%,2.19%
2020-01-01 00:15:10,1,11,2856,63,2793,4.36%,2.21%
2020-01-01 00:15:10,1,12,9483,650,8833,14.47%,6.85%
2020-01-01 00:15:10,2,1,718,5,713,1.10%,0.70%
2020-01-01 00:15:10,2,2,25848,4513,21335,39.44%,17.46%
2020-01-01 00:15:10,2,3,19929,2771,17158,30.41%,13.90%
2020-01-01 00:15:10,2,4,644,5,639,0.98%,0.78%
2020-01-01 00:15:10,2,5,12963,1217,11746,19.78%,9.39%
2020-01-01 00:15:10,2,6,58,0,58,0.09%,0.00%
2020-01-01 00:15:10,2,7,5173,204,4969,7.89%,3.94%
2020-01-01 00:15:10,2,8,3470,86,3384,5.29%,2.48%
2020-01-01 00:15:10,2,9,12865,1191,11674,19.63%,9.26%
2020-01-01 00:15:10,2,10,2706,51,2655,4.13%,1.88%
2020-01-01 00:15:10,2,11,2740,52,2688,4.18%,1.90%
2020-01-01 00:15:10,2,12,12713,1160,11553,19.40%,9.12%
2020-01-01 00:15:10,3,1,1570,18,1552,2.40%,1.15%
2020-01-01 00:15:10,3,2,24171,3949,20222,36.88%,16.34%
2020-01-01 00:15:10,3,3,71465,27882,43583,109.05%,39.01%
2020-01-01 00:15:10,3,4,10632,782,9850,16.22%,7.35%
2020-01-01 00:15:10,3,5,46277,13018,33259,70.61%,28.13%
2020-01-01 00:15:10,3,6,11718,953,10765,17.88%,8.13%
2020-01-01 00:15:10,3,7,20876,2983,17893,31.85%,14.29%
2020-01-01 00:15:10,3,8,18295,2331,15964,27.92%,12.74%
2020-01-01 00:15:10,3,9,34014,7487,26527,51.90%,22.01%
2020-01-01 00:15:10,3,10,6597,337,6260,10.07%,5.11%
2020-01-01 00:15:10,3,11,2265,35,2230,3.46%,1.54%
2020-01-01 00:15:10,3,12,24644,4070,20574,37.60%,16.51%
2020-01-01 00:15:10,4,1,537,3,534,0.82%,0.56%
2020-01-01 00:15:10,4,2,361,0,361,0.55%,0.00%
2020-01-01 00:15:10,4,3,932,22,910,1.42%,2.36%
2020-01-01 00:15:10,4,4,28227,5262,22965,43.07%,18.64%
2020-01-01 00:15:10,4,5,17033,2046,14987,25.99%,12.01%
2020-01-01 00:15:10,4,6,23653,3809,19844,36.09%,16.10%
2020-01-01 00:15:10,4,7,5273,210,5063,8.05%,3.98%
2020-01-01 00:15:10,4,8,3193,84,3109,4.87%,2.63%
2020-01-01 00:15:10,4,9,14994,1614,13380,22.88%,10.76%
2020-01-01 00:15:10,4,10,1766,35,1731,2.69%,1.98%
2020-01-01 00:15:10,4,11,253,2,251,0.39%,0.79%
2020-01-01 00:15:10,4,12,12644,1151,11493,19.29%,9.10%
2020-01-01 00:15:10,5,1,3406,97,3309,5.20%,2.85%
2020-01-01 00:15:10,5,2,817,8,809,1.25%,0.98%
2020-01-01 00:15:10,5,3,2020,29,1991,3.08%,1.43%
2020-01-01 00:15:10,5,4,23931,3942,19989,36.52%,16.47%
2020-01-01 00:15:10,5,5,12284,1080,11204,18.74%,8.79%
2020-01-01 00:15:10,5,6,17213,2092,15121,26.26%,12.15%
2020-01-01 00:15:10,5,7,4533,172,4361,6.92%,3.79%
2020-01-01 00:15:10,5,8,3679,110,3569,5.61%,2.99%
2020-01-01 00:15:10,5,9,10135,749,9386,15.46%,7.39%
2020-01-01 00:15:10,5,10,1598,29,1569,2.44%,1.81%
2020-01-01 00:15:10,5,11,620,5,615,0.95%,0.81%
2020-01-01 00:15:10,5,12,8265,495,7770,12.61%,5.99%
2020-01-01 00:15:10,6,1,984,7,977,1.50%,0.71%
2020-01-01 00:15:10,6,2,1052,9,1043,1.61%,0.85%
2020-01-01 00:15:10,6,3,1494,22,1472,2.28%,1.47%
2020-01-01 00:15:10,6,4,1322,19,1303,2.02%,1.44%
2020-01-01 00:15:10,6,5,17827,2226,15601,27.20%,12.49%
2020-01-01 00:15:10,6,6,4742,191,4551,7.24%,4.03%
2020-01-01 00:15:10,6,7,3092,87,3005,4.72%,2.81%
2020-01-01 00:15:10,6,8,2616,65,2551,3.99%,2.48%
2020-01-01 00:15:10,6,9,11259,900,10359,17.18%,7.99%
2020-01-01 00:15:10,6,10,2567,38,2529,3.92%,1.48%
2020-01-01 00:15:10,6,11,426,0,426,0.65%,0.00%
2020-01-01 00:15:10,6,12,8645,568,8077,13.19%,6.57%
2020-01-01 00:15:10,7,1,464,0,464,0.71%,0.00%
2020-01-01 00:15:10,7,2,223,0,223,0.34%,0.00%
2020-01-01 00:15:10,7,3,988,6,982,1.51%,0.61%
2020-01-01 00:15:10,7,4,2251,39,2212,3.43%,1.73%
2020-01-01 00:15:10,7,5,7421,404,7017,11.32%,5.44%
2020-01-01 00:15:10,7,6,14495,1490,13005,22.12%,10.28%
2020-01-01 00:15:10,7,7,4727,199,4528,7.21%,4.21%
2020-01-01 00:15:10,7,8,2266,35,2231,3.46%,1.54%
2020-01-01 00:15:10,7,9,6256,305,5951,9.55%,4.87%
2020-01-01 00:15:10,7,10,1220,11,1209,1.86%,0.90%
2020-01-01 00:15:10,7,11,477,1,476,0.73%,0.21%
2020-01-01 00:15:10,7,12,4981,185,4796,7.60%,3.71%
2020-01-01 00:15:10,8,1,777,4,773,1.19%,0.51%
2020-01-01 00:15:10,8,2,115,0,115,0.18%,0.00%
2020-01-01 00:15:10,8,3,2048,39,2009,3.12%,1.90%
2020-01-01 00:15:10,8,4,3154,69,3085,4.81%,2.19%
2020-01-01 00:15:10,8,5,9195,660,8535,14.03%,7.18%
2020-01-01 00:15:10,8,6,17697,2277,15420,27.00%,12.87%
2020-01-01 00:15:10,8,7,5166,217,4949,7.88%,4.20%
2020-01-01 00:15:10,8,8,1953,35,1918,2.98%,1.79%
2020-01-01 00:15:10,8,9,6920,366,6554,10.56%,5.29%
2020-01-01 00:15:10,8,10,1778,21,1757,2.71%,1.18%
2020-01-01 00:15:10,8,11,114,0,114,0.17%,0.00%
2020-01-01 00:15:10,8,12,5093,198,4895,7.77%,3.89%
2020-01-01 00:15:10,9,1,1129,2,1127,1.72%,0.18%
2020-01-01 00:15:10,9,2,3489,62,3427,5.32%,1.78%
2020-01-01 00:15:10,9,3,2007,28,1979,3.06%,1.39%
2020-01-01 00:15:10,9,4,4919,152,4767,7.51%,3.09%
2020-01-01 00:15:10,9,5,398,1,397,0.61%,0.25%
2020-01-01 00:15:10,9,6,6073,265,5808,9.27%,4.36%
2020-01-01 00:15:10,9,7,26818,4867,21951,40.92%,18.15%
2020-01-01 00:15:10,9,8,10578,811,9767,16.14%,7.67%
2020-01-01 00:15:10,9,9,149,1,148,0.23%,0.67%
2020-01-01 00:15:10,9,10,3613,96,3517,5.51%,2.66%
2020-01-01 00:15:10,9,11,9419,664,8755,14.37%,7.05%
2020-01-01 00:15:10,9,12,5363,221,5142,8.18%,4.12%
2020-01-01 00:15:10,10,1,1638,297,1341,2.50%,18.12%
2020-01-01 00:15:10,10,2,3494,356,3138,5.33%,10.19%
2020-01-01 00:15:10,10,3,1657,18,1639,2.53%,1.09%
2020-01-01 00:15:10,10,4,3595,1004,2591,5.49%,27.92%
2020-01-01 00:15:10,10,5,940,92,848,1.43%,9.78%
2020-01-01 00:15:10,10,6,5880,1222,4658,8.97%,20.78%
2020-01-01 00:15:10,10,7,11699,2058,9641,17.85%,17.59%
2020-01-01 00:15:10,10,8,29824,7521,22303,45.51%,25.22%
2020-01-01 00:15:10,10,9,394,2,392,0.60%,0.51%
2020-01-01 00:15:10,10,10,2353,50,2303,3.59%,2.12%
2020-01-01 00:15:10,10,11,14295,1827,12468,21.81%,12.78%
2020-01-01 00:15:10,10,12,11312,1318,9994,17.26%,11.65%
2020-01-01 00:15:10,11,1,2206,40,2166,3.37%,1.81%
2020-01-01 00:15:10,11,2,3505,99,3406,5.35%,2.82%
2020-01-01 00:15:10,11,3,1006,6,1000,1.54%,0.60%
2020-01-01 00:15:10,11,4,4766,161,4605,7.27%,3.38%
2020-01-01 00:15:10,11,5,336,0,336,0.51%,0.00%
2020-01-01 00:15:10,11,6,6041,257,5784,9.22%,4.25%
2020-01-01 00:15:10,11,7,11481,986,10495,17.52%,8.59%
2020-01-01 00:15:10,11,8,26602,4745,21857,40.59%,17.84%
2020-01-01 00:15:10,11,9,180,1,179,0.27%,0.55%
2020-01-01 00:15:10,11,10,3237,77,3160,4.94%,2.38%
2020-01-01 00:15:10,11,11,10394,790,9604,15.86%,7.60%
2020-01-01 00:15:10,11,12,6859,368,6491,10.47%,5.36%
2020-01-01 00:15:10,12,1,27,0,27,0.04%,0.00%
2020-01-01 00:15:10,12,2,596,133,463,0.91%,22.28%
2020-01-01 00:15:10,12,3,3030,192,2838,4.62%,6.33%
2020-01-01 00:15:10,12,4,3072,70,3002,4.69%,2.28%
2020-01-01 00:15:10,12,5,8911,674,8237,13.60%,7.56%
2020-01-01 00:15:10,12,6,5138,191,4947,7.84%,3.72%
2020-01-01 00:15:10,12,7,1963,36,1927,3.00%,1.83%
2020-01-01 00:15:10,12,8,1401,298,1103,2.14%,21.26%
2020-01-01 00:15:10,12,9,22080,4400,17680,33.69%,19.93%
2020-01-01 00:15:10,12,10,4490,423,4067,6.85%,9.42%
2020-01-01 00:15:10,12,11,1586,304,1282,2.42%,19.16%
2020-01-01 00:15:10,12,12,8087,1484,6603,12.34%,18.35%
2020-01-01 00:15:10,13,1,1780,21,1759,2.72%,1.18%
2020-01-01 00:15:10,13,2,2115,37,2078,3.23%,1.75%
2020-01-01 00:15:10,13,3,814,5,809,1.24%,0.61%
2020-01-01 00:15:10,13,4,5541,944,4597,8.45%,17.03%
2020-01-01 00:15:10,13,5,7800,1281,6519,11.90%,16.42%
2020-01-01 00:15:10,13,6,6087,982,5105,9.29%,16.13%
2020-01-01 00:15:10,13,7,4059,134,3925,6.19%,3.30%
2020-01-01 00:15:10,13,8,6914,363,6551,10.55%,5.25%
2020-01-01 00:15:10,13,9,8222,1332,6890,12.55%,16.20%
2020-01-01 00:15:10,13,10,28731,6339,22392,43.84%,22.06%
2020-01-01 00:15:10,13,11,18117,2608,15509,27.64%,14.39%
2020-01-01 00:15:10,13,12,10681,1150,9531,16.30%,10.77%
2020-01-01 00:15:10,14,1,297,0,297,0.45%,0.00%
2020-01-01 00:15:10,14,2,1377,10,1367,2.10%,0.73%
2020-01-01 00:15:10,14,3,890,3,887,1.36%,0.34%
2020-01-01 00:15:10,14,4,3477,90,3387,5.31%,2.59%
2020-01-01 00:15:10,14,5,1240,13,1227,1.89%,1.05%
2020-01-01 00:15:10,14,6,3743,104,3639,5.71%,2.78%
2020-01-01 00:15:10,14,7,11488,972,10516,17.53%,8.46%
2020-01-01 00:15:10,14,8,13121,1268,11853,20.02%,9.66%
2020-01-01 00:15:10,14,9,1438,18,1420,2.19%,1.25%
2020-01-01 00:15:10,14,10,4791,176,4615,7.31%,3.67%
2020-01-01 00:15:10,14,11,27644,5142,22502,42.18%,18.60%
2020-01-01 00:15:10,14,12,9350,632,8718,14.27%,6.76%
2020-01-01 00:15:10,15,1,468,1,467,0.71%,0.21%
2020-01-01 00:15:10,15,2,178,1,177,0.27%,0.56%
2020-01-01 00:15:10,15,3,3833,104,3729,5.85%,2.71%
2020-01-01 00:15:10,15,4,4453,186,4267,6.79%,4.18%
2020-01-01 00:15:10,15,5,9214,653,8561,14.06%,7.09%
2020-01-01 00:15:10,15,6,4816,252,4564,7.35%,5.23%
2020-01-01 00:15:10,15,7,3763,119,3644,5.74%,3.16%
2020-01-01 00:15:10,15,8,5998,287,5711,9.15%,4.78%
2020-01-01 00:15:10,15,9,9431,690,8741,14.39%,7.32%
2020-01-01 00:15:10,15,10,5347,535,4812,8.16%,10.00%
2020-01-01 00:15:10,15,11,11574,1237,10337,17.66%,10.69%
2020-01-01 00:15:10,15,12,26806,5408,21398,40.90%,20.17%
2020-01-01 00:15:10,16,1,398,0,398,0.61%,0.00%
2020-01-01 00:15:10,16,2,287,0,287,0.44%,0.00%
2020-01-01 00:15:10,16,3,3129,59,3070,4.77%,1.88%
2020-01-01 00:15:10,16,4,4115,128,3987,6.28%,3.11%
2020-01-01 00:15:10,16,5,9361,675,8686,14.28%,7.21%
2020-01-01 00:15:10,16,6,5099,197,4902,7.78%,3.86%
2020-01-01 00:15:10,16,7,3631,110,3521,5.54%,3.03%
2020-01-01 00:15:10,16,8,7533,467,7066,11.49%,6.20%
2020-01-01 00:15:10,16,9,9781,736,9045,14.92%,7.52%
2020-01-01 00:15:10,16,10,1665,20,1645,2.54%,1.20%
2020-01-01 00:15:10,16,11,9412,688,8724,14.36%,7.31%
2020-01-01 00:15:10,16,12,26566,4747,21819,40.54%,17.87%
2020-01-01 00:15:20,1,1,17408,2111,15297,26.56%,12.13%
2020-01-01 00:15:20,1,2,7295,397,6898,11.13%,5.44%
2020-01-01 00:15:20,1,3,1498,13,1485,2.29%,0.87%
2020-01-01 00:15:20,1,4,9726,712,9014,14.84%,7.32%
2020-01-01 00:15:20,1,5,9097,639,8458,13.88%,7.02%
2020-01-01 00:15:20,1,6,9052,631,8421,13.81%,6.97%
2020-01-01 00:15:20,1,7,5770,249,5521,8.80%,4.31%
2020-01-01 00:15:20,1,8,5289,207,5082,8.07%,3.91%
2020-01-01 00:15:20,1,9,9011,628,8383,13.75%,6.97%
2020-01-01 00:15:20,1,10,4552,145,4407,6.95%,3.18%
2020-01-01 00:15:20,1,11,4635,153,4482,7.07%,3.30%
2020-01-01 00:15:20,1,12,8980,626,8354,13.70%,6.97%
2020-01-01 00:15:20,2,1,527,2,525,0.80%,0.38%
2020-01-01 00:15:20,2,2,28978,5557,23421,44.22%,19.18%
2020-01-01 00:15:20,2,3,24120,3939,20181,36.80%,16.33%
2020-01-01 00:15:20,2,4,411,1,410,0.63%,0.24%
2020-01-01 00:15:20,2,5,15652,1667,13985,23.88%,10.65%
2020-01-01 00:15:20,2,6,226,0,226,0.34%,0.00%
2020-01-01 00:15:20,2,7,4302,150,4152,6.56%,3.49%
2020-01-01 00:15:20,2,8,2794,66,2728,4.26%,2.36%
2020-01-01 00:15:20,2,9,15571,1657,13914,23.76%,10.64%
2020-01-01 00:15:20,2,10,2018,40,1978,3.08%,1.98%
2020-01-01 00:15:20,2,11,2031,42,1989,3.10%,2.07%
2020-01-01 00:15:20,2,12,15441,1630,13811,23.56%,10.56%
2020-01-01 00:15:20,3,1,1571,12,1559,2.40%,0.76%
2020-01-01 00:15:20,3,2,24094,3855,20239,36.76%,16.00%
2020-01-01 00:15:20,3,3,65882,24325,41557,100.53%,36.92%
2020-01-01 00:15:20,3,4,4699,171,4528,7.17%,3.64%
2020-01-01 00:15:20,3,5,40864,10479,30385,62.35%,25.64%
2020-01-01 00:15:20,3,6,5972,261,5711,9.11%,4.37%
2020-01-01 00:15:20,3,7,20601,2919,17682,31.43%,14.17%
2020-01-01 00:15:20,3,8,16971,2016,14955,25.90%,11.88%
2020-01-01 00:15:20,3,9,34492,7712,26780,52.63%,22.36%
2020-01-01 00:15:20,3,10,6139,290,5849,9.37%,4.72%
2020-01-01 00:15:20,3,11,1834,22,1812,2.80%,1.20%
2020-01-01 00:15:20,3,12,25148,4301,20847,38.37%,17.10%
2020-01-01 00:15:20,4,1,494,3,491,0.75%,0.61%
2020-01-01 00:15:20,4,2,298,2,296,0.45%,0.67%
2020-01-01 00:15:20,4,3,958,6,952,1.46%,0.63%
2020-01-01 00:15:20,4,4,28163,5269,22894,42.97%,18.71%
2020-01-01 00:15:20,4,5,17438,2120,15318,26.61%,12.16%
2020-01-01 00:15:20,4,6,24224,3992,20232,36.96%,16.48%
2020-01-01 00:15:20,4,7,5522,234,5288,8.43%,4.24%
2020-01-01 00:15:20,4,8,3136,79,3057,4.79%,2.52%
2020-01-01 00:15:20,4,9,15222,1618,13604,23.23%,10.63%
2020-01-01 00:15:20,4,10,1976,30,1946,3.02%,1.52%
2020-01-01 00:15:20,4,11,161,0,161,0.25%,0.00%
2020-01-01 00:15:20,4,12,12633,1132,11501,19.28%,8.96%
2020-01-01 00:15:20,5,1,3254,73,3181,4.97%,2.24%
2020-01-01 00:15:20,5,2,736,4,732,1.12%,0.54%
2020-01-01 00:15:20,5,3,895,8,887,1.37%,0.89%
2020-01-01 00:15:20,5,4,24953,4251,20702,38.08%,17.04%
2020-01-01 00:15:20,5,5,10045,724,9321,15.33%,7.21%
2020-01-01 00:15:20,5,6,15300,1674,13626,23.35%,10.94%
2020-01-01 00:15:20,5,7,4776,168,4608,7.29%,3.52%
2020-01-01 00:15:20,5,8,3468,92,3376,5.29%,2.65%
2020-01-01 00:15:20,5,9,8955,576,8379,13.66%,6.43%
2020-01-01 00:15:20,5,10,1089,7,1082,1.66%,0.64%
2020-01-01 00:15:20,5,11,663,5,658,1.01%,0.75%
2020-01-01 00:15:20,5,12,7418,395,7023,11.32%,5.32%
2020-01-01 00:15:20,6,1,1136,9,1127,1.73%,0.79%
2020-01-01 00:15:20,6,2,1267,13,1254,1.93%,1.03%
2020-01-01 00:15:20,6,3,1809,23,1786,2.76%,1.27%
2020-01-01 00:15:20,6,4,1375,16,1359,2.10%,1.16%
2020-01-01 00:15:20,6,5,17009,1967,15042,25.95%,11.56%
2020-01-01 00:15:20,6,6,5808,231,5577,8.86%,3.98%
2020-01-01 00:15:20,6,7,4013,105,3908,6.12%,2.62%
2020-01-01 00:15:20,6,8,3410,81,3329,5.20%,2.37%
2020-01-01 00:15:20,6,9,9034,539,8495,13.78%,5.97%
2020-01-01 00:15:20,6,10,1971,30,1941,3.01%,1.52%
2020-01-01 00:15:20,6,11,396,1,395,0.60%,0.25%
2020-01-01 00:15:20,6,12,6980,320,6660,10.65%,4.58%
2020-01-01 00:15:20,7,1,522,2,520,0.80%,0.38%
2020-01-01 00:15:20,7,2,107,0,107,0.16%,0.00%
2020-01-01 00:15:20,7,3,934,6,928,1.43%,0.64%
2020-01-01 00:15:20,7,4,1868,34,1834,2.85%,1.82%
2020-01-01 00:15:20,7,5,7209,370,6839,11.00%,5.13%
2020-01-01 00:15:20,7,6,13054,1213,11841,19.92%,9.29%
2020-01-01 00:15:20,7,7,3904,131,3773,5.96%,3.35%
2020-01-01 00:15:20,7,8,1680,21,1659,2.56%,1.25%
2020-01-01 00:15:20,7,9,6106,262,5844,9.32%,4.29%
2020-01-01 00:15:20,7,10,1084,3,1081,1.65%,0.28%
2020-01-01 00:15:20,7,11,240,0,240,0.37%,0.00%
2020-01-01 00:15:20,7,12,4948,179,4769,7.55%,3.62%
2020-01-01 00:15:20,8,1,568,2,566,0.87%,0.35%
2020-01-01 00:15:20,8,2,149,0,149,0.23%,0.00%
2020-01-01 00:15:20,8,3,1736,21,1715,2.65%,1.21%
2020-01-01 00:15:20,8,4,2702,55,2647,4.12%,2.03%
2020-01-01 00:15:20,8,5,8177,472,7705,12.48%,5.77%
2020-01-01 00:15:20,8,6,17278,2072,15206,26.36%,11.99%
2020-01-01 00:15:20,8,7,6308,279,6029,9.63%,4.42%
2020-01-01 00:15:20,8,8,2591,53,2538,3.95%,2.04%
2020-01-01 00:15:20,8,9,6233,293,5940,9.51%,4.70%
2020-01-01 00:15:20,8,10,1636,29,1607,2.50%,1.77%
2020-01-01 00:15:20,8,11,392,1,391,0.60%,0.25%
2020-01-01 00:15:20,8,12,4527,145,4382,6.91%,3.20%
2020-01-01 00:15:20,9,1,749,0,749,1.14%,0.00%
2020-01-01 00:15:20,9,2,5043,187,4856,7.70%,3.71%
2020-01-01 00:15:20,9,3,3957,113,3844,6.04%,2.85%
2020-01-01 00:15:20,9,4,5805,265,5540,8.86%,4.56%
2020-01-01 00:15:20,9,5,299,0,299,0.46%,0.00%
2020-01-01 00:15:20,9,6,6665,346,6319,10.17%,5.19%
2020-01-01 00:15:20,9,7,29167,5694,23473,44.51%,19.52%
2020-01-01 00:15:20,9,8,11350,916,10434,17.32%,8.07%
2020-01-01 00:15:20,9,9,201,0,201,0.31%,0.00%
2020-01-01 00:15:20,9,10,4834,146,4688,7.38%,3.02%
2020-01-01 00:15:20,9,11,10278,703,9575,15.68%,6.84%
2020-01-01 00:15:20,9,12,4993,179,4814,7.62%,3.58%
2020-01-01 00:15:20,10,1,1421,281,1140,2.17%,19.76%
2020-01-01 00:15:20,10,2,3095,356,2739,4.72%,11.50%
2020-01-01 00:15:20,10,3,1478,19,1459,2.26%,1.28%
2020-01-01 00:15:20,10,4,4027,802,3225,6.14%,19.91%
2020-01-01 00:15:20,10,5,715,31,684,1.09%,4.33%
2020-01-01 00:15:20,10,6,6351,1008,5343,9.69%,15.87%
2020-01-01 00:15:20,10,7,11435,1843,9592,17.45%,16.12%
2020-01-01 00:15:20,10,8,29113,7172,21941,44.42%,24.63%
2020-01-01 00:15:20,10,9,655,2,653,1.00%,0.30%
2020-01-01 00:15:20,10,10,2797,56,2741,4.27%,2.00%
2020-01-01 00:15:20,10,11,13667,1659,12008,20.85%,12.14%
2020-01-01 00:15:20,10,12,10209,1123,9086,15.58%,11.00%
2020-01-01 00:15:20,11,1,2611,53,2558,3.98%,2.03%
2020-01-01 00:15:20,11,2,4154,136,4018,6.34%,3.27%
2020-01-01 00:15:20,11,3,1391,10,1381,2.12%,0.72%
2020-01-01 00:15:20,11,4,5245,184,5061,8.00%,3.51%
2020-01-01 00:15:20,11,5,174,0,174,0.27%,0.00%
2020-01-01 00:15:20,11,6,6308,244,6064,9.63%,3.87%
2020-01-01 00:15:20,11,7,12584,1100,11484,19.20%,8.74%
2020-01-01 00:15:20,11,8,28523,5425,23098,43.52%,19.02%
2020-01-01 00:15:20,11,9,279,1,278,0.43%,0.36%
2020-01-01 00:15:20,11,10,4130,124,4006,6.30%,3.00%
2020-01-01 00:15:20,11,11,11124,928,10196,16.97%,8.34%
2020-01-01 00:15:20,11,12,6708,344,6364,10.24%,5.13%
2020-01-01 00:15:20,12,1,36,0,36,0.05%,0.00%
2020-01-01 00:15:20,12,2,666,195,471,1.02%,29.24%
2020-01-01 00:15:20,12,3,2831,246,2585,4.32%,8.69%
2020-01-01 00:15:20,12,4,3394,87,3307,5.18%,2.56%
2020-01-01 00:15:20,12,5,10421,921,9500,15.90%,8.84%
2020-01-01 00:15:20,12,6,6591,321,6270,10.06%,4.87%
2020-01-01 00:15:20,12,7,3080,87,2993,4.70%,2.82%
2020-01-01 00:15:20,12,8,1257,228,1029,1.92%,18.12%
2020-01-01 00:15:20,12,9,23460,4797,18663,35.80%,20.45%
2020-01-01 00:15:20,12,10,4624,369,4255,7.06%,7.98%
2020-01-01 00:15:20,12,11,1573,234,1339,2.40%,14.87%
2020-01-01 00:15:20,12,12,7603,1246,6357,11.60%,16.39%
2020-01-01 00:15:20,13,1,2029,33,1996,3.10%,1.63%
2020-01-01 00:15:20,13,2,2375,41,2334,3.62%,1.73%
2020-01-01 00:15:20,13,3,782,6,776,1.19%,0.77%
2020-01-01 00:15:20,13,4,6166,637,5529,9.41%,10.33%
2020-01-01 00:15:20,13,5,9058,1049,8009,13.82%,11.58%
2020-01-01 00:15:20,13,6,7239,729,6510,11.05%,10.07%
2020-01-01 00:15:20,13,7,4819,181,4638,7.35%,3.76%
2020-01-01 00:15:20,13,8,6807,361,6446,10.39%,5.30%
2020-01-01 00:15:20,13,9,9322,1079,8243,14.22%,11.57%
2020-01-01 00:15:20,13,10,27971,5825,22146,42.68%,20.82%
2020-01-01 00:15:20,13,11,16101,2160,13941,24.57%,13.41%
2020-01-01 00:15:20,13,12,8747,868,7879,13.35%,9.92%
2020-01-01 00:15:20,14,1,339,0,339,0.52%,0.00%
2020-01-01 00:15:20,14,2,1493,16,1477,2.28%,1.07%
2020-01-01 00:15:20,14,3,953,8,945,1.45%,0.84%
2020-01-01 00:15:20,14,4,4014,99,3915,6.12%,2.47%
2020-01-01 00:15:20,14,5,1398,15,1383,2.13%,1.07%
2020-01-01 00:15:20,14,6,4252,114,4138,6.49%,2.68%
2020-01-01 00:15:20,14,7,11740,940,10800,17.91%,8.01%
2020-01-01 00:15:20,14,8,13666,1279,12387,20.85%,9.36%
2020-01-01 00:15:20,14,9,1611,19,1592,2.46%,1.18%
2020-01-01 00:15:20,14,10,4692,191,4501,7.16%,4.07%
2020-01-01 00:15:20,14,11,26123,4538,21585,39.86%,17.37%
2020-01-01 00:15:20,14,12,7529,384,7145,11.49%,5.10%
2020-01-01 00:15:20,15,1,436,1,435,0.67%,0.23%
2020-01-01 00:15:20,15,2,308,1,307,0.47%,0.32%
2020-01-01 00:15:20,15,3,3739,115,3624,5.71%,3.07%
2020-01-01 00:15:20,15,4,4940,194,4746,7.54%,3.93%
2020-01-01 00:15:20,15,5,9511,679,8832,14.51%,7.14%
2020-01-01 00:15:20,15,6,5346,232,5114,8.16%,4.34%
2020-01-01 00:15:20,15,7,4048,161,3887,6.18%,3.98%
2020-01-01 00:15:20,15,8,5992,321,5671,9.14%,5.36%
2020-01-01 00:15:20,15,9,9765,716,9049,14.90%,7.33%
2020-01-01 00:15:20,15,10,4067,214,3853,6.21%,5.26%
2020-01-01 00:15:20,15,11,10428,895,9533,15.91%,8.58%
2020-01-01 00:15:20,15,12,26071,5137,20934,39.78%,19.70%
2020-01-01 00:15:20,16,1,388,2,386,0.59%,0.51%
2020-01-01 00:15:20,16,2,321,0,321,0.49%,0.00%
2020-01-01 00:15:20,16,3,2831,66,2765,4.32%,2.33%
2020-01-01 00:15:20,16,4,3934,114,3820,6.00%,2.90%
2020-01-01 00:15:20,16,5,8852,621,8231,13.51%,7.01%
2020-01-01 00:15:20,16,6,4765,174,4591,7.27%,3.65%
2020-01-01 00:15:20,16,7,3383,84,3299,5.16%,2.48%
2020-01-01 00:15:20,16,8,7269,377,6892,11.09%,5.19%
2020-01-01 00:15:20,16,9,9270,665,8605,14.14%,7.17%
2020-01-01 00:15:20,16,10,1750,33,1717,2.67%,1.88%
2020-01-01 00:15:20,16,11,9291,663,8628,14.18%,7.14%
2020-01-01 00:15:20,16,12,26848,4836,22012,40.97%,18.01%
2020-01-01 00:15:30,1,1,16458,1953,14505,25.11%,11.87%
2020-01-01 00:15:30,1,2,5576,252,5324,8.51%,4.52%
2020-01-01 00:15:30,1,3,451,0,451,0.69%,0.00%
2020-01-01 00:15:30,1,4,10593,828,9765,16.16%,7.82%
2020-01-01 00:15:30,1,5,10323,785,9538,15.75%,7.60%
2020-01-01 00:15:30,1,6,10274,777,9497,15.68%,7.56%
2020-01-01 00:15:30,1,7,5095,217,4878,7.77%,4.26%
2020-01-01 00:15:30,1,8,4364,155,4209,6.66%,3.55%
2020-01-01 00:15:30,1,9,10214,774,9440,15.59%,7.58%
2020-01-01 00:15:30,1,10,3664,104,3560,5.59%,2.84%
2020-01-01 00:15:30,1,11,3764,111,3653,5.74%,2.95%
2020-01-01 00:15:30,1,12,10190,767,9423,15.55%,7.53%
2020-01-01 00:15:30,2,1,568,1,567,0.87%,0.18%
2020-01-01 00:15:30,2,2,24388,4066,20322,37.21%,16.67%
2020-01-01 00:15:30,2,3,19813,2740,17073,30.23%,13.83%
2020-01-01 00:15:30,2,4,481,0,481,0.73%,0.00%
2020-01-01 00:15:30,2,5,11352,966,10386,17.32%,8.51%
2020-01-01 00:15:30,2,6,119,0,119,0.18%,0.00%
2020-01-01 00:15:30,2,7,3991,132,3859,6.09%,3.31%
2020-01-01 00:15:30,2,8,2919,61,2858,4.45%,2.09%
2020-01-01 00:15:30,2,9,11232,943,10289,17.14%,8.39%
2020-01-01 00:15:30,2,10,2065,28,2037,3.15%,1.36%
2020-01-01 00:15:30,2,11,2105,28,2077,3.21%,1.33%
2020-01-01 00:15:30,2,12,11101,926,10175,16.94%,8.34%
2020-01-01 00:15:30,3,1,1632,20,1612,2.49%,1.22%
2020-01-01 00:15:30,3,2,26901,4767,22134,41.05%,17.72%
2020-01-01 00:15:30,3,3,75406,30635,44771,115.06%,40.63%
2020-01-01 00:15:30,3,4,9497,629,8868,14.49%,6.62%
2020-01-01 00:15:30,3,5,47249,13644,33605,72.10%,28.88%
2020-01-01 00:15:30,3,6,11086,869,10217,16.92%,7.84%
2020-01-01 00:15:30,3,7,23308,3606,19702,35.57%,15.47%
2020-01-01 00:15:30,3,8,19208,2497,16711,29.31%,13.00%
2020-01-01 00:15:30,3,9,35759,8266,27493,54.56%,23.12%
2020-01-01 00:15:30,3,10,4170,134,4036,6.36%,3.21%
2020-01-01 00:15:30,3,11,2774,45,2729,4.23%,1.62%
2020-01-01 00:15:30,3,12,28356,5337,23019,43.27%,18.82%
2020-01-01 00:15:30,4,1,539,4,535,0.82%,0.74%
2020-01-01 00:15:30,4,2,354,1,353,0.54%,0.28%
2020-01-01 00:15:30,4,3,1158,3,1155,1.77%,0.26%
2020-01-01 00:15:30,4,4,28010,5290,22720,42.74%,18.89%
2020-01-01 00:15:30,4,5,17607,2204,15403,26.87%,12.52%
2020-01-01 00:15:30,4,6,23938,3937,20001,36.53%,16.45%
2020-01-01 00:15:30,4,7,5068,215,4853,7.73%,4.24%
2020-01-01 00:15:30,4,8,2821,66,2755,4.30%,2.34%
2020-01-01 00:15:30,4,9,15007,1614,13393,22.90%,10.75%
2020-01-01 00:15:30,4,10,1897,35,1862,2.89%,1.84%
2020-01-01 00:15:30,4,11,152,0,152,0.23%,0.00%
2020-01-01 00:15:30,4,12,12495,1106,11389,19.07%,8.85%
2020-01-01 00:15:30,5,1,2952,67,2885,4.50%,2.27%
2020-01-01 00:15:30,5,2,772,6,766,1.18%,0.78%
2020-01-01 00:15:30,5,3,421,0,421,0.64%,0.00%
2020-01-01 00:15:30,5,4,25289,4298,20991,38.59%,16.99%
2020-01-01 00:15:30,5,5,10073,712,9361,15.37%,7.07%
2020-01-01 00:15:30,5,6,15384,1634,13750,23.47%,10.62%
2020-01-01 00:15:30,5,7,4707,175,4532,7.18%,3.72%
2020-01-01 00:15:30,5,8,3677,104,3573,5.61%,2.83%
2020-01-01 00:15:30,5,9,9462,633,8829,14.44%,6.69%
2020-01-01 00:15:30,5,10,1052,7,1045,1.61%,0.66%
2020-01-01 00:15:30,5,11,815,8,807,1.24%,0.98%
2020-01-01 00:15:30,5,12,7802,437,7365,11.90%,5.60%
2020-01-01 00:15:30,6,1,1014,14,1000,1.55%,1.38%
2020-01-01 00:15:30,6,2,1141,14,1127,1.74%,1.23%
2020-01-01 00:15:30,6,3,1772,27,1745,2.70%,1.52%
2020-01-01 00:15:30,6,4,1332,20,1312,2.03%,1.50%
2020-01-01 00:15:30,6,5,17483,2101,15382,26.68%,12.02%
2020-01-01 00:15:30,6,6,4941,185,4756,7.54%,3.74%
2020-01-01 00:15:30,6,7,3120,77,3043,4.76%,2.47%
2020-01-01 00:15:30,6,8,2553,59,2494,3.90%,2.31%
2020-01-01 00:15:30,6,9,10441,763,9678,15.93%,7.31%
2020-01-01 00:15:30,6,10,2205,39,2166,3.36%,1.77%
2020-01-01 00:15:30,6,11,425,2,423,0.65%,0.47%
2020-01-01 00:15:30,6,12,8141,466,7675,12.42%,5.72%
2020-01-01 00:15:30,7,1,472,2,470,0.72%,0.42%
2020-01-01 00:15:30,7,2,154,0,154,0.23%,0.00%
2020-01-01 00:15:30,7,3,1133,5,1128,1.73%,0.44%
2020-01-01 00:15:30,7,4,2000,49,1951,3.05%,2.45%
2020-01-01 00:15:30,7,5,7116,335,6781,10.86%,4.71%
2020-01-01 00:15:30,7,6,12080,1104,10976,18.43%,9.14%
2020-01-01 00:15:30,7,7,2866,83,2783,4.37%,2.90%
2020-01-01 00:15:30,7,8,1013,27,986,1.55%,2.66%
2020-01-01 00:15:30,7,9,5900,243,5657,9.00%,4.12%
2020-01-01 00:15:30,7,10,1227,14,1213,1.87%,1.14%
2020-01-01 00:15:30,7,11,112,0,112,0.17%,0.00%
2020-01-01 00:15:30,7,12,4646,140,4506,7.09%,3.01%
2020-01-01 00:15:30,8,1,542,2,540,0.83%,0.37%
2020-01-01 00:15:30,8,2,121,0,121,0.18%,0.00%
2020-01-01 00:15:30,8,3,2009,24,1985,3.07%,1.19%
2020-01-01 00:15:30,8,4,2740,56,2684,4.18%,2.04%
2020-01-01 00:15:30,8,5,8357,515,7842,12.75%,6.16%
2020-01-01 00:15:30,8,6,19143,2552,16591,29.21%,13.33%
2020-01-01 00:15:30,8,7,7983,477,7506,12.18%,5.97%
2020-01-01 00:15:30,8,8,4727,177,4550,7.21%,3.74%
2020-01-01 00:15:30,8,9,6155,284,5871,9.39%,4.61%
2020-01-01 00:15:30,8,10,1604,16,1588,2.45%,1.00%
2020-01-01 00:15:30,8,11,310,1,309,0.47%,0.32%
2020-01-01 00:15:30,8,12,4409,157,4252,6.73%,3.56%
2020-01-01 00:15:30,9,1,235,0,235,0.36%,0.00%
2020-01-01 00:15:30,9,2,2186,40,2146,3.34%,1.83%
2020-01-01 00:15:30,9,3,1634,25,1609,2.49%,1.53%
2020-01-01 00:15:30,9,4,8471,534,7937,12.93%,6.30%
2020-01-01 00:15:30,9,5,513,3,510,0.78%,0.58%
2020-01-01 00:15:30,9,6,9667,693,8974,14.75%,7.17%
2020-01-01 00:15:30,9,7,27135,5064,22071,41.40%,18.66%
2020-01-01 00:15:30,9,8,10134,800,9334,15.46%,7.89%
2020-01-01 00:15:30,9,9,487,3,484,0.74%,0.61%
2020-01-01 00:15:30,9,10,3567,94,3473,5.44%,2.63%
2020-01-01 00:15:30,9,11,8582,584,7998,13.10%,6.80%
2020-01-01 00:15:30,9,12,4694,183,4511,7.16%,3.90%
2020-01-01 00:15:30,10,1,1211,287,924,1.85%,23.68%
2020-01-01 00:15:30,10,2,2781,329,2452,4.24%,11.83%
2020-01-01 00:15:30,10,3,1366,18,1348,2.08%,1.32%
2020-01-01 00:15:30,10,4,4564,984,3580,6.96%,21.56%
2020-01-01 00:15:30,10,5,601,1,600,0.92%,0.17%
2020-01-01 00:15:30,10,6,6590,1109,5481,10.06%,16.83%
2020-01-01 00:15:30,10,7,11171,1901,9270,17.05%,17.02%
2020-01-01 00:15:30,10,8,26913,6590,20323,41.07%,24.49%
2020-01-01 00:15:30,10,9,679,3,676,1.04%,0.44%
2020-01-01 00:15:30,10,10,2539,61,2478,3.87%,2.40%
2020-01-01 00:15:30,10,11,11930,1391,10539,18.20%,11.66%
2020-01-01 00:15:30,10,12,8740,934,7806,13.34%,10.69%
2020-01-01 00:15:30,11,1,2244,41,2203,3.42%,1.83%
2020-01-01 00:15:30,11,2,3417,97,3320,5.21%,2.84%
2020-01-01 00:15:30,11,3,984,11,973,1.50%,1.12%
2020-01-01 00:15:30,11,4,4735,172,4563,7.23%,3.63%
2020-01-01 00:15:30,11,5,726,3,723,1.11%,0.41%
2020-01-01 00:15:30,11,6,6131,270,5861,9.36%,4.40%
2020-01-01 00:15:30,11,7,12072,1120,10952,18.42%,9.28%
2020-01-01 00:15:30,11,8,25527,4469,21058,38.95%,17.51%
2020-01-01 00:15:30,11,9,190,1,189,0.29%,0.52%
2020-01-01 00:15:30,11,10,3380,72,3308,5.16%,2.13%
2020-01-01 00:15:30,11,11,10012,734,9278,15.28%,7.33%
2020-01-01 00:15:30,11,12,6417,313,6104,9.79%,4.88%
2020-01-01 00:15:30,12,1,23,0,23,0.04%,0.00%
2020-01-01 00:15:30,12,2,787,220,567,1.20%,27.92%
2020-01-01 00:15:30,12,3,2650,264,2386,4.04%,9.96%
2020-01-01 00:15:30,12,4,3139,58,3081,4.79%,1.85%
2020-01-01 00:15:30,12,5,11022,1033,9989,16.82%,9.37%
2020-01-01 00:15:30,12,6,6340,270,6070,9.67%,4.26%
2020-01-01 00:15:30,12,7,3077,68,3009,4.70%,2.21%
2020-01-01 00:15:30,12,8,1413,202,1211,2.16%,14.29%
2020-01-01 00:15:30,12,9,24011,4913,19098,36.64%,20.46%
2020-01-01 00:15:30,12,10,4262,308,3954,6.50%,7.22%
2020-01-01 00:15:30,12,11,1611,207,1404,2.46%,12.84%
2020-01-01 00:15:30,12,12,7730,1115,6615,11.80%,14.42%
2020-01-01 00:15:30,13,1,2256,38,2218,3.44%,1.68%
2020-01-01 00:15:30,13,2,2571,47,2524,3.92%,1.83%
2020-01-01 00:15:30,13,3,605,5,600,0.92%,0.83%
2020-01-01 00:15:30,13,4,4840,441,4399,7.39%,9.11%
2020-01-01 00:15:30,13,5,7236,786,6450,11.04%,10.86%
2020-01-01 00:15:30,13,6,5830,524,5306,8.90%,8.99%
2020-01-01 00:15:30,13,7,5197,208,4989,7.93%,4.00%
2020-01-01 00:15:30,13,8,7060,418,6642,10.77%,5.92%
2020-01-01 00:15:30,13,9,7551,827,6724,11.52%,10.95%
2020-01-01 00:15:30,13,10,27948,5799,22149,42.65%,20.75%
2020-01-01 00:15:30,13,11,17794,2596,15198,27.15%,14.59%
2020-01-01 00:15:30,13,12,10034,1142,8892,15.31%,11.38%
2020-01-01 00:15:30,14,1,338,0,338,0.52%,0.00%
2020-01-01 00:15:30,14,2,1658,18,1640,2.53%,1.08%
2020-01-01 00:15:30,14,3,1159,8,1151,1.77%,0.69%
2020-01-01 00:15:30,14,4,4096,143,3953,6.25%,3.49%
2020-01-01 00:15:30,14,5,1349,12,1337,2.06%,0.89%
2020-01-01 00:15:30,14,6,4296,153,4143,6.56%,3.56%
2020-01-01 00:15:30,14,7,11499,957,10542,17.55%,8.32%
2020-01-01 00:15:30,14,8,13444,1321,12123,20.51%,9.83%
2020-01-01 00:15:30,14,9,1609,14,1595,2.46%,0.87%
2020-01-01 00:15:30,14,10,4201,137,4064,6.41%,3.26%
2020-01-01 00:15:30,14,11,25308,4344,20964,38.62%,17.16%
2020-01-01 00:15:30,14,12,7388,379,7009,11.27%,5.13%
2020-01-01 00:15:30,15,1,473,4,469,0.72%,0.84%
2020-01-01 00:15:30,15,2,257,0,257,0.39%,0.00%
2020-01-01 00:15:30,15,3,4417,134,4283,6.74%,3.03%
2020-01-01 00:15:30,15,4,6120,319,5801,9.34%,5.21%
2020-01-01 00:15:30,15,5,12063,1058,11005,18.41%,8.77%
2020-01-01 00:15:30,15,6,6356,345,6011,9.70%,5.43%
2020-01-01 00:15:30,15,7,3857,131,3726,5.89%,3.40%
2020-01-01 00:15:30,15,8,5463,215,5248,8.34%,3.93%
2020-01-01 00:15:30,15,9,12303,1097,11206,18.77%,8.92%
2020-01-01 00:15:30,15,10,4511,141,4370,6.88%,3.12%
2020-01-01 00:15:30,15,11,10148,740,9408,15.48%,7.29%
2020-01-01 00:15:30,15,12,29277,6017,23260,44.67%,20.55%
2020-01-01 00:15:30,16,1,457,1,456,0.70%,0.22%
2020-01-01 00:15:30,16,2,214,0,214,0.33%,0.00%
2020-01-01 00:15:30,16,3,1315,15,1300,2.01%,1.14%
2020-01-01 00:15:30,16,4,4663,176,4487,7.12%,3.77%
2020-01-01 00:15:30,16,5,7934,531,7403,12.11%,6.69%
2020-01-01 00:15:30,16,6,5387,229,5158,8.22%,4.25%
2020-01-01 00:15:30,16,7,3715,106,3609,5.67%,2.85%
2020-01-01 00:15:30,16,8,7733,423,7310,11.80%,5.47%
2020-01-01 00:15:30,16,9,8322,578,7744,12.70%,6.94%
2020-01-01 00:15:30,16,10,1430,26,1404,2.18%,1.82%
2020-01-01 00:15:30,16,11,9355,628,8727,14.27%,6.71%
2020-01-01 00:15:30,16,12,25625,4545,21080,39.10%,17.74%
2020-01-01 00:15:40,1,1,18233,2334,15899,27.82%,12.80%
2020-01-01 00:15:40,1,2,8765,544,8221,13.37%,6.21%
2020-01-01 00:15:40,1,3,547,1,546,0.83%,0.18%
2020-01-01 00:15:40,1,4,9149,616,8533,13.96%,6.73%
2020-01-01 00:15:40,1,5,8814,582,8232,13.45%,6.60%
2020-01-01 00:15:40,1,6,8750,567,8183,13.35%,6.48%
2020-01-01 00:15:40,1,7,8196,486,7710,12.51%,5.93%
2020-01-01 00:15:40,1,8,7454,376,7078,11.37%,5.04%
2020-01-01 00:15:40,1,9,8685,561,8124,13.25%,6.46%
2020-01-01 00:15:40,1,10,6806,318,6488,10.39%,4.67%
2020-01-01 00:15:40,1,11,6886,328,6558,10.51%,4.76%
2020-01-01 00:15:40,1,12,8662,557,8105,13.22%,6.43%
2020-01-01 00:15:40,2,1,948,3,945,1.45%,0.32%
2020-01-01 00:15:40,2,2,27294,4926,22368,41.65%,18.05%
2020-01-01 00:15:40,2,3,20696,2933,17763,31.58%,14.17%
2020-01-01 00:15:40,2,4,835,2,833,1.27%,0.24%
2020-01-01 00:15:40,2,5,13032,1226,11806,19.89%,9.41%
2020-01-01 00:15:40,2,6,53,0,53,0.08%,0.00%
2020-01-01 00:15:40,2,7,5626,229,5397,8.58%,4.07%
2020-01-01 00:15:40,2,8,4227,124,4103,6.45%,2.93%
2020-01-01 00:15:40,2,9,12952,1214,11738,19.76%,9.37%
2020-01-01 00:15:40,2,10,3260,73,3187,4.97%,2.24%
2020-01-01 00:15:40,2,11,3289,75,3214,5.02%,2.28%
2020-01-01 00:15:40,2,12,12769,1176,11593,19.48%,9.21%
2020-01-01 00:15:40,3,1,2008,34,1974,3.06%,1.69%
2020-01-01 00:15:40,3,2,25327,4352,20975,38.65%,17.18%
2020-01-01 00:15:40,3,3,72008,28311,43697,109.88%,39.32%
2020-01-01 00:15:40,3,4,10893,872,10021,16.62%,8.00%
2020-01-01 00:15:40,3,5,45632,12743,32889,69.63%,27.92%
2020-01-01 00:15:40,3,6,11709,995,10714,17.87%,8.50%
2020-01-01 00:15:40,3,7,21546,3219,18327,32.88%,14.94%
2020-01-01 00:15:40,3,8,16638,1940,14698,25.39%,11.66%
2020-01-01 00:15:40,3,9,33350,7194,26156,50.89%,21.57%
2020-01-01 00:15:40,3,10,3831,112,3719,5.85%,2.92%
2020-01-01 00:15:40,3,11,2405,46,2359,3.67%,1.91%
2020-01-01 00:15:40,3,12,25877,4497,21380,39.49%,17.38%
2020-01-01 00:15:40,4,1,478,1,477,0.73%,0.21%
2020-01-01 00:15:40,4,2,325,0,325,0.50%,0.00%
2020-01-01 00:15:40,4,3,808,8,800,1.23%,0.99%
2020-01-01 00:15:40,4,4,27356,4980,22376,41.74%,18.20%
2020-01-01 00:15:40,4,5,17327,2135,15192,26.44%,12.32%
2020-01-01 00:15:40,4,6,23740,3788,19952,36.22%,15.96%
2020-01-01 00:15:40,4,7,5096,195,4901,7.78%,3.83%
2020-01-01 00:15:40,4,8,2939,58,2881,4.48%,1.97%
2020-01-01 00:15:40,4,9,15560,1741,13819,23.74%,11.19%
2020-01-01 00:15:40,4,10,1830,21,1809,2.79%,1.15%
2020-01-01 00:15:40,4,11,151,0,151,0.23%,0.00%
2020-01-01 00:15:40,4,12,12752,1197,11555,19.46%,9.39%
2020-01-01 00:15:40,5,1,3284,70,3214,5.01%,2.13%
2020-01-01 00:15:40,5,2,873,2,871,1.33%,0.23%
2020-01-01 00:15:40,5,3,393,1,392,0.60%,0.25%
2020-01-01 00:15:40,5,4,25033,4157,20876,38.20%,16.61%
2020-01-01 00:15:40,5,5,10070,721,9349,15.37%,7.16%
2020-01-01 00:15:40,5,6,15312,1645,13667,23.36%,10.74%
2020-01-01 00:15:40,5,7,4708,178,4530,7.18%,3.78%
2020-01-01 00:15:40,5,8,3620,111,3509,5.52%,3.07%
2020-01-01 00:15:40,5,9,9558,647,8911,14.58%,6.77%
2020-01-01 00:15:40,5,10,1330,17,1313,2.03%,1.28%
2020-01-01 00:15:40,5,11,644,5,639,0.98%,0.78%
2020-01-01 00:15:40,5,12,7873,420,7453,12.01%,5.33%
2020-01-01 00:15:40,6,1,1114,12,1102,1.70%,1.08%
2020-01-01 00:15:40,6,2,1283,13,1270,1.96%,1.01%
2020-01-01 00:15:40,6,3,2003,27,1976,3.06%,1.35%
2020-01-01 00:15:40,6,4,1135,11,1124,1.73%,0.97%
2020-01-01 00:15:40,6,5,13811,1368,12443,21.07%,9.90%
2020-01-01 00:15:40,6,6,3689,105,3584,5.63%,2.85%
2020-01-01 00:15:40,6,7,2057,37,2020,3.14%,1.80%
2020-01-01 00:15:40,6,8,1597,28,1569,2.44%,1.75%
2020-01-01 00:15:40,6,9,7897,456,7441,12.05%,5.77%
2020-01-01 00:15:40,6,10,2805,44,2761,4.28%,1.57%
2020-01-01 00:15:40,6,11,439,0,439,0.67%,0.00%
2020-01-01 00:15:40,6,12,4976,168,4808,7.59%,3.38%
2020-01-01 00:15:40,7,1,435,1,434,0.66%,0.23%
2020-01-01 00:15:40,7,2,149,0,149,0.23%,0.00%
2020-01-01 00:15:40,7,3,749,5,744,1.14%,0.67%
2020-01-01 00:15:40,7,4,1603,39,1564,2.45%,2.43%
2020-01-01 00:15:40,7,5,8818,573,8245,13.46%,6.50%
2020-01-01 00:15:40,7,6,14273,1445,12828,21.78%,10.12%
2020-01-01 00:15:40,7,7,3775,88,3687,5.76%,2.33%
2020-01-01 00:15:40,7,8,1846,23,1823,2.82%,1.25%
2020-01-01 00:15:40,7,9,7997,485,7512,12.20%,6.06%
2020-01-01 00:15:40,7,10,1793,19,1774,2.74%,1.06%
2020-01-01 00:15:40,7,11,103,0,103,0.16%,0.00%
2020-01-01 00:15:40,7,12,6149,294,5855,9.38%,4.78%
2020-01-01 00:15:40,8,1,334,0,334,0.51%,0.00%
2020-01-01 00:15:40,8,2,123,0,123,0.19%,0.00%
2020-01-01 00:15:40,8,3,1710,23,1687,2.61%,1.34%
2020-01-01 00:15:40,8,4,2983,61,2922,4.55%,2.04%
2020-01-01 00:15:40,8,5,9456,703,8753,14.43%,7.43%
2020-01-01 00:15:40,8,6,18283,2451,15832,27.90%,13.41%
2020-01-01 00:15:40,8,7,5786,246,5540,8.83%,4.25%
2020-01-01 00:15:40,8,8,2366,49,2317,3.61%,2.07%
2020-01-01 00:15:40,8,9,7412,429,6983,11.31%,5.79%
2020-01-01 00:15:40,8,10,1550,26,1524,2.37%,1.68%
2020-01-01 00:15:40,8,11,210,1,209,0.32%,0.47%
2020-01-01 00:15:40,8,12,5779,240,5539,8.82%,4.15%
2020-01-01 00:15:40,9,1,448,0,448,0.68%,0.00%
2020-01-01 00:15:40,9,2,4205,127,4078,6.42%,3.02%
2020-01-01 00:15:40,9,3,3174,70,3104,4.84%,2.20%
2020-01-01 00:15:40,9,4,4332,127,4205,6.61%,2.93%
2020-01-01 00:15:40,9,5,279,1,278,0.43%,0.36%
2020-01-01 00:15:40,9,6,5280,189,5091,8.06%,3.58%
2020-01-01 00:15:40,9,7,27433,5078,22355,41.86%,18.51%
2020-01-01 00:15:40,9,8,12022,1025,10997,18.34%,8.53%
2020-01-01 00:15:40,9,9,235,0,235,0.36%,0.00%
2020-01-01 00:15:40,9,10,4046,102,3944,6.17%,2.52%
2020-01-01 00:15:40,9,11,10505,756,9749,16.03%,7.20%
2020-01-01 00:15:40,9,12,6217,298,5919,9.49%,4.79%
2020-01-01 00:15:40,10,1,1104,211,893,1.68%,19.10%
2020-01-01 00:15:40,10,2,6239,482,5757,9.52%,7.72%
2020-01-01 00:15:40,10,3,4935,178,4757,7.53%,3.61%
2020-01-01 00:15:40,10,4,3929,789,3140,6.00%,20.08%
2020-01-01 00:15:40,10,5,709,2,707,1.08%,0.28%
2020-01-01 00:15:40,10,6,5659,899,4760,8.63%,15.88%
2020-01-01 00:15:40,10,7,14040,2145,11895,21.42%,15.28%
2020-01-01 00:15:40,10,8,33467,8742,24725,51.07%,26.12%
2020-01-01 00:15:40,10,9,1194,9,1185,1.82%,0.75%
2020-01-01 00:15:40,10,10,2914,71,2843,4.45%,2.44%
2020-01-01 00:15:40,10,11,13666,1704,11962,20.85%,12.47%
2020-01-01 00:15:40,10,12,9967,1171,8796,15.21%,11.75%
2020-01-01 00:15:40,11,1,2274,72,2202,3.47%,3.16%
2020-01-01 00:15:40,11,2,3409,110,3299,5.20%,3.23%
2020-01-01 00:15:40,11,3,969,11,958,1.48%,1.13%
2020-01-01 00:15:40,11,4,3194,78,3116,4.87%,2.44%
2020-01-01 00:15:40,11,5,188,0,188,0.29%,0.00%
2020-01-01 00:15:40,11,6,3875,97,3778,5.91%,2.50%
2020-01-01 00:15:40,11,7,9929,714,9215,15.15%,7.19%
2020-01-01 00:15:40,11,8,24652,4231,20421,37.62%,17.16%
2020-01-01 00:15:40,11,9,232,0,232,0.35%,0.00%
2020-01-01 00:15:40,11,10,3793,115,3678,5.79%,3.03%
2020-01-01 00:15:40,11,11,10958,900,10058,16.72%,8.21%
2020-01-01 00:15:40,11,12,6811,356,6455,10.39%,5.23%
2020-01-01 00:15:40,12,1,50,0,50,0.08%,0.00%
2020-01-01 00:15:40,12,2,663,184,479,1.01%,27.71%
2020-01-01 00:15:40,12,3,2769,230,2539,4.23%,8.30%
2020-01-01 00:15:40,12,4,2315,44,2271,3.53%,1.90%
2020-01-01 00:15:40,12,5,9136,724,8412,13.94%,7.92%
2020-01-01 00:15:40,12,6,5020,180,4840,7.66%,3.58%
2020-01-01 00:15:40,12,7,2548,56,2492,3.89%,2.20%
2020-01-01 00:15:40,12,8,1200,219,981,1.83%,18.23%
2020-01-01 00:15:40,12,9,21940,4233,17707,33.48%,19.29%
2020-01-01 00:15:40,12,10,3665,286,3379,5.59%,7.80%
2020-01-01 00:15:40,12,11,1369,222,1147,2.09%,16.20%
2020-01-01 00:15:40,12,12,8458,1219,7239,12.91%,14.41%
2020-01-01 00:15:40,13,1,2128,39,2089,3.25%,1.83%
2020-01-01 00:15:40,13,2,2589,56,2533,3.95%,2.16%
2020-01-01 00:15:40,13,3,701,2,699,1.07%,0.28%
2020-01-01 00:15:40,13,4,4745,565,4180,7.24%,11.90%
2020-01-01 00:15:40,13,5,7277,835,6442,11.10%,11.47%
2020-01-01 00:15:40,13,6,5785,649,5136,8.83%,11.22%
2020-01-01 00:15:40,13,7,4924,196,4728,7.51%,3.98%
2020-01-01 00:15:40,13,8,6889,383,6506,10.51%,5.56%
2020-01-01 00:15:40,13,9,7570,867,6703,11.55%,11.45%
2020-01-01 00:15:40,13,10,26859,5412,21447,40.98%,20.15%
2020-01-01 00:15:40,13,11,16560,2195,14365,25.27%,13.25%
2020-01-01 00:15:40,13,12,9167,941,8226,13.99%,10.26%
2020-01-01 00:15:40,14,1,343,2,341,0.52%,0.58%
2020-01-01 00:15:40,14,2,1513,29,1484,2.31%,1.92%
2020-01-01 00:15:40,14,3,1020,11,1009,1.56%,1.08%
2020-01-01 00:15:40,14,4,4201,129,4072,6.41%,3.07%
2020-01-01 00:15:40,14,5,1466,12,1454,2.24%,0.82%
2020-01-01 00:15:40,14,6,4556,156,4400,6.95%,3.42%
2020-01-01 00:15:40,14,7,12712,1196,11516,19.40%,9.41%
2020-01-01 00:15:40,14,8,14641,1583,13058,22.34%,10.81%
2020-01-01 00:15:40,14,9,1762,24,1738,2.69%,1.36%
2020-01-01 00:15:40,14,10,4545,154,4391,6.94%,3.39%
2020-01-01 00:15:40,14,11,27203,4980,22223,41.51%,18.31%
2020-01-01 00:15:40,14,12,7773,429,7344,11.86%,5.52%
2020-01-01 00:15:40,15,1,593,3,590,0.90%,0.51%
2020-01-01 00:15:40,15,2,175,0,175,0.27%,0.00%
2020-01-01 00:15:40,15,3,4531,159,4372,6.91%,3.51%
2020-01-01 00:15:40,15,4,5391,249,5142,8.23%,4.62%
2020-01-01 00:15:40,15,5,10839,899,9940,16.54%,8.29%
2020-01-01 00:15:40,15,6,5656,273,5383,8.63%,4.83%
2020-01-01 00:15:40,15,7,4091,139,3952,6.24%,3.40%
2020-01-01 00:15:40,15,8,6056,286,5770,9.24%,4.72%
2020-01-01 00:15:40,15,9,11041,934,10107,16.85%,8.46%
2020-01-01 00:15:40,15,10,3890,191,3699,5.94%,4.91%
2020-01-01 00:15:40,15,11,10115,824,9291,15.43%,8.15%
2020-01-01 00:15:40,15,12,27528,5424,22104,42.00%,19.70%
2020-01-01 00:15:40,16,1,445,5,440,0.68%,1.12%
2020-01-01 00:15:40,16,2,265,0,265,0.40%,0.00%
2020-01-01 00:15:40,16,3,1413,11,1402,2.16%,0.78%
2020-01-01 00:15:40,16,4,3962,128,3834,6.05%,3.23%
2020-01-01 00:15:40,16,5,7596,489,7107,11.59%,6.44%
2020-01-01 00:15:40,16,6,4625,162,4463,7.06%,3.50%
2020-01-01 00:15:40,16,7,3544,103,3441,5.41%,2.91%
2020-01-01 00:15:40,16,8,7253,439,6814,11.07%,6.05%
2020-01-01 00:15:40,16,9,7927,538,7389,12.10%,6.79%
2020-01-01 00:15:40,16,10,1553,15,1538,2.37%,0.97%
2020-01-01 00:15:40,16,11,8996,643,8353,13.73%,7.15%
2020-01-01 00:15:40,16,12,24628,4191,20437,37.58%,17.02%
2020-01-01 00:15:50,1,1,20233,2802,17431,30.87%,13.85%
2020-01-01 00:15:50,1,2,7307,386,6921,11.15%,5.28%
2020-01-01 00:15:50,1,3,713,2,711,1.09%,0.28%
2020-01-01 00:15:50,1,4,12590,1151,11439,19.21%,9.14%
2020-01-01 00:15:50,1,5,12266,1095,11171,18.72%,8.93%
2020-01-01 00:15:50,1,6,12186,1088,11098,18.59%,8.93%
2020-01-01 00:15:50,1,7,6576,330,6246,10.03%,5.02%
2020-01-01 00:15:50,1,8,5791,265,5526,8.84%,4.58%
2020-01-01 00:15:50,1,9,12140,1075,11065,18.52%,8.85%
2020-01-01 00:15:50,1,10,5015,204,4811,7.65%,4.07%
2020-01-01 00:15:50,1,11,5110,209,4901,7.80%,4.09%
2020-01-01 00:15:50,1,12,12114,1068,11046,18.48%,8.82%
2020-01-01 00:15:50,2,1,891,3,888,1.36%,0.34%
2020-01-01 00:15:50,2,2,25010,4266,20744,38.16%,17.06%
2020-01-01 00:15:50,2,3,20045,2841,17204,30.59%,14.17%
2020-01-01 00:15:50,2,4,830,2,828,1.27%,0.24%
2020-01-01 00:15:50,2,5,12877,1222,11655,19.65%,9.49%
2020-01-01 00:15:50,2,6,36,0,36,0.05%,0.00%
2020-01-01 00:15:50,2,7,4063,128,3935,6.20%,3.15%
2020-01-01 00:15:50,2,8,2880,53,2827,4.39%,1.84%
2020-01-01 00:15:50,2,9,12764,1193,11571,19.48%,9.35%
2020-01-01 00:15:50,2,10,2387,36,2351,3.64%,1.51%
2020-01-01 00:15:50,2,11,2392,36,2356,3.65%,1.50%
2020-01-01 00:15:50,2,12,12610,1172,11438,19.24%,9.29%
2020-01-01 00:15:50,3,1,1944,24,1920,2.97%,1.23%
2020-01-01 00:15:50,3,2,22306,3429,18877,34.04%,15.37%
2020-01-01 00:15:50,3,3,71601,27990,43611,109.25%,39.09%
2020-01-01 00:15:50,3,4,8164,489,7675,12.46%,5.99%
2020-01-01 00:15:50,3,5,48296,13999,34297,73.69%,28.99%
2020-01-01 00:15:50,3,6,9547,667,8880,14.57%,6.99%
2020-01-01 00:15:50,3,7,18756,2479,16277,28.62%,13.22%
2020-01-01 00:15:50,3,8,15082,1642,13440,23.01%,10.89%
2020-01-01 00:15:50,3,9,38345,9216,29129,58.51%,24.03%
2020-01-01 00:15:50,3,10,7740,438,7302,11.81%,5.66%
2020-01-01 00:15:50,3,11,2201,46,2155,3.36%,2.09%
2020-01-01 00:15:50,3,12,27991,5145,22846,42.71%,18.38%
2020-01-01 00:15:50,4,1,421,4,417,0.64%,0.95%
2020-01-01 00:15:50,4,2,246,0,246,0.38%,0.00%
2020-01-01 00:15:50,4,3,967,12,955,1.48%,1.24%
2020-01-01 00:15:50,4,4,27823,5265,22558,42.45%,18.92%
2020-01-01 00:15:50,4,5,17811,2304,15507,27.18%,12.94%
2020-01-01 00:15:50,4,6,24283,4070,20213,37.05%,16.76%
2020-01-01 00:15:50,4,7,5140,196,4944,7.84%,3.81%
2020-01-01 00:15:50,4,8,3304,86,3218,5.04%,2.60%
2020-01-01 00:15:50,4,9,15810,1853,13957,24.12%,11.72%
2020-01-01 00:15:50,4,10,1796,35,1761,2.74%,1.95%
2020-01-01 00:15:50,4,11,119,0,119,0.18%,0.00%
2020-01-01 00:15:50,4,12,12981,1274,11707,19.81%,9.81%
2020-01-01 00:15:50,5,1,3016,72,2944,4.60%,2.39%
2020-01-01 00:15:50,5,2,812,1,811,1.24%,0.12%
2020-01-01 00:15:50,5,3,972,3,969,1.48%,0.31%
2020-01-01 00:15:50,5,4,24173,3962,20211,36.89%,16.39%
2020-01-01 00:15:50,5,5,10771,845,9926,16.44%,7.84%
2020-01-01 00:15:50,5,6,15772,1735,14037,24.07%,11.00%
2020-01-01 00:15:50,5,7,4513,152,4361,6.89%,3.37%
2020-01-01 00:15:50,5,8,3671,96,3575,5.60%,2.61%
2020-01-01 00:15:50,5,9,9680,694,8986,14.77%,7.17%
2020-01-01 00:15:50,5,10,1746,18,1728,2.66%,1.03%
2020-01-01 00:15:50,5,11,911,5,906,1.39%,0.55%
2020-01-01 00:15:50,5,12,7574,425,7149,11.56%,5.61%
2020-01-01 00:15:50,6,1,1164,9,1155,1.78%,0.77%
2020-01-01 00:15:50,6,2,1264,11,1253,1.93%,0.87%
2020-01-01 00:15:50,6,3,1650,20,1630,2.52%,1.21%
2020-01-01 00:15:50,6,4,1524,19,1505,2.33%,1.25%
2020-01-01 00:15:50,6,5,15292,1757,13535,23.33%,11.49%
2020-01-01 00:15:50,6,6,4282,163,4119,6.53%,3.81%
2020-01-01 00:15:50,6,7,2141,45,2096,3.27%,2.10%
2020-01-01 00:15:50,6,8,1550,22,1528,2.37%,1.42%
2020-01-01 00:15:50,6,9,9063,634,8429,13.83%,6.99%
2020-01-01 00:15:50,6,10,2362,33,2329,3.60%,1.40%
2020-01-01 00:15:50,6,11,375,2,373,0.57%,0.53%
2020-01-01 00:15:50,6,12,6592,342,6250,10.06%,5.19%
2020-01-01 00:15:50,7,1,524,4,520,0.80%,0.76%
2020-01-01 00:15:50,7,2,88,0,88,0.13%,0.00%
2020-01-01 00:15:50,7,3,1177,8,1169,1.80%,0.68%
2020-01-01 00:15:50,7,4,1456,22,1434,2.22%,1.51%
2020-01-01 00:15:50,7,5,7633,421,7212,11.65%,5.51%
2020-01-01 00:15:50,7,6,13210,1207,12003,20.16%,9.14%
2020-01-01 00:15:50,7,7,4043,140,3903,6.17%,3.46%
2020-01-01 00:15:50,7,8,1569,16,1553,2.39%,1.02%
2020-01-01 00:15:50,7,9,6356,289,6067,9.70%,4.55%
2020-01-01 00:15:50,7,10,1334,13,1321,2.04%,0.97%
2020-01-01 00:15:50,7,11,155,0,155,0.24%,0.00%
2020-01-01 00:15:50,7,12,4989,193,4796,7.61%,3.87%
2020-01-01 00:15:50,8,1,289,0,289,0.44%,0.00%
2020-01-01 00:15:50,8,2,57,0,57,0.09%,0.00%
2020-01-01 00:15:50,8,3,1476,16,1460,2.25%,1.08%
2020-01-01 00:15:50,8,4,2666,66,2600,4.07%,2.47%
2020-01-01 00:15:50,8,5,8054,471,7583,12.29%,5.85%
2020-01-01 00:15:50,8,6,15714,1699,14015,23.98%,10.81%
2020-01-01 00:15:50,8,7,4865,196,4669,7.42%,4.03%
2020-01-01 00:15:50,8,8,1721,35,1686,2.63%,2.03%
2020-01-01 00:15:50,8,9,6422,308,6114,9.80%,4.80%
2020-01-01 00:15:50,8,10,1879,25,1854,2.87%,1.33%
2020-01-01 00:15:50,8,11,292,1,291,0.45%,0.34%
2020-01-01 00:15:50,8,12,4422,147,4275,6.75%,3.32%
2020-01-01 00:15:50,9,1,1485,4,1481,2.27%,0.27%
2020-01-01 00:15:50,9,2,4860,163,4697,7.42%,3.35%
2020-01-01 00:15:50,9,3,2948,68,2880,4.50%,2.31%
2020-01-01 00:15:50,9,4,7080,357,6723,10.80%,5.04%
2020-01-01 00:15:50,9,5,281,0,281,0.43%,0.00%
2020-01-01 00:15:50,9,6,8002,471,7531,12.21%,5.89%
2020-01-01 00:15:50,9,7,32737,7023,25714,49.95%,21.45%
2020-01-01 00:15:50,9,8,10137,749,9388,15.47%,7.39%
2020-01-01 00:15:50,9,9,259,0,259,0.40%,0.00%
2020-01-01 00:15:50,9,10,3531,90,3441,5.39%,2.55%
2020-01-01 00:15:50,9,11,8704,568,8136,13.28%,6.52%
2020-01-01 00:15:50,9,12,4901,174,4727,7.48%,3.55%
2020-01-01 00:15:50,10,1,1399,275,1124,2.13%,19.64%
2020-01-01 00:15:50,10,2,3804,368,3436,5.80%,9.67%
2020-01-01 00:15:50,10,3,2140,38,2102,3.27%,1.77%
2020-01-01 00:15:50,10,4,3863,894,2969,5.89%,23.14%
2020-01-01 00:15:50,10,5,868,11,857,1.32%,1.27%
2020-01-01 00:15:50,10,6,5831,1007,4824,8.90%,17.27%
2020-01-01 00:15:50,10,7,11502,1919,9583,17.55%,16.68%
2020-01-01 00:15:50,10,8,28368,6856,21512,43.29%,24.17%
2020-01-01 00:15:50,10,9,1043,9,1034,1.59%,0.86%
2020-01-01 00:15:50,10,10,3416,81,3335,5.21%,2.37%
2020-01-01 00:15:50,10,11,13271,1647,11624,20.25%,12.41%
2020-01-01 00:15:50,10,12,9101,1056,8045,13.89%,11.60%
2020-01-01 00:15:50,11,1,2680,47,2633,4.09%,1.75%
2020-01-01 00:15:50,11,2,3690,98,3592,5.63%,2.66%
2020-01-01 00:15:50,11,3,828,5,823,1.26%,0.60%
2020-01-01 00:15:50,11,4,6457,316,6141,9.85%,4.89%
2020-01-01 00:15:50,11,5,219,0,219,0.33%,0.00%
2020-01-01 00:15:50,11,6,7305,411,6894,11.15%,5.63%
2020-01-01 00:15:50,11,7,12821,1197,11624,19.56%,9.34%
2020-01-01 00:15:50,11,8,27022,4912,22110,41.23%,18.18%
2020-01-01 00:15:50,11,9,335,0,335,0.51%,0.00%
2020-01-01 00:15:50,11,10,3151,92,3059,4.81%,2.92%
2020-01-01 00:15:50,11,11,9888,696,9192,15.09%,7.04%
2020-01-01 00:15:50,11,12,6339,291,6048,9.67%,4.59%
2020-01-01 00:15:50,12,1,39,0,39,0.06%,0.00%
2020-01-01 00:15:50,12,2,659,233,426,1.01%,35.30%
2020-01-01 00:15:50,12,3,3026,291,2735,4.62%,9.61%
2020-01-01 00:15:50,12,4,2988,89,2899,4.56%,2.98%
2020-01-01 00:15:50,12,5,9830,953,8877,15.00%,9.69%
2020-01-01 00:15:50,12,6,5737,275,5462,8.75%,4.79%
2020-01-01 00:15:50,12,7,2610,39,2571,3.98%,1.49%
2020-01-01 00:15:50,12,8,1257,286,971,1.92%,22.73%
2020-01-01 00:15:50,12,9,22474,4475,17999,34.29%,19.91%
2020-01-01 00:15:50,12,10,3709,376,3333,5.66%,10.13%
2020-01-01 00:15:50,12,11,1532,298,1234,2.34%,19.44%
2020-01-01 00:15:50,12,12,7873,1092,6781,12.01%,13.87%
2020-01-01 00:15:50,13,1,2535,50,2485,3.87%,1.97%
2020-01-01 00:15:50,13,2,3036,72,2964,4.63%,2.37%
2020-01-01 00:15:50,13,3,792,1,791,1.21%,0.13%
2020-01-01 00:15:50,13,4,4184,434,3750,6.38%,10.37%
2020-01-01 00:15:50,13,5,6896,735,6161,10.52%,10.66%
2020-01-01 00:15:50,13,6,4966,479,4487,7.58%,9.64%
2020-01-01 00:15:50,13,7,5652,256,5396,8.62%,4.53%
2020-01-01 00:15:50,13,8,7700,472,7228,11.75%,6.13%
2020-01-01 00:15:50,13,9,7233,762,6471,11.04%,10.53%
2020-01-01 00:15:50,13,10,27336,5455,21881,41.71%,19.95%
2020-01-01 00:15:50,13,11,17435,2363,15072,26.60%,13.55%
2020-01-01 00:15:50,13,12,9318,943,8375,14.22%,10.12%
2020-01-01 00:15:50,14,1,361,0,361,0.55%,0.00%
2020-01-01 00:15:50,14,2,1684,15,1669,2.57%,0.89%
2020-01-01 00:15:50,14,3,1059,5,1054,1.62%,0.47%
2020-01-01 00:15:50,14,4,4549,162,4387,6.94%,3.56%
2020-01-01 00:15:50,14,5,1761,27,1734,2.69%,1.53%
2020-01-01 00:15:50,14,6,4899,188,4711,7.48%,3.84%
2020-01-01 00:15:50,14,7,12313,1138,11175,18.79%,9.24%
2020-01-01 00:15:50,14,8,14043,1467,12576,21.43%,10.45%
2020-01-01 00:15:50,14,9,1922,29,1893,2.93%,1.51%
2020-01-01 00:15:50,14,10,4427,142,4285,6.76%,3.21%
2020-01-01 00:15:50,14,11,26024,4515,21509,39.71%,17.35%
2020-01-01 00:15:50,14,12,7384,375,7009,11.27%,5.08%
2020-01-01 00:15:50,15,1,440,2,438,0.67%,0.45%
2020-01-01 00:15:50,15,2,143,0,143,0.22%,0.00%
2020-01-01 00:15:50,15,3,3898,116,3782,5.95%,2.98%
2020-01-01 00:15:50,15,4,6890,352,6538,10.51%,5.11%
2020-01-01 00:15:50,15,5,11495,1051,10444,17.54%,9.14%
2020-01-01 00:15:50,15,6,7098,379,6719,10.83%,5.34%
2020-01-01 00:15:50,15,7,3651,137,3514,5.57%,3.75%
2020-01-01 00:15:50,15,8,5625,289,5336,8.58%,5.14%
2020-01-01 00:15:50,15,9,11688,1084,10604,17.83%,9.27%
2020-01-01 00:15:50,15,10,4554,180,4374,6.95%,3.95%
2020-01-01 00:15:50,15,11,10313,851,9462,15.74%,8.25%
2020-01-01 00:15:50,15,12,27168,5243,21925,41.46%,19.30%
2020-01-01 00:15:50,16,1,482,0,482,0.74%,0.00%
2020-01-01 00:15:50,16,2,305,1,304,0.47%,0.33%
2020-01-01 00:15:50,16,3,1357,12,1345,2.07%,0.88%
2020-01-01 00:15:50,16,4,4942,204,4738,7.54%,4.13%
2020-01-01 00:15:50,16,5,8560,643,7917,13.06%,7.51%
2020-01-01 00:15:50,16,6,5787,283,5504,8.83%,4.89%
2020-01-01 00:15:50,16,7,3380,106,3274,5.16%,3.14%
2020-01-01 00:15:50,16,8,7273,481,6792,11.10%,6.61%
2020-01-01 00:15:50,16,9,8933,675,8258,13.63%,7.56%
2020-01-01 00:15:50,16,10,1310,13,1297,2.00%,0.99%
2020-01-01 00:15:50,16,11,8783,672,8111,13.40%,7.65%
2020-01-01 00:15:50,16,12,25816,4640,21176,39.39%,17.97%
2020-01-01 00:16:00,1,1,19777,2755,17022,30.18%,13.93%
2020-01-01 00:16:00,1,2,7419,415,7004,11.32%,5.59%
2020-01-01 00:16:00,1,3,1966,22,1944,3.00%,1.12%
2020-01-01 00:16:00,1,4,11974,1077,10897,18.27%,8.99%
2020-01-01 00:16:00,1,5,11640,1030,10610,17.76%,8.85%
2020-01-01 00:16:00,1,6,11576,1017,10559,17.66%,8.78%
2020-01-01 00:16:00,1,7,5445,252,5193,8.31%,4.63%
2020-01-01 00:16:00,1,8,3854,127,3727,5.88%,3.29%
2020-01-01 00:16:00,1,9,11525,1009,10516,17.59%,8.75%
2020-01-01 00:16:00,1,10,2989,73,2916,4.56%,2.44%
2020-01-01 00:16:00,1,11,3097,81,3016,4.73%,2.61%
2020-01-01 00:16:00,1,12,11494,1004,10490,17.54%,8.73%
2020-01-01 00:16:00,2,1,660,1,659,1.01%,0.15%
2020-01-01 00:16:00,2,2,22767,3512,19255,34.74%,15.43%
2020-01-01 00:16:00,2,3,18485,2393,16092,28.21%,12.94%
2020-01-01 00:16:00,2,4,604,1,603,0.92%,0.17%
2020-01-01 00:16:00,2,5,11667,1040,10627,17.80%,8.91%
2020-01-01 00:16:00,2,6,39,0,39,0.06%,0.00%
2020-01-01 00:16:00,2,7,3612,105,3507,5.51%,2.91%
2020-01-01 00:16:00,2,8,2636,63,2573,4.02%,2.39%
2020-01-01 00:16:00,2,9,11537,1023,10514,17.60%,8.87%
2020-01-01 00:16:00,2,10,2025,36,1989,3.09%,1.78%
2020-01-01 00:16:00,2,11,2035,37,1998,3.11%,1.82%
2020-01-01 00:16:00,2,12,11344,984,10360,17.31%,8.67%
2020-01-01 00:16:00,3,1,1284,16,1268,1.96%,1.25%
2020-01-01 00:16:00,3,2,23568,3765,19803,35.96%,15.97%
2020-01-01 00:16:00,3,3,73532,29457,44075,112.20%,40.06%
2020-01-01 00:16:00,3,4,10848,853,9995,16.55%,7.86%
2020-01-01 00:16:00,3,5,47456,13769,33687,72.41%,29.01%
2020-01-01 00:16:00,3,6,11906,1020,10886,18.17%,8.57%
2020-01-01 00:16:00,3,7,19952,2758,17194,30.44%,13.82%
2020-01-01 00:16:00,3,8,16729,1944,14785,25.53%,11.62%
2020-01-01 00:16:00,3,9,35059,7982,27077,53.50%,22.77%
2020-01-01 00:16:00,3,10,5423,206,5217,8.27%,3.80%
2020-01-01 00:16:00,3,11,1931,25,1906,2.95%,1.29%
2020-01-01 00:16:00,3,12,25150,4294,20856,38.38%,17.07%
2020-01-01 00:16:00,4,1,563,0,563,0.86%,0.00%
2020-01-01 00:16:00,4,2,340,0,340,0.52%,0.00%
2020-01-01 00:16:00,4,3,791,9,782,1.21%,1.14%
2020-01-01 00:16:00,4,4,28846,5544,23302,44.02%,19.22%
2020-01-01 00:16:00,4,5,18064,2333,15731,27.56%,12.91%
2020-01-01 00:16:00,4,6,25121,4318,20803,38.33%,17.19%
2020-01-01 00:16:00,4,7,5688,239,5449,8.68%,4.20%
2020-01-01 00:16:00,4,8,3628,98,3530,5.54%,2.70%
2020-01-01 00:16:00,4,9,16048,1829,14219,24.49%,11.40%
2020-01-01 00:16:00,4,10,2053,38,2015,3.13%,1.85%
2020-01-01 00:16:00,4,11,146,0,146,0.22%,0.00%
2020-01-01 00:16:00,4,12,12926,1197,11729,19.72%,9.26%
2020-01-01 00:16:00,5,1,3138,79,3059,4.79%,2.52%
2020-01-01 00:16:00,5,2,762,5,757,1.16%,0.66%
2020-01-01 00:16:00,5,3,1035,4,1031,1.58%,0.39%
2020-01-01 00:16:00,5,4,26028,4622,21406,39.72%,17.76%
2020-01-01 00:16:00,5,5,9944,728,9216,15.17%,7.32%
2020-01-01 00:16:00,5,6,16089,1887,14202,24.55%,11.73%
2020-01-01 00:16:00,5,7,5593,267,5326,8.53%,4.77%
2020-01-01 00:16:00,5,8,4616,188,4428,7.04%,4.07%
2020-01-01 00:16:00,5,9,8742,545,8197,13.34%,6.23%
2020-01-01 00:16:00,5,10,1414,14,1400,2.16%,0.99%
2020-01-01 00:16:00,5,11,689,6,683,1.05%,0.87%
2020-01-01 00:16:00,5,12,7141,365,6776,10.90%,5.11%
2020-01-01 00:16:00,6,1,1140,9,1131,1.74%,0.79%
2020-01-01 00:16:00,6,2,1291,14,1277,1.97%,1.08%
2020-01-01 00:16:00,6,3,2000,29,1971,3.05%,1.45%
2020-01-01 00:16:00,6,4,1348,11,1337,2.06%,0.82%
2020-01-01 00:16:00,6,5,15095,1647,13448,23.03%,10.91%
2020-01-01 00:16:00,6,6,4805,168,4637,7.33%,3.50%
2020-01-01 00:16:00,6,7,2897,65,2832,4.42%,2.24%
2020-01-01 00:16:00,6,8,2335,41,2294,3.56%,1.76%
2020-01-01 00:16:00,6,9,7927,465,7462,12.10%,5.87%
2020-01-01 00:16:00,6,10,2021,34,1987,3.08%,1.68%
2020-01-01 00:16:00,6,11,361,4,357,0.55%,1.10%
2020-01-01 00:16:00,6,12,5840,258,5582,8.91%,4.42%
2020-01-01 00:16:00,7,1,509,1,508,0.78%,0.20%
2020-01-01 00:16:00,7,2,182,0,182,0.28%,0.00%
2020-01-01 00:16:00,7,3,1792,16,1776,2.73%,0.89%
2020-01-01 00:16:00,7,4,1989,31,1958,3.03%,1.56%
2020-01-01 00:16:00,7,5,8519,544,7975,13.00%,6.38%
2020-01-01 00:16:00,7,6,14583,1517,13066,22.25%,10.40%
2020-01-01 00:16:00,7,7,4002,143,3859,6.11%,3.57%
2020-01-01 00:16:00,7,8,1510,11,1499,2.30%,0.73%
2020-01-01 00:16:00,7,9,6648,335,6313,10.14%,5.04%
2020-01-01 00:16:00,7,10,1467,27,1440,2.24%,1.84%
2020-01-01 00:16:00,7,11,163,0,163,0.25%,0.00%
2020-01-01 00:16:00,7,12,5147,188,4959,7.85%,3.65%
2020-01-01 00:16:00,8,1,460,1,459,0.70%,0.22%
2020-01-01 00:16:00,8,2,66,0,66,0.10%,0.00%
2020-01-01 00:16:00,8,3,1640,16,1624,2.50%,0.98%
2020-01-01 00:16:00,8,4,3087,73,3014,4.71%,2.36%
2020-01-01 00:16:00,8,5,7724,423,7301,11.79%,5.48%
2020-01-01 00:16:00,8,6,16329,1912,14417,24.92%,11.71%
2020-01-01 00:16:00,8,7,5281,200,5081,8.06%,3.79%
2020-01-01 00:16:00,8,8,2029,33,1996,3.10%,1.63%
2020-01-01 00:16:00,8,9,5857,278,5579,8.94%,4.75%
2020-01-01 00:16:00,8,10,1774,26,1748,2.71%,1.46%
2020-01-01 00:16:00,8,11,313,0,313,0.48%,0.00%
2020-01-01 00:16:00,8,12,4035,137,3898,6.16%,3.39%
2020-01-01 00:16:00,9,1,750,1,749,1.14%,0.13%
2020-01-01 00:16:00,9,2,2789,43,2746,4.26%,1.54%
2020-01-01 00:16:00,9,3,1699,18,1681,2.59%,1.06%
2020-01-01 00:16:00,9,4,4240,103,4137,6.47%,2.43%
2020-01-01 00:16:00,9,5,284,1,283,0.43%,0.35%
2020-01-01 00:16:00,9,6,5516,205,5311,8.42%,3.72%
2020-01-01 00:16:00,9,7,27100,4909,22191,41.35%,18.11%
2020-01-01 00:16:00,9,8,11351,930,10421,17.32%,8.19%
2020-01-01 00:16:00,9,9,199,1,198,0.30%,0.50%
2020-01-01 00:16:00,9,10,2996,54,2942,4.57%,1.80%
2020-01-01 00:16:00,9,11,10317,770,9547,15.74%,7.46%
2020-01-01 00:16:00,9,12,6937,341,6596,10.59%,4.91%
2020-01-01 00:16:00,10,1,1289,280,1009,1.97%,21.71%
2020-01-01 00:16:00,10,2,4328,407,3921,6.60%,9.40%
2020-01-01 00:16:00,10,3,2875,48,2827,4.39%,1.67%
2020-01-01 00:16:00,10,4,4389,1093,3296,6.70%,24.90%
2020-01-01 00:16:00,10,5,749,37,712,1.14%,4.93%
2020-01-01 00:16:00,10,6,6360,1242,5118,9.70%,19.53%
2020-01-01 00:16:00,10,7,13003,2333,10670,19.84%,17.94%
2020-01-01 00:16:00,10,8,29752,7576,22176,45.40%,25.46%
2020-01-01 00:16:00,10,9,980,10,970,1.50%,1.02%
2020-01-01 00:16:00,10,10,3036,80,2956,4.63%,2.63%
2020-01-01 00:16:00,10,11,13511,1693,11818,20.62%,12.53%
2020-01-01 00:16:00,10,12,9649,1056,8593,14.72%,10.94%
2020-01-01 00:16:00,11,1,2530,44,2486,3.86%,1.74%
2020-01-01 00:16:00,11,2,3509,97,3412,5.35%,2.76%
2020-01-01 00:16:00,11,3,818,6,812,1.25%,0.73%
2020-01-01 00:16:00,11,4,4209,138,4071,6.42%,3.28%
2020-01-01 00:16:00,11,5,316,2,314,0.48%,0.63%
2020-01-01 00:16:00,11,6,5322,213,5109,8.12%,4.00%
2020-01-01 00:16:00,11,7,10646,820,9826,16.24%,7.70%
2020-01-01 00:16:00,11,8,25211,4261,20950,38.47%,16.90%
2020-01-01 00:16:00,11,9,217,0,217,0.33%,0.00%
2020-01-01 00:16:00,11,10,3364,87,3277,5.13%,2.59%
2020-01-01 00:16:00,11,11,10207,759,9448,15.57%,7.44%
2020-01-01 00:16:00,11,12,6467,335,6132,9.87%,5.18%
2020-01-01 00:16:00,12,1,95,0,95,0.14%,0.00%
2020-01-01 00:16:00,12,2,698,212,486,1.07%,30.33%
2020-01-01 00:16:00,12,3,3533,273,3260,5.39%,7.72%
2020-01-01 00:16:00,12,4,3177,101,3076,4.85%,3.18%
2020-01-01 00:16:00,12,5,10117,936,9181,15.44%,9.25%
2020-01-01 00:16:00,12,6,5686,259,5427,8.68%,4.55%
2020-01-01 00:16:00,12,7,2339,41,2298,3.57%,1.75%
2020-01-01 00:16:00,12,8,1434,306,1128,2.19%,21.32%
2020-01-01 00:16:00,12,9,23282,4569,18713,35.53%,19.62%
2020-01-01 00:16:00,12,10,4423,423,4000,6.75%,9.56%
2020-01-01 00:16:00,12,11,1578,310,1268,2.41%,19.63%
2020-01-01 00:16:00,12,12,8175,1059,7116,12.47%,12.95%
2020-01-01 00:16:00,13,1,2309,47,2262,3.52%,2.03%
2020-01-01 00:16:00,13,2,2684,59,2625,4.10%,2.20%
2020-01-01 00:16:00,13,3,767,4,763,1.17%,0.52%
2020-01-01 00:16:00,13,4,5150,475,4675,7.86%,9.22%
2020-01-01 00:16:00,13,5,7833,860,6973,11.95%,10.98%
2020-01-01 00:16:00,13,6,6042,551,5491,9.22%,9.12%
2020-01-01 00:16:00,13,7,4834,182,4652,7.38%,3.76%
2020-01-01 00:16:00,13,8,6873,374,6499,10.49%,5.44%
2020-01-01 00:16:00,13,9,8305,908,7397,12.67%,10.93%
2020-01-01 00:16:00,13,10,27031,5546,21485,41.25%,20.52%
2020-01-01 00:16:00,13,11,16188,2323,13865,24.70%,14.35%
2020-01-01 00:16:00,13,12,8865,1105,7760,13.53%,12.46%
2020-01-01 00:16:00,14,1,329,0,329,0.50%,0.00%
2020-01-01 00:16:00,14,2,1585,19,1566,2.42%,1.20%
2020-01-01 00:16:00,14,3,954,8,946,1.46%,0.84%
2020-01-01 00:16:00,14,4,4148,119,4029,6.33%,2.87%
2020-01-01 00:16:00,14,5,1337,16,1321,2.04%,1.20%
2020-01-01 00:16:00,14,6,4551,147,4404,6.94%,3.23%
2020-01-01 00:16:00,14,7,12355,1020,11335,18.85%,8.26%
2020-01-01 00:16:00,14,8,13789,1294,12495,21.04%,9.38%
2020-01-01 00:16:00,14,9,1528,19,1509,2.33%,1.24%
2020-01-01 00:16:00,14,10,4045,114,3931,6.17%,2.82%
2020-01-01 00:16:00,14,11,25924,4460,21464,39.56%,17.20%
2020-01-01 00:16:00,14,12,7765,448,7317,11.85%,5.77%
2020-01-01 00:16:00,15,1,501,1,500,0.76%,0.20%
2020-01-01 00:16:00,15,2,139,0,139,0.21%,0.00%
2020-01-01 00:16:00,15,3,4283,141,4142,6.54%,3.29%
2020-01-01 00:16:00,15,4,6045,213,5832,9.22%,3.52%
2020-01-01 00:16:00,15,5,11107,924,10183,16.95%,8.32%
2020-01-01 00:16:00,15,6,6238,226,6012,9.52%,3.62%
2020-01-01 00:16:00,15,7,3555,96,3459,5.42%,2.70%
2020-01-01 00:16:00,15,8,5925,289,5636,9.04%,4.88%
2020-01-01 00:16:00,15,9,11272,950,10322,17.20%,8.43%
2020-01-01 00:16:00,15,10,5849,264,5585,8.92%,4.51%
2020-01-01 00:16:00,15,11,11899,1061,10838,18.16%,8.92%
2020-01-01 00:16:00,15,12,28796,5677,23119,43.94%,19.71%
2020-01-01 00:16:00,16,1,420,3,417,0.64%,0.71%
2020-01-01 00:16:00,16,2,301,0,301,0.46%,0.00%
2020-01-01 00:16:00,16,3,1438,23,1415,2.19%,1.60%
2020-01-01 00:16:00,16,4,4729,166,4563,7.22%,3.51%
2020-01-01 00:16:00,16,5,8179,547,7632,12.48%,6.69%
2020-01-01 00:16:00,16,6,5590,226,5364,8.53%,4.04%
2020-01-01 00:16:00,16,7,3350,94,3256,5.11%,2.81%
2020-01-01 00:16:00,16,8,7241,498,6743,11.05%,6.88%
2020-01-01 00:16:00,16,9,8644,612,8032,13.19%,7.08%
2020-01-01 00:16:00,16,10,1541,13,1528,2.35%,0.84%
2020-01-01 00:16:00,16,11,9011,694,8317,13.75%,7.70%
2020-01-01 00:16:00,16,12,25948,4640,21308,39.59%,17.88%
2020-01-01 00:16:10,1,1,16912,2058,14854,25.81%,12.17%
2020-01-01 00:16:10,1,2,6506,330,6176,9.93%,5.07%
2020-01-01 00:16:10,1,3,434,2,432,0.66%,0.46%
2020-01-01 00:16:10,1,4,9925,744,9181,15.14%,7.50%
2020-01-01 00:16:10,1,5,9616,703,8913,14.67%,7.31%
2020-01-01 00:16:10,1,6,9526,693,8833,14.54%,7.27%
2020-01-01 00:16:10,1,7,6055,291,5764,9.24%,4.81%
2020-01-01 00:16:10,1,8,4545,164,4381,6.94%,3.61%
2020-01-01 00:16:10,1,9,9480,685,8795,14.47%,7.22%
2020-01-01 00:16:10,1,10,4058,126,3932,6.19%,3.10%
2020-01-01 00:16:10,1,11,4162,137,4025,6.35%,3.29%
2020-01-01 00:16:10,1,12,9451,680,8771,14.42%,7.19%
2020-01-01 00:16:10,2,1,1430,11,1419,2.18%,0.77%
2020-01-01 00:16:10,2,2,28075,5325,22750,42.84%,18.97%
2020-01-01 00:16:10,2,3,21747,3305,18442,33.18%,15.20%
2020-01-01 00:16:10,2,4,1372,11,1361,2.09%,0.80%
2020-01-01 00:16:10,2,5,13484,1345,12139,20.57%,9.97%
2020-01-01 00:16:10,2,6,31,0,31,0.05%,0.00%
2020-01-01 00:16:10,2,7,4884,161,4723,7.45%,3.30%
2020-01-01 00:16:10,2,8,3740,98,3642,5.71%,2.62%
2020-01-01 00:16:10,2,9,13432,1337,12095,20.50%,9.95%
2020-01-01 00:16:10,2,10,2928,55,2873,4.47%,1.88%
2020-01-01 00:16:10,2,11,2943,55,2888,4.49%,1.87%
2020-01-01 00:16:10,2,12,13269,1310,11959,20.25%,9.87%
2020-01-01 00:16:10,3,1,1566,11,1555,2.39%,0.70%
2020-01-01 00:16:10,3,2,25213,4330,20883,38.47%,17.17%
2020-01-01 00:16:10,3,3,71782,28115,43667,109.53%,39.17%
2020-01-01 00:16:10,3,4,12099,1094,11005,18.46%,9.04%
2020-01-01 00:16:10,3,5,43297,11719,31578,66.07%,27.07%
2020-01-01 00:16:10,3,6,13203,1292,11911,20.15%,9.78%
2020-01-01 00:16:10,3,7,21578,3222,18356,32.93%,14.93%
2020-01-01 00:16:10,3,8,17768,2277,15491,27.11%,12.81%
2020-01-01 00:16:10,3,9,29597,5857,23740,45.16%,19.79%
2020-01-01 00:16:10,3,10,5478,239,5239,8.36%,4.36%
2020-01-01 00:16:10,3,11,2010,41,1969,3.07%,2.04%
2020-01-01 00:16:10,3,12,21303,3147,18156,32.51%,14.77%
2020-01-01 00:16:10,4,1,595,4,591,0.91%,0.67%
2020-01-01 00:16:10,4,2,369,3,366,0.56%,0.81%
2020-01-01 00:16:10,4,3,666,4,662,1.02%,0.60%
2020-01-01 00:16:10,4,4,28899,5533,23366,44.10%,19.15%
2020-01-01 00:16:10,4,5,17870,2233,15637,27.27%,12.50%
2020-01-01 00:16:10,4,6,24728,4155,20573,37.73%,16.80%
2020-01-01 00:16:10,4,7,5289,227,5062,8.07%,4.29%
2020-01-01 00:16:10,4,8,3053,84,2969,4.66%,2.75%
2020-01-01 00:16:10,4,9,15958,1805,14153,24.35%,11.31%
2020-01-01 00:16:10,4,10,2250,34,2216,3.43%,1.51%
2020-01-01 00:16:10,4,11,221,0,221,0.34%,0.00%
2020-01-01 00:16:10,4,12,12714,1189,11525,19.40%,9.35%
2020-01-01 00:16:10,5,1,3135,77,3058,4.78%,2.46%
2020-01-01 00:16:10,5,2,820,7,813,1.25%,0.85%
2020-01-01 00:16:10,5,3,515,2,513,0.79%,0.39%
2020-01-01 00:16:10,5,4,26278,4618,21660,40.10%,17.57%
2020-01-01 00:16:10,5,5,8183,488,7695,12.49%,5.96%
2020-01-01 00:16:10,5,6,16942,2017,14925,25.85%,11.90%
2020-01-01 00:16:10,5,7,8104,483,7621,12.37%,5.96%
2020-01-01 00:16:10,5,8,3628,103,3525,5.54%,2.84%
2020-01-01 00:16:10,5,9,7514,409,7105,11.47%,5.44%
2020-01-01 00:16:10,5,10,797,2,795,1.22%,0.25%
2020-01-01 00:16:10,5,11,465,7,458,0.71%,1.50%
2020-01-01 00:16:10,5,12,6450,313,6137,9.84%,4.85%
2020-01-01 00:16:10,6,1,1005,11,994,1.53%,1.09%
2020-01-01 00:16:10,6,2,1110,11,1099,1.69%,0.99%
2020-01-01 00:16:10,6,3,1762,36,1726,2.69%,2.04%
2020-01-01 00:16:10,6,4,1417,40,1377,2.16%,2.82%
2020-01-01 00:16:10,6,5,13620,1380,12240,20.78%,10.13%
2020-01-01 00:16:10,6,6,5073,268,4805,7.74%,5.28%
2020-01-01 00:16:10,6,7,3099,125,2974,4.73%,4.03%
2020-01-01 00:16:10,6,8,2405,95,2310,3.67%,3.95%
2020-01-01 00:16:10,6,9,6577,314,6263,10.04%,4.77%
2020-01-01 00:16:10,6,10,2127,32,2095,3.25%,1.50%
2020-01-01 00:16:10,6,11,413,1,412,0.63%,0.24%
2020-01-01 00:16:10,6,12,4394,151,4243,6.70%,3.44%
2020-01-01 00:16:10,7,1,424,1,423,0.65%,0.24%
2020-01-01 00:16:10,7,2,164,0,164,0.25%,0.00%
2020-01-01 00:16:10,7,3,970,4,966,1.48%,0.41%
2020-01-01 00:16:10,7,4,2126,39,2087,3.24%,1.83%
2020-01-01 00:16:10,7,5,7857,436,7421,11.99%,5.55%
2020-01-01 00:16:10,7,6,13684,1319,12365,20.88%,9.64%
2020-01-01 00:16:10,7,7,3639,123,3516,5.55%,3.38%
2020-01-01 00:16:10,7,8,1556,36,1520,2.37%,2.31%
2020-01-01 00:16:10,7,9,6665,312,6353,10.17%,4.68%
2020-01-01 00:16:10,7,10,1205,11,1194,1.84%,0.91%
2020-01-01 00:16:10,7,11,78,0,78,0.12%,0.00%
2020-01-01 00:16:10,7,12,5423,215,5208,8.27%,3.96%
2020-01-01 00:16:10,8,1,437,2,435,0.67%,0.46%
2020-01-01 00:16:10,8,2,63,0,63,0.10%,0.00%
2020-01-01 00:16:10,8,3,2050,41,2009,3.13%,2.00%
2020-01-01 00:16:10,8,4,2918,63,2855,4.45%,2.16%
2020-01-01 00:16:10,8,5,8118,467,7651,12.39%,5.75%
2020-01-01 00:16:10,8,6,17454,2164,15290,26.63%,12.40%
2020-01-01 00:16:10,8,7,6259,264,5995,9.55%,4.22%
2020-01-01 00:16:10,8,8,3066,57,3009,4.68%,1.86%
2020-01-01 00:16:10,8,9,5858,238,5620,8.94%,4.06%
2020-01-01 00:16:10,8,10,1673,21,1652,2.55%,1.25%
2020-01-01 00:16:10,8,11,198,0,198,0.30%,0.00%
2020-01-01 00:16:10,8,12,4145,125,4020,6.32%,3.01%
2020-01-01 00:16:10,9,1,464,1,463,0.71%,0.22%
2020-01-01 00:16:10,9,2,2347,39,2308,3.58%,1.66%
2020-01-01 00:16:10,9,3,1486,12,1474,2.27%,0.81%
2020-01-01 00:16:10,9,4,7807,464,7343,11.91%,5.94%
2020-01-01 00:16:10,9,5,419,1,418,0.64%,0.24%
2020-01-01 00:16:10,9,6,9264,660,8604,14.14%,7.12%
2020-01-01 00:16:10,9,7,29032,5616,23416,44.30%,19.34%
2020-01-01 00:16:10,9,8,11880,1050,10830,18.13%,8.84%
2020-01-01 00:16:10,9,9,300,0,300,0.46%,0.00%
2020-01-01 00:16:10,9,10,4710,181,4529,7.19%,3.84%
2020-01-01 00:16:10,9,11,10647,868,9779,16.25%,8.15%
2020-01-01 00:16:10,9,12,5524,214,5310,8.43%,3.87%
2020-01-01 00:16:10,10,1,1323,260,1063,2.02%,19.64%
2020-01-01 00:16:10,10,2,3341,323,3018,5.10%,9.66%
2020-01-01 00:16:10,10,3,1887,29,1858,2.88%,1.54%
2020-01-01 00:16:10,10,4,4194,1113,3081,6.40%,26.53%
2020-01-01 00:16:10,10,5,1127,87,1040,1.72%,7.71%
2020-01-01 00:16:10,10,6,6454,1326,5128,9.85%,20.54%
2020-01-01 00:16:10,10,7,11433,2118,9315,17.45%,18.52%
2020-01-01 00:16:10,10,8,29791,7837,21954,45.46%,26.31%
2020-01-01 00:16:10,10,9,765,2,763,1.17%,0.26%
2020-01-01 00:16:10,10,10,2890,53,2837,4.41%,1.83%
2020-01-01 00:16:10,10,11,14438,1927,12511,22.03%,13.35%
2020-01-01 00:16:10,10,12,10562,1239,9323,16.12%,11.73%
2020-01-01 00:16:10,11,1,2623,60,2563,4.00%,2.29%
2020-01-01 00:16:10,11,2,3544,97,3447,5.41%,2.74%
2020-01-01 00:16:10,11,3,751,5,746,1.15%,0.66%
2020-01-01 00:16:10,11,4,3032,74,2958,4.63%,2.44%
2020-01-01 00:16:10,11,5,273,2,271,0.42%,0.73%
2020-01-01 00:16:10,11,6,4120,142,3978,6.29%,3.45%
2020-01-01 00:16:10,11,7,9497,670,8827,14.49%,7.05%
2020-01-01 00:16:10,11,8,23747,3843,19904,36.24%,16.18%
2020-01-01 00:16:10,11,9,215,0,215,0.33%,0.00%
2020-01-01 00:16:10,11,10,2891,51,2840,4.41%,1.76%
2020-01-01 00:16:10,11,11,10291,789,9502,15.70%,7.67%
2020-01-01 00:16:10,11,12,6906,394,6512,10.54%,5.70%
2020-01-01 00:16:10,12,1,44,0,44,0.07%,0.00%
2020-01-01 00:16:10,12,2,657,164,493,1.00%,24.92%
2020-01-01 00:16:10,12,3,3196,218,2978,4.88%,6.82%
2020-01-01 00:16:10,12,4,2842,87,2755,4.34%,3.06%
2020-01-01 00:16:10,12,5,8674,722,7952,13.24%,8.32%
2020-01-01 00:16:10,12,6,4712,206,4506,7.19%,4.37%
2020-01-01 00:16:10,12,7,1662,24,1638,2.54%,1.44%
2020-01-01 00:16:10,12,8,1454,309,1145,2.22%,21.24%
2020-01-01 00:16:10,12,9,22668,4472,18196,34.59%,19.73%
2020-01-01 00:16:10,12,10,5135,477,4658,7.84%,9.29%
2020-01-01 00:16:10,12,11,1693,314,1379,2.58%,18.54%
2020-01-01 00:16:10,12,12,8150,1173,6977,12.44%,14.39%
2020-01-01 00:16:10,13,1,2363,50,2313,3.61%,2.12%
2020-01-01 00:16:10,13,2,2709,65,2644,4.13%,2.40%
2020-01-01 00:16:10,13,3,927,7,920,1.41%,0.75%
2020-01-01 00:16:10,13,4,5706,503,5203,8.71%,8.81%
2020-01-01 00:16:10,13,5,8160,813,7347,12.45%,9.96%
2020-01-01 00:16:10,13,6,6488,569,5919,9.90%,8.77%
2020-01-01 00:16:10,13,7,4895,196,4699,7.47%,4.00%
2020-01-01 00:16:10,13,8,7756,507,7249,11.83%,6.54%
2020-01-01 00:16:10,13,9,8645,881,7764,13.19%,10.19%
2020-01-01 00:16:10,13,10,29036,6215,22821,44.31%,21.40%
2020-01-01 00:16:10,13,11,17399,2695,14704,26.55%,15.49%
2020-01-01 00:16:10,13,12,9251,1135,8116,14.12%,12.27%
2020-01-01 00:16:10,14,1,369,0,369,0.56%,0.00%
2020-01-01 00:16:10,14,2,1524,15,1509,2.33%,0.98%
2020-01-01 00:16:10,14,3,923,9,914,1.41%,0.97%
2020-01-01 00:16:10,14,4,4586,194,4392,7.00%,4.23%
2020-01-01 00:16:10,14,5,1412,12,1400,2.15%,0.85%
2020-01-01 00:16:10,14,6,4824,212,4612,7.36%,4.39%
2020-01-01 00:16:10,14,7,12954,1169,11785,19.77%,9.02%
2020-01-01 00:16:10,14,8,14705,1484,13221,22.44%,10.09%
2020-01-01 00:16:10,14,9,1593,18,1575,2.43%,1.13%
2020-01-01 00:16:10,14,10,3740,103,3637,5.71%,2.75%
2020-01-01 00:16:10,14,11,26719,4763,21956,40.77%,17.83%
2020-01-01 00:16:10,14,12,7939,450,7489,12.11%,5.67%
2020-01-01 00:16:10,15,1,540,5,535,0.82%,0.92%
2020-01-01 00:16:10,15,2,110,0,110,0.17%,0.00%
2020-01-01 00:16:10,15,3,3665,114,3551,5.59%,3.11%
2020-01-01 00:16:10,15,4,5044,229,4815,7.70%,4.54%
2020-01-01 00:16:10,15,5,9469,706,8763,14.45%,7.46%
2020-01-01 00:16:10,15,6,5238,243,4995,7.99%,4.64%
2020-01-01 00:16:10,15,7,3747,111,3636,5.72%,2.96%
2020-01-01 00:16:10,15,8,5728,266,5462,8.74%,4.64%
2020-01-01 00:16:10,15,9,9637,730,8907,14.70%,7.57%
2020-01-01 00:16:10,15,10,4331,266,4065,6.61%,6.14%
2020-01-01 00:16:10,15,11,10181,897,9284,15.53%,8.81%
2020-01-01 00:16:10,15,12,26025,5150,20875,39.71%,19.79%
2020-01-01 00:16:10,16,1,526,4,522,0.80%,0.76%
2020-01-01 00:16:10,16,2,237,1,236,0.36%,0.42%
2020-01-01 00:16:10,16,3,1821,19,1802,2.78%,1.04%
2020-01-01 00:16:10,16,4,4579,124,4455,6.99%,2.71%
2020-01-01 00:16:10,16,5,8399,558,7841,12.82%,6.64%
2020-01-01 00:16:10,16,6,5555,210,5345,8.48%,3.78%
2020-01-01 00:16:10,16,7,3945,124,3821,6.02%,3.14%
2020-01-01 00:16:10,16,8,7490,514,6976,11.43%,6.86%
2020-01-01 00:16:10,16,9,8939,629,8310,13.64%,7.04%
2020-01-01 00:16:10,16,10,1715,22,1693,2.62%,1.28%
2020-01-01 00:16:10,16,11,9423,758,8665,14.38%,8.04%
2020-01-01 00:16:10,16,12,26279,4732,21547,40.10%,18.01%
2020-01-01 00:16:20,1,1,17202,2050,15152,26.25%,11.92%
2020-01-01 00:16:20,1,2,6430,323,6107,9.81%,5.02%
2020-01-01 00:16:20,1,3,318,1,317,0.49%,0.31%
2020-01-01 00:16:20,1,4,10141,750,9391,15.47%,7.39%
2020-01-01 00:16:20,1,5,6996,371,6625,10.68%,5.30%
2020-01-01 00:16:20,1,6,6937,361,6576,10.59%,5.20%
2020-01-01 00:16:20,1,7,6094,291,5803,9.30%,4.77%
2020-01-01 00:16:20,1,8,3999,136,3863,6.10%,3.40%
2020-01-01 00:16:20,1,9,6889,361,6528,10.51%,5.24%
2020-01-01 00:16:20,1,10,3269,87,3182,4.99%,2.66%
2020-01-01 00:16:20,1,11,3384,97,3287,5.16%,2.87%
2020-01-01 00:16:20,1,12,6867,357,6510,10.48%,5.20%
2020-01-01 00:16:20,2,1,1737,30,1707,2.65%,1.73%
2020-01-01 00:16:20,2,2,27543,5100,22443,42.03%,18.52%
2020-01-01 00:16:20,2,3,21104,3095,18009,32.20%,14.66%
2020-01-01 00:16:20,2,4,1643,25,1618,2.51%,1.52%
2020-01-01 00:16:20,2,5,11031,915,10116,16.83%,8.29%
2020-01-01 00:16:20,2,6,23,0,23,0.04%,0.00%
2020-01-01 00:16:20,2,7,4686,147,4539,7.15%,3.14%
2020-01-01 00:16:20,2,8,3481,85,3396,5.31%,2.44%
2020-01-01 00:16:20,2,9,10989,910,10079,16.77%,8.28%
2020-01-01 00:16:20,2,10,2678,38,2640,4.09%,1.42%
2020-01-01 00:16:20,2,11,2703,38,2665,4.12%,1.41%
2020-01-01 00:16:20,2,12,10844,890,9954,16.55%,8.21%
2020-01-01 00:16:20,3,1,1788,27,1761,2.73%,1.51%
2020-01-01 00:16:20,3,2,22778,3520,19258,34.76%,15.45%
2020-01-01 00:16:20,3,3,78116,32465,45651,119.20%,41.56%
2020-01-01 00:16:20,3,4,10932,869,10063,16.68%,7.95%
2020-01-01 00:16:20,3,5,54248,17325,36923,82.78%,31.94%
2020-01-01 00:16:20,3,6,12573,1122,11451,19.18%,8.92%
2020-01-01 00:16:20,3,7,19393,2596,16797,29.59%,13.39%
2020-01-01 00:16:20,3,8,16532,1914,14618,25.23%,11.58%
2020-01-01 00:16:20,3,9,41298,10634,30664,63.02%,25.75%
2020-01-01 00:16:20,3,10,8441,518,7923,12.88%,6.14%
2020-01-01 00:16:20,3,11,1982,39,1943,3.02%,1.97%
2020-01-01 00:16:20,3,12,30471,6119,24352,46.50%,20.08%
2020-01-01 00:16:20,4,1,631,3,628,0.96%,0.47%
2020-01-01 00:16:20,4,2,394,1,393,0.60%,0.25%
2020-01-01 00:16:20,4,3,689,3,686,1.05%,0.43%
2020-01-01 00:16:20,4,4,27675,5109,22566,42.23%,18.46%
2020-01-01 00:16:20,4,5,17321,2133,15188,26.43%,12.31%
2020-01-01 00:16:20,4,6,23970,3891,20079,36.58%,16.23%
2020-01-01 00:16:20,4,7,5252,171,5081,8.01%,3.26%
2020-01-01 00:16:20,4,8,3176,65,3111,4.85%,2.05%
2020-01-01 00:16:20,4,9,15408,1729,13679,23.51%,11.22%
2020-01-01 00:16:20,4,10,2147,34,2113,3.28%,1.58%
2020-01-01 00:16:20,4,11,236,0,236,0.36%,0.00%
2020-01-01 00:16:20,4,12,12366,1140,11226,18.87%,9.22%
2020-01-01 00:16:20,5,1,2671,54,2617,4.08%,2.02%
2020-01-01 00:16:20,5,2,644,1,643,0.98%,0.16%
2020-01-01 00:16:20,5,3,1989,31,1958,3.03%,1.56%
2020-01-01 00:16:20,5,4,24317,4073,20244,37.10%,16.75%
2020-01-01 00:16:20,5,5,10715,855,9860,16.35%,7.98%
2020-01-01 00:16:20,5,6,15889,1832,14057,24.24%,11.53%
2020-01-01 00:16:20,5,7,4701,169,4532,7.17%,3.59%
2020-01-01 00:16:20,5,8,3265,84,3181,4.98%,2.57%
2020-01-01 00:16:20,5,9,8594,557,8037,13.11%,6.48%
2020-01-01 00:16:20,5,10,935,10,925,1.43%,1.07%
2020-01-01 00:16:20,5,11,326,4,322,0.50%,1.22%
2020-01-01 00:16:20,5,12,7153,397,6756,10.91%,5.55%
2020-01-01 00:16:20,6,1,1198,14,1184,1.83%,1.17%
2020-01-01 00:16:20,6,2,1255,15,1240,1.91%,1.19%
2020-01-01 00:16:20,6,3,1744,23,1721,2.66%,1.32%
2020-01-01 00:16:20,6,4,1093,26,1067,1.67%,2.38%
2020-01-01 00:16:20,6,5,14084,1410,12674,21.49%,10.01%
2020-01-01 00:16:20,6,6,5925,302,5623,9.04%,5.10%
2020-01-01 00:16:20,6,7,4395,165,4230,6.71%,3.75%
2020-01-01 00:16:20,6,8,3450,84,3366,5.26%,2.43%
2020-01-01 00:16:20,6,9,6172,271,5901,9.42%,4.39%
2020-01-01 00:16:20,6,10,2203,41,2162,3.36%,1.86%
2020-01-01 00:16:20,6,11,471,0,471,0.72%,0.00%
2020-01-01 00:16:20,6,12,3944,107,3837,6.02%,2.71%
2020-01-01 00:16:20,7,1,564,3,561,0.86%,0.53%
2020-01-01 00:16:20,7,2,137,0,137,0.21%,0.00%
2020-01-01 00:16:20,7,3,634,3,631,0.97%,0.47%
2020-01-01 00:16:20,7,4,2628,56,2572,4.01%,2.13%
2020-01-01 00:16:20,7,5,7959,464,7495,12.14%,5.83%
2020-01-01 00:16:20,7,6,13854,1403,12451,21.14%,10.13%
2020-01-01 00:16:20,7,7,3200,90,3110,4.88%,2.81%
2020-01-01 00:16:20,7,8,1453,17,1436,2.22%,1.17%
2020-01-01 00:16:20,7,9,6900,355,6545,10.53%,5.14%
2020-01-01 00:16:20,7,10,1477,13,1464,2.25%,0.88%
2020-01-01 00:16:20,7,11,98,0,98,0.15%,0.00%
2020-01-01 00:16:20,7,12,5382,232,5150,8.21%,4.31%
2020-01-01 00:16:20,8,1,355,1,354,0.54%,0.28%
2020-01-01 00:16:20,8,2,96,0,96,0.15%,0.00%
2020-01-01 00:16:20,8,3,2507,44,2463,3.83%,1.75%
2020-01-01 00:16:20,8,4,2803,79,2724,4.28%,2.82%
2020-01-01 00:16:20,8,5,9833,661,9172,15.00%,6.72%
2020-01-01 00:16:20,8,6,17395,2097,15298,26.54%,12.05%
2020-01-01 00:16:20,8,7,4622,170,4452,7.05%,3.68%
2020-01-01 00:16:20,8,8,1970,40,1930,3.01%,2.03%
2020-01-01 00:16:20,8,9,7100,366,6734,10.83%,5.15%
2020-01-01 00:16:20,8,10,2898,45,2853,4.42%,1.55%
2020-01-01 00:16:20,8,11,157,0,157,0.24%,0.00%
2020-01-01 00:16:20,8,12,4122,134,3988,6.29%,3.25%
2020-01-01 00:16:20,9,1,293,0,293,0.45%,0.00%
2020-01-01 00:16:20,9,2,2012,30,1982,3.07%,1.49%
2020-01-01 00:16:20,9,3,1385,17,1368,2.11%,1.23%
2020-01-01 00:16:20,9,4,5020,168,4852,7.66%,3.35%
2020-01-01 00:16:20,9,5,456,3,453,0.70%,0.66%
2020-01-01 00:16:20,9,6,6172,245,5927,9.42%,3.97%
2020-01-01 00:16:20,9,7,28948,5642,23306,44.17%,19.49%
2020-01-01 00:16:20,9,8,12001,1106,10895,18.31%,9.22%
2020-01-01 00:16:20,9,9,335,2,333,0.51%,0.60%
2020-01-01 00:16:20,9,10,4490,194,4296,6.85%,4.32%
2020-01-01 00:16:20,9,11,10819,923,9896,16.51%,8.53%
2020-01-01 00:16:20,9,12,6020,330,5690,9.19%,5.48%
2020-01-01 00:16:20,10,1,1506,295,1211,2.30%,19.58%
2020-01-01 00:16:20,10,2,3349,392,2957,5.11%,11.70%
2020-01-01 00:16:20,10,3,1730,38,1692,2.64%,2.20%
2020-01-01 00:16:20,10,4,3853,1044,2809,5.88%,27.09%
2020-01-01 00:16:20,10,5,893,113,780,1.36%,12.64%
2020-01-01 00:16:20,10,6,6059,1284,4775,9.25%,21.19%
2020-01-01 00:16:20,10,7,11093,2126,8967,16.93%,19.16%
2020-01-01 00:16:20,10,8,30824,8169,22655,47.03%,26.50%
2020-01-01 00:16:20,10,9,518,3,515,0.79%,0.58%
2020-01-01 00:16:20,10,10,2838,59,2779,4.33%,2.08%
2020-01-01 00:16:20,10,11,14732,2053,12679,22.48%,13.93%
2020-01-01 00:16:20,10,12,11089,1423,9666,16.92%,12.83%
2020-01-01 00:16:20,11,1,2758,68,2690,4.21%,2.46%
2020-01-01 00:16:20,11,2,3681,116,3565,5.62%,3.15%
2020-01-01 00:16:20,11,3,719,5,714,1.10%,0.69%
2020-01-01 00:16:20,11,4,3091,88,3003,4.72%,2.85%
2020-01-01 00:16:20,11,5,198,0,198,0.30%,0.00%
2020-01-01 00:16:20,11,6,3981,135,3846,6.07%,3.39%
2020-01-01 00:16:20,11,7,9330,673,8657,14.24%,7.21%
2020-01-01 00:16:20,11,8,23284,3789,19495,35.53%,16.27%
2020-01-01 00:16:20,11,9,296,0,296,0.45%,0.00%
2020-01-01 00:16:20,11,10,3061,80,2981,4.67%,2.61%
2020-01-01 00:16:20,11,11,10328,807,9521,15.76%,7.81%
2020-01-01 00:16:20,11,12,6695,349,6346,10.22%,5.21%
2020-01-01 00:16:20,12,1,49,0,49,0.07%,0.00%
2020-01-01 00:16:20,12,2,582,165,417,0.89%,28.30%
2020-01-01 00:16:20,12,3,2223,191,2032,3.39%,8.59%
2020-01-01 00:16:20,12,4,2741,119,2622,4.18%,4.34%
2020-01-01 00:16:20,12,5,7216,585,6631,11.01%,8.11%
2020-01-01 00:16:20,12,6,4353,203,4150,6.64%,4.66%
2020-01-01 00:16:20,12,7,1456,19,1437,2.22%,1.30%
2020-01-01 00:16:20,12,8,1484,340,1144,2.26%,22.90%
2020-01-01 00:16:20,12,9,20503,4023,16480,31.29%,19.62%
2020-01-01 00:16:20,12,10,4961,477,4484,7.57%,9.61%
2020-01-01 00:16:20,12,11,1746,342,1404,2.66%,19.58%
2020-01-01 00:16:20,12,12,7272,1231,6041,11.10%,16.93%
2020-01-01 00:16:20,13,1,2002,30,1972,3.05%,1.50%
2020-01-01 00:16:20,13,2,2427,44,2383,3.70%,1.81%
2020-01-01 00:16:20,13,3,882,6,876,1.35%,0.68%
2020-01-01 00:16:20,13,4,4358,468,3890,6.65%,10.74%
2020-01-01 00:16:20,13,5,6647,734,5913,10.14%,11.04%
2020-01-01 00:16:20,13,6,5037,508,4529,7.69%,10.08%
2020-01-01 00:16:20,13,7,4558,147,4411,6.95%,3.22%
2020-01-01 00:16:20,13,8,8251,507,7744,12.59%,6.14%
2020-01-01 00:16:20,13,9,6938,769,6169,10.59%,11.08%
2020-01-01 00:16:20,13,10,27741,5760,21981,42.33%,20.76%
2020-01-01 00:16:20,13,11,17485,2466,15019,26.68%,14.10%
2020-01-01 00:16:20,13,12,8902,950,7952,13.58%,10.67%
2020-01-01 00:16:20,14,1,208,0,208,0.32%,0.00%
2020-01-01 00:16:20,14,2,1556,17,1539,2.37%,1.09%
2020-01-01 00:16:20,14,3,1170,8,1162,1.79%,0.68%
2020-01-01 00:16:20,14,4,3892,137,3755,5.94%,3.52%
2020-01-01 00:16:20,14,5,1303,18,1285,1.99%,1.38%
2020-01-01 00:16:20,14,6,4102,151,3951,6.26%,3.68%
2020-01-01 00:16:20,14,7,11929,1079,10850,18.20%,9.04%
2020-01-01 00:16:20,14,8,13439,1346,12093,20.51%,10.01%
2020-01-01 00:16:20,14,9,1471,22,1449,2.24%,1.49%
2020-01-01 00:16:20,14,10,3955,131,3824,6.03%,3.31%
2020-01-01 00:16:20,14,11,26222,4606,21616,40.01%,17.56%
2020-01-01 00:16:20,14,12,8450,525,7925,12.89%,6.21%
2020-01-01 00:16:20,15,1,616,2,614,0.94%,0.32%
2020-01-01 00:16:20,15,2,115,0,115,0.18%,0.00%
2020-01-01 00:16:20,15,3,3215,89,3126,4.91%,2.77%
2020-01-01 00:16:20,15,4,4734,187,4547,7.22%,3.95%
2020-01-01 00:16:20,15,5,8898,579,8319,13.58%,6.51%
2020-01-01 00:16:20,15,6,4965,205,4760,7.58%,4.13%
2020-01-01 00:16:20,15,7,3633,96,3537,5.54%,2.64%
2020-01-01 00:16:20,15,8,5511,200,5311,8.41%,3.63%
2020-01-01 00:16:20,15,9,9089,611,8478,13.87%,6.72%
2020-01-01 00:16:20,15,10,5217,422,4795,7.96%,8.09%
2020-01-01 00:16:20,15,11,10853,1039,9814,16.56%,9.57%
2020-01-01 00:16:20,15,12,25391,4835,20556,38.74%,19.04%
2020-01-01 00:16:20,16,1,467,7,460,0.71%,1.50%
2020-01-01 00:16:20,16,2,295,0,295,0.45%,0.00%
2020-01-01 00:16:20,16,3,1711,34,1677,2.61%,1.99%
2020-01-01 00:16:20,16,4,5659,232,5427,8.63%,4.10%
2020-01-01 00:16:20,16,5,9200,708,8492,14.04%,7.69%
2020-01-01 00:16:20,16,6,6584,323,6261,10.05%,4.91%
2020-01-01 00:16:20,16,7,3491,109,3382,5.33%,3.12%
2020-01-01 00:16:20,16,8,7476,473,7003,11.41%,6.33%
2020-01-01 00:16:20,16,9,9724,782,8942,14.84%,8.04%
2020-01-01 00:16:20,16,10,1498,15,1483,2.29%,1.00%
2020-01-01 00:16:20,16,11,9169,644,8525,13.99%,7.02%
2020-01-01 00:16:20,16,12,26902,4962,21940,41.05%,18.44%
